state_name,year,details,male,female,total
ANDHRA PRADESH,2001,Convicts Released - Released after completion of conviction,9716,447,10163
ANDHRA PRADESH,2001,Convicts Released - Premature release,232,1,233
ANDHRA PRADESH,2001,Convicts Released - Released on appeal,626,37,663
ANDHRA PRADESH,2001,Convicts Released - Released on bail,5656,260,5916
ANDHRA PRADESH,2001,Convicts Released - Pardons,42,10,52
ANDHRA PRADESH,2001,Convicts Released - Transferred to other States,0,0,0
ANDHRA PRADESH,2001,"Convicts Released - Other Releases (due to illness, transferred to Mental hospital)",116,0,116
ANDHRA PRADESH,2001,Total Convicts Released,16388,755,17143
ANDHRA PRADESH,2001,Under trials Released - Acquitted,7791,717,8508
ANDHRA PRADESH,2001,Under trials Released - Released on appeal,16,0,16
ANDHRA PRADESH,2001,Under trials Released - Released on bail,118487,14780,133267
ANDHRA PRADESH,2001,Under trials Released - Transferred to other States,0,0,0
ANDHRA PRADESH,2001,Under trials Released - Extradited,13,2,15
ANDHRA PRADESH,2001,Under trials Released - Other releases (transferred to Mental/Civil hospital),958,37,995
ANDHRA PRADESH,2001,Total Under trials Released,127265,15536,142801
ANDHRA PRADESH,2001,Detenus Released - Released on completion of detention period,0,0,0
ANDHRA PRADESH,2001,Detenus Released - Released before completion of detention period,2,0,2
ANDHRA PRADESH,2001,Detenus Released - Released on bail,1,0,1
ANDHRA PRADESH,2001,Detenus Released - Other releases (temporary transfer etc.),0,0,0
ANDHRA PRADESH,2001,Total Detenus Released,3,0,3
ANDHRA PRADESH,2002,Convicts Released - Released after completion of conviction,7562,316,7878
ANDHRA PRADESH,2002,Convicts Released - Premature release,223,0,223
ANDHRA PRADESH,2002,Convicts Released - Released on appeal,636,32,668
ANDHRA PRADESH,2002,Convicts Released - Released on bail,3522,178,3700
ANDHRA PRADESH,2002,Convicts Released - Pardons,131,0,131
ANDHRA PRADESH,2002,Convicts Released - Transferred to other States,47,3,50
ANDHRA PRADESH,2002,"Convicts Released - Other Releases (due to illness, transferred to Mental hospital)",21,0,21
ANDHRA PRADESH,2002,Total Convicts Released,12142,529,12671
ANDHRA PRADESH,2002,Under trials Released - Acquitted,7027,844,7871
ANDHRA PRADESH,2002,Under trials Released - Released on appeal,8729,2814,11543
ANDHRA PRADESH,2002,Under trials Released - Released on bail,118719,15428,134147
ANDHRA PRADESH,2002,Under trials Released - Transferred to other States,8,0,8
ANDHRA PRADESH,2002,Under trials Released - Extradited,7,0,7
ANDHRA PRADESH,2002,Under trials Released - Other releases (transferred to Mental/Civil hospital),170,18,188
ANDHRA PRADESH,2002,Total Under trials Released,134660,19104,153764
ANDHRA PRADESH,2002,Detenus Released - Released on completion of detention period,1,0,1
ANDHRA PRADESH,2002,Detenus Released - Released before completion of detention period,5,0,5
ANDHRA PRADESH,2002,Detenus Released - Released on bail,2,0,2
ANDHRA PRADESH,2002,Detenus Released - Other releases (temporary transfer etc.),0,0,0
ANDHRA PRADESH,2002,Total Detenus Released,8,0,8
ANDHRA PRADESH,2003,Convicts Released - Released after completion of conviction,6117,351,6468
ANDHRA PRADESH,2003,Convicts Released - Premature release,157,13,170
ANDHRA PRADESH,2003,Convicts Released - Released on appeal,697,48,745
ANDHRA PRADESH,2003,Convicts Released - Released on bail,6720,695,7415
ANDHRA PRADESH,2003,Convicts Released - Pardons,0,0,0
ANDHRA PRADESH,2003,Convicts Released - Transferred to other States,51,0,51
ANDHRA PRADESH,2003,"Convicts Released - Other Releases (due to illness, transferred to Mental hospital)",544,47,591
ANDHRA PRADESH,2003,Total Convicts Released,14286,1154,15440
ANDHRA PRADESH,2003,Under trials Released - Acquitted,6631,253,6884
ANDHRA PRADESH,2003,Under trials Released - Released on appeal,2269,294,2563
ANDHRA PRADESH,2003,Under trials Released - Released on bail,127246,17993,145239
ANDHRA PRADESH,2003,Under trials Released - Transferred to other States,1,0,1
ANDHRA PRADESH,2003,Under trials Released - Extradited,0,0,0
ANDHRA PRADESH,2003,Under trials Released - Other releases (transferred to Mental/Civil hospital),226,13,239
ANDHRA PRADESH,2003,Total Under trials Released,136373,18553,154926
ANDHRA PRADESH,2003,Detenus Released - Released on completion of detention period,9,0,9
ANDHRA PRADESH,2003,Detenus Released - Released before completion of detention period,15,0,15
ANDHRA PRADESH,2003,Detenus Released - Released on bail,2,0,2
ANDHRA PRADESH,2003,Detenus Released - Other releases (temporary transfer etc.),0,0,0
ANDHRA PRADESH,2003,Total Detenus Released,26,0,26
ANDHRA PRADESH,2004,Convicts Released - Released after completion of conviction,7548,422,7970
ANDHRA PRADESH,2004,Convicts Released - Premature release,918,0,918
ANDHRA PRADESH,2004,Convicts Released - Released on appeal,427,29,456
ANDHRA PRADESH,2004,Convicts Released - Released on bail,4853,365,5218
ANDHRA PRADESH,2004,Convicts Released - Pardons,22,0,22
ANDHRA PRADESH,2004,Convicts Released - Transferred to other States,1,0,1
ANDHRA PRADESH,2004,"Convicts Released - Other Releases (due to illness, transferred to Mental hospital)",188,6,194
ANDHRA PRADESH,2004,Total Convicts Released,13957,822,14779
ANDHRA PRADESH,2004,Under trials Released - Acquitted,6218,232,6450
ANDHRA PRADESH,2004,Under trials Released - Released on appeal,268,0,268
ANDHRA PRADESH,2004,Under trials Released - Released on bail,109785,18233,128018
ANDHRA PRADESH,2004,Under trials Released - Transferred to other States,23,0,23
ANDHRA PRADESH,2004,Under trials Released - Extradited,3,0,3
ANDHRA PRADESH,2004,Under trials Released - Other releases (transferred to Mental/Civil hospital),240,2,242
ANDHRA PRADESH,2004,Total Under trials Released,116537,18467,135004
ANDHRA PRADESH,2004,Detenus Released - Released on completion of detention period,6,1,7
ANDHRA PRADESH,2004,Detenus Released - Released before completion of detention period,82,0,82
ANDHRA PRADESH,2004,Detenus Released - Released on bail,21,2,23
ANDHRA PRADESH,2004,Detenus Released - Other releases (temporary transfer etc.),3,0,3
ANDHRA PRADESH,2004,Total Detenus Released,112,3,115
ANDHRA PRADESH,2005,Convicts Released - Released after completion of conviction,6863,233,7096
ANDHRA PRADESH,2005,Convicts Released - Premature release,0,0,0
ANDHRA PRADESH,2005,Convicts Released - Released on appeal,518,40,558
ANDHRA PRADESH,2005,Convicts Released - Released on bail,4006,271,4277
ANDHRA PRADESH,2005,Convicts Released - Pardons,1,0,1
ANDHRA PRADESH,2005,Convicts Released - Transferred to other States,2,0,2
ANDHRA PRADESH,2005,"Convicts Released - Other Releases (due to illness, transferred to Mental hospital)",204,5,209
ANDHRA PRADESH,2005,Total Convicts Released,11594,549,12143
ANDHRA PRADESH,2005,Under trials Released - Acquitted,5728,228,5956
ANDHRA PRADESH,2005,Under trials Released - Released on appeal,385,18,403
ANDHRA PRADESH,2005,Under trials Released - Released on bail,123487,18377,141864
ANDHRA PRADESH,2005,Under trials Released - Transferred to other States,0,0,0
ANDHRA PRADESH,2005,Under trials Released - Extradited,0,0,0
ANDHRA PRADESH,2005,Under trials Released - Other releases (transferred to Mental/Civil hospital),338,8,346
ANDHRA PRADESH,2005,Total Under trials Released,129938,18631,148569
ANDHRA PRADESH,2005,Detenus Released - Released on completion of detention period,0,0,0
ANDHRA PRADESH,2005,Detenus Released - Released before completion of detention period,13,4,17
ANDHRA PRADESH,2005,Detenus Released - Released on bail,4,0,4
ANDHRA PRADESH,2005,Detenus Released - Other releases (temporary transfer etc.),0,0,0
ANDHRA PRADESH,2005,Total Detenus Released,17,4,21
ANDHRA PRADESH,2006,Convicts Released - Released after completion of conviction,7101,156,7257
ANDHRA PRADESH,2006,Convicts Released - Premature release,0,0,0
ANDHRA PRADESH,2006,Convicts Released - Released on appeal,460,30,490
ANDHRA PRADESH,2006,Convicts Released - Released on bail,10361,157,10518
ANDHRA PRADESH,2006,Convicts Released - Pardons,35,102,137
ANDHRA PRADESH,2006,Convicts Released - Transferred to other States,1,0,1
ANDHRA PRADESH,2006,"Convicts Released - Other Releases (due to illness, transferred to Mental hospital)",2497,108,2605
ANDHRA PRADESH,2006,Total Convicts Released,20455,553,21008
ANDHRA PRADESH,2006,Under trials Released - Acquitted,7662,253,7915
ANDHRA PRADESH,2006,Under trials Released - Released on appeal,5506,0,5506
ANDHRA PRADESH,2006,Under trials Released - Released on bail,117406,12198,129604
ANDHRA PRADESH,2006,Under trials Released - Transferred to other States,0,0,0
ANDHRA PRADESH,2006,Under trials Released - Extradited,337,0,337
ANDHRA PRADESH,2006,Under trials Released - Other releases (transferred to Mental/Civil hospital),4340,55,4395
ANDHRA PRADESH,2006,Total Under trials Released,135251,12506,147757
ANDHRA PRADESH,2006,Detenus Released - Released on completion of detention period,29,1,30
ANDHRA PRADESH,2006,Detenus Released - Released before completion of detention period,15,0,15
ANDHRA PRADESH,2006,Detenus Released - Released on bail,0,0,0
ANDHRA PRADESH,2006,Detenus Released - Other releases (temporary transfer etc.),4,1,5
ANDHRA PRADESH,2006,Total Detenus Released,48,2,50
ANDHRA PRADESH,2007,Convicts Released - Released after completion of conviction,7205,217,7422
ANDHRA PRADESH,2007,Convicts Released - Premature release,0,0,0
ANDHRA PRADESH,2007,Convicts Released - Released on appeal,718,50,768
ANDHRA PRADESH,2007,Convicts Released - Released on bail,11012,454,11466
ANDHRA PRADESH,2007,Convicts Released - Pardons,37,0,37
ANDHRA PRADESH,2007,Convicts Released - Transferred to other States,0,0,0
ANDHRA PRADESH,2007,"Convicts Released - Other Releases (due to illness, transferred to Mental hospital)",684,57,741
ANDHRA PRADESH,2007,Total Convicts Released,19656,778,20434
ANDHRA PRADESH,2007,Under trials Released - Acquitted,4508,234,4742
ANDHRA PRADESH,2007,Under trials Released - Released on appeal,1445,124,1569
ANDHRA PRADESH,2007,Under trials Released - Released on bail,122854,18178,141032
ANDHRA PRADESH,2007,Under trials Released - Transferred to other States,0,0,0
ANDHRA PRADESH,2007,Under trials Released - Extradited,160,6,166
ANDHRA PRADESH,2007,Under trials Released - Other releases (transferred to Mental/Civil hospital),1559,42,1601
ANDHRA PRADESH,2007,Total Under trials Released,130526,18584,149110
ANDHRA PRADESH,2007,Detenus Released - Released on completion of detention period,0,0,0
ANDHRA PRADESH,2007,Detenus Released - Released before completion of detention period,4,0,4
ANDHRA PRADESH,2007,Detenus Released - Released on bail,21,0,21
ANDHRA PRADESH,2007,Detenus Released - Other releases (temporary transfer etc.),0,0,0
ANDHRA PRADESH,2007,Total Detenus Released,25,0,25
ANDHRA PRADESH,2008,Convicts Released - Released after completion of conviction,6342,116,6458
ANDHRA PRADESH,2008,Convicts Released - Premature release,82,20,102
ANDHRA PRADESH,2008,Convicts Released - Released on appeal,424,18,442
ANDHRA PRADESH,2008,Convicts Released - Released on bail,7312,792,8104
ANDHRA PRADESH,2008,Convicts Released - Pardons,0,0,0
ANDHRA PRADESH,2008,Convicts Released - Transferred to other States,0,0,0
ANDHRA PRADESH,2008,"Convicts Released - Other Releases (due to illness, transferred to Mental hospital)",173,68,241
ANDHRA PRADESH,2008,Total Convicts Released,14333,1014,15347
ANDHRA PRADESH,2008,Under trials Released - Acquitted,6307,248,6555
ANDHRA PRADESH,2008,Under trials Released - Released on appeal,0,0,0
ANDHRA PRADESH,2008,Under trials Released - Released on bail,121684,21833,143517
ANDHRA PRADESH,2008,Under trials Released - Transferred to other States,0,0,0
ANDHRA PRADESH,2008,Under trials Released - Extradited,80,3,83
ANDHRA PRADESH,2008,Under trials Released - Other releases (transferred to Mental/Civil hospital),802,42,844
ANDHRA PRADESH,2008,Total Under trials Released,128873,22126,150999
ANDHRA PRADESH,2008,Detenus Released - Released on completion of detention period,9,0,9
ANDHRA PRADESH,2008,Detenus Released - Released before completion of detention period,6,0,6
ANDHRA PRADESH,2008,Detenus Released - Released on bail,5,0,5
ANDHRA PRADESH,2008,Detenus Released - Other releases (temporary transfer etc.),1,0,1
ANDHRA PRADESH,2008,Total Detenus Released,21,0,21
ANDHRA PRADESH,2009,Convicts Released - Released after completion of conviction,5082,190,5272
ANDHRA PRADESH,2009,Convicts Released - Premature release,705,38,743
ANDHRA PRADESH,2009,Convicts Released - Released on appeal,347,18,365
ANDHRA PRADESH,2009,Convicts Released - Released on bail,2969,188,3157
ANDHRA PRADESH,2009,Convicts Released - Pardons,0,0,0
ANDHRA PRADESH,2009,Convicts Released - Transferred to other States,0,0,0
ANDHRA PRADESH,2009,"Convicts Released - Other Releases (due to illness, transferred to Mental hospital)",3655,294,3949
ANDHRA PRADESH,2009,Total Convicts Released,12758,728,13486
ANDHRA PRADESH,2009,Under trials Released - Acquitted,3773,221,3994
ANDHRA PRADESH,2009,Under trials Released - Released on appeal,27,0,27
ANDHRA PRADESH,2009,Under trials Released - Released on bail,133570,16194,149764
ANDHRA PRADESH,2009,Under trials Released - Transferred to other States,0,0,0
ANDHRA PRADESH,2009,Under trials Released - Extradited,8,0,8
ANDHRA PRADESH,2009,Under trials Released - Other releases (transferred to Mental/Civil hospital),472,36,508
ANDHRA PRADESH,2009,Total Under trials Released,137850,16451,154301
ANDHRA PRADESH,2009,Detenus Released - Released on completion of detention period,8,0,8
ANDHRA PRADESH,2009,Detenus Released - Released before completion of detention period,11,0,11
ANDHRA PRADESH,2009,Detenus Released - Released on bail,0,0,0
ANDHRA PRADESH,2009,Detenus Released - Other releases (temporary transfer etc.),2,0,2
ANDHRA PRADESH,2009,Total Detenus Released,21,0,21
ANDHRA PRADESH,2010,Convicts Released - Released after completion of conviction,7918,365,8283
ANDHRA PRADESH,2010,Convicts Released - Premature release,40,1,41
ANDHRA PRADESH,2010,Convicts Released - Released on appeal,355,83,438
ANDHRA PRADESH,2010,Convicts Released - Released on bail,3019,164,3183
ANDHRA PRADESH,2010,Convicts Released - Pardons,0,0,0
ANDHRA PRADESH,2010,Convicts Released - Transferred to other States,77,2,79
ANDHRA PRADESH,2010,"Convicts Released - Other Releases (due to illness, transferred to Mental hospital)",753,83,836
ANDHRA PRADESH,2010,Total Convicts Released,12162,698,12860
ANDHRA PRADESH,2010,Under trials Released - Acquitted,3772,225,3997
ANDHRA PRADESH,2010,Under trials Released - Released on appeal,433,5,438
ANDHRA PRADESH,2010,Under trials Released - Released on bail,137703,21639,159342
ANDHRA PRADESH,2010,Under trials Released - Transferred to other States,226,1,227
ANDHRA PRADESH,2010,Under trials Released - Extradited,0,0,0
ANDHRA PRADESH,2010,Under trials Released - Other releases (transferred to Mental/Civil hospital),330,29,359
ANDHRA PRADESH,2010,Total Under trials Released,142464,21899,164363
ANDHRA PRADESH,2010,Detenus Released - Released on completion of detention period,23,0,23
ANDHRA PRADESH,2010,Detenus Released - Released before completion of detention period,12,0,12
ANDHRA PRADESH,2010,Detenus Released - Released on bail,0,0,0
ANDHRA PRADESH,2010,Detenus Released - Other releases (temporary transfer etc.),0,0,0
ANDHRA PRADESH,2010,Total Detenus Released,35,0,35
ANDHRA PRADESH,2011,Convicts Released - Released after completion of conviction,6104,205,6309
ANDHRA PRADESH,2011,Convicts Released - Premature release,826,27,853
ANDHRA PRADESH,2011,Convicts Released - Released on appeal,350,24,374
ANDHRA PRADESH,2011,Convicts Released - Released on bail,6744,249,6993
ANDHRA PRADESH,2011,Convicts Released - Pardons,1,0,1
ANDHRA PRADESH,2011,Convicts Released - Transferred to other States,129,8,137
ANDHRA PRADESH,2011,"Convicts Released - Other Releases (due to illness, transferred to Mental hospital)",69,1,70
ANDHRA PRADESH,2011,Total Convicts Released,14223,514,14737
ANDHRA PRADESH,2011,Under trials Released - Acquitted,4627,352,4979
ANDHRA PRADESH,2011,Under trials Released - Released on appeal,114,16,130
ANDHRA PRADESH,2011,Under trials Released - Released on bail,119408,19508,138916
ANDHRA PRADESH,2011,Under trials Released - Transferred to other States,10,3,13
ANDHRA PRADESH,2011,Under trials Released - Extradited,0,0,0
ANDHRA PRADESH,2011,Under trials Released - Other releases (transferred to Mental/Civil hospital),85,0,85
ANDHRA PRADESH,2011,Total Under trials Released,124244,19879,144123
ANDHRA PRADESH,2011,Detenus Released - Released on completion of detention period,23,1,24
ANDHRA PRADESH,2011,Detenus Released - Released before completion of detention period,21,0,21
ANDHRA PRADESH,2011,Detenus Released - Released on bail,3,0,3
ANDHRA PRADESH,2011,Detenus Released - Other releases (temporary transfer etc.),0,0,0
ANDHRA PRADESH,2011,Total Detenus Released,47,1,48
ANDHRA PRADESH,2012,Convicts Released - Released after completion of conviction,5453,110,5563
ANDHRA PRADESH,2012,Convicts Released - Premature release,0,0,0
ANDHRA PRADESH,2012,Convicts Released - Released on appeal,381,23,404
ANDHRA PRADESH,2012,Convicts Released - Released on bail,3215,216,3431
ANDHRA PRADESH,2012,Convicts Released - Pardons,0,0,0
ANDHRA PRADESH,2012,Convicts Released - Transferred to other States,24,0,24
ANDHRA PRADESH,2012,"Convicts Released - Other Releases (due to illness, transferred to Mental hospital)",1,1,2
ANDHRA PRADESH,2012,Total Convicts Released,9074,350,9424
ANDHRA PRADESH,2012,Under trials Released - Acquitted,4720,182,4902
ANDHRA PRADESH,2012,Under trials Released - Released on appeal,651,1,652
ANDHRA PRADESH,2012,Under trials Released - Released on bail,124831,20403,145234
ANDHRA PRADESH,2012,Under trials Released - Transferred to other States,201,8,209
ANDHRA PRADESH,2012,Under trials Released - Extradited,0,0,0
ANDHRA PRADESH,2012,Under trials Released - Other releases (transferred to Mental/Civil hospital),13,0,13
ANDHRA PRADESH,2012,Total Under trials Released,130416,20594,151010
ANDHRA PRADESH,2012,Detenus Released - Released on completion of detention period,9,2,11
ANDHRA PRADESH,2012,Detenus Released - Released before completion of detention period,26,0,26
ANDHRA PRADESH,2012,Detenus Released - Released on bail,0,1,1
ANDHRA PRADESH,2012,Detenus Released - Other releases (temporary transfer etc.),2,2,4
ANDHRA PRADESH,2012,Total Detenus Released,37,5,42
ARUNACHAL PRADESH,2009,Convicts Released - Released after completion of conviction,0,0,0
ARUNACHAL PRADESH,2009,Convicts Released - Premature release,0,0,0
ARUNACHAL PRADESH,2009,Convicts Released - Released on appeal,0,0,0
ARUNACHAL PRADESH,2009,Convicts Released - Released on bail,0,0,0
ARUNACHAL PRADESH,2009,Convicts Released - Pardons,0,0,0
ARUNACHAL PRADESH,2009,Convicts Released - Transferred to other States,0,0,0
ARUNACHAL PRADESH,2009,"Convicts Released - Other Releases (due to illness, transferred to Mental hospital)",0,0,0
ARUNACHAL PRADESH,2009,Total Convicts Released,0,0,0
ARUNACHAL PRADESH,2009,Under trials Released - Acquitted,0,0,0
ARUNACHAL PRADESH,2009,Under trials Released - Released on appeal,0,0,0
ARUNACHAL PRADESH,2009,Under trials Released - Released on bail,25,1,26
ARUNACHAL PRADESH,2009,Under trials Released - Transferred to other States,0,0,0
ARUNACHAL PRADESH,2009,Under trials Released - Extradited,0,0,0
ARUNACHAL PRADESH,2009,Under trials Released - Other releases (transferred to Mental/Civil hospital),0,0,0
ARUNACHAL PRADESH,2009,Total Under trials Released,25,1,26
ARUNACHAL PRADESH,2009,Detenus Released - Released on completion of detention period,0,0,0
ARUNACHAL PRADESH,2009,Detenus Released - Released before completion of detention period,0,0,0
ARUNACHAL PRADESH,2009,Detenus Released - Released on bail,0,0,0
ARUNACHAL PRADESH,2009,Detenus Released - Other releases (temporary transfer etc.),0,0,0
ARUNACHAL PRADESH,2009,Total Detenus Released,0,0,0
ARUNACHAL PRADESH,2010,Convicts Released - Released after completion of conviction,6,0,6
ARUNACHAL PRADESH,2010,Convicts Released - Premature release,0,0,0
ARUNACHAL PRADESH,2010,Convicts Released - Released on appeal,0,0,0
ARUNACHAL PRADESH,2010,Convicts Released - Released on bail,0,0,0
ARUNACHAL PRADESH,2010,Convicts Released - Pardons,0,0,0
ARUNACHAL PRADESH,2010,Convicts Released - Transferred to other States,0,0,0
ARUNACHAL PRADESH,2010,"Convicts Released - Other Releases (due to illness, transferred to Mental hospital)",0,0,0
ARUNACHAL PRADESH,2010,Total Convicts Released,6,0,6
ARUNACHAL PRADESH,2010,Under trials Released - Acquitted,0,0,0
ARUNACHAL PRADESH,2010,Under trials Released - Released on appeal,0,0,0
ARUNACHAL PRADESH,2010,Under trials Released - Released on bail,135,4,139
ARUNACHAL PRADESH,2010,Under trials Released - Transferred to other States,0,0,0
ARUNACHAL PRADESH,2010,Under trials Released - Extradited,0,0,0
ARUNACHAL PRADESH,2010,Under trials Released - Other releases (transferred to Mental/Civil hospital),0,0,0
ARUNACHAL PRADESH,2010,Total Under trials Released,135,4,139
ARUNACHAL PRADESH,2010,Detenus Released - Released on completion of detention period,0,0,0
ARUNACHAL PRADESH,2010,Detenus Released - Released before completion of detention period,0,0,0
ARUNACHAL PRADESH,2010,Detenus Released - Released on bail,0,0,0
ARUNACHAL PRADESH,2010,Detenus Released - Other releases (temporary transfer etc.),0,0,0
ARUNACHAL PRADESH,2010,Total Detenus Released,0,0,0
ARUNACHAL PRADESH,2011,Convicts Released - Released after completion of conviction,8,0,8
ARUNACHAL PRADESH,2011,Convicts Released - Premature release,0,0,0
ARUNACHAL PRADESH,2011,Convicts Released - Released on appeal,0,0,0
ARUNACHAL PRADESH,2011,Convicts Released - Released on bail,0,0,0
ARUNACHAL PRADESH,2011,Convicts Released - Pardons,0,0,0
ARUNACHAL PRADESH,2011,Convicts Released - Transferred to other States,0,0,0
ARUNACHAL PRADESH,2011,"Convicts Released - Other Releases (due to illness, transferred to Mental hospital)",0,0,0
ARUNACHAL PRADESH,2011,Total Convicts Released,8,0,8
ARUNACHAL PRADESH,2011,Under trials Released - Acquitted,0,0,0
ARUNACHAL PRADESH,2011,Under trials Released - Released on appeal,0,0,0
ARUNACHAL PRADESH,2011,Under trials Released - Released on bail,213,14,227
ARUNACHAL PRADESH,2011,Under trials Released - Transferred to other States,0,0,0
ARUNACHAL PRADESH,2011,Under trials Released - Extradited,0,0,0
ARUNACHAL PRADESH,2011,Under trials Released - Other releases (transferred to Mental/Civil hospital),0,0,0
ARUNACHAL PRADESH,2011,Total Under trials Released,213,14,227
ARUNACHAL PRADESH,2011,Detenus Released - Released on completion of detention period,0,0,0
ARUNACHAL PRADESH,2011,Detenus Released - Released before completion of detention period,0,0,0
ARUNACHAL PRADESH,2011,Detenus Released - Released on bail,0,0,0
ARUNACHAL PRADESH,2011,Detenus Released - Other releases (temporary transfer etc.),0,0,0
ARUNACHAL PRADESH,2011,Total Detenus Released,0,0,0
ARUNACHAL PRADESH,2012,Convicts Released - Released after completion of conviction,11,0,11
ARUNACHAL PRADESH,2012,Convicts Released - Premature release,0,0,0
ARUNACHAL PRADESH,2012,Convicts Released - Released on appeal,0,0,0
ARUNACHAL PRADESH,2012,Convicts Released - Released on bail,0,0,0
ARUNACHAL PRADESH,2012,Convicts Released - Pardons,0,0,0
ARUNACHAL PRADESH,2012,Convicts Released - Transferred to other States,0,0,0
ARUNACHAL PRADESH,2012,"Convicts Released - Other Releases (due to illness, transferred to Mental hospital)",0,0,0
ARUNACHAL PRADESH,2012,Total Convicts Released,11,0,11
ARUNACHAL PRADESH,2012,Under trials Released - Acquitted,0,0,0
ARUNACHAL PRADESH,2012,Under trials Released - Released on appeal,0,0,0
ARUNACHAL PRADESH,2012,Under trials Released - Released on bail,260,14,274
ARUNACHAL PRADESH,2012,Under trials Released - Transferred to other States,0,0,0
ARUNACHAL PRADESH,2012,Under trials Released - Extradited,0,0,0
ARUNACHAL PRADESH,2012,Under trials Released - Other releases (transferred to Mental/Civil hospital),0,0,0
ARUNACHAL PRADESH,2012,Total Under trials Released,260,14,274
ARUNACHAL PRADESH,2012,Detenus Released - Released on completion of detention period,0,0,0
ARUNACHAL PRADESH,2012,Detenus Released - Released before completion of detention period,0,0,0
ARUNACHAL PRADESH,2012,Detenus Released - Released on bail,0,0,0
ARUNACHAL PRADESH,2012,Detenus Released - Other releases (temporary transfer etc.),0,0,0
ARUNACHAL PRADESH,2012,Total Detenus Released,0,0,0
ASSAM,2001,Convicts Released - Released after completion of conviction,1487,28,1515
ASSAM,2001,Convicts Released - Premature release,3,9,12
ASSAM,2001,Convicts Released - Released on appeal,53,3,56
ASSAM,2001,Convicts Released - Released on bail,245,1,246
ASSAM,2001,Convicts Released - Pardons,2,0,2
ASSAM,2001,Convicts Released - Transferred to other States,13,2,15
ASSAM,2001,"Convicts Released - Other Releases (due to illness, transferred to Mental hospital)",27,0,27
ASSAM,2001,Total Convicts Released,1830,43,1873
ASSAM,2001,Under trials Released - Acquitted,772,38,810
ASSAM,2001,Under trials Released - Released on appeal,760,16,776
ASSAM,2001,Under trials Released - Released on bail,23477,686,24163
ASSAM,2001,Under trials Released - Transferred to other States,11,0,11
ASSAM,2001,Under trials Released - Extradited,24,0,24
ASSAM,2001,Under trials Released - Other releases (transferred to Mental/Civil hospital),90,3,93
ASSAM,2001,Total Under trials Released,25134,743,25877
ASSAM,2001,Detenus Released - Released on completion of detention period,33,0,33
ASSAM,2001,Detenus Released - Released before completion of detention period,13,0,13
ASSAM,2001,Detenus Released - Released on bail,3,0,3
ASSAM,2001,Detenus Released - Other releases (temporary transfer etc.),2,0,2
ASSAM,2001,Total Detenus Released,51,0,51
ASSAM,2002,Convicts Released - Released after completion of conviction,1726,20,1746
ASSAM,2002,Convicts Released - Premature release,49,2,51
ASSAM,2002,Convicts Released - Released on appeal,99,3,102
ASSAM,2002,Convicts Released - Released on bail,196,7,203
ASSAM,2002,Convicts Released - Pardons,0,0,0
ASSAM,2002,Convicts Released - Transferred to other States,48,1,49
ASSAM,2002,"Convicts Released - Other Releases (due to illness, transferred to Mental hospital)",10,0,10
ASSAM,2002,Total Convicts Released,2128,33,2161
ASSAM,2002,Under trials Released - Acquitted,890,31,921
ASSAM,2002,Under trials Released - Released on appeal,426,6,432
ASSAM,2002,Under trials Released - Released on bail,23860,808,24668
ASSAM,2002,Under trials Released - Transferred to other States,91,10,101
ASSAM,2002,Under trials Released - Extradited,12,1,13
ASSAM,2002,Under trials Released - Other releases (transferred to Mental/Civil hospital),9,2,11
ASSAM,2002,Total Under trials Released,25288,858,26146
ASSAM,2002,Detenus Released - Released on completion of detention period,11,0,11
ASSAM,2002,Detenus Released - Released before completion of detention period,0,1,1
ASSAM,2002,Detenus Released - Released on bail,11,5,16
ASSAM,2002,Detenus Released - Other releases (temporary transfer etc.),11,0,11
ASSAM,2002,Total Detenus Released,33,6,39
ASSAM,2003,Convicts Released - Released after completion of conviction,1615,19,1634
ASSAM,2003,Convicts Released - Premature release,10,0,10
ASSAM,2003,Convicts Released - Released on appeal,97,1,98
ASSAM,2003,Convicts Released - Released on bail,857,4,861
ASSAM,2003,Convicts Released - Pardons,9,0,9
ASSAM,2003,Convicts Released - Transferred to other States,7,0,7
ASSAM,2003,"Convicts Released - Other Releases (due to illness, transferred to Mental hospital)",9,0,9
ASSAM,2003,Total Convicts Released,2604,24,2628
ASSAM,2003,Under trials Released - Acquitted,749,47,796
ASSAM,2003,Under trials Released - Released on appeal,184,4,188
ASSAM,2003,Under trials Released - Released on bail,20990,709,21699
ASSAM,2003,Under trials Released - Transferred to other States,27,0,27
ASSAM,2003,Under trials Released - Extradited,3,0,3
ASSAM,2003,Under trials Released - Other releases (transferred to Mental/Civil hospital),26,4,30
ASSAM,2003,Total Under trials Released,21979,764,22743
ASSAM,2003,Detenus Released - Released on completion of detention period,15,0,15
ASSAM,2003,Detenus Released - Released before completion of detention period,2,0,2
ASSAM,2003,Detenus Released - Released on bail,15,5,20
ASSAM,2003,Detenus Released - Other releases (temporary transfer etc.),10,0,10
ASSAM,2003,Total Detenus Released,42,5,47
ASSAM,2004,Convicts Released - Released after completion of conviction,1512,14,1526
ASSAM,2004,Convicts Released - Premature release,213,6,219
ASSAM,2004,Convicts Released - Released on appeal,182,6,188
ASSAM,2004,Convicts Released - Released on bail,721,10,731
ASSAM,2004,Convicts Released - Pardons,0,0,0
ASSAM,2004,Convicts Released - Transferred to other States,0,0,0
ASSAM,2004,"Convicts Released - Other Releases (due to illness, transferred to Mental hospital)",1,0,1
ASSAM,2004,Total Convicts Released,2629,36,2665
ASSAM,2004,Under trials Released - Acquitted,1048,41,1089
ASSAM,2004,Under trials Released - Released on appeal,1731,12,1743
ASSAM,2004,Under trials Released - Released on bail,20860,673,21533
ASSAM,2004,Under trials Released - Transferred to other States,12,2,14
ASSAM,2004,Under trials Released - Extradited,10,0,10
ASSAM,2004,Under trials Released - Other releases (transferred to Mental/Civil hospital),1381,22,1403
ASSAM,2004,Total Under trials Released,25042,750,25792
ASSAM,2004,Detenus Released - Released on completion of detention period,9,3,12
ASSAM,2004,Detenus Released - Released before completion of detention period,10,1,11
ASSAM,2004,Detenus Released - Released on bail,0,0,0
ASSAM,2004,Detenus Released - Other releases (temporary transfer etc.),24,2,26
ASSAM,2004,Total Detenus Released,43,6,49
ASSAM,2005,Convicts Released - Released after completion of conviction,2058,21,2079
ASSAM,2005,Convicts Released - Premature release,13,2,15
ASSAM,2005,Convicts Released - Released on appeal,112,7,119
ASSAM,2005,Convicts Released - Released on bail,1323,48,1371
ASSAM,2005,Convicts Released - Pardons,1,0,1
ASSAM,2005,Convicts Released - Transferred to other States,18,0,18
ASSAM,2005,"Convicts Released - Other Releases (due to illness, transferred to Mental hospital)",12,0,12
ASSAM,2005,Total Convicts Released,3537,78,3615
ASSAM,2005,Under trials Released - Acquitted,1142,17,1159
ASSAM,2005,Under trials Released - Released on appeal,3407,125,3532
ASSAM,2005,Under trials Released - Released on bail,19084,591,19675
ASSAM,2005,Under trials Released - Transferred to other States,88,2,90
ASSAM,2005,Under trials Released - Extradited,19,0,19
ASSAM,2005,Under trials Released - Other releases (transferred to Mental/Civil hospital),5,0,5
ASSAM,2005,Total Under trials Released,23745,735,24480
ASSAM,2005,Detenus Released - Released on completion of detention period,135,14,149
ASSAM,2005,Detenus Released - Released before completion of detention period,17,5,22
ASSAM,2005,Detenus Released - Released on bail,1,0,1
ASSAM,2005,Detenus Released - Other releases (temporary transfer etc.),29,2,31
ASSAM,2005,Total Detenus Released,182,21,203
ASSAM,2006,Convicts Released - Released after completion of conviction,1406,22,1428
ASSAM,2006,Convicts Released - Premature release,42,0,42
ASSAM,2006,Convicts Released - Released on appeal,166,5,171
ASSAM,2006,Convicts Released - Released on bail,1599,8,1607
ASSAM,2006,Convicts Released - Pardons,4,0,4
ASSAM,2006,Convicts Released - Transferred to other States,25,0,25
ASSAM,2006,"Convicts Released - Other Releases (due to illness, transferred to Mental hospital)",4,1,5
ASSAM,2006,Total Convicts Released,3246,36,3282
ASSAM,2006,Under trials Released - Acquitted,737,21,758
ASSAM,2006,Under trials Released - Released on appeal,936,35,971
ASSAM,2006,Under trials Released - Released on bail,22134,714,22848
ASSAM,2006,Under trials Released - Transferred to other States,40,1,41
ASSAM,2006,Under trials Released - Extradited,0,0,0
ASSAM,2006,Under trials Released - Other releases (transferred to Mental/Civil hospital),29,0,29
ASSAM,2006,Total Under trials Released,23876,771,24647
ASSAM,2006,Detenus Released - Released on completion of detention period,20,2,22
ASSAM,2006,Detenus Released - Released before completion of detention period,5,0,5
ASSAM,2006,Detenus Released - Released on bail,4,0,4
ASSAM,2006,Detenus Released - Other releases (temporary transfer etc.),12,0,12
ASSAM,2006,Total Detenus Released,41,2,43
ASSAM,2007,Convicts Released - Released after completion of conviction,845,10,855
ASSAM,2007,Convicts Released - Premature release,23,1,24
ASSAM,2007,Convicts Released - Released on appeal,108,1,109
ASSAM,2007,Convicts Released - Released on bail,1324,88,1412
ASSAM,2007,Convicts Released - Pardons,0,0,0
ASSAM,2007,Convicts Released - Transferred to other States,19,0,19
ASSAM,2007,"Convicts Released - Other Releases (due to illness, transferred to Mental hospital)",0,0,0
ASSAM,2007,Total Convicts Released,2319,100,2419
ASSAM,2007,Under trials Released - Acquitted,569,24,593
ASSAM,2007,Under trials Released - Released on appeal,241,3,244
ASSAM,2007,Under trials Released - Released on bail,21518,499,22017
ASSAM,2007,Under trials Released - Transferred to other States,109,0,109
ASSAM,2007,Under trials Released - Extradited,0,0,0
ASSAM,2007,Under trials Released - Other releases (transferred to Mental/Civil hospital),23,1,24
ASSAM,2007,Total Under trials Released,22460,527,22987
ASSAM,2007,Detenus Released - Released on completion of detention period,21,1,22
ASSAM,2007,Detenus Released - Released before completion of detention period,7,0,7
ASSAM,2007,Detenus Released - Released on bail,10,0,10
ASSAM,2007,Detenus Released - Other releases (temporary transfer etc.),13,2,15
ASSAM,2007,Total Detenus Released,51,3,54
ASSAM,2008,Convicts Released - Released after completion of conviction,668,16,684
ASSAM,2008,Convicts Released - Premature release,32,1,33
ASSAM,2008,Convicts Released - Released on appeal,109,5,114
ASSAM,2008,Convicts Released - Released on bail,1634,125,1759
ASSAM,2008,Convicts Released - Pardons,0,0,0
ASSAM,2008,Convicts Released - Transferred to other States,15,0,15
ASSAM,2008,"Convicts Released - Other Releases (due to illness, transferred to Mental hospital)",0,0,0
ASSAM,2008,Total Convicts Released,2458,147,2605
ASSAM,2008,Under trials Released - Acquitted,944,25,969
ASSAM,2008,Under trials Released - Released on appeal,259,3,262
ASSAM,2008,Under trials Released - Released on bail,24853,577,25430
ASSAM,2008,Under trials Released - Transferred to other States,103,0,103
ASSAM,2008,Under trials Released - Extradited,0,0,0
ASSAM,2008,Under trials Released - Other releases (transferred to Mental/Civil hospital),35,0,35
ASSAM,2008,Total Under trials Released,26194,605,26799
ASSAM,2008,Detenus Released - Released on completion of detention period,16,1,17
ASSAM,2008,Detenus Released - Released before completion of detention period,5,0,5
ASSAM,2008,Detenus Released - Released on bail,30,0,30
ASSAM,2008,Detenus Released - Other releases (temporary transfer etc.),7,2,9
ASSAM,2008,Total Detenus Released,58,3,61
ASSAM,2009,Convicts Released - Released after completion of conviction,1591,17,1608
ASSAM,2009,Convicts Released - Premature release,4,0,4
ASSAM,2009,Convicts Released - Released on appeal,156,5,161
ASSAM,2009,Convicts Released - Released on bail,691,6,697
ASSAM,2009,Convicts Released - Pardons,0,0,0
ASSAM,2009,Convicts Released - Transferred to other States,94,0,94
ASSAM,2009,"Convicts Released - Other Releases (due to illness, transferred to Mental hospital)",0,0,0
ASSAM,2009,Total Convicts Released,2536,28,2564
ASSAM,2009,Under trials Released - Acquitted,843,18,861
ASSAM,2009,Under trials Released - Released on appeal,252,6,258
ASSAM,2009,Under trials Released - Released on bail,24123,559,24682
ASSAM,2009,Under trials Released - Transferred to other States,112,0,112
ASSAM,2009,Under trials Released - Extradited,0,0,0
ASSAM,2009,Under trials Released - Other releases (transferred to Mental/Civil hospital),30,0,30
ASSAM,2009,Total Under trials Released,25360,583,25943
ASSAM,2009,Detenus Released - Released on completion of detention period,18,2,20
ASSAM,2009,Detenus Released - Released before completion of detention period,7,0,7
ASSAM,2009,Detenus Released - Released on bail,35,0,35
ASSAM,2009,Detenus Released - Other releases (temporary transfer etc.),6,0,6
ASSAM,2009,Total Detenus Released,66,2,68
ASSAM,2010,Convicts Released - Released after completion of conviction,1715,22,1737
ASSAM,2010,Convicts Released - Premature release,0,0,0
ASSAM,2010,Convicts Released - Released on appeal,124,3,127
ASSAM,2010,Convicts Released - Released on bail,235,0,235
ASSAM,2010,Convicts Released - Pardons,0,0,0
ASSAM,2010,Convicts Released - Transferred to other States,3,0,3
ASSAM,2010,"Convicts Released - Other Releases (due to illness, transferred to Mental hospital)",0,0,0
ASSAM,2010,Total Convicts Released,2077,25,2102
ASSAM,2010,Under trials Released - Acquitted,973,23,996
ASSAM,2010,Under trials Released - Released on appeal,158,5,163
ASSAM,2010,Under trials Released - Released on bail,25193,613,25806
ASSAM,2010,Under trials Released - Transferred to other States,62,0,62
ASSAM,2010,Under trials Released - Extradited,0,0,0
ASSAM,2010,Under trials Released - Other releases (transferred to Mental/Civil hospital),15,0,15
ASSAM,2010,Total Under trials Released,26401,641,27042
ASSAM,2010,Detenus Released - Released on completion of detention period,12,1,13
ASSAM,2010,Detenus Released - Released before completion of detention period,5,0,5
ASSAM,2010,Detenus Released - Released on bail,32,0,32
ASSAM,2010,Detenus Released - Other releases (temporary transfer etc.),3,0,3
ASSAM,2010,Total Detenus Released,52,1,53
ASSAM,2011,Convicts Released - Released after completion of conviction,1383,22,1405
ASSAM,2011,Convicts Released - Premature release,135,2,137
ASSAM,2011,Convicts Released - Released on appeal,145,0,145
ASSAM,2011,Convicts Released - Released on bail,240,0,240
ASSAM,2011,Convicts Released - Pardons,0,0,0
ASSAM,2011,Convicts Released - Transferred to other States,2,0,2
ASSAM,2011,"Convicts Released - Other Releases (due to illness, transferred to Mental hospital)",0,0,0
ASSAM,2011,Total Convicts Released,1905,24,1929
ASSAM,2011,Under trials Released - Acquitted,875,24,899
ASSAM,2011,Under trials Released - Released on appeal,135,4,139
ASSAM,2011,Under trials Released - Released on bail,24975,721,25696
ASSAM,2011,Under trials Released - Transferred to other States,21,0,21
ASSAM,2011,Under trials Released - Extradited,0,0,0
ASSAM,2011,Under trials Released - Other releases (transferred to Mental/Civil hospital),16,0,16
ASSAM,2011,Total Under trials Released,26022,749,26771
ASSAM,2011,Detenus Released - Released on completion of detention period,10,1,11
ASSAM,2011,Detenus Released - Released before completion of detention period,4,0,4
ASSAM,2011,Detenus Released - Released on bail,35,0,35
ASSAM,2011,Detenus Released - Other releases (temporary transfer etc.),3,0,3
ASSAM,2011,Total Detenus Released,52,1,53
ASSAM,2012,Convicts Released - Released after completion of conviction,1173,19,1192
ASSAM,2012,Convicts Released - Premature release,145,3,148
ASSAM,2012,Convicts Released - Released on appeal,162,2,164
ASSAM,2012,Convicts Released - Released on bail,548,42,590
ASSAM,2012,Convicts Released - Pardons,0,0,0
ASSAM,2012,Convicts Released - Transferred to other States,20,0,20
ASSAM,2012,"Convicts Released - Other Releases (due to illness, transferred to Mental hospital)",5,0,5
ASSAM,2012,Total Convicts Released,2053,66,2119
ASSAM,2012,Under trials Released - Acquitted,867,27,894
ASSAM,2012,Under trials Released - Released on appeal,217,12,229
ASSAM,2012,Under trials Released - Released on bail,23019,715,23734
ASSAM,2012,Under trials Released - Transferred to other States,22,0,22
ASSAM,2012,Under trials Released - Extradited,0,0,0
ASSAM,2012,Under trials Released - Other releases (transferred to Mental/Civil hospital),20,2,22
ASSAM,2012,Total Under trials Released,24145,756,24901
ASSAM,2012,Detenus Released - Released on completion of detention period,121,3,124
ASSAM,2012,Detenus Released - Released before completion of detention period,3,0,3
ASSAM,2012,Detenus Released - Released on bail,73,3,76
ASSAM,2012,Detenus Released - Other releases (temporary transfer etc.),3,0,3
ASSAM,2012,Total Detenus Released,200,6,206
BIHAR,2001,Convicts Released - Released after completion of conviction,4531,26,4557
BIHAR,2001,Convicts Released - Premature release,306,7,313
BIHAR,2001,Convicts Released - Released on appeal,4097,131,4228
BIHAR,2001,Convicts Released - Released on bail,22225,279,22504
BIHAR,2001,Convicts Released - Pardons,214,1,215
BIHAR,2001,Convicts Released - Transferred to other States,107,0,107
BIHAR,2001,"Convicts Released - Other Releases (due to illness, transferred to Mental hospital)",431,4,435
BIHAR,2001,Total Convicts Released,31911,448,32359
BIHAR,2001,Under trials Released - Acquitted,0,0,0
BIHAR,2001,Under trials Released - Released on appeal,459,7,466
BIHAR,2001,Under trials Released - Released on bail,11103,226,11329
BIHAR,2001,Under trials Released - Transferred to other States,5099,81,5180
BIHAR,2001,Under trials Released - Extradited,118,0,118
BIHAR,2001,Under trials Released - Other releases (transferred to Mental/Civil hospital),2,0,2
BIHAR,2001,Total Under trials Released,16781,314,17095
BIHAR,2001,Detenus Released - Released on completion of detention period,0,0,0
BIHAR,2001,Detenus Released - Released before completion of detention period,0,0,0
BIHAR,2001,Detenus Released - Released on bail,0,0,0
BIHAR,2001,Detenus Released - Other releases (temporary transfer etc.),0,0,0
BIHAR,2001,Total Detenus Released,0,0,0
BIHAR,2002,Convicts Released - Released after completion of conviction,3741,3,3744
BIHAR,2002,Convicts Released - Premature release,380,0,380
BIHAR,2002,Convicts Released - Released on appeal,771,9,780
BIHAR,2002,Convicts Released - Released on bail,4997,36,5033
BIHAR,2002,Convicts Released - Pardons,46,0,46
BIHAR,2002,Convicts Released - Transferred to other States,575,1,576
BIHAR,2002,"Convicts Released - Other Releases (due to illness, transferred to Mental hospital)",2143,10,2153
BIHAR,2002,Total Convicts Released,12653,59,12712
BIHAR,2002,Under trials Released - Acquitted,4358,130,4488
BIHAR,2002,Under trials Released - Released on appeal,4591,69,4660
BIHAR,2002,Under trials Released - Released on bail,76184,1656,77840
BIHAR,2002,Under trials Released - Transferred to other States,385,2,387
BIHAR,2002,Under trials Released - Extradited,51,40,91
BIHAR,2002,Under trials Released - Other releases (transferred to Mental/Civil hospital),96,6,102
BIHAR,2002,Total Under trials Released,85665,1903,87568
BIHAR,2002,Detenus Released - Released on completion of detention period,54,0,54
BIHAR,2002,Detenus Released - Released before completion of detention period,31,0,31
BIHAR,2002,Detenus Released - Released on bail,0,0,0
BIHAR,2002,Detenus Released - Other releases (temporary transfer etc.),0,0,0
BIHAR,2002,Total Detenus Released,85,0,85
BIHAR,2003,Convicts Released - Released after completion of conviction,135,2,137
BIHAR,2003,Convicts Released - Premature release,0,0,0
BIHAR,2003,Convicts Released - Released on appeal,51,0,51
BIHAR,2003,Convicts Released - Released on bail,115,4,119
BIHAR,2003,Convicts Released - Pardons,0,0,0
BIHAR,2003,Convicts Released - Transferred to other States,0,0,0
BIHAR,2003,"Convicts Released - Other Releases (due to illness, transferred to Mental hospital)",0,0,0
BIHAR,2003,Total Convicts Released,301,6,307
BIHAR,2003,Under trials Released - Acquitted,116,7,123
BIHAR,2003,Under trials Released - Released on appeal,0,0,0
BIHAR,2003,Under trials Released - Released on bail,2697,99,2796
BIHAR,2003,Under trials Released - Transferred to other States,0,0,0
BIHAR,2003,Under trials Released - Extradited,0,0,0
BIHAR,2003,Under trials Released - Other releases (transferred to Mental/Civil hospital),0,0,0
BIHAR,2003,Total Under trials Released,2813,106,2919
BIHAR,2003,Detenus Released - Released on completion of detention period,0,0,0
BIHAR,2003,Detenus Released - Released before completion of detention period,0,0,0
BIHAR,2003,Detenus Released - Released on bail,0,0,0
BIHAR,2003,Detenus Released - Other releases (temporary transfer etc.),0,0,0
BIHAR,2003,Total Detenus Released,0,0,0
BIHAR,2004,Convicts Released - Released after completion of conviction,3103,7,3110
BIHAR,2004,Convicts Released - Premature release,0,0,0
BIHAR,2004,Convicts Released - Released on appeal,1537,28,1565
BIHAR,2004,Convicts Released - Released on bail,13384,224,13608
BIHAR,2004,Convicts Released - Pardons,22,0,22
BIHAR,2004,Convicts Released - Transferred to other States,625,5,630
BIHAR,2004,"Convicts Released - Other Releases (due to illness, transferred to Mental hospital)",34,1,35
BIHAR,2004,Total Convicts Released,18705,265,18970
BIHAR,2004,Under trials Released - Acquitted,3766,134,3900
BIHAR,2004,Under trials Released - Released on appeal,3605,80,3685
BIHAR,2004,Under trials Released - Released on bail,64205,1383,65588
BIHAR,2004,Under trials Released - Transferred to other States,452,2,454
BIHAR,2004,Under trials Released - Extradited,322,0,322
BIHAR,2004,Under trials Released - Other releases (transferred to Mental/Civil hospital),0,0,0
BIHAR,2004,Total Under trials Released,72350,1599,73949
BIHAR,2004,Detenus Released - Released on completion of detention period,0,0,0
BIHAR,2004,Detenus Released - Released before completion of detention period,0,0,0
BIHAR,2004,Detenus Released - Released on bail,0,0,0
BIHAR,2004,Detenus Released - Other releases (temporary transfer etc.),0,0,0
BIHAR,2004,Total Detenus Released,0,0,0
BIHAR,2005,Convicts Released - Released after completion of conviction,3734,26,3760
BIHAR,2005,Convicts Released - Premature release,0,0,0
BIHAR,2005,Convicts Released - Released on appeal,1538,20,1558
BIHAR,2005,Convicts Released - Released on bail,4194,52,4246
BIHAR,2005,Convicts Released - Pardons,0,0,0
BIHAR,2005,Convicts Released - Transferred to other States,0,0,0
BIHAR,2005,"Convicts Released - Other Releases (due to illness, transferred to Mental hospital)",0,0,0
BIHAR,2005,Total Convicts Released,9466,98,9564
BIHAR,2005,Under trials Released - Acquitted,3925,163,4088
BIHAR,2005,Under trials Released - Released on appeal,6468,205,6673
BIHAR,2005,Under trials Released - Released on bail,93712,1464,95176
BIHAR,2005,Under trials Released - Transferred to other States,0,0,0
BIHAR,2005,Under trials Released - Extradited,0,0,0
BIHAR,2005,Under trials Released - Other releases (transferred to Mental/Civil hospital),0,0,0
BIHAR,2005,Total Under trials Released,104105,1832,105937
BIHAR,2005,Detenus Released - Released on completion of detention period,22,0,22
BIHAR,2005,Detenus Released - Released before completion of detention period,34,0,34
BIHAR,2005,Detenus Released - Released on bail,0,0,0
BIHAR,2005,Detenus Released - Other releases (temporary transfer etc.),0,0,0
BIHAR,2005,Total Detenus Released,56,0,56
BIHAR,2006,Convicts Released - Released after completion of conviction,3485,60,3545
BIHAR,2006,Convicts Released - Premature release,0,0,0
BIHAR,2006,Convicts Released - Released on appeal,1532,83,1615
BIHAR,2006,Convicts Released - Released on bail,4524,85,4609
BIHAR,2006,Convicts Released - Pardons,0,0,0
BIHAR,2006,Convicts Released - Transferred to other States,0,0,0
BIHAR,2006,"Convicts Released - Other Releases (due to illness, transferred to Mental hospital)",0,0,0
BIHAR,2006,Total Convicts Released,9541,228,9769
BIHAR,2006,Under trials Released - Acquitted,5649,201,5850
BIHAR,2006,Under trials Released - Released on appeal,5755,282,6037
BIHAR,2006,Under trials Released - Released on bail,78321,1520,79841
BIHAR,2006,Under trials Released - Transferred to other States,0,0,0
BIHAR,2006,Under trials Released - Extradited,0,0,0
BIHAR,2006,Under trials Released - Other releases (transferred to Mental/Civil hospital),0,0,0
BIHAR,2006,Total Under trials Released,89725,2003,91728
BIHAR,2006,Detenus Released - Released on completion of detention period,48,0,48
BIHAR,2006,Detenus Released - Released before completion of detention period,43,0,43
BIHAR,2006,Detenus Released - Released on bail,0,0,0
BIHAR,2006,Detenus Released - Other releases (temporary transfer etc.),0,0,0
BIHAR,2006,Total Detenus Released,91,0,91
BIHAR,2007,Convicts Released - Released after completion of conviction,3217,53,3270
BIHAR,2007,Convicts Released - Premature release,0,0,0
BIHAR,2007,Convicts Released - Released on appeal,1456,78,1534
BIHAR,2007,Convicts Released - Released on bail,6231,87,6318
BIHAR,2007,Convicts Released - Pardons,0,0,0
BIHAR,2007,Convicts Released - Transferred to other States,0,0,0
BIHAR,2007,"Convicts Released - Other Releases (due to illness, transferred to Mental hospital)",0,0,0
BIHAR,2007,Total Convicts Released,10904,218,11122
BIHAR,2007,Under trials Released - Acquitted,7486,307,7793
BIHAR,2007,Under trials Released - Released on appeal,6380,413,6793
BIHAR,2007,Under trials Released - Released on bail,88278,1672,89950
BIHAR,2007,Under trials Released - Transferred to other States,0,0,0
BIHAR,2007,Under trials Released - Extradited,0,0,0
BIHAR,2007,Under trials Released - Other releases (transferred to Mental/Civil hospital),0,0,0
BIHAR,2007,Total Under trials Released,102144,2392,104536
BIHAR,2007,Detenus Released - Released on completion of detention period,17,0,17
BIHAR,2007,Detenus Released - Released before completion of detention period,4,0,4
BIHAR,2007,Detenus Released - Released on bail,0,0,0
BIHAR,2007,Detenus Released - Other releases (temporary transfer etc.),0,0,0
BIHAR,2007,Total Detenus Released,21,0,21
BIHAR,2008,Convicts Released - Released after completion of conviction,3318,32,3350
BIHAR,2008,Convicts Released - Premature release,62,0,62
BIHAR,2008,Convicts Released - Released on appeal,1273,23,1296
BIHAR,2008,Convicts Released - Released on bail,10307,161,10468
BIHAR,2008,Convicts Released - Pardons,0,0,0
BIHAR,2008,Convicts Released - Transferred to other States,9,0,9
BIHAR,2008,"Convicts Released - Other Releases (due to illness, transferred to Mental hospital)",0,0,0
BIHAR,2008,Total Convicts Released,14969,216,15185
BIHAR,2008,Under trials Released - Acquitted,5318,215,5533
BIHAR,2008,Under trials Released - Released on appeal,5012,201,5213
BIHAR,2008,Under trials Released - Released on bail,74977,1499,76476
BIHAR,2008,Under trials Released - Transferred to other States,29,0,29
BIHAR,2008,Under trials Released - Extradited,0,0,0
BIHAR,2008,Under trials Released - Other releases (transferred to Mental/Civil hospital),0,0,0
BIHAR,2008,Total Under trials Released,85336,1915,87251
BIHAR,2008,Detenus Released - Released on completion of detention period,14,0,14
BIHAR,2008,Detenus Released - Released before completion of detention period,3,0,3
BIHAR,2008,Detenus Released - Released on bail,0,0,0
BIHAR,2008,Detenus Released - Other releases (temporary transfer etc.),0,0,0
BIHAR,2008,Total Detenus Released,17,0,17
BIHAR,2009,Convicts Released - Released after completion of conviction,3007,27,3034
BIHAR,2009,Convicts Released - Premature release,60,1,61
BIHAR,2009,Convicts Released - Released on appeal,1013,20,1033
BIHAR,2009,Convicts Released - Released on bail,8298,167,8465
BIHAR,2009,Convicts Released - Pardons,0,0,0
BIHAR,2009,Convicts Released - Transferred to other States,11,0,11
BIHAR,2009,"Convicts Released - Other Releases (due to illness, transferred to Mental hospital)",0,0,0
BIHAR,2009,Total Convicts Released,12389,215,12604
BIHAR,2009,Under trials Released - Acquitted,4678,175,4853
BIHAR,2009,Under trials Released - Released on appeal,4596,158,4754
BIHAR,2009,Under trials Released - Released on bail,69775,1328,71103
BIHAR,2009,Under trials Released - Transferred to other States,32,0,32
BIHAR,2009,Under trials Released - Extradited,0,0,0
BIHAR,2009,Under trials Released - Other releases (transferred to Mental/Civil hospital),0,0,0
BIHAR,2009,Total Under trials Released,79081,1661,80742
BIHAR,2009,Detenus Released - Released on completion of detention period,19,0,19
BIHAR,2009,Detenus Released - Released before completion of detention period,2,0,2
BIHAR,2009,Detenus Released - Released on bail,3,0,3
BIHAR,2009,Detenus Released - Other releases (temporary transfer etc.),0,0,0
BIHAR,2009,Total Detenus Released,24,0,24
BIHAR,2010,Convicts Released - Released after completion of conviction,3112,29,3141
BIHAR,2010,Convicts Released - Premature release,289,2,291
BIHAR,2010,Convicts Released - Released on appeal,1099,28,1127
BIHAR,2010,Convicts Released - Released on bail,8170,159,8329
BIHAR,2010,Convicts Released - Pardons,0,0,0
BIHAR,2010,Convicts Released - Transferred to other States,16,0,16
BIHAR,2010,"Convicts Released - Other Releases (due to illness, transferred to Mental hospital)",0,0,0
BIHAR,2010,Total Convicts Released,12686,218,12904
BIHAR,2010,Under trials Released - Acquitted,4786,177,4963
BIHAR,2010,Under trials Released - Released on appeal,4217,142,4359
BIHAR,2010,Under trials Released - Released on bail,69218,1270,70488
BIHAR,2010,Under trials Released - Transferred to other States,34,0,34
BIHAR,2010,Under trials Released - Extradited,0,0,0
BIHAR,2010,Under trials Released - Other releases (transferred to Mental/Civil hospital),0,0,0
BIHAR,2010,Total Under trials Released,78255,1589,79844
BIHAR,2010,Detenus Released - Released on completion of detention period,17,0,17
BIHAR,2010,Detenus Released - Released before completion of detention period,0,0,0
BIHAR,2010,Detenus Released - Released on bail,7,0,7
BIHAR,2010,Detenus Released - Other releases (temporary transfer etc.),0,0,0
BIHAR,2010,Total Detenus Released,24,0,24
BIHAR,2011,Convicts Released - Released after completion of conviction,1602,23,1625
BIHAR,2011,Convicts Released - Premature release,137,1,138
BIHAR,2011,Convicts Released - Released on appeal,766,129,895
BIHAR,2011,Convicts Released - Released on bail,6003,101,6104
BIHAR,2011,Convicts Released - Pardons,0,0,0
BIHAR,2011,Convicts Released - Transferred to other States,0,0,0
BIHAR,2011,"Convicts Released - Other Releases (due to illness, transferred to Mental hospital)",92,2,94
BIHAR,2011,Total Convicts Released,8600,256,8856
BIHAR,2011,Under trials Released - Acquitted,4767,228,4995
BIHAR,2011,Under trials Released - Released on appeal,11163,287,11450
BIHAR,2011,Under trials Released - Released on bail,78399,1755,80154
BIHAR,2011,Under trials Released - Transferred to other States,0,0,0
BIHAR,2011,Under trials Released - Extradited,0,0,0
BIHAR,2011,Under trials Released - Other releases (transferred to Mental/Civil hospital),271,47,318
BIHAR,2011,Total Under trials Released,94600,2317,96917
BIHAR,2011,Detenus Released - Released on completion of detention period,60,0,60
BIHAR,2011,Detenus Released - Released before completion of detention period,15,0,15
BIHAR,2011,Detenus Released - Released on bail,41,0,41
BIHAR,2011,Detenus Released - Other releases (temporary transfer etc.),105,0,105
BIHAR,2011,Total Detenus Released,221,0,221
BIHAR,2012,Convicts Released - Released after completion of conviction,1939,16,1955
BIHAR,2012,Convicts Released - Premature release,268,0,268
BIHAR,2012,Convicts Released - Released on appeal,964,66,1030
BIHAR,2012,Convicts Released - Released on bail,4986,67,5053
BIHAR,2012,Convicts Released - Pardons,0,3,3
BIHAR,2012,Convicts Released - Transferred to other States,146,6,152
BIHAR,2012,"Convicts Released - Other Releases (due to illness, transferred to Mental hospital)",298,6,304
BIHAR,2012,Total Convicts Released,8601,164,8765
BIHAR,2012,Under trials Released - Acquitted,5864,240,6104
BIHAR,2012,Under trials Released - Released on appeal,16654,338,16992
BIHAR,2012,Under trials Released - Released on bail,75045,1447,76492
BIHAR,2012,Under trials Released - Transferred to other States,18,0,18
BIHAR,2012,Under trials Released - Extradited,0,0,0
BIHAR,2012,Under trials Released - Other releases (transferred to Mental/Civil hospital),170,1,171
BIHAR,2012,Total Under trials Released,97751,2026,99777
BIHAR,2012,Detenus Released - Released on completion of detention period,40,0,40
BIHAR,2012,Detenus Released - Released before completion of detention period,13,0,13
BIHAR,2012,Detenus Released - Released on bail,55,0,55
BIHAR,2012,Detenus Released - Other releases (temporary transfer etc.),18,0,18
BIHAR,2012,Total Detenus Released,126,0,126
CHHATTISGARH,2012,Convicts Released - Released after completion of conviction,1775,25,1800
CHHATTISGARH,2012,Convicts Released - Premature release,35,1,36
CHHATTISGARH,2012,Convicts Released - Released on appeal,286,14,300
CHHATTISGARH,2012,Convicts Released - Released on bail,1030,55,1085
CHHATTISGARH,2012,Convicts Released - Pardons,0,0,0
CHHATTISGARH,2012,Convicts Released - Transferred to other States,4,0,4
CHHATTISGARH,2012,"Convicts Released - Other Releases (due to illness, transferred to Mental hospital)",0,0,0
CHHATTISGARH,2012,Total Convicts Released,3130,95,3225
CHHATTISGARH,2012,Under trials Released - Acquitted,3856,107,3963
CHHATTISGARH,2012,Under trials Released - Released on appeal,8,0,8
CHHATTISGARH,2012,Under trials Released - Released on bail,30643,1294,31937
CHHATTISGARH,2012,Under trials Released - Transferred to other States,17,0,17
CHHATTISGARH,2012,Under trials Released - Extradited,0,0,0
CHHATTISGARH,2012,Under trials Released - Other releases (transferred to Mental/Civil hospital),0,0,0
CHHATTISGARH,2012,Total Under trials Released,34524,1401,35925
CHHATTISGARH,2012,Detenus Released - Released on completion of detention period,30,0,30
CHHATTISGARH,2012,Detenus Released - Released before completion of detention period,25,0,25
CHHATTISGARH,2012,Detenus Released - Released on bail,0,0,0
CHHATTISGARH,2012,Detenus Released - Other releases (temporary transfer etc.),5,0,5
CHHATTISGARH,2012,Total Detenus Released,60,0,60
CHHATTISGARH,2001,Convicts Released - Released after completion of conviction,1665,44,1709
CHHATTISGARH,2001,Convicts Released - Premature release,307,6,313
CHHATTISGARH,2001,Convicts Released - Released on appeal,78,4,82
CHHATTISGARH,2001,Convicts Released - Released on bail,2819,163,2982
CHHATTISGARH,2001,Convicts Released - Pardons,571,22,593
CHHATTISGARH,2001,Convicts Released - Transferred to other States,11,0,11
CHHATTISGARH,2001,"Convicts Released - Other Releases (due to illness, transferred to Mental hospital)",650,12,662
CHHATTISGARH,2001,Total Convicts Released,6101,251,6352
CHHATTISGARH,2001,Under trials Released - Acquitted,7285,329,7614
CHHATTISGARH,2001,Under trials Released - Released on appeal,209,7,216
CHHATTISGARH,2001,Under trials Released - Released on bail,14576,548,15124
CHHATTISGARH,2001,Under trials Released - Transferred to other States,3223,71,3294
CHHATTISGARH,2001,Under trials Released - Extradited,89,0,89
CHHATTISGARH,2001,Under trials Released - Other releases (transferred to Mental/Civil hospital),3254,114,3368
CHHATTISGARH,2001,Total Under trials Released,28636,1069,29705
CHHATTISGARH,2001,Detenus Released - Released on completion of detention period,8,0,8
CHHATTISGARH,2001,Detenus Released - Released before completion of detention period,10,0,10
CHHATTISGARH,2001,Detenus Released - Released on bail,0,0,0
CHHATTISGARH,2001,Detenus Released - Other releases (temporary transfer etc.),0,0,0
CHHATTISGARH,2001,Total Detenus Released,18,0,18
CHHATTISGARH,2002,Convicts Released - Released after completion of conviction,2110,55,2165
CHHATTISGARH,2002,Convicts Released - Premature release,187,5,192
CHHATTISGARH,2002,Convicts Released - Released on appeal,57,0,57
CHHATTISGARH,2002,Convicts Released - Released on bail,1398,59,1457
CHHATTISGARH,2002,Convicts Released - Pardons,138,6,144
CHHATTISGARH,2002,Convicts Released - Transferred to other States,8,0,8
CHHATTISGARH,2002,"Convicts Released - Other Releases (due to illness, transferred to Mental hospital)",363,3,366
CHHATTISGARH,2002,Total Convicts Released,4261,128,4389
CHHATTISGARH,2002,Under trials Released - Acquitted,2264,75,2339
CHHATTISGARH,2002,Under trials Released - Released on appeal,581,14,595
CHHATTISGARH,2002,Under trials Released - Released on bail,21036,980,22016
CHHATTISGARH,2002,Under trials Released - Transferred to other States,44,0,44
CHHATTISGARH,2002,Under trials Released - Extradited,298,11,309
CHHATTISGARH,2002,Under trials Released - Other releases (transferred to Mental/Civil hospital),702,8,710
CHHATTISGARH,2002,Total Under trials Released,24925,1088,26013
CHHATTISGARH,2002,Detenus Released - Released on completion of detention period,15,0,15
CHHATTISGARH,2002,Detenus Released - Released before completion of detention period,13,0,13
CHHATTISGARH,2002,Detenus Released - Released on bail,0,0,0
CHHATTISGARH,2002,Detenus Released - Other releases (temporary transfer etc.),4,0,4
CHHATTISGARH,2002,Total Detenus Released,32,0,32
CHHATTISGARH,2003,Convicts Released - Released after completion of conviction,2566,31,2597
CHHATTISGARH,2003,Convicts Released - Premature release,426,0,426
CHHATTISGARH,2003,Convicts Released - Released on appeal,195,7,202
CHHATTISGARH,2003,Convicts Released - Released on bail,1977,214,2191
CHHATTISGARH,2003,Convicts Released - Pardons,286,15,301
CHHATTISGARH,2003,Convicts Released - Transferred to other States,296,27,323
CHHATTISGARH,2003,"Convicts Released - Other Releases (due to illness, transferred to Mental hospital)",655,55,710
CHHATTISGARH,2003,Total Convicts Released,6401,349,6750
CHHATTISGARH,2003,Under trials Released - Acquitted,1329,71,1400
CHHATTISGARH,2003,Under trials Released - Released on appeal,25,0,25
CHHATTISGARH,2003,Under trials Released - Released on bail,26263,812,27075
CHHATTISGARH,2003,Under trials Released - Transferred to other States,1514,0,1514
CHHATTISGARH,2003,Under trials Released - Extradited,515,21,536
CHHATTISGARH,2003,Under trials Released - Other releases (transferred to Mental/Civil hospital),174,0,174
CHHATTISGARH,2003,Total Under trials Released,29820,904,30724
CHHATTISGARH,2003,Detenus Released - Released on completion of detention period,1,0,1
CHHATTISGARH,2003,Detenus Released - Released before completion of detention period,4,0,4
CHHATTISGARH,2003,Detenus Released - Released on bail,0,0,0
CHHATTISGARH,2003,Detenus Released - Other releases (temporary transfer etc.),0,0,0
CHHATTISGARH,2003,Total Detenus Released,5,0,5
CHHATTISGARH,2004,Convicts Released - Released after completion of conviction,2624,41,2665
CHHATTISGARH,2004,Convicts Released - Premature release,222,5,227
CHHATTISGARH,2004,Convicts Released - Released on appeal,79,4,83
CHHATTISGARH,2004,Convicts Released - Released on bail,1617,92,1709
CHHATTISGARH,2004,Convicts Released - Pardons,98,5,103
CHHATTISGARH,2004,Convicts Released - Transferred to other States,244,20,264
CHHATTISGARH,2004,"Convicts Released - Other Releases (due to illness, transferred to Mental hospital)",651,11,662
CHHATTISGARH,2004,Total Convicts Released,5535,178,5713
CHHATTISGARH,2004,Under trials Released - Acquitted,1742,69,1811
CHHATTISGARH,2004,Under trials Released - Released on appeal,17,0,17
CHHATTISGARH,2004,Under trials Released - Released on bail,28007,848,28855
CHHATTISGARH,2004,Under trials Released - Transferred to other States,347,4,351
CHHATTISGARH,2004,Under trials Released - Extradited,136,0,136
CHHATTISGARH,2004,Under trials Released - Other releases (transferred to Mental/Civil hospital),1211,22,1233
CHHATTISGARH,2004,Total Under trials Released,31460,943,32403
CHHATTISGARH,2004,Detenus Released - Released on completion of detention period,0,0,0
CHHATTISGARH,2004,Detenus Released - Released before completion of detention period,5,0,5
CHHATTISGARH,2004,Detenus Released - Released on bail,0,0,0
CHHATTISGARH,2004,Detenus Released - Other releases (temporary transfer etc.),0,0,0
CHHATTISGARH,2004,Total Detenus Released,5,0,5
CHHATTISGARH,2005,Convicts Released - Released after completion of conviction,1798,46,1844
CHHATTISGARH,2005,Convicts Released - Premature release,223,1,224
CHHATTISGARH,2005,Convicts Released - Released on appeal,76,7,83
CHHATTISGARH,2005,Convicts Released - Released on bail,1148,92,1240
CHHATTISGARH,2005,Convicts Released - Pardons,236,6,242
CHHATTISGARH,2005,Convicts Released - Transferred to other States,4,1,5
CHHATTISGARH,2005,"Convicts Released - Other Releases (due to illness, transferred to Mental hospital)",370,35,405
CHHATTISGARH,2005,Total Convicts Released,3855,188,4043
CHHATTISGARH,2005,Under trials Released - Acquitted,1473,82,1555
CHHATTISGARH,2005,Under trials Released - Released on appeal,12,0,12
CHHATTISGARH,2005,Under trials Released - Released on bail,29391,1008,30399
CHHATTISGARH,2005,Under trials Released - Transferred to other States,59,0,59
CHHATTISGARH,2005,Under trials Released - Extradited,0,0,0
CHHATTISGARH,2005,Under trials Released - Other releases (transferred to Mental/Civil hospital),926,4,930
CHHATTISGARH,2005,Total Under trials Released,31861,1094,32955
CHHATTISGARH,2005,Detenus Released - Released on completion of detention period,4,0,4
CHHATTISGARH,2005,Detenus Released - Released before completion of detention period,0,0,0
CHHATTISGARH,2005,Detenus Released - Released on bail,0,0,0
CHHATTISGARH,2005,Detenus Released - Other releases (temporary transfer etc.),0,0,0
CHHATTISGARH,2005,Total Detenus Released,4,0,4
CHHATTISGARH,2006,Convicts Released - Released after completion of conviction,1706,25,1731
CHHATTISGARH,2006,Convicts Released - Premature release,69,1,70
CHHATTISGARH,2006,Convicts Released - Released on appeal,345,32,377
CHHATTISGARH,2006,Convicts Released - Released on bail,861,45,906
CHHATTISGARH,2006,Convicts Released - Pardons,52,0,52
CHHATTISGARH,2006,Convicts Released - Transferred to other States,222,15,237
CHHATTISGARH,2006,"Convicts Released - Other Releases (due to illness, transferred to Mental hospital)",503,14,517
CHHATTISGARH,2006,Total Convicts Released,3758,132,3890
CHHATTISGARH,2006,Under trials Released - Acquitted,2098,54,2152
CHHATTISGARH,2006,Under trials Released - Released on appeal,672,405,1077
CHHATTISGARH,2006,Under trials Released - Released on bail,30952,727,31679
CHHATTISGARH,2006,Under trials Released - Transferred to other States,208,1,209
CHHATTISGARH,2006,Under trials Released - Extradited,259,7,266
CHHATTISGARH,2006,Under trials Released - Other releases (transferred to Mental/Civil hospital),21,1,22
CHHATTISGARH,2006,Total Under trials Released,34210,1195,35405
CHHATTISGARH,2006,Detenus Released - Released on completion of detention period,14,0,14
CHHATTISGARH,2006,Detenus Released - Released before completion of detention period,0,0,0
CHHATTISGARH,2006,Detenus Released - Released on bail,0,0,0
CHHATTISGARH,2006,Detenus Released - Other releases (temporary transfer etc.),3,0,3
CHHATTISGARH,2006,Total Detenus Released,17,0,17
CHHATTISGARH,2007,Convicts Released - Released after completion of conviction,2584,41,2625
CHHATTISGARH,2007,Convicts Released - Premature release,166,5,171
CHHATTISGARH,2007,Convicts Released - Released on appeal,374,13,387
CHHATTISGARH,2007,Convicts Released - Released on bail,972,54,1026
CHHATTISGARH,2007,Convicts Released - Pardons,30,1,31
CHHATTISGARH,2007,Convicts Released - Transferred to other States,0,0,0
CHHATTISGARH,2007,"Convicts Released - Other Releases (due to illness, transferred to Mental hospital)",229,2,231
CHHATTISGARH,2007,Total Convicts Released,4355,116,4471
CHHATTISGARH,2007,Under trials Released - Acquitted,2384,98,2482
CHHATTISGARH,2007,Under trials Released - Released on appeal,100,2,102
CHHATTISGARH,2007,Under trials Released - Released on bail,29906,1142,31048
CHHATTISGARH,2007,Under trials Released - Transferred to other States,0,0,0
CHHATTISGARH,2007,Under trials Released - Extradited,443,36,479
CHHATTISGARH,2007,Under trials Released - Other releases (transferred to Mental/Civil hospital),1010,41,1051
CHHATTISGARH,2007,Total Under trials Released,33843,1319,35162
CHHATTISGARH,2007,Detenus Released - Released on completion of detention period,20,0,20
CHHATTISGARH,2007,Detenus Released - Released before completion of detention period,0,0,0
CHHATTISGARH,2007,Detenus Released - Released on bail,0,0,0
CHHATTISGARH,2007,Detenus Released - Other releases (temporary transfer etc.),0,0,0
CHHATTISGARH,2007,Total Detenus Released,20,0,20
CHHATTISGARH,2008,Convicts Released - Released after completion of conviction,2548,45,2593
CHHATTISGARH,2008,Convicts Released - Premature release,261,6,267
CHHATTISGARH,2008,Convicts Released - Released on appeal,288,11,299
CHHATTISGARH,2008,Convicts Released - Released on bail,1018,74,1092
CHHATTISGARH,2008,Convicts Released - Pardons,12,2,14
CHHATTISGARH,2008,Convicts Released - Transferred to other States,322,4,326
CHHATTISGARH,2008,"Convicts Released - Other Releases (due to illness, transferred to Mental hospital)",107,4,111
CHHATTISGARH,2008,Total Convicts Released,4556,146,4702
CHHATTISGARH,2008,Under trials Released - Acquitted,2470,101,2571
CHHATTISGARH,2008,Under trials Released - Released on appeal,131,0,131
CHHATTISGARH,2008,Under trials Released - Released on bail,33649,1295,34944
CHHATTISGARH,2008,Under trials Released - Transferred to other States,185,0,185
CHHATTISGARH,2008,Under trials Released - Extradited,441,38,479
CHHATTISGARH,2008,Under trials Released - Other releases (transferred to Mental/Civil hospital),130,3,133
CHHATTISGARH,2008,Total Under trials Released,37006,1437,38443
CHHATTISGARH,2008,Detenus Released - Released on completion of detention period,21,0,21
CHHATTISGARH,2008,Detenus Released - Released before completion of detention period,3,0,3
CHHATTISGARH,2008,Detenus Released - Released on bail,0,0,0
CHHATTISGARH,2008,Detenus Released - Other releases (temporary transfer etc.),0,0,0
CHHATTISGARH,2008,Total Detenus Released,24,0,24
CHHATTISGARH,2009,Convicts Released - Released after completion of conviction,2018,37,2055
CHHATTISGARH,2009,Convicts Released - Premature release,95,4,99
CHHATTISGARH,2009,Convicts Released - Released on appeal,167,4,171
CHHATTISGARH,2009,Convicts Released - Released on bail,770,33,803
CHHATTISGARH,2009,Convicts Released - Pardons,58,4,62
CHHATTISGARH,2009,Convicts Released - Transferred to other States,281,8,289
CHHATTISGARH,2009,"Convicts Released - Other Releases (due to illness, transferred to Mental hospital)",212,3,215
CHHATTISGARH,2009,Total Convicts Released,3601,93,3694
CHHATTISGARH,2009,Under trials Released - Acquitted,3381,89,3470
CHHATTISGARH,2009,Under trials Released - Released on appeal,31,3,34
CHHATTISGARH,2009,Under trials Released - Released on bail,33466,1172,34638
CHHATTISGARH,2009,Under trials Released - Transferred to other States,30,2,32
CHHATTISGARH,2009,Under trials Released - Extradited,0,0,0
CHHATTISGARH,2009,Under trials Released - Other releases (transferred to Mental/Civil hospital),456,57,513
CHHATTISGARH,2009,Total Under trials Released,37364,1323,38687
CHHATTISGARH,2009,Detenus Released - Released on completion of detention period,0,0,0
CHHATTISGARH,2009,Detenus Released - Released before completion of detention period,0,0,0
CHHATTISGARH,2009,Detenus Released - Released on bail,0,0,0
CHHATTISGARH,2009,Detenus Released - Other releases (temporary transfer etc.),0,0,0
CHHATTISGARH,2009,Total Detenus Released,0,0,0
CHHATTISGARH,2010,Convicts Released - Released after completion of conviction,1544,23,1567
CHHATTISGARH,2010,Convicts Released - Premature release,312,7,319
CHHATTISGARH,2010,Convicts Released - Released on appeal,213,9,222
CHHATTISGARH,2010,Convicts Released - Released on bail,763,43,806
CHHATTISGARH,2010,Convicts Released - Pardons,93,7,100
CHHATTISGARH,2010,Convicts Released - Transferred to other States,365,3,368
CHHATTISGARH,2010,"Convicts Released - Other Releases (due to illness, transferred to Mental hospital)",22,0,22
CHHATTISGARH,2010,Total Convicts Released,3312,92,3404
CHHATTISGARH,2010,Under trials Released - Acquitted,3202,114,3316
CHHATTISGARH,2010,Under trials Released - Released on appeal,211,0,211
CHHATTISGARH,2010,Under trials Released - Released on bail,31339,1141,32480
CHHATTISGARH,2010,Under trials Released - Transferred to other States,158,1,159
CHHATTISGARH,2010,Under trials Released - Extradited,0,0,0
CHHATTISGARH,2010,Under trials Released - Other releases (transferred to Mental/Civil hospital),374,23,397
CHHATTISGARH,2010,Total Under trials Released,35284,1279,36563
CHHATTISGARH,2010,Detenus Released - Released on completion of detention period,0,0,0
CHHATTISGARH,2010,Detenus Released - Released before completion of detention period,1,0,1
CHHATTISGARH,2010,Detenus Released - Released on bail,0,0,0
CHHATTISGARH,2010,Detenus Released - Other releases (temporary transfer etc.),0,0,0
CHHATTISGARH,2010,Total Detenus Released,1,0,1
CHHATTISGARH,2011,Convicts Released - Released after completion of conviction,2181,46,2227
CHHATTISGARH,2011,Convicts Released - Premature release,146,5,151
CHHATTISGARH,2011,Convicts Released - Released on appeal,335,17,352
CHHATTISGARH,2011,Convicts Released - Released on bail,1066,41,1107
CHHATTISGARH,2011,Convicts Released - Pardons,0,0,0
CHHATTISGARH,2011,Convicts Released - Transferred to other States,3,0,3
CHHATTISGARH,2011,"Convicts Released - Other Releases (due to illness, transferred to Mental hospital)",0,0,0
CHHATTISGARH,2011,Total Convicts Released,3731,109,3840
CHHATTISGARH,2011,Under trials Released - Acquitted,2680,119,2799
CHHATTISGARH,2011,Under trials Released - Released on appeal,324,5,329
CHHATTISGARH,2011,Under trials Released - Released on bail,34929,1518,36447
CHHATTISGARH,2011,Under trials Released - Transferred to other States,0,0,0
CHHATTISGARH,2011,Under trials Released - Extradited,0,0,0
CHHATTISGARH,2011,Under trials Released - Other releases (transferred to Mental/Civil hospital),0,0,0
CHHATTISGARH,2011,Total Under trials Released,37933,1642,39575
CHHATTISGARH,2011,Detenus Released - Released on completion of detention period,0,0,0
CHHATTISGARH,2011,Detenus Released - Released before completion of detention period,0,0,0
CHHATTISGARH,2011,Detenus Released - Released on bail,0,0,0
CHHATTISGARH,2011,Detenus Released - Other releases (temporary transfer etc.),0,0,0
CHHATTISGARH,2011,Total Detenus Released,0,0,0
GOA,2001,Convicts Released - Released after completion of conviction,71,6,77
GOA,2001,Convicts Released - Premature release,3,0,3
GOA,2001,Convicts Released - Released on appeal,26,0,26
GOA,2001,Convicts Released - Released on bail,15,3,18
GOA,2001,Convicts Released - Pardons,0,0,0
GOA,2001,Convicts Released - Transferred to other States,23,0,23
GOA,2001,"Convicts Released - Other Releases (due to illness, transferred to Mental hospital)",2,0,2
GOA,2001,Total Convicts Released,140,9,149
GOA,2001,Under trials Released - Acquitted,112,4,116
GOA,2001,Under trials Released - Released on appeal,9,0,9
GOA,2001,Under trials Released - Released on bail,499,15,514
GOA,2001,Under trials Released - Transferred to other States,53,0,53
GOA,2001,Under trials Released - Extradited,0,0,0
GOA,2001,Under trials Released - Other releases (transferred to Mental/Civil hospital),118,25,143
GOA,2001,Total Under trials Released,791,44,835
GOA,2001,Detenus Released - Released on completion of detention period,1,0,1
GOA,2001,Detenus Released - Released before completion of detention period,0,0,0
GOA,2001,Detenus Released - Released on bail,0,0,0
GOA,2001,Detenus Released - Other releases (temporary transfer etc.),0,0,0
GOA,2001,Total Detenus Released,1,0,1
GOA,2002,Convicts Released - Released after completion of conviction,70,0,70
GOA,2002,Convicts Released - Premature release,0,0,0
GOA,2002,Convicts Released - Released on appeal,0,0,0
GOA,2002,Convicts Released - Released on bail,17,2,19
GOA,2002,Convicts Released - Pardons,0,0,0
GOA,2002,Convicts Released - Transferred to other States,2,0,2
GOA,2002,"Convicts Released - Other Releases (due to illness, transferred to Mental hospital)",0,0,0
GOA,2002,Total Convicts Released,89,2,91
GOA,2002,Under trials Released - Acquitted,193,1,194
GOA,2002,Under trials Released - Released on appeal,0,0,0
GOA,2002,Under trials Released - Released on bail,564,30,594
GOA,2002,Under trials Released - Transferred to other States,79,0,79
GOA,2002,Under trials Released - Extradited,20,0,20
GOA,2002,Under trials Released - Other releases (transferred to Mental/Civil hospital),13,0,13
GOA,2002,Total Under trials Released,869,31,900
GOA,2002,Detenus Released - Released on completion of detention period,0,0,0
GOA,2002,Detenus Released - Released before completion of detention period,0,0,0
GOA,2002,Detenus Released - Released on bail,0,0,0
GOA,2002,Detenus Released - Other releases (temporary transfer etc.),0,0,0
GOA,2002,Total Detenus Released,0,0,0
GOA,2003,Convicts Released - Released after completion of conviction,71,0,71
GOA,2003,Convicts Released - Premature release,2,0,2
GOA,2003,Convicts Released - Released on appeal,13,1,14
GOA,2003,Convicts Released - Released on bail,12,0,12
GOA,2003,Convicts Released - Pardons,1,0,1
GOA,2003,Convicts Released - Transferred to other States,2,0,2
GOA,2003,"Convicts Released - Other Releases (due to illness, transferred to Mental hospital)",0,0,0
GOA,2003,Total Convicts Released,101,1,102
GOA,2003,Under trials Released - Acquitted,81,9,90
GOA,2003,Under trials Released - Released on appeal,43,0,43
GOA,2003,Under trials Released - Released on bail,590,37,627
GOA,2003,Under trials Released - Transferred to other States,38,0,38
GOA,2003,Under trials Released - Extradited,0,0,0
GOA,2003,Under trials Released - Other releases (transferred to Mental/Civil hospital),33,0,33
GOA,2003,Total Under trials Released,785,46,831
GOA,2003,Detenus Released - Released on completion of detention period,0,0,0
GOA,2003,Detenus Released - Released before completion of detention period,0,0,0
GOA,2003,Detenus Released - Released on bail,0,0,0
GOA,2003,Detenus Released - Other releases (temporary transfer etc.),0,0,0
GOA,2003,Total Detenus Released,0,0,0
GOA,2004,Convicts Released - Released after completion of conviction,58,2,60
GOA,2004,Convicts Released - Premature release,0,0,0
GOA,2004,Convicts Released - Released on appeal,10,0,10
GOA,2004,Convicts Released - Released on bail,9,0,9
GOA,2004,Convicts Released - Pardons,1,0,1
GOA,2004,Convicts Released - Transferred to other States,0,0,0
GOA,2004,"Convicts Released - Other Releases (due to illness, transferred to Mental hospital)",0,0,0
GOA,2004,Total Convicts Released,78,2,80
GOA,2004,Under trials Released - Acquitted,111,5,116
GOA,2004,Under trials Released - Released on appeal,0,0,0
GOA,2004,Under trials Released - Released on bail,542,22,564
GOA,2004,Under trials Released - Transferred to other States,0,0,0
GOA,2004,Under trials Released - Extradited,0,0,0
GOA,2004,Under trials Released - Other releases (transferred to Mental/Civil hospital),101,0,101
GOA,2004,Total Under trials Released,754,27,781
GOA,2004,Detenus Released - Released on completion of detention period,0,0,0
GOA,2004,Detenus Released - Released before completion of detention period,0,0,0
GOA,2004,Detenus Released - Released on bail,0,0,0
GOA,2004,Detenus Released - Other releases (temporary transfer etc.),0,0,0
GOA,2004,Total Detenus Released,0,0,0
GOA,2005,Convicts Released - Released after completion of conviction,76,0,76
GOA,2005,Convicts Released - Premature release,0,0,0
GOA,2005,Convicts Released - Released on appeal,14,0,14
GOA,2005,Convicts Released - Released on bail,21,9,30
GOA,2005,Convicts Released - Pardons,0,0,0
GOA,2005,Convicts Released - Transferred to other States,0,0,0
GOA,2005,"Convicts Released - Other Releases (due to illness, transferred to Mental hospital)",1,1,2
GOA,2005,Total Convicts Released,112,10,122
GOA,2005,Under trials Released - Acquitted,112,0,112
GOA,2005,Under trials Released - Released on appeal,3,8,11
GOA,2005,Under trials Released - Released on bail,341,0,341
GOA,2005,Under trials Released - Transferred to other States,142,14,156
GOA,2005,Under trials Released - Extradited,37,0,37
GOA,2005,Under trials Released - Other releases (transferred to Mental/Civil hospital),39,0,39
GOA,2005,Total Under trials Released,674,22,696
GOA,2005,Detenus Released - Released on completion of detention period,0,0,0
GOA,2005,Detenus Released - Released before completion of detention period,0,0,0
GOA,2005,Detenus Released - Released on bail,0,0,0
GOA,2005,Detenus Released - Other releases (temporary transfer etc.),0,0,0
GOA,2005,Total Detenus Released,0,0,0
GOA,2006,Convicts Released - Released after completion of conviction,82,1,83
GOA,2006,Convicts Released - Premature release,6,0,6
GOA,2006,Convicts Released - Released on appeal,3,0,3
GOA,2006,Convicts Released - Released on bail,10,0,10
GOA,2006,Convicts Released - Pardons,0,0,0
GOA,2006,Convicts Released - Transferred to other States,0,0,0
GOA,2006,"Convicts Released - Other Releases (due to illness, transferred to Mental hospital)",0,0,0
GOA,2006,Total Convicts Released,101,1,102
GOA,2006,Under trials Released - Acquitted,80,8,88
GOA,2006,Under trials Released - Released on appeal,0,0,0
GOA,2006,Under trials Released - Released on bail,325,10,335
GOA,2006,Under trials Released - Transferred to other States,2,0,2
GOA,2006,Under trials Released - Extradited,43,0,43
GOA,2006,Under trials Released - Other releases (transferred to Mental/Civil hospital),95,0,95
GOA,2006,Total Under trials Released,545,18,563
GOA,2006,Detenus Released - Released on completion of detention period,0,0,0
GOA,2006,Detenus Released - Released before completion of detention period,0,0,0
GOA,2006,Detenus Released - Released on bail,0,0,0
GOA,2006,Detenus Released - Other releases (temporary transfer etc.),0,0,0
GOA,2006,Total Detenus Released,0,0,0
GOA,2007,Convicts Released - Released after completion of conviction,90,2,92
GOA,2007,Convicts Released - Premature release,12,1,13
GOA,2007,Convicts Released - Released on appeal,2,0,2
GOA,2007,Convicts Released - Released on bail,19,0,19
GOA,2007,Convicts Released - Pardons,0,0,0
GOA,2007,Convicts Released - Transferred to other States,0,0,0
GOA,2007,"Convicts Released - Other Releases (due to illness, transferred to Mental hospital)",0,0,0
GOA,2007,Total Convicts Released,123,3,126
GOA,2007,Under trials Released - Acquitted,53,5,58
GOA,2007,Under trials Released - Released on appeal,0,0,0
GOA,2007,Under trials Released - Released on bail,216,18,234
GOA,2007,Under trials Released - Transferred to other States,1,0,1
GOA,2007,Under trials Released - Extradited,0,0,0
GOA,2007,Under trials Released - Other releases (transferred to Mental/Civil hospital),0,0,0
GOA,2007,Total Under trials Released,270,23,293
GOA,2007,Detenus Released - Released on completion of detention period,0,0,0
GOA,2007,Detenus Released - Released before completion of detention period,0,0,0
GOA,2007,Detenus Released - Released on bail,0,0,0
GOA,2007,Detenus Released - Other releases (temporary transfer etc.),0,0,0
GOA,2007,Total Detenus Released,0,0,0
GOA,2008,Convicts Released - Released after completion of conviction,93,2,95
GOA,2008,Convicts Released - Premature release,10,0,10
GOA,2008,Convicts Released - Released on appeal,23,0,23
GOA,2008,Convicts Released - Released on bail,5,2,7
GOA,2008,Convicts Released - Pardons,0,0,0
GOA,2008,Convicts Released - Transferred to other States,1,0,1
GOA,2008,"Convicts Released - Other Releases (due to illness, transferred to Mental hospital)",12,1,13
GOA,2008,Total Convicts Released,144,5,149
GOA,2008,Under trials Released - Acquitted,47,10,57
GOA,2008,Under trials Released - Released on appeal,122,41,163
GOA,2008,Under trials Released - Released on bail,60,0,60
GOA,2008,Under trials Released - Transferred to other States,300,0,300
GOA,2008,Under trials Released - Extradited,0,0,0
GOA,2008,Under trials Released - Other releases (transferred to Mental/Civil hospital),0,6,6
GOA,2008,Total Under trials Released,529,57,586
GOA,2008,Detenus Released - Released on completion of detention period,0,0,0
GOA,2008,Detenus Released - Released before completion of detention period,0,0,0
GOA,2008,Detenus Released - Released on bail,0,0,0
GOA,2008,Detenus Released - Other releases (temporary transfer etc.),0,0,0
GOA,2008,Total Detenus Released,0,0,0
GOA,2009,Convicts Released - Released after completion of conviction,62,0,62
GOA,2009,Convicts Released - Premature release,0,0,0
GOA,2009,Convicts Released - Released on appeal,3,0,3
GOA,2009,Convicts Released - Released on bail,0,0,0
GOA,2009,Convicts Released - Pardons,0,0,0
GOA,2009,Convicts Released - Transferred to other States,0,0,0
GOA,2009,"Convicts Released - Other Releases (due to illness, transferred to Mental hospital)",0,0,0
GOA,2009,Total Convicts Released,65,0,65
GOA,2009,Under trials Released - Acquitted,129,12,141
GOA,2009,Under trials Released - Released on appeal,0,0,0
GOA,2009,Under trials Released - Released on bail,111,40,151
GOA,2009,Under trials Released - Transferred to other States,0,0,0
GOA,2009,Under trials Released - Extradited,0,0,0
GOA,2009,Under trials Released - Other releases (transferred to Mental/Civil hospital),0,0,0
GOA,2009,Total Under trials Released,240,52,292
GOA,2009,Detenus Released - Released on completion of detention period,0,0,0
GOA,2009,Detenus Released - Released before completion of detention period,0,0,0
GOA,2009,Detenus Released - Released on bail,0,0,0
GOA,2009,Detenus Released - Other releases (temporary transfer etc.),0,0,0
GOA,2009,Total Detenus Released,0,0,0
GOA,2010,Convicts Released - Released after completion of conviction,107,10,117
GOA,2010,Convicts Released - Premature release,2,0,2
GOA,2010,Convicts Released - Released on appeal,6,1,7
GOA,2010,Convicts Released - Released on bail,10,1,11
GOA,2010,Convicts Released - Pardons,0,0,0
GOA,2010,Convicts Released - Transferred to other States,1,0,1
GOA,2010,"Convicts Released - Other Releases (due to illness, transferred to Mental hospital)",1,0,1
GOA,2010,Total Convicts Released,127,12,139
GOA,2010,Under trials Released - Acquitted,54,8,62
GOA,2010,Under trials Released - Released on appeal,0,0,0
GOA,2010,Under trials Released - Released on bail,421,36,457
GOA,2010,Under trials Released - Transferred to other States,4,0,4
GOA,2010,Under trials Released - Extradited,0,0,0
GOA,2010,Under trials Released - Other releases (transferred to Mental/Civil hospital),2,0,2
GOA,2010,Total Under trials Released,481,44,525
GOA,2010,Detenus Released - Released on completion of detention period,0,0,0
GOA,2010,Detenus Released - Released before completion of detention period,0,0,0
GOA,2010,Detenus Released - Released on bail,0,0,0
GOA,2010,Detenus Released - Other releases (temporary transfer etc.),0,0,0
GOA,2010,Total Detenus Released,0,0,0
GOA,2011,Convicts Released - Released after completion of conviction,95,1,96
GOA,2011,Convicts Released - Premature release,3,0,3
GOA,2011,Convicts Released - Released on appeal,10,0,10
GOA,2011,Convicts Released - Released on bail,59,2,61
GOA,2011,Convicts Released - Pardons,0,0,0
GOA,2011,Convicts Released - Transferred to other States,1,0,1
GOA,2011,"Convicts Released - Other Releases (due to illness, transferred to Mental hospital)",0,0,0
GOA,2011,Total Convicts Released,168,3,171
GOA,2011,Under trials Released - Acquitted,28,7,35
GOA,2011,Under trials Released - Released on appeal,0,0,0
GOA,2011,Under trials Released - Released on bail,588,45,633
GOA,2011,Under trials Released - Transferred to other States,0,0,0
GOA,2011,Under trials Released - Extradited,0,0,0
GOA,2011,Under trials Released - Other releases (transferred to Mental/Civil hospital),0,0,0
GOA,2011,Total Under trials Released,616,52,668
GOA,2011,Detenus Released - Released on completion of detention period,0,0,0
GOA,2011,Detenus Released - Released before completion of detention period,0,0,0
GOA,2011,Detenus Released - Released on bail,0,0,0
GOA,2011,Detenus Released - Other releases (temporary transfer etc.),0,0,0
GOA,2011,Total Detenus Released,0,0,0
GOA,2012,Convicts Released - Released after completion of conviction,78,3,81
GOA,2012,Convicts Released - Premature release,2,0,2
GOA,2012,Convicts Released - Released on appeal,3,0,3
GOA,2012,Convicts Released - Released on bail,56,2,58
GOA,2012,Convicts Released - Pardons,0,0,0
GOA,2012,Convicts Released - Transferred to other States,1,0,1
GOA,2012,"Convicts Released - Other Releases (due to illness, transferred to Mental hospital)",0,0,0
GOA,2012,Total Convicts Released,140,5,145
GOA,2012,Under trials Released - Acquitted,51,2,53
GOA,2012,Under trials Released - Released on appeal,0,0,0
GOA,2012,Under trials Released - Released on bail,825,65,890
GOA,2012,Under trials Released - Transferred to other States,2,0,2
GOA,2012,Under trials Released - Extradited,0,0,0
GOA,2012,Under trials Released - Other releases (transferred to Mental/Civil hospital),0,0,0
GOA,2012,Total Under trials Released,878,67,945
GOA,2012,Detenus Released - Released on completion of detention period,0,0,0
GOA,2012,Detenus Released - Released before completion of detention period,0,0,0
GOA,2012,Detenus Released - Released on bail,0,0,0
GOA,2012,Detenus Released - Other releases (temporary transfer etc.),0,0,0
GOA,2012,Total Detenus Released,0,0,0
GUJARAT,2001,Convicts Released - Released after completion of conviction,4905,48,4953
GUJARAT,2001,Convicts Released - Premature release,276,5,281
GUJARAT,2001,Convicts Released - Released on appeal,284,2,286
GUJARAT,2001,Convicts Released - Released on bail,87,29,116
GUJARAT,2001,Convicts Released - Pardons,87,9,96
GUJARAT,2001,Convicts Released - Transferred to other States,157,0,157
GUJARAT,2001,"Convicts Released - Other Releases (due to illness, transferred to Mental hospital)",149,0,149
GUJARAT,2001,Total Convicts Released,5945,93,6038
GUJARAT,2001,Under trials Released - Acquitted,7234,229,7463
GUJARAT,2001,Under trials Released - Released on appeal,8032,328,8360
GUJARAT,2001,Under trials Released - Released on bail,19521,1633,21154
GUJARAT,2001,Under trials Released - Transferred to other States,972,0,972
GUJARAT,2001,Under trials Released - Extradited,61,0,61
GUJARAT,2001,Under trials Released - Other releases (transferred to Mental/Civil hospital),470,12,482
GUJARAT,2001,Total Under trials Released,36290,2202,38492
GUJARAT,2001,Detenus Released - Released on completion of detention period,91,0,91
GUJARAT,2001,Detenus Released - Released before completion of detention period,524,65,589
GUJARAT,2001,Detenus Released - Released on bail,12,0,12
GUJARAT,2001,Detenus Released - Other releases (temporary transfer etc.),7,0,7
GUJARAT,2001,Total Detenus Released,634,65,699
GUJARAT,2002,Convicts Released - Released after completion of conviction,4423,38,4461
GUJARAT,2002,Convicts Released - Premature release,160,2,162
GUJARAT,2002,Convicts Released - Released on appeal,170,5,175
GUJARAT,2002,Convicts Released - Released on bail,183,15,198
GUJARAT,2002,Convicts Released - Pardons,0,0,0
GUJARAT,2002,Convicts Released - Transferred to other States,2,0,2
GUJARAT,2002,"Convicts Released - Other Releases (due to illness, transferred to Mental hospital)",118,1,119
GUJARAT,2002,Total Convicts Released,5056,61,5117
GUJARAT,2002,Under trials Released - Acquitted,5875,250,6125
GUJARAT,2002,Under trials Released - Released on appeal,605,3,608
GUJARAT,2002,Under trials Released - Released on bail,35078,2105,37183
GUJARAT,2002,Under trials Released - Transferred to other States,890,0,890
GUJARAT,2002,Under trials Released - Extradited,0,0,0
GUJARAT,2002,Under trials Released - Other releases (transferred to Mental/Civil hospital),40,5,45
GUJARAT,2002,Total Under trials Released,42488,2363,44851
GUJARAT,2002,Detenus Released - Released on completion of detention period,144,18,162
GUJARAT,2002,Detenus Released - Released before completion of detention period,390,30,420
GUJARAT,2002,Detenus Released - Released on bail,33,0,33
GUJARAT,2002,Detenus Released - Other releases (temporary transfer etc.),20,2,22
GUJARAT,2002,Total Detenus Released,587,50,637
GUJARAT,2003,Convicts Released - Released after completion of conviction,5407,63,5470
GUJARAT,2003,Convicts Released - Premature release,315,1,316
GUJARAT,2003,Convicts Released - Released on appeal,287,8,295
GUJARAT,2003,Convicts Released - Released on bail,408,42,450
GUJARAT,2003,Convicts Released - Pardons,285,6,291
GUJARAT,2003,Convicts Released - Transferred to other States,2,0,2
GUJARAT,2003,"Convicts Released - Other Releases (due to illness, transferred to Mental hospital)",128,36,164
GUJARAT,2003,Total Convicts Released,6832,156,6988
GUJARAT,2003,Under trials Released - Acquitted,5320,223,5543
GUJARAT,2003,Under trials Released - Released on appeal,348,11,359
GUJARAT,2003,Under trials Released - Released on bail,32061,1198,33259
GUJARAT,2003,Under trials Released - Transferred to other States,994,5,999
GUJARAT,2003,Under trials Released - Extradited,0,0,0
GUJARAT,2003,Under trials Released - Other releases (transferred to Mental/Civil hospital),29,0,29
GUJARAT,2003,Total Under trials Released,38752,1437,40189
GUJARAT,2003,Detenus Released - Released on completion of detention period,122,0,122
GUJARAT,2003,Detenus Released - Released before completion of detention period,503,54,557
GUJARAT,2003,Detenus Released - Released on bail,291,0,291
GUJARAT,2003,Detenus Released - Other releases (temporary transfer etc.),1,0,1
GUJARAT,2003,Total Detenus Released,917,54,971
GUJARAT,2004,Convicts Released - Released after completion of conviction,7302,75,7377
GUJARAT,2004,Convicts Released - Premature release,88,4,92
GUJARAT,2004,Convicts Released - Released on appeal,340,42,382
GUJARAT,2004,Convicts Released - Released on bail,572,23,595
GUJARAT,2004,Convicts Released - Pardons,255,15,270
GUJARAT,2004,Convicts Released - Transferred to other States,722,24,746
GUJARAT,2004,"Convicts Released - Other Releases (due to illness, transferred to Mental hospital)",177,9,186
GUJARAT,2004,Total Convicts Released,9456,192,9648
GUJARAT,2004,Under trials Released - Acquitted,3714,135,3849
GUJARAT,2004,Under trials Released - Released on appeal,19,4,23
GUJARAT,2004,Under trials Released - Released on bail,34411,2352,36763
GUJARAT,2004,Under trials Released - Transferred to other States,845,13,858
GUJARAT,2004,Under trials Released - Extradited,1,0,1
GUJARAT,2004,Under trials Released - Other releases (transferred to Mental/Civil hospital),187,4,191
GUJARAT,2004,Total Under trials Released,39177,2508,41685
GUJARAT,2004,Detenus Released - Released on completion of detention period,194,0,194
GUJARAT,2004,Detenus Released - Released before completion of detention period,1015,146,1161
GUJARAT,2004,Detenus Released - Released on bail,0,0,0
GUJARAT,2004,Detenus Released - Other releases (temporary transfer etc.),7,1,8
GUJARAT,2004,Total Detenus Released,1216,147,1363
GUJARAT,2005,Convicts Released - Released after completion of conviction,8851,106,8957
GUJARAT,2005,Convicts Released - Premature release,1,0,1
GUJARAT,2005,Convicts Released - Released on appeal,174,29,203
GUJARAT,2005,Convicts Released - Released on bail,298,40,338
GUJARAT,2005,Convicts Released - Pardons,56,2,58
GUJARAT,2005,Convicts Released - Transferred to other States,595,32,627
GUJARAT,2005,"Convicts Released - Other Releases (due to illness, transferred to Mental hospital)",168,0,168
GUJARAT,2005,Total Convicts Released,10143,209,10352
GUJARAT,2005,Under trials Released - Acquitted,4432,90,4522
GUJARAT,2005,Under trials Released - Released on appeal,0,0,0
GUJARAT,2005,Under trials Released - Released on bail,35583,2245,37828
GUJARAT,2005,Under trials Released - Transferred to other States,1744,37,1781
GUJARAT,2005,Under trials Released - Extradited,5,0,5
GUJARAT,2005,Under trials Released - Other releases (transferred to Mental/Civil hospital),28,0,28
GUJARAT,2005,Total Under trials Released,41792,2372,44164
GUJARAT,2005,Detenus Released - Released on completion of detention period,151,0,151
GUJARAT,2005,Detenus Released - Released before completion of detention period,1247,146,1393
GUJARAT,2005,Detenus Released - Released on bail,0,0,0
GUJARAT,2005,Detenus Released - Other releases (temporary transfer etc.),0,0,0
GUJARAT,2005,Total Detenus Released,1398,146,1544
GUJARAT,2006,Convicts Released - Released after completion of conviction,7262,147,7409
GUJARAT,2006,Convicts Released - Premature release,63,0,63
GUJARAT,2006,Convicts Released - Released on appeal,171,4,175
GUJARAT,2006,Convicts Released - Released on bail,285,23,308
GUJARAT,2006,Convicts Released - Pardons,69,6,75
GUJARAT,2006,Convicts Released - Transferred to other States,695,22,717
GUJARAT,2006,"Convicts Released - Other Releases (due to illness, transferred to Mental hospital)",1,0,1
GUJARAT,2006,Total Convicts Released,8546,202,8748
GUJARAT,2006,Under trials Released - Acquitted,5757,236,5993
GUJARAT,2006,Under trials Released - Released on appeal,0,0,0
GUJARAT,2006,Under trials Released - Released on bail,33464,1761,35225
GUJARAT,2006,Under trials Released - Transferred to other States,1260,15,1275
GUJARAT,2006,Under trials Released - Extradited,0,0,0
GUJARAT,2006,Under trials Released - Other releases (transferred to Mental/Civil hospital),423,7,430
GUJARAT,2006,Total Under trials Released,40904,2019,42923
GUJARAT,2006,Detenus Released - Released on completion of detention period,145,8,153
GUJARAT,2006,Detenus Released - Released before completion of detention period,1021,90,1111
GUJARAT,2006,Detenus Released - Released on bail,0,0,0
GUJARAT,2006,Detenus Released - Other releases (temporary transfer etc.),33,0,33
GUJARAT,2006,Total Detenus Released,1199,98,1297
GUJARAT,2007,Convicts Released - Released after completion of conviction,6397,55,6452
GUJARAT,2007,Convicts Released - Premature release,1035,17,1052
GUJARAT,2007,Convicts Released - Released on appeal,245,6,251
GUJARAT,2007,Convicts Released - Released on bail,612,49,661
GUJARAT,2007,Convicts Released - Pardons,219,10,229
GUJARAT,2007,Convicts Released - Transferred to other States,881,28,909
GUJARAT,2007,"Convicts Released - Other Releases (due to illness, transferred to Mental hospital)",0,0,0
GUJARAT,2007,Total Convicts Released,9389,165,9554
GUJARAT,2007,Under trials Released - Acquitted,3922,336,4258
GUJARAT,2007,Under trials Released - Released on appeal,0,0,0
GUJARAT,2007,Under trials Released - Released on bail,36488,2450,38938
GUJARAT,2007,Under trials Released - Transferred to other States,445,6,451
GUJARAT,2007,Under trials Released - Extradited,0,0,0
GUJARAT,2007,Under trials Released - Other releases (transferred to Mental/Civil hospital),1045,10,1055
GUJARAT,2007,Total Under trials Released,41900,2802,44702
GUJARAT,2007,Detenus Released - Released on completion of detention period,54,2,56
GUJARAT,2007,Detenus Released - Released before completion of detention period,666,89,755
GUJARAT,2007,Detenus Released - Released on bail,35,2,37
GUJARAT,2007,Detenus Released - Other releases (temporary transfer etc.),143,0,143
GUJARAT,2007,Total Detenus Released,898,93,991
GUJARAT,2008,Convicts Released - Released after completion of conviction,6353,58,6411
GUJARAT,2008,Convicts Released - Premature release,76,0,76
GUJARAT,2008,Convicts Released - Released on appeal,373,10,383
GUJARAT,2008,Convicts Released - Released on bail,826,81,907
GUJARAT,2008,Convicts Released - Pardons,96,2,98
GUJARAT,2008,Convicts Released - Transferred to other States,82,7,89
GUJARAT,2008,"Convicts Released - Other Releases (due to illness, transferred to Mental hospital)",0,0,0
GUJARAT,2008,Total Convicts Released,7806,158,7964
GUJARAT,2008,Under trials Released - Acquitted,2385,164,2549
GUJARAT,2008,Under trials Released - Released on appeal,0,0,0
GUJARAT,2008,Under trials Released - Released on bail,30218,1928,32146
GUJARAT,2008,Under trials Released - Transferred to other States,671,13,684
GUJARAT,2008,Under trials Released - Extradited,808,24,832
GUJARAT,2008,Under trials Released - Other releases (transferred to Mental/Civil hospital),606,9,615
GUJARAT,2008,Total Under trials Released,34688,2138,36826
GUJARAT,2008,Detenus Released - Released on completion of detention period,285,41,326
GUJARAT,2008,Detenus Released - Released before completion of detention period,750,185,935
GUJARAT,2008,Detenus Released - Released on bail,0,0,0
GUJARAT,2008,Detenus Released - Other releases (temporary transfer etc.),7,91,98
GUJARAT,2008,Total Detenus Released,1042,317,1359
GUJARAT,2009,Convicts Released - Released after completion of conviction,6007,73,6080
GUJARAT,2009,Convicts Released - Premature release,86,1,87
GUJARAT,2009,Convicts Released - Released on appeal,349,29,378
GUJARAT,2009,Convicts Released - Released on bail,576,110,686
GUJARAT,2009,Convicts Released - Pardons,93,2,95
GUJARAT,2009,Convicts Released - Transferred to other States,92,7,99
GUJARAT,2009,"Convicts Released - Other Releases (due to illness, transferred to Mental hospital)",0,0,0
GUJARAT,2009,Total Convicts Released,7203,222,7425
GUJARAT,2009,Under trials Released - Acquitted,4826,301,5127
GUJARAT,2009,Under trials Released - Released on appeal,0,0,0
GUJARAT,2009,Under trials Released - Released on bail,34440,2549,36989
GUJARAT,2009,Under trials Released - Transferred to other States,642,16,658
GUJARAT,2009,Under trials Released - Extradited,0,0,0
GUJARAT,2009,Under trials Released - Other releases (transferred to Mental/Civil hospital),3,0,3
GUJARAT,2009,Total Under trials Released,39911,2866,42777
GUJARAT,2009,Detenus Released - Released on completion of detention period,111,0,111
GUJARAT,2009,Detenus Released - Released before completion of detention period,1050,276,1326
GUJARAT,2009,Detenus Released - Released on bail,0,0,0
GUJARAT,2009,Detenus Released - Other releases (temporary transfer etc.),48,5,53
GUJARAT,2009,Total Detenus Released,1209,281,1490
GUJARAT,2010,Convicts Released - Released after completion of conviction,6007,73,6080
GUJARAT,2010,Convicts Released - Premature release,103,1,104
GUJARAT,2010,Convicts Released - Released on appeal,181,8,189
GUJARAT,2010,Convicts Released - Released on bail,393,96,489
GUJARAT,2010,Convicts Released - Pardons,479,13,492
GUJARAT,2010,Convicts Released - Transferred to other States,0,0,0
GUJARAT,2010,"Convicts Released - Other Releases (due to illness, transferred to Mental hospital)",0,0,0
GUJARAT,2010,Total Convicts Released,7163,191,7354
GUJARAT,2010,Under trials Released - Acquitted,5326,165,5491
GUJARAT,2010,Under trials Released - Released on appeal,0,0,0
GUJARAT,2010,Under trials Released - Released on bail,31933,2169,34102
GUJARAT,2010,Under trials Released - Transferred to other States,34,2,36
GUJARAT,2010,Under trials Released - Extradited,0,0,0
GUJARAT,2010,Under trials Released - Other releases (transferred to Mental/Civil hospital),7,0,7
GUJARAT,2010,Total Under trials Released,37300,2336,39636
GUJARAT,2010,Detenus Released - Released on completion of detention period,138,15,153
GUJARAT,2010,Detenus Released - Released before completion of detention period,1357,157,1514
GUJARAT,2010,Detenus Released - Released on bail,0,0,0
GUJARAT,2010,Detenus Released - Other releases (temporary transfer etc.),45,2,47
GUJARAT,2010,Total Detenus Released,1540,174,1714
GUJARAT,2011,Convicts Released - Released after completion of conviction,6372,58,6430
GUJARAT,2011,Convicts Released - Premature release,221,0,221
GUJARAT,2011,Convicts Released - Released on appeal,295,23,318
GUJARAT,2011,Convicts Released - Released on bail,337,41,378
GUJARAT,2011,Convicts Released - Pardons,0,0,0
GUJARAT,2011,Convicts Released - Transferred to other States,3,0,3
GUJARAT,2011,"Convicts Released - Other Releases (due to illness, transferred to Mental hospital)",339,23,362
GUJARAT,2011,Total Convicts Released,7567,145,7712
GUJARAT,2011,Under trials Released - Acquitted,3348,83,3431
GUJARAT,2011,Under trials Released - Released on appeal,0,0,0
GUJARAT,2011,Under trials Released - Released on bail,35382,2419,37801
GUJARAT,2011,Under trials Released - Transferred to other States,53,0,53
GUJARAT,2011,Under trials Released - Extradited,0,0,0
GUJARAT,2011,Under trials Released - Other releases (transferred to Mental/Civil hospital),941,21,962
GUJARAT,2011,Total Under trials Released,39724,2523,42247
GUJARAT,2011,Detenus Released - Released on completion of detention period,466,0,466
GUJARAT,2011,Detenus Released - Released before completion of detention period,1408,243,1651
GUJARAT,2011,Detenus Released - Released on bail,0,0,0
GUJARAT,2011,Detenus Released - Other releases (temporary transfer etc.),49,1,50
GUJARAT,2011,Total Detenus Released,1923,244,2167
GUJARAT,2012,Convicts Released - Released after completion of conviction,5553,97,5650
GUJARAT,2012,Convicts Released - Premature release,32,7,39
GUJARAT,2012,Convicts Released - Released on appeal,241,9,250
GUJARAT,2012,Convicts Released - Released on bail,289,21,310
GUJARAT,2012,Convicts Released - Pardons,0,0,0
GUJARAT,2012,Convicts Released - Transferred to other States,16,0,16
GUJARAT,2012,"Convicts Released - Other Releases (due to illness, transferred to Mental hospital)",829,10,839
GUJARAT,2012,Total Convicts Released,6960,144,7104
GUJARAT,2012,Under trials Released - Acquitted,4392,203,4595
GUJARAT,2012,Under trials Released - Released on appeal,0,0,0
GUJARAT,2012,Under trials Released - Released on bail,33311,1572,34883
GUJARAT,2012,Under trials Released - Transferred to other States,98,0,98
GUJARAT,2012,Under trials Released - Extradited,0,0,0
GUJARAT,2012,Under trials Released - Other releases (transferred to Mental/Civil hospital),604,40,644
GUJARAT,2012,Total Under trials Released,38405,1815,40220
GUJARAT,2012,Detenus Released - Released on completion of detention period,400,1,401
GUJARAT,2012,Detenus Released - Released before completion of detention period,1826,194,2020
GUJARAT,2012,Detenus Released - Released on bail,0,0,0
GUJARAT,2012,Detenus Released - Other releases (temporary transfer etc.),12,5,17
GUJARAT,2012,Total Detenus Released,2238,200,2438
HARYANA,2001,Convicts Released - Released after completion of conviction,628,8,636
HARYANA,2001,Convicts Released - Premature release,73,4,77
HARYANA,2001,Convicts Released - Released on appeal,56,4,60
HARYANA,2001,Convicts Released - Released on bail,1101,31,1132
HARYANA,2001,Convicts Released - Pardons,2,0,2
HARYANA,2001,Convicts Released - Transferred to other States,4,0,4
HARYANA,2001,"Convicts Released - Other Releases (due to illness, transferred to Mental hospital)",94,0,94
HARYANA,2001,Total Convicts Released,1958,47,2005
HARYANA,2001,Under trials Released - Acquitted,11482,86,11568
HARYANA,2001,Under trials Released - Released on appeal,1421,22,1443
HARYANA,2001,Under trials Released - Released on bail,40547,1042,41589
HARYANA,2001,Under trials Released - Transferred to other States,107,7,114
HARYANA,2001,Under trials Released - Extradited,0,0,0
HARYANA,2001,Under trials Released - Other releases (transferred to Mental/Civil hospital),834,0,834
HARYANA,2001,Total Under trials Released,54391,1157,55548
HARYANA,2001,Detenus Released - Released on completion of detention period,0,0,0
HARYANA,2001,Detenus Released - Released before completion of detention period,0,0,0
HARYANA,2001,Detenus Released - Released on bail,0,0,0
HARYANA,2001,Detenus Released - Other releases (temporary transfer etc.),0,0,0
HARYANA,2001,Total Detenus Released,0,0,0
HARYANA,2002,Convicts Released - Released after completion of conviction,1487,8,1495
HARYANA,2002,Convicts Released - Premature release,65,6,71
HARYANA,2002,Convicts Released - Released on appeal,177,2,179
HARYANA,2002,Convicts Released - Released on bail,1013,39,1052
HARYANA,2002,Convicts Released - Pardons,0,0,0
HARYANA,2002,Convicts Released - Transferred to other States,79,0,79
HARYANA,2002,"Convicts Released - Other Releases (due to illness, transferred to Mental hospital)",140,1,141
HARYANA,2002,Total Convicts Released,2961,56,3017
HARYANA,2002,Under trials Released - Acquitted,3861,288,4149
HARYANA,2002,Under trials Released - Released on appeal,0,0,0
HARYANA,2002,Under trials Released - Released on bail,34422,1285,35707
HARYANA,2002,Under trials Released - Transferred to other States,14478,158,14636
HARYANA,2002,Under trials Released - Extradited,0,0,0
HARYANA,2002,Under trials Released - Other releases (transferred to Mental/Civil hospital),573,0,573
HARYANA,2002,Total Under trials Released,53334,1731,55065
HARYANA,2002,Detenus Released - Released on completion of detention period,0,0,0
HARYANA,2002,Detenus Released - Released before completion of detention period,0,0,0
HARYANA,2002,Detenus Released - Released on bail,0,0,0
HARYANA,2002,Detenus Released - Other releases (temporary transfer etc.),0,0,0
HARYANA,2002,Total Detenus Released,0,0,0
HARYANA,2003,Convicts Released - Released after completion of conviction,2097,14,2111
HARYANA,2003,Convicts Released - Premature release,68,9,77
HARYANA,2003,Convicts Released - Released on appeal,321,12,333
HARYANA,2003,Convicts Released - Released on bail,1640,72,1712
HARYANA,2003,Convicts Released - Pardons,168,0,168
HARYANA,2003,Convicts Released - Transferred to other States,107,29,136
HARYANA,2003,"Convicts Released - Other Releases (due to illness, transferred to Mental hospital)",45,0,45
HARYANA,2003,Total Convicts Released,4446,136,4582
HARYANA,2003,Under trials Released - Acquitted,1610,62,1672
HARYANA,2003,Under trials Released - Released on appeal,2730,0,2730
HARYANA,2003,Under trials Released - Released on bail,15707,633,16340
HARYANA,2003,Under trials Released - Transferred to other States,318,0,318
HARYANA,2003,Under trials Released - Extradited,0,0,0
HARYANA,2003,Under trials Released - Other releases (transferred to Mental/Civil hospital),155,0,155
HARYANA,2003,Total Under trials Released,20520,695,21215
HARYANA,2003,Detenus Released - Released on completion of detention period,0,0,0
HARYANA,2003,Detenus Released - Released before completion of detention period,0,0,0
HARYANA,2003,Detenus Released - Released on bail,1,0,1
HARYANA,2003,Detenus Released - Other releases (temporary transfer etc.),0,0,0
HARYANA,2003,Total Detenus Released,1,0,1
HARYANA,2004,Convicts Released - Released after completion of conviction,636,14,650
HARYANA,2004,Convicts Released - Premature release,16,0,16
HARYANA,2004,Convicts Released - Released on appeal,199,7,206
HARYANA,2004,Convicts Released - Released on bail,1388,71,1459
HARYANA,2004,Convicts Released - Pardons,5,0,5
HARYANA,2004,Convicts Released - Transferred to other States,5,0,5
HARYANA,2004,"Convicts Released - Other Releases (due to illness, transferred to Mental hospital)",2162,98,2260
HARYANA,2004,Total Convicts Released,4411,190,4601
HARYANA,2004,Under trials Released - Acquitted,5529,382,5911
HARYANA,2004,Under trials Released - Released on appeal,2334,328,2662
HARYANA,2004,Under trials Released - Released on bail,30775,627,31402
HARYANA,2004,Under trials Released - Transferred to other States,3661,140,3801
HARYANA,2004,Under trials Released - Extradited,45,0,45
HARYANA,2004,Under trials Released - Other releases (transferred to Mental/Civil hospital),70,0,70
HARYANA,2004,Total Under trials Released,42414,1477,43891
HARYANA,2004,Detenus Released - Released on completion of detention period,0,0,0
HARYANA,2004,Detenus Released - Released before completion of detention period,0,0,0
HARYANA,2004,Detenus Released - Released on bail,0,0,0
HARYANA,2004,Detenus Released - Other releases (temporary transfer etc.),0,0,0
HARYANA,2004,Total Detenus Released,0,0,0
HARYANA,2005,Convicts Released - Released after completion of conviction,1263,24,1287
HARYANA,2005,Convicts Released - Premature release,24,0,24
HARYANA,2005,Convicts Released - Released on appeal,261,61,322
HARYANA,2005,Convicts Released - Released on bail,1489,49,1538
HARYANA,2005,Convicts Released - Pardons,175,0,175
HARYANA,2005,Convicts Released - Transferred to other States,29,0,29
HARYANA,2005,"Convicts Released - Other Releases (due to illness, transferred to Mental hospital)",179,0,179
HARYANA,2005,Total Convicts Released,3420,134,3554
HARYANA,2005,Under trials Released - Acquitted,2582,53,2635
HARYANA,2005,Under trials Released - Released on appeal,3217,412,3629
HARYANA,2005,Under trials Released - Released on bail,43548,822,44370
HARYANA,2005,Under trials Released - Transferred to other States,15514,721,16235
HARYANA,2005,Under trials Released - Extradited,72,0,72
HARYANA,2005,Under trials Released - Other releases (transferred to Mental/Civil hospital),0,0,0
HARYANA,2005,Total Under trials Released,64933,2008,66941
HARYANA,2005,Detenus Released - Released on completion of detention period,0,0,0
HARYANA,2005,Detenus Released - Released before completion of detention period,0,0,0
HARYANA,2005,Detenus Released - Released on bail,0,0,0
HARYANA,2005,Detenus Released - Other releases (temporary transfer etc.),0,0,0
HARYANA,2005,Total Detenus Released,0,0,0
HARYANA,2006,Convicts Released - Released after completion of conviction,828,16,844
HARYANA,2006,Convicts Released - Premature release,17,0,17
HARYANA,2006,Convicts Released - Released on appeal,66,6,72
HARYANA,2006,Convicts Released - Released on bail,1927,84,2011
HARYANA,2006,Convicts Released - Pardons,1,0,1
HARYANA,2006,Convicts Released - Transferred to other States,29,3,32
HARYANA,2006,"Convicts Released - Other Releases (due to illness, transferred to Mental hospital)",179,5,184
HARYANA,2006,Total Convicts Released,3047,114,3161
HARYANA,2006,Under trials Released - Acquitted,4259,0,4259
HARYANA,2006,Under trials Released - Released on appeal,299,0,299
HARYANA,2006,Under trials Released - Released on bail,45692,0,45692
HARYANA,2006,Under trials Released - Transferred to other States,65,0,65
HARYANA,2006,Under trials Released - Extradited,96,0,96
HARYANA,2006,Under trials Released - Other releases (transferred to Mental/Civil hospital),38,0,38
HARYANA,2006,Total Under trials Released,50449,0,50449
HARYANA,2006,Detenus Released - Released on completion of detention period,0,0,0
HARYANA,2006,Detenus Released - Released before completion of detention period,0,0,0
HARYANA,2006,Detenus Released - Released on bail,0,0,0
HARYANA,2006,Detenus Released - Other releases (temporary transfer etc.),0,0,0
HARYANA,2006,Total Detenus Released,0,0,0
HARYANA,2007,Convicts Released - Released after completion of conviction,2325,20,2345
HARYANA,2007,Convicts Released - Premature release,45,0,45
HARYANA,2007,Convicts Released - Released on appeal,85,4,89
HARYANA,2007,Convicts Released - Released on bail,2196,63,2259
HARYANA,2007,Convicts Released - Pardons,2,0,2
HARYANA,2007,Convicts Released - Transferred to other States,30,11,41
HARYANA,2007,"Convicts Released - Other Releases (due to illness, transferred to Mental hospital)",13,0,13
HARYANA,2007,Total Convicts Released,4696,98,4794
HARYANA,2007,Under trials Released - Acquitted,2273,53,2326
HARYANA,2007,Under trials Released - Released on appeal,320,0,320
HARYANA,2007,Under trials Released - Released on bail,46545,1026,47571
HARYANA,2007,Under trials Released - Transferred to other States,220,5,225
HARYANA,2007,Under trials Released - Extradited,0,0,0
HARYANA,2007,Under trials Released - Other releases (transferred to Mental/Civil hospital),23,0,23
HARYANA,2007,Total Under trials Released,49381,1084,50465
HARYANA,2007,Detenus Released - Released on completion of detention period,0,0,0
HARYANA,2007,Detenus Released - Released before completion of detention period,0,0,0
HARYANA,2007,Detenus Released - Released on bail,0,0,0
HARYANA,2007,Detenus Released - Other releases (temporary transfer etc.),0,0,0
HARYANA,2007,Total Detenus Released,0,0,0
HARYANA,2008,Convicts Released - Released after completion of conviction,1939,15,1954
HARYANA,2008,Convicts Released - Premature release,55,1,56
HARYANA,2008,Convicts Released - Released on appeal,240,5,245
HARYANA,2008,Convicts Released - Released on bail,1649,89,1738
HARYANA,2008,Convicts Released - Pardons,0,0,0
HARYANA,2008,Convicts Released - Transferred to other States,21,1,22
HARYANA,2008,"Convicts Released - Other Releases (due to illness, transferred to Mental hospital)",451,8,459
HARYANA,2008,Total Convicts Released,4355,119,4474
HARYANA,2008,Under trials Released - Acquitted,4675,316,4991
HARYANA,2008,Under trials Released - Released on appeal,5868,295,6163
HARYANA,2008,Under trials Released - Released on bail,41764,1930,43694
HARYANA,2008,Under trials Released - Transferred to other States,336,5,341
HARYANA,2008,Under trials Released - Extradited,1155,131,1286
HARYANA,2008,Under trials Released - Other releases (transferred to Mental/Civil hospital),912,86,998
HARYANA,2008,Total Under trials Released,54710,2763,57473
HARYANA,2008,Detenus Released - Released on completion of detention period,0,0,0
HARYANA,2008,Detenus Released - Released before completion of detention period,0,0,0
HARYANA,2008,Detenus Released - Released on bail,0,0,0
HARYANA,2008,Detenus Released - Other releases (temporary transfer etc.),0,0,0
HARYANA,2008,Total Detenus Released,0,0,0
HARYANA,2009,Convicts Released - Released after completion of conviction,1322,24,1346
HARYANA,2009,Convicts Released - Premature release,58,0,58
HARYANA,2009,Convicts Released - Released on appeal,551,6,557
HARYANA,2009,Convicts Released - Released on bail,1566,102,1668
HARYANA,2009,Convicts Released - Pardons,0,0,0
HARYANA,2009,Convicts Released - Transferred to other States,235,11,246
HARYANA,2009,"Convicts Released - Other Releases (due to illness, transferred to Mental hospital)",4,0,4
HARYANA,2009,Total Convicts Released,3736,143,3879
HARYANA,2009,Under trials Released - Acquitted,7766,517,8283
HARYANA,2009,Under trials Released - Released on appeal,5850,224,6074
HARYANA,2009,Under trials Released - Released on bail,37175,1524,38699
HARYANA,2009,Under trials Released - Transferred to other States,48,0,48
HARYANA,2009,Under trials Released - Extradited,19,0,19
HARYANA,2009,Under trials Released - Other releases (transferred to Mental/Civil hospital),197,0,197
HARYANA,2009,Total Under trials Released,51055,2265,53320
HARYANA,2009,Detenus Released - Released on completion of detention period,0,0,0
HARYANA,2009,Detenus Released - Released before completion of detention period,0,0,0
HARYANA,2009,Detenus Released - Released on bail,0,0,0
HARYANA,2009,Detenus Released - Other releases (temporary transfer etc.),0,0,0
HARYANA,2009,Total Detenus Released,0,0,0
HARYANA,2010,Convicts Released - Released after completion of conviction,1424,19,1443
HARYANA,2010,Convicts Released - Premature release,289,18,307
HARYANA,2010,Convicts Released - Released on appeal,334,2,336
HARYANA,2010,Convicts Released - Released on bail,1535,52,1587
HARYANA,2010,Convicts Released - Pardons,0,0,0
HARYANA,2010,Convicts Released - Transferred to other States,48,45,93
HARYANA,2010,"Convicts Released - Other Releases (due to illness, transferred to Mental hospital)",678,30,708
HARYANA,2010,Total Convicts Released,4308,166,4474
HARYANA,2010,Under trials Released - Acquitted,3754,231,3985
HARYANA,2010,Under trials Released - Released on appeal,792,2,794
HARYANA,2010,Under trials Released - Released on bail,41652,1291,42943
HARYANA,2010,Under trials Released - Transferred to other States,313,1,314
HARYANA,2010,Under trials Released - Extradited,0,0,0
HARYANA,2010,Under trials Released - Other releases (transferred to Mental/Civil hospital),153,3,156
HARYANA,2010,Total Under trials Released,46664,1528,48192
HARYANA,2010,Detenus Released - Released on completion of detention period,0,0,0
HARYANA,2010,Detenus Released - Released before completion of detention period,0,0,0
HARYANA,2010,Detenus Released - Released on bail,0,0,0
HARYANA,2010,Detenus Released - Other releases (temporary transfer etc.),0,0,0
HARYANA,2010,Total Detenus Released,0,0,0
HARYANA,2011,Convicts Released - Released after completion of conviction,1459,25,1484
HARYANA,2011,Convicts Released - Premature release,161,14,175
HARYANA,2011,Convicts Released - Released on appeal,248,52,300
HARYANA,2011,Convicts Released - Released on bail,1902,87,1989
HARYANA,2011,Convicts Released - Pardons,0,0,0
HARYANA,2011,Convicts Released - Transferred to other States,45,0,45
HARYANA,2011,"Convicts Released - Other Releases (due to illness, transferred to Mental hospital)",441,0,441
HARYANA,2011,Total Convicts Released,4256,178,4434
HARYANA,2011,Under trials Released - Acquitted,4037,175,4212
HARYANA,2011,Under trials Released - Released on appeal,5391,213,5604
HARYANA,2011,Under trials Released - Released on bail,37413,1127,38540
HARYANA,2011,Under trials Released - Transferred to other States,349,0,349
HARYANA,2011,Under trials Released - Extradited,0,0,0
HARYANA,2011,Under trials Released - Other releases (transferred to Mental/Civil hospital),166,0,166
HARYANA,2011,Total Under trials Released,47356,1515,48871
HARYANA,2011,Detenus Released - Released on completion of detention period,0,0,0
HARYANA,2011,Detenus Released - Released before completion of detention period,0,0,0
HARYANA,2011,Detenus Released - Released on bail,0,0,0
HARYANA,2011,Detenus Released - Other releases (temporary transfer etc.),0,0,0
HARYANA,2011,Total Detenus Released,0,0,0
HARYANA,2012,Convicts Released - Released after completion of conviction,1167,17,1184
HARYANA,2012,Convicts Released - Premature release,95,4,99
HARYANA,2012,Convicts Released - Released on appeal,460,52,512
HARYANA,2012,Convicts Released - Released on bail,1989,95,2084
HARYANA,2012,Convicts Released - Pardons,0,0,0
HARYANA,2012,Convicts Released - Transferred to other States,101,21,122
HARYANA,2012,"Convicts Released - Other Releases (due to illness, transferred to Mental hospital)",1,0,1
HARYANA,2012,Total Convicts Released,3813,189,4002
HARYANA,2012,Under trials Released - Acquitted,2869,117,2986
HARYANA,2012,Under trials Released - Released on appeal,2482,119,2601
HARYANA,2012,Under trials Released - Released on bail,35382,837,36219
HARYANA,2012,Under trials Released - Transferred to other States,613,4,617
HARYANA,2012,Under trials Released - Extradited,0,0,0
HARYANA,2012,Under trials Released - Other releases (transferred to Mental/Civil hospital),513,10,523
HARYANA,2012,Total Under trials Released,41859,1087,42946
HARYANA,2012,Detenus Released - Released on completion of detention period,0,0,0
HARYANA,2012,Detenus Released - Released before completion of detention period,0,0,0
HARYANA,2012,Detenus Released - Released on bail,0,0,0
HARYANA,2012,Detenus Released - Other releases (temporary transfer etc.),0,0,0
HARYANA,2012,Total Detenus Released,0,0,0
HIMACHAL PRADESH,2001,Convicts Released - Released after completion of conviction,155,0,155
HIMACHAL PRADESH,2001,Convicts Released - Premature release,3,0,3
HIMACHAL PRADESH,2001,Convicts Released - Released on appeal,11,3,14
HIMACHAL PRADESH,2001,Convicts Released - Released on bail,100,1,101
HIMACHAL PRADESH,2001,Convicts Released - Pardons,0,0,0
HIMACHAL PRADESH,2001,Convicts Released - Transferred to other States,0,0,0
HIMACHAL PRADESH,2001,"Convicts Released - Other Releases (due to illness, transferred to Mental hospital)",0,0,0
HIMACHAL PRADESH,2001,Total Convicts Released,269,4,273
HIMACHAL PRADESH,2001,Under trials Released - Acquitted,88,4,92
HIMACHAL PRADESH,2001,Under trials Released - Released on appeal,70,3,73
HIMACHAL PRADESH,2001,Under trials Released - Released on bail,132,2,134
HIMACHAL PRADESH,2001,Under trials Released - Transferred to other States,0,0,0
HIMACHAL PRADESH,2001,Under trials Released - Extradited,0,0,0
HIMACHAL PRADESH,2001,Under trials Released - Other releases (transferred to Mental/Civil hospital),0,0,0
HIMACHAL PRADESH,2001,Total Under trials Released,290,9,299
HIMACHAL PRADESH,2001,Detenus Released - Released on completion of detention period,0,0,0
HIMACHAL PRADESH,2001,Detenus Released - Released before completion of detention period,0,0,0
HIMACHAL PRADESH,2001,Detenus Released - Released on bail,0,0,0
HIMACHAL PRADESH,2001,Detenus Released - Other releases (temporary transfer etc.),0,0,0
HIMACHAL PRADESH,2001,Total Detenus Released,0,0,0
HIMACHAL PRADESH,2002,Convicts Released - Released after completion of conviction,130,1,131
HIMACHAL PRADESH,2002,Convicts Released - Premature release,1,0,1
HIMACHAL PRADESH,2002,Convicts Released - Released on appeal,31,2,33
HIMACHAL PRADESH,2002,Convicts Released - Released on bail,61,4,65
HIMACHAL PRADESH,2002,Convicts Released - Pardons,0,0,0
HIMACHAL PRADESH,2002,Convicts Released - Transferred to other States,0,0,0
HIMACHAL PRADESH,2002,"Convicts Released - Other Releases (due to illness, transferred to Mental hospital)",0,0,0
HIMACHAL PRADESH,2002,Total Convicts Released,223,7,230
HIMACHAL PRADESH,2002,Under trials Released - Acquitted,162,8,170
HIMACHAL PRADESH,2002,Under trials Released - Released on appeal,0,0,0
HIMACHAL PRADESH,2002,Under trials Released - Released on bail,1872,105,1977
HIMACHAL PRADESH,2002,Under trials Released - Transferred to other States,7,0,7
HIMACHAL PRADESH,2002,Under trials Released - Extradited,0,0,0
HIMACHAL PRADESH,2002,Under trials Released - Other releases (transferred to Mental/Civil hospital),10,0,10
HIMACHAL PRADESH,2002,Total Under trials Released,2051,113,2164
HIMACHAL PRADESH,2002,Detenus Released - Released on completion of detention period,0,0,0
HIMACHAL PRADESH,2002,Detenus Released - Released before completion of detention period,0,0,0
HIMACHAL PRADESH,2002,Detenus Released - Released on bail,0,0,0
HIMACHAL PRADESH,2002,Detenus Released - Other releases (temporary transfer etc.),0,0,0
HIMACHAL PRADESH,2002,Total Detenus Released,0,0,0
HIMACHAL PRADESH,2003,Convicts Released - Released after completion of conviction,148,0,148
HIMACHAL PRADESH,2003,Convicts Released - Premature release,1,0,1
HIMACHAL PRADESH,2003,Convicts Released - Released on appeal,30,1,31
HIMACHAL PRADESH,2003,Convicts Released - Released on bail,64,2,66
HIMACHAL PRADESH,2003,Convicts Released - Pardons,0,0,0
HIMACHAL PRADESH,2003,Convicts Released - Transferred to other States,2,1,3
HIMACHAL PRADESH,2003,"Convicts Released - Other Releases (due to illness, transferred to Mental hospital)",0,0,0
HIMACHAL PRADESH,2003,Total Convicts Released,245,4,249
HIMACHAL PRADESH,2003,Under trials Released - Acquitted,205,13,218
HIMACHAL PRADESH,2003,Under trials Released - Released on appeal,4,0,4
HIMACHAL PRADESH,2003,Under trials Released - Released on bail,1601,113,1714
HIMACHAL PRADESH,2003,Under trials Released - Transferred to other States,5,0,5
HIMACHAL PRADESH,2003,Under trials Released - Extradited,0,0,0
HIMACHAL PRADESH,2003,Under trials Released - Other releases (transferred to Mental/Civil hospital),0,0,0
HIMACHAL PRADESH,2003,Total Under trials Released,1815,126,1941
HIMACHAL PRADESH,2003,Detenus Released - Released on completion of detention period,0,0,0
HIMACHAL PRADESH,2003,Detenus Released - Released before completion of detention period,0,0,0
HIMACHAL PRADESH,2003,Detenus Released - Released on bail,0,0,0
HIMACHAL PRADESH,2003,Detenus Released - Other releases (temporary transfer etc.),0,0,0
HIMACHAL PRADESH,2003,Total Detenus Released,0,0,0
HIMACHAL PRADESH,2004,Convicts Released - Released after completion of conviction,121,0,121
HIMACHAL PRADESH,2004,Convicts Released - Premature release,2,0,2
HIMACHAL PRADESH,2004,Convicts Released - Released on appeal,39,0,39
HIMACHAL PRADESH,2004,Convicts Released - Released on bail,39,4,43
HIMACHAL PRADESH,2004,Convicts Released - Pardons,0,0,0
HIMACHAL PRADESH,2004,Convicts Released - Transferred to other States,0,0,0
HIMACHAL PRADESH,2004,"Convicts Released - Other Releases (due to illness, transferred to Mental hospital)",1,0,1
HIMACHAL PRADESH,2004,Total Convicts Released,202,4,206
HIMACHAL PRADESH,2004,Under trials Released - Acquitted,186,3,189
HIMACHAL PRADESH,2004,Under trials Released - Released on appeal,6,0,6
HIMACHAL PRADESH,2004,Under trials Released - Released on bail,1868,106,1974
HIMACHAL PRADESH,2004,Under trials Released - Transferred to other States,12,0,12
HIMACHAL PRADESH,2004,Under trials Released - Extradited,0,0,0
HIMACHAL PRADESH,2004,Under trials Released - Other releases (transferred to Mental/Civil hospital),2,0,2
HIMACHAL PRADESH,2004,Total Under trials Released,2074,109,2183
HIMACHAL PRADESH,2004,Detenus Released - Released on completion of detention period,0,0,0
HIMACHAL PRADESH,2004,Detenus Released - Released before completion of detention period,0,0,0
HIMACHAL PRADESH,2004,Detenus Released - Released on bail,0,0,0
HIMACHAL PRADESH,2004,Detenus Released - Other releases (temporary transfer etc.),0,0,0
HIMACHAL PRADESH,2004,Total Detenus Released,0,0,0
HIMACHAL PRADESH,2005,Convicts Released - Released after completion of conviction,121,0,121
HIMACHAL PRADESH,2005,Convicts Released - Premature release,2,0,2
HIMACHAL PRADESH,2005,Convicts Released - Released on appeal,39,0,39
HIMACHAL PRADESH,2005,Convicts Released - Released on bail,39,4,43
HIMACHAL PRADESH,2005,Convicts Released - Pardons,0,0,0
HIMACHAL PRADESH,2005,Convicts Released - Transferred to other States,0,0,0
HIMACHAL PRADESH,2005,"Convicts Released - Other Releases (due to illness, transferred to Mental hospital)",1,0,1
HIMACHAL PRADESH,2005,Total Convicts Released,202,4,206
HIMACHAL PRADESH,2005,Under trials Released - Acquitted,186,3,189
HIMACHAL PRADESH,2005,Under trials Released - Released on appeal,6,0,6
HIMACHAL PRADESH,2005,Under trials Released - Released on bail,1868,106,1974
HIMACHAL PRADESH,2005,Under trials Released - Transferred to other States,12,0,12
HIMACHAL PRADESH,2005,Under trials Released - Extradited,0,0,0
HIMACHAL PRADESH,2005,Under trials Released - Other releases (transferred to Mental/Civil hospital),2,0,2
HIMACHAL PRADESH,2005,Total Under trials Released,2074,109,2183
HIMACHAL PRADESH,2005,Detenus Released - Released on completion of detention period,0,0,0
HIMACHAL PRADESH,2005,Detenus Released - Released before completion of detention period,0,0,0
HIMACHAL PRADESH,2005,Detenus Released - Released on bail,0,0,0
HIMACHAL PRADESH,2005,Detenus Released - Other releases (temporary transfer etc.),0,0,0
HIMACHAL PRADESH,2005,Total Detenus Released,0,0,0
HIMACHAL PRADESH,2006,Convicts Released - Released after completion of conviction,158,5,163
HIMACHAL PRADESH,2006,Convicts Released - Premature release,0,0,0
HIMACHAL PRADESH,2006,Convicts Released - Released on appeal,25,3,28
HIMACHAL PRADESH,2006,Convicts Released - Released on bail,75,0,75
HIMACHAL PRADESH,2006,Convicts Released - Pardons,2,0,2
HIMACHAL PRADESH,2006,Convicts Released - Transferred to other States,2,0,2
HIMACHAL PRADESH,2006,"Convicts Released - Other Releases (due to illness, transferred to Mental hospital)",1,0,1
HIMACHAL PRADESH,2006,Total Convicts Released,263,8,271
HIMACHAL PRADESH,2006,Under trials Released - Acquitted,72,0,72
HIMACHAL PRADESH,2006,Under trials Released - Released on appeal,0,0,0
HIMACHAL PRADESH,2006,Under trials Released - Released on bail,1276,104,1380
HIMACHAL PRADESH,2006,Under trials Released - Transferred to other States,3,0,3
HIMACHAL PRADESH,2006,Under trials Released - Extradited,0,0,0
HIMACHAL PRADESH,2006,Under trials Released - Other releases (transferred to Mental/Civil hospital),0,0,0
HIMACHAL PRADESH,2006,Total Under trials Released,1351,104,1455
HIMACHAL PRADESH,2006,Detenus Released - Released on completion of detention period,0,0,0
HIMACHAL PRADESH,2006,Detenus Released - Released before completion of detention period,0,0,0
HIMACHAL PRADESH,2006,Detenus Released - Released on bail,0,0,0
HIMACHAL PRADESH,2006,Detenus Released - Other releases (temporary transfer etc.),0,0,0
HIMACHAL PRADESH,2006,Total Detenus Released,0,0,0
HIMACHAL PRADESH,2007,Convicts Released - Released after completion of conviction,168,1,169
HIMACHAL PRADESH,2007,Convicts Released - Premature release,10,1,11
HIMACHAL PRADESH,2007,Convicts Released - Released on appeal,63,6,69
HIMACHAL PRADESH,2007,Convicts Released - Released on bail,58,0,58
HIMACHAL PRADESH,2007,Convicts Released - Pardons,0,0,0
HIMACHAL PRADESH,2007,Convicts Released - Transferred to other States,13,0,13
HIMACHAL PRADESH,2007,"Convicts Released - Other Releases (due to illness, transferred to Mental hospital)",0,0,0
HIMACHAL PRADESH,2007,Total Convicts Released,312,8,320
HIMACHAL PRADESH,2007,Under trials Released - Acquitted,146,9,155
HIMACHAL PRADESH,2007,Under trials Released - Released on appeal,12,0,12
HIMACHAL PRADESH,2007,Under trials Released - Released on bail,1653,101,1754
HIMACHAL PRADESH,2007,Under trials Released - Transferred to other States,6,0,6
HIMACHAL PRADESH,2007,Under trials Released - Extradited,0,0,0
HIMACHAL PRADESH,2007,Under trials Released - Other releases (transferred to Mental/Civil hospital),2,0,2
HIMACHAL PRADESH,2007,Total Under trials Released,1819,110,1929
HIMACHAL PRADESH,2007,Detenus Released - Released on completion of detention period,0,0,0
HIMACHAL PRADESH,2007,Detenus Released - Released before completion of detention period,0,0,0
HIMACHAL PRADESH,2007,Detenus Released - Released on bail,0,0,0
HIMACHAL PRADESH,2007,Detenus Released - Other releases (temporary transfer etc.),0,0,0
HIMACHAL PRADESH,2007,Total Detenus Released,0,0,0
HIMACHAL PRADESH,2008,Convicts Released - Released after completion of conviction,299,5,304
HIMACHAL PRADESH,2008,Convicts Released - Premature release,2,0,2
HIMACHAL PRADESH,2008,Convicts Released - Released on appeal,80,3,83
HIMACHAL PRADESH,2008,Convicts Released - Released on bail,87,4,91
HIMACHAL PRADESH,2008,Convicts Released - Pardons,0,0,0
HIMACHAL PRADESH,2008,Convicts Released - Transferred to other States,6,1,7
HIMACHAL PRADESH,2008,"Convicts Released - Other Releases (due to illness, transferred to Mental hospital)",0,0,0
HIMACHAL PRADESH,2008,Total Convicts Released,474,13,487
HIMACHAL PRADESH,2008,Under trials Released - Acquitted,105,3,108
HIMACHAL PRADESH,2008,Under trials Released - Released on appeal,0,0,0
HIMACHAL PRADESH,2008,Under trials Released - Released on bail,2095,102,2197
HIMACHAL PRADESH,2008,Under trials Released - Transferred to other States,8,0,8
HIMACHAL PRADESH,2008,Under trials Released - Extradited,0,0,0
HIMACHAL PRADESH,2008,Under trials Released - Other releases (transferred to Mental/Civil hospital),0,0,0
HIMACHAL PRADESH,2008,Total Under trials Released,2208,105,2313
HIMACHAL PRADESH,2008,Detenus Released - Released on completion of detention period,0,0,0
HIMACHAL PRADESH,2008,Detenus Released - Released before completion of detention period,0,0,0
HIMACHAL PRADESH,2008,Detenus Released - Released on bail,0,0,0
HIMACHAL PRADESH,2008,Detenus Released - Other releases (temporary transfer etc.),0,0,0
HIMACHAL PRADESH,2008,Total Detenus Released,0,0,0
HIMACHAL PRADESH,2009,Convicts Released - Released after completion of conviction,272,1,273
HIMACHAL PRADESH,2009,Convicts Released - Premature release,2,0,2
HIMACHAL PRADESH,2009,Convicts Released - Released on appeal,109,8,117
HIMACHAL PRADESH,2009,Convicts Released - Released on bail,57,2,59
HIMACHAL PRADESH,2009,Convicts Released - Pardons,2,0,2
HIMACHAL PRADESH,2009,Convicts Released - Transferred to other States,1,0,1
HIMACHAL PRADESH,2009,"Convicts Released - Other Releases (due to illness, transferred to Mental hospital)",0,0,0
HIMACHAL PRADESH,2009,Total Convicts Released,443,11,454
HIMACHAL PRADESH,2009,Under trials Released - Acquitted,135,0,135
HIMACHAL PRADESH,2009,Under trials Released - Released on appeal,0,0,0
HIMACHAL PRADESH,2009,Under trials Released - Released on bail,1865,122,1987
HIMACHAL PRADESH,2009,Under trials Released - Transferred to other States,10,0,10
HIMACHAL PRADESH,2009,Under trials Released - Extradited,6,0,6
HIMACHAL PRADESH,2009,Under trials Released - Other releases (transferred to Mental/Civil hospital),0,0,0
HIMACHAL PRADESH,2009,Total Under trials Released,2016,122,2138
HIMACHAL PRADESH,2009,Detenus Released - Released on completion of detention period,0,0,0
HIMACHAL PRADESH,2009,Detenus Released - Released before completion of detention period,0,0,0
HIMACHAL PRADESH,2009,Detenus Released - Released on bail,0,0,0
HIMACHAL PRADESH,2009,Detenus Released - Other releases (temporary transfer etc.),0,0,0
HIMACHAL PRADESH,2009,Total Detenus Released,0,0,0
HIMACHAL PRADESH,2010,Convicts Released - Released after completion of conviction,248,9,257
HIMACHAL PRADESH,2010,Convicts Released - Premature release,2,0,2
HIMACHAL PRADESH,2010,Convicts Released - Released on appeal,38,5,43
HIMACHAL PRADESH,2010,Convicts Released - Released on bail,45,5,50
HIMACHAL PRADESH,2010,Convicts Released - Pardons,0,1,1
HIMACHAL PRADESH,2010,Convicts Released - Transferred to other States,0,0,0
HIMACHAL PRADESH,2010,"Convicts Released - Other Releases (due to illness, transferred to Mental hospital)",0,0,0
HIMACHAL PRADESH,2010,Total Convicts Released,333,20,353
HIMACHAL PRADESH,2010,Under trials Released - Acquitted,206,4,210
HIMACHAL PRADESH,2010,Under trials Released - Released on appeal,5,0,5
HIMACHAL PRADESH,2010,Under trials Released - Released on bail,2103,168,2271
HIMACHAL PRADESH,2010,Under trials Released - Transferred to other States,6,0,6
HIMACHAL PRADESH,2010,Under trials Released - Extradited,0,0,0
HIMACHAL PRADESH,2010,Under trials Released - Other releases (transferred to Mental/Civil hospital),0,0,0
HIMACHAL PRADESH,2010,Total Under trials Released,2320,172,2492
HIMACHAL PRADESH,2010,Detenus Released - Released on completion of detention period,0,0,0
HIMACHAL PRADESH,2010,Detenus Released - Released before completion of detention period,0,0,0
HIMACHAL PRADESH,2010,Detenus Released - Released on bail,0,0,0
HIMACHAL PRADESH,2010,Detenus Released - Other releases (temporary transfer etc.),0,0,0
HIMACHAL PRADESH,2010,Total Detenus Released,0,0,0
HIMACHAL PRADESH,2011,Convicts Released - Released after completion of conviction,315,7,322
HIMACHAL PRADESH,2011,Convicts Released - Premature release,8,0,8
HIMACHAL PRADESH,2011,Convicts Released - Released on appeal,47,0,47
HIMACHAL PRADESH,2011,Convicts Released - Released on bail,104,4,108
HIMACHAL PRADESH,2011,Convicts Released - Pardons,0,0,0
HIMACHAL PRADESH,2011,Convicts Released - Transferred to other States,1,0,1
HIMACHAL PRADESH,2011,"Convicts Released - Other Releases (due to illness, transferred to Mental hospital)",0,0,0
HIMACHAL PRADESH,2011,Total Convicts Released,475,11,486
HIMACHAL PRADESH,2011,Under trials Released - Acquitted,288,7,295
HIMACHAL PRADESH,2011,Under trials Released - Released on appeal,1,0,1
HIMACHAL PRADESH,2011,Under trials Released - Released on bail,2129,143,2272
HIMACHAL PRADESH,2011,Under trials Released - Transferred to other States,6,0,6
HIMACHAL PRADESH,2011,Under trials Released - Extradited,0,0,0
HIMACHAL PRADESH,2011,Under trials Released - Other releases (transferred to Mental/Civil hospital),11,0,11
HIMACHAL PRADESH,2011,Total Under trials Released,2435,150,2585
HIMACHAL PRADESH,2011,Detenus Released - Released on completion of detention period,0,0,0
HIMACHAL PRADESH,2011,Detenus Released - Released before completion of detention period,0,0,0
HIMACHAL PRADESH,2011,Detenus Released - Released on bail,0,0,0
HIMACHAL PRADESH,2011,Detenus Released - Other releases (temporary transfer etc.),0,0,0
HIMACHAL PRADESH,2011,Total Detenus Released,0,0,0
HIMACHAL PRADESH,2012,Convicts Released - Released after completion of conviction,336,1,337
HIMACHAL PRADESH,2012,Convicts Released - Premature release,15,0,15
HIMACHAL PRADESH,2012,Convicts Released - Released on appeal,52,3,55
HIMACHAL PRADESH,2012,Convicts Released - Released on bail,71,5,76
HIMACHAL PRADESH,2012,Convicts Released - Pardons,0,0,0
HIMACHAL PRADESH,2012,Convicts Released - Transferred to other States,13,2,15
HIMACHAL PRADESH,2012,"Convicts Released - Other Releases (due to illness, transferred to Mental hospital)",97,5,102
HIMACHAL PRADESH,2012,Total Convicts Released,584,16,600
HIMACHAL PRADESH,2012,Under trials Released - Acquitted,286,10,296
HIMACHAL PRADESH,2012,Under trials Released - Released on appeal,0,0,0
HIMACHAL PRADESH,2012,Under trials Released - Released on bail,2498,118,2616
HIMACHAL PRADESH,2012,Under trials Released - Transferred to other States,3,0,3
HIMACHAL PRADESH,2012,Under trials Released - Extradited,0,0,0
HIMACHAL PRADESH,2012,Under trials Released - Other releases (transferred to Mental/Civil hospital),34,0,34
HIMACHAL PRADESH,2012,Total Under trials Released,2821,128,2949
HIMACHAL PRADESH,2012,Detenus Released - Released on completion of detention period,0,0,0
HIMACHAL PRADESH,2012,Detenus Released - Released before completion of detention period,0,0,0
HIMACHAL PRADESH,2012,Detenus Released - Released on bail,0,0,0
HIMACHAL PRADESH,2012,Detenus Released - Other releases (temporary transfer etc.),0,0,0
HIMACHAL PRADESH,2012,Total Detenus Released,0,0,0
JAMMU & KASHMIR,2001,Convicts Released - Released after completion of conviction,112,0,112
JAMMU & KASHMIR,2001,Convicts Released - Premature release,0,0,0
JAMMU & KASHMIR,2001,Convicts Released - Released on appeal,2,1,3
JAMMU & KASHMIR,2001,Convicts Released - Released on bail,2,0,2
JAMMU & KASHMIR,2001,Convicts Released - Pardons,68,0,68
JAMMU & KASHMIR,2001,Convicts Released - Transferred to other States,0,0,0
JAMMU & KASHMIR,2001,"Convicts Released - Other Releases (due to illness, transferred to Mental hospital)",124,0,124
JAMMU & KASHMIR,2001,Total Convicts Released,308,1,309
JAMMU & KASHMIR,2001,Under trials Released - Acquitted,256,1,257
JAMMU & KASHMIR,2001,Under trials Released - Released on appeal,10,0,10
JAMMU & KASHMIR,2001,Under trials Released - Released on bail,1583,35,1618
JAMMU & KASHMIR,2001,Under trials Released - Transferred to other States,4,0,4
JAMMU & KASHMIR,2001,Under trials Released - Extradited,0,0,0
JAMMU & KASHMIR,2001,Under trials Released - Other releases (transferred to Mental/Civil hospital),26,0,26
JAMMU & KASHMIR,2001,Total Under trials Released,1879,36,1915
JAMMU & KASHMIR,2001,Detenus Released - Released on completion of detention period,69,1,70
JAMMU & KASHMIR,2001,Detenus Released - Released before completion of detention period,58,0,58
JAMMU & KASHMIR,2001,Detenus Released - Released on bail,0,0,0
JAMMU & KASHMIR,2001,Detenus Released - Other releases (temporary transfer etc.),36,0,36
JAMMU & KASHMIR,2001,Total Detenus Released,163,1,164
JAMMU & KASHMIR,2002,Convicts Released - Released after completion of conviction,76,0,76
JAMMU & KASHMIR,2002,Convicts Released - Premature release,1,0,1
JAMMU & KASHMIR,2002,Convicts Released - Released on appeal,6,1,7
JAMMU & KASHMIR,2002,Convicts Released - Released on bail,98,2,100
JAMMU & KASHMIR,2002,Convicts Released - Pardons,0,0,0
JAMMU & KASHMIR,2002,Convicts Released - Transferred to other States,3,0,3
JAMMU & KASHMIR,2002,"Convicts Released - Other Releases (due to illness, transferred to Mental hospital)",1,0,1
JAMMU & KASHMIR,2002,Total Convicts Released,185,3,188
JAMMU & KASHMIR,2002,Under trials Released - Acquitted,148,2,150
JAMMU & KASHMIR,2002,Under trials Released - Released on appeal,15,0,15
JAMMU & KASHMIR,2002,Under trials Released - Released on bail,2649,45,2694
JAMMU & KASHMIR,2002,Under trials Released - Transferred to other States,0,0,0
JAMMU & KASHMIR,2002,Under trials Released - Extradited,0,0,0
JAMMU & KASHMIR,2002,Under trials Released - Other releases (transferred to Mental/Civil hospital),0,0,0
JAMMU & KASHMIR,2002,Total Under trials Released,2812,47,2859
JAMMU & KASHMIR,2002,Detenus Released - Released on completion of detention period,43,0,43
JAMMU & KASHMIR,2002,Detenus Released - Released before completion of detention period,90,1,91
JAMMU & KASHMIR,2002,Detenus Released - Released on bail,14,1,15
JAMMU & KASHMIR,2002,Detenus Released - Other releases (temporary transfer etc.),51,0,51
JAMMU & KASHMIR,2002,Total Detenus Released,198,2,200
JAMMU & KASHMIR,2003,Convicts Released - Released after completion of conviction,100,2,102
JAMMU & KASHMIR,2003,Convicts Released - Premature release,11,1,12
JAMMU & KASHMIR,2003,Convicts Released - Released on appeal,7,0,7
JAMMU & KASHMIR,2003,Convicts Released - Released on bail,95,2,97
JAMMU & KASHMIR,2003,Convicts Released - Pardons,0,0,0
JAMMU & KASHMIR,2003,Convicts Released - Transferred to other States,9,0,9
JAMMU & KASHMIR,2003,"Convicts Released - Other Releases (due to illness, transferred to Mental hospital)",0,0,0
JAMMU & KASHMIR,2003,Total Convicts Released,222,5,227
JAMMU & KASHMIR,2003,Under trials Released - Acquitted,106,4,110
JAMMU & KASHMIR,2003,Under trials Released - Released on appeal,0,0,0
JAMMU & KASHMIR,2003,Under trials Released - Released on bail,1562,34,1596
JAMMU & KASHMIR,2003,Under trials Released - Transferred to other States,0,0,0
JAMMU & KASHMIR,2003,Under trials Released - Extradited,0,0,0
JAMMU & KASHMIR,2003,Under trials Released - Other releases (transferred to Mental/Civil hospital),0,0,0
JAMMU & KASHMIR,2003,Total Under trials Released,1668,38,1706
JAMMU & KASHMIR,2003,Detenus Released - Released on completion of detention period,51,0,51
JAMMU & KASHMIR,2003,Detenus Released - Released before completion of detention period,113,1,114
JAMMU & KASHMIR,2003,Detenus Released - Released on bail,4,2,6
JAMMU & KASHMIR,2003,Detenus Released - Other releases (temporary transfer etc.),33,0,33
JAMMU & KASHMIR,2003,Total Detenus Released,201,3,204
JAMMU & KASHMIR,2004,Convicts Released - Released after completion of conviction,14,2,16
JAMMU & KASHMIR,2004,Convicts Released - Premature release,5,0,5
JAMMU & KASHMIR,2004,Convicts Released - Released on appeal,13,0,13
JAMMU & KASHMIR,2004,Convicts Released - Released on bail,78,1,79
JAMMU & KASHMIR,2004,Convicts Released - Pardons,0,0,0
JAMMU & KASHMIR,2004,Convicts Released - Transferred to other States,13,0,13
JAMMU & KASHMIR,2004,"Convicts Released - Other Releases (due to illness, transferred to Mental hospital)",0,0,0
JAMMU & KASHMIR,2004,Total Convicts Released,123,3,126
JAMMU & KASHMIR,2004,Under trials Released - Acquitted,109,1,110
JAMMU & KASHMIR,2004,Under trials Released - Released on appeal,19,0,19
JAMMU & KASHMIR,2004,Under trials Released - Released on bail,2999,37,3036
JAMMU & KASHMIR,2004,Under trials Released - Transferred to other States,0,0,0
JAMMU & KASHMIR,2004,Under trials Released - Extradited,0,0,0
JAMMU & KASHMIR,2004,Under trials Released - Other releases (transferred to Mental/Civil hospital),0,0,0
JAMMU & KASHMIR,2004,Total Under trials Released,3127,38,3165
JAMMU & KASHMIR,2004,Detenus Released - Released on completion of detention period,25,0,25
JAMMU & KASHMIR,2004,Detenus Released - Released before completion of detention period,141,0,141
JAMMU & KASHMIR,2004,Detenus Released - Released on bail,30,0,30
JAMMU & KASHMIR,2004,Detenus Released - Other releases (temporary transfer etc.),29,0,29
JAMMU & KASHMIR,2004,Total Detenus Released,225,0,225
JAMMU & KASHMIR,2005,Convicts Released - Released after completion of conviction,176,6,182
JAMMU & KASHMIR,2005,Convicts Released - Premature release,8,0,8
JAMMU & KASHMIR,2005,Convicts Released - Released on appeal,16,0,16
JAMMU & KASHMIR,2005,Convicts Released - Released on bail,135,5,140
JAMMU & KASHMIR,2005,Convicts Released - Pardons,0,0,0
JAMMU & KASHMIR,2005,Convicts Released - Transferred to other States,8,0,8
JAMMU & KASHMIR,2005,"Convicts Released - Other Releases (due to illness, transferred to Mental hospital)",4,0,4
JAMMU & KASHMIR,2005,Total Convicts Released,347,11,358
JAMMU & KASHMIR,2005,Under trials Released - Acquitted,158,6,164
JAMMU & KASHMIR,2005,Under trials Released - Released on appeal,33,0,33
JAMMU & KASHMIR,2005,Under trials Released - Released on bail,3214,62,3276
JAMMU & KASHMIR,2005,Under trials Released - Transferred to other States,63,4,67
JAMMU & KASHMIR,2005,Under trials Released - Extradited,0,0,0
JAMMU & KASHMIR,2005,Under trials Released - Other releases (transferred to Mental/Civil hospital),41,0,41
JAMMU & KASHMIR,2005,Total Under trials Released,3509,72,3581
JAMMU & KASHMIR,2005,Detenus Released - Released on completion of detention period,31,0,31
JAMMU & KASHMIR,2005,Detenus Released - Released before completion of detention period,193,10,203
JAMMU & KASHMIR,2005,Detenus Released - Released on bail,78,0,78
JAMMU & KASHMIR,2005,Detenus Released - Other releases (temporary transfer etc.),19,0,19
JAMMU & KASHMIR,2005,Total Detenus Released,321,10,331
JAMMU & KASHMIR,2006,Convicts Released - Released after completion of conviction,274,8,282
JAMMU & KASHMIR,2006,Convicts Released - Premature release,4,0,4
JAMMU & KASHMIR,2006,Convicts Released - Released on appeal,24,0,24
JAMMU & KASHMIR,2006,Convicts Released - Released on bail,116,0,116
JAMMU & KASHMIR,2006,Convicts Released - Pardons,0,0,0
JAMMU & KASHMIR,2006,Convicts Released - Transferred to other States,13,0,13
JAMMU & KASHMIR,2006,"Convicts Released - Other Releases (due to illness, transferred to Mental hospital)",9,0,9
JAMMU & KASHMIR,2006,Total Convicts Released,440,8,448
JAMMU & KASHMIR,2006,Under trials Released - Acquitted,217,1,218
JAMMU & KASHMIR,2006,Under trials Released - Released on appeal,0,0,0
JAMMU & KASHMIR,2006,Under trials Released - Released on bail,4878,0,4878
JAMMU & KASHMIR,2006,Under trials Released - Transferred to other States,0,0,0
JAMMU & KASHMIR,2006,Under trials Released - Extradited,0,0,0
JAMMU & KASHMIR,2006,Under trials Released - Other releases (transferred to Mental/Civil hospital),16,4,20
JAMMU & KASHMIR,2006,Total Under trials Released,5111,5,5116
JAMMU & KASHMIR,2006,Detenus Released - Released on completion of detention period,11,0,11
JAMMU & KASHMIR,2006,Detenus Released - Released before completion of detention period,128,3,131
JAMMU & KASHMIR,2006,Detenus Released - Released on bail,69,1,70
JAMMU & KASHMIR,2006,Detenus Released - Other releases (temporary transfer etc.),16,0,16
JAMMU & KASHMIR,2006,Total Detenus Released,224,4,228
JAMMU & KASHMIR,2007,Convicts Released - Released after completion of conviction,275,3,278
JAMMU & KASHMIR,2007,Convicts Released - Premature release,0,0,0
JAMMU & KASHMIR,2007,Convicts Released - Released on appeal,5,3,8
JAMMU & KASHMIR,2007,Convicts Released - Released on bail,170,2,172
JAMMU & KASHMIR,2007,Convicts Released - Pardons,0,0,0
JAMMU & KASHMIR,2007,Convicts Released - Transferred to other States,9,0,9
JAMMU & KASHMIR,2007,"Convicts Released - Other Releases (due to illness, transferred to Mental hospital)",1,0,1
JAMMU & KASHMIR,2007,Total Convicts Released,460,8,468
JAMMU & KASHMIR,2007,Under trials Released - Acquitted,133,4,137
JAMMU & KASHMIR,2007,Under trials Released - Released on appeal,54,0,54
JAMMU & KASHMIR,2007,Under trials Released - Released on bail,5080,67,5147
JAMMU & KASHMIR,2007,Under trials Released - Transferred to other States,5,0,5
JAMMU & KASHMIR,2007,Under trials Released - Extradited,0,0,0
JAMMU & KASHMIR,2007,Under trials Released - Other releases (transferred to Mental/Civil hospital),30,1,31
JAMMU & KASHMIR,2007,Total Under trials Released,5302,72,5374
JAMMU & KASHMIR,2007,Detenus Released - Released on completion of detention period,15,0,15
JAMMU & KASHMIR,2007,Detenus Released - Released before completion of detention period,165,3,168
JAMMU & KASHMIR,2007,Detenus Released - Released on bail,73,0,73
JAMMU & KASHMIR,2007,Detenus Released - Other releases (temporary transfer etc.),19,0,19
JAMMU & KASHMIR,2007,Total Detenus Released,272,3,275
JAMMU & KASHMIR,2008,Convicts Released - Released after completion of conviction,149,4,153
JAMMU & KASHMIR,2008,Convicts Released - Premature release,0,0,0
JAMMU & KASHMIR,2008,Convicts Released - Released on appeal,27,0,27
JAMMU & KASHMIR,2008,Convicts Released - Released on bail,46,1,47
JAMMU & KASHMIR,2008,Convicts Released - Pardons,0,0,0
JAMMU & KASHMIR,2008,Convicts Released - Transferred to other States,35,0,35
JAMMU & KASHMIR,2008,"Convicts Released - Other Releases (due to illness, transferred to Mental hospital)",5,0,5
JAMMU & KASHMIR,2008,Total Convicts Released,262,5,267
JAMMU & KASHMIR,2008,Under trials Released - Acquitted,134,0,134
JAMMU & KASHMIR,2008,Under trials Released - Released on appeal,159,1,160
JAMMU & KASHMIR,2008,Under trials Released - Released on bail,3498,43,3541
JAMMU & KASHMIR,2008,Under trials Released - Transferred to other States,801,51,852
JAMMU & KASHMIR,2008,Under trials Released - Extradited,45,0,45
JAMMU & KASHMIR,2008,Under trials Released - Other releases (transferred to Mental/Civil hospital),34,0,34
JAMMU & KASHMIR,2008,Total Under trials Released,4671,95,4766
JAMMU & KASHMIR,2008,Detenus Released - Released on completion of detention period,24,2,26
JAMMU & KASHMIR,2008,Detenus Released - Released before completion of detention period,120,0,120
JAMMU & KASHMIR,2008,Detenus Released - Released on bail,11,0,11
JAMMU & KASHMIR,2008,Detenus Released - Other releases (temporary transfer etc.),20,0,20
JAMMU & KASHMIR,2008,Total Detenus Released,175,2,177
JAMMU & KASHMIR,2009,Convicts Released - Released after completion of conviction,87,0,87
JAMMU & KASHMIR,2009,Convicts Released - Premature release,3,0,3
JAMMU & KASHMIR,2009,Convicts Released - Released on appeal,1,0,1
JAMMU & KASHMIR,2009,Convicts Released - Released on bail,40,0,40
JAMMU & KASHMIR,2009,Convicts Released - Pardons,0,0,0
JAMMU & KASHMIR,2009,Convicts Released - Transferred to other States,9,0,9
JAMMU & KASHMIR,2009,"Convicts Released - Other Releases (due to illness, transferred to Mental hospital)",0,0,0
JAMMU & KASHMIR,2009,Total Convicts Released,140,0,140
JAMMU & KASHMIR,2009,Under trials Released - Acquitted,47,1,48
JAMMU & KASHMIR,2009,Under trials Released - Released on appeal,0,0,0
JAMMU & KASHMIR,2009,Under trials Released - Released on bail,1880,38,1918
JAMMU & KASHMIR,2009,Under trials Released - Transferred to other States,0,0,0
JAMMU & KASHMIR,2009,Under trials Released - Extradited,0,0,0
JAMMU & KASHMIR,2009,Under trials Released - Other releases (transferred to Mental/Civil hospital),0,0,0
JAMMU & KASHMIR,2009,Total Under trials Released,1927,39,1966
JAMMU & KASHMIR,2009,Detenus Released - Released on completion of detention period,1,0,1
JAMMU & KASHMIR,2009,Detenus Released - Released before completion of detention period,0,0,0
JAMMU & KASHMIR,2009,Detenus Released - Released on bail,9,0,9
JAMMU & KASHMIR,2009,Detenus Released - Other releases (temporary transfer etc.),1,0,1
JAMMU & KASHMIR,2009,Total Detenus Released,11,0,11
JAMMU & KASHMIR,2010,Convicts Released - Released after completion of conviction,212,1,213
JAMMU & KASHMIR,2010,Convicts Released - Premature release,5,0,5
JAMMU & KASHMIR,2010,Convicts Released - Released on appeal,11,1,12
JAMMU & KASHMIR,2010,Convicts Released - Released on bail,68,1,69
JAMMU & KASHMIR,2010,Convicts Released - Pardons,8,0,8
JAMMU & KASHMIR,2010,Convicts Released - Transferred to other States,12,0,12
JAMMU & KASHMIR,2010,"Convicts Released - Other Releases (due to illness, transferred to Mental hospital)",12,0,12
JAMMU & KASHMIR,2010,Total Convicts Released,328,3,331
JAMMU & KASHMIR,2010,Under trials Released - Acquitted,116,2,118
JAMMU & KASHMIR,2010,Under trials Released - Released on appeal,64,2,66
JAMMU & KASHMIR,2010,Under trials Released - Released on bail,6312,69,6381
JAMMU & KASHMIR,2010,Under trials Released - Transferred to other States,25,0,25
JAMMU & KASHMIR,2010,Under trials Released - Extradited,0,0,0
JAMMU & KASHMIR,2010,Under trials Released - Other releases (transferred to Mental/Civil hospital),0,0,0
JAMMU & KASHMIR,2010,Total Under trials Released,6517,73,6590
JAMMU & KASHMIR,2010,Detenus Released - Released on completion of detention period,3,0,3
JAMMU & KASHMIR,2010,Detenus Released - Released before completion of detention period,192,0,192
JAMMU & KASHMIR,2010,Detenus Released - Released on bail,4,0,4
JAMMU & KASHMIR,2010,Detenus Released - Other releases (temporary transfer etc.),31,0,31
JAMMU & KASHMIR,2010,Total Detenus Released,230,0,230
JAMMU & KASHMIR,2011,Convicts Released - Released after completion of conviction,92,0,92
JAMMU & KASHMIR,2011,Convicts Released - Premature release,5,0,5
JAMMU & KASHMIR,2011,Convicts Released - Released on appeal,4,0,4
JAMMU & KASHMIR,2011,Convicts Released - Released on bail,92,0,92
JAMMU & KASHMIR,2011,Convicts Released - Pardons,0,0,0
JAMMU & KASHMIR,2011,Convicts Released - Transferred to other States,2,1,3
JAMMU & KASHMIR,2011,"Convicts Released - Other Releases (due to illness, transferred to Mental hospital)",7,0,7
JAMMU & KASHMIR,2011,Total Convicts Released,202,1,203
JAMMU & KASHMIR,2011,Under trials Released - Acquitted,154,5,159
JAMMU & KASHMIR,2011,Under trials Released - Released on appeal,18,0,18
JAMMU & KASHMIR,2011,Under trials Released - Released on bail,3689,58,3747
JAMMU & KASHMIR,2011,Under trials Released - Transferred to other States,21,2,23
JAMMU & KASHMIR,2011,Under trials Released - Extradited,0,0,0
JAMMU & KASHMIR,2011,Under trials Released - Other releases (transferred to Mental/Civil hospital),61,0,61
JAMMU & KASHMIR,2011,Total Under trials Released,3943,65,4008
JAMMU & KASHMIR,2011,Detenus Released - Released on completion of detention period,12,0,12
JAMMU & KASHMIR,2011,Detenus Released - Released before completion of detention period,444,4,448
JAMMU & KASHMIR,2011,Detenus Released - Released on bail,9,0,9
JAMMU & KASHMIR,2011,Detenus Released - Other releases (temporary transfer etc.),26,0,26
JAMMU & KASHMIR,2011,Total Detenus Released,491,4,495
JAMMU & KASHMIR,2012,Convicts Released - Released after completion of conviction,124,1,125
JAMMU & KASHMIR,2012,Convicts Released - Premature release,0,0,0
JAMMU & KASHMIR,2012,Convicts Released - Released on appeal,2,0,2
JAMMU & KASHMIR,2012,Convicts Released - Released on bail,179,7,186
JAMMU & KASHMIR,2012,Convicts Released - Pardons,0,0,0
JAMMU & KASHMIR,2012,Convicts Released - Transferred to other States,24,0,24
JAMMU & KASHMIR,2012,"Convicts Released - Other Releases (due to illness, transferred to Mental hospital)",60,0,60
JAMMU & KASHMIR,2012,Total Convicts Released,389,8,397
JAMMU & KASHMIR,2012,Under trials Released - Acquitted,233,5,238
JAMMU & KASHMIR,2012,Under trials Released - Released on appeal,4,0,4
JAMMU & KASHMIR,2012,Under trials Released - Released on bail,6563,68,6631
JAMMU & KASHMIR,2012,Under trials Released - Transferred to other States,22,0,22
JAMMU & KASHMIR,2012,Under trials Released - Extradited,0,0,0
JAMMU & KASHMIR,2012,Under trials Released - Other releases (transferred to Mental/Civil hospital),287,4,291
JAMMU & KASHMIR,2012,Total Under trials Released,7109,77,7186
JAMMU & KASHMIR,2012,Detenus Released - Released on completion of detention period,102,0,102
JAMMU & KASHMIR,2012,Detenus Released - Released before completion of detention period,129,1,130
JAMMU & KASHMIR,2012,Detenus Released - Released on bail,1,0,1
JAMMU & KASHMIR,2012,Detenus Released - Other releases (temporary transfer etc.),74,3,77
JAMMU & KASHMIR,2012,Total Detenus Released,306,4,310
JHARKHAND,2001,Convicts Released - Released after completion of conviction,1228,25,1253
JHARKHAND,2001,Convicts Released - Premature release,2,0,2
JHARKHAND,2001,Convicts Released - Released on appeal,546,25,571
JHARKHAND,2001,Convicts Released - Released on bail,13308,380,13688
JHARKHAND,2001,Convicts Released - Pardons,0,0,0
JHARKHAND,2001,Convicts Released - Transferred to other States,58,1,59
JHARKHAND,2001,"Convicts Released - Other Releases (due to illness, transferred to Mental hospital)",512,8,520
JHARKHAND,2001,Total Convicts Released,15654,439,16093
JHARKHAND,2001,Under trials Released - Acquitted,1969,91,2060
JHARKHAND,2001,Under trials Released - Released on appeal,289,7,296
JHARKHAND,2001,Under trials Released - Released on bail,20792,553,21345
JHARKHAND,2001,Under trials Released - Transferred to other States,184,7,191
JHARKHAND,2001,Under trials Released - Extradited,0,0,0
JHARKHAND,2001,Under trials Released - Other releases (transferred to Mental/Civil hospital),1,0,1
JHARKHAND,2001,Total Under trials Released,23235,658,23893
JHARKHAND,2001,Detenus Released - Released on completion of detention period,0,0,0
JHARKHAND,2001,Detenus Released - Released before completion of detention period,0,0,0
JHARKHAND,2001,Detenus Released - Released on bail,4,0,4
JHARKHAND,2001,Detenus Released - Other releases (temporary transfer etc.),0,0,0
JHARKHAND,2001,Total Detenus Released,4,0,4
JHARKHAND,2002,Convicts Released - Released after completion of conviction,2106,24,2130
JHARKHAND,2002,Convicts Released - Premature release,0,0,0
JHARKHAND,2002,Convicts Released - Released on appeal,351,15,366
JHARKHAND,2002,Convicts Released - Released on bail,804,47,851
JHARKHAND,2002,Convicts Released - Pardons,0,0,0
JHARKHAND,2002,Convicts Released - Transferred to other States,10,0,10
JHARKHAND,2002,"Convicts Released - Other Releases (due to illness, transferred to Mental hospital)",0,0,0
JHARKHAND,2002,Total Convicts Released,3271,86,3357
JHARKHAND,2002,Under trials Released - Acquitted,1983,173,2156
JHARKHAND,2002,Under trials Released - Released on appeal,0,0,0
JHARKHAND,2002,Under trials Released - Released on bail,30389,913,31302
JHARKHAND,2002,Under trials Released - Transferred to other States,112,3,115
JHARKHAND,2002,Under trials Released - Extradited,1,0,1
JHARKHAND,2002,Under trials Released - Other releases (transferred to Mental/Civil hospital),6,0,6
JHARKHAND,2002,Total Under trials Released,32491,1089,33580
JHARKHAND,2002,Detenus Released - Released on completion of detention period,0,0,0
JHARKHAND,2002,Detenus Released - Released before completion of detention period,0,0,0
JHARKHAND,2002,Detenus Released - Released on bail,0,0,0
JHARKHAND,2002,Detenus Released - Other releases (temporary transfer etc.),0,0,0
JHARKHAND,2002,Total Detenus Released,0,0,0
JHARKHAND,2003,Convicts Released - Released after completion of conviction,3486,107,3593
JHARKHAND,2003,Convicts Released - Premature release,2,0,2
JHARKHAND,2003,Convicts Released - Released on appeal,1088,13,1101
JHARKHAND,2003,Convicts Released - Released on bail,4699,193,4892
JHARKHAND,2003,Convicts Released - Pardons,0,0,0
JHARKHAND,2003,Convicts Released - Transferred to other States,270,20,290
JHARKHAND,2003,"Convicts Released - Other Releases (due to illness, transferred to Mental hospital)",4,0,4
JHARKHAND,2003,Total Convicts Released,9549,333,9882
JHARKHAND,2003,Under trials Released - Acquitted,2529,148,2677
JHARKHAND,2003,Under trials Released - Released on appeal,3055,77,3132
JHARKHAND,2003,Under trials Released - Released on bail,28404,779,29183
JHARKHAND,2003,Under trials Released - Transferred to other States,130,0,130
JHARKHAND,2003,Under trials Released - Extradited,0,0,0
JHARKHAND,2003,Under trials Released - Other releases (transferred to Mental/Civil hospital),17,0,17
JHARKHAND,2003,Total Under trials Released,34135,1004,35139
JHARKHAND,2003,Detenus Released - Released on completion of detention period,0,0,0
JHARKHAND,2003,Detenus Released - Released before completion of detention period,0,0,0
JHARKHAND,2003,Detenus Released - Released on bail,4,0,4
JHARKHAND,2003,Detenus Released - Other releases (temporary transfer etc.),0,0,0
JHARKHAND,2003,Total Detenus Released,4,0,4
JHARKHAND,2004,Convicts Released - Released after completion of conviction,3253,7,3260
JHARKHAND,2004,Convicts Released - Premature release,24,2,26
JHARKHAND,2004,Convicts Released - Released on appeal,2100,74,2174
JHARKHAND,2004,Convicts Released - Released on bail,2083,156,2239
JHARKHAND,2004,Convicts Released - Pardons,66,2,68
JHARKHAND,2004,Convicts Released - Transferred to other States,30,0,30
JHARKHAND,2004,"Convicts Released - Other Releases (due to illness, transferred to Mental hospital)",83,3,86
JHARKHAND,2004,Total Convicts Released,7639,244,7883
JHARKHAND,2004,Under trials Released - Acquitted,2303,133,2436
JHARKHAND,2004,Under trials Released - Released on appeal,3249,176,3425
JHARKHAND,2004,Under trials Released - Released on bail,30393,1001,31394
JHARKHAND,2004,Under trials Released - Transferred to other States,189,0,189
JHARKHAND,2004,Under trials Released - Extradited,7,0,7
JHARKHAND,2004,Under trials Released - Other releases (transferred to Mental/Civil hospital),76,1,77
JHARKHAND,2004,Total Under trials Released,36217,1311,37528
JHARKHAND,2004,Detenus Released - Released on completion of detention period,0,0,0
JHARKHAND,2004,Detenus Released - Released before completion of detention period,0,0,0
JHARKHAND,2004,Detenus Released - Released on bail,0,0,0
JHARKHAND,2004,Detenus Released - Other releases (temporary transfer etc.),1,0,1
JHARKHAND,2004,Total Detenus Released,1,0,1
JHARKHAND,2005,Convicts Released - Released after completion of conviction,1072,49,1121
JHARKHAND,2005,Convicts Released - Premature release,80,2,82
JHARKHAND,2005,Convicts Released - Released on appeal,1610,73,1683
JHARKHAND,2005,Convicts Released - Released on bail,3399,151,3550
JHARKHAND,2005,Convicts Released - Pardons,928,0,928
JHARKHAND,2005,Convicts Released - Transferred to other States,144,2,146
JHARKHAND,2005,"Convicts Released - Other Releases (due to illness, transferred to Mental hospital)",77,3,80
JHARKHAND,2005,Total Convicts Released,7310,280,7590
JHARKHAND,2005,Under trials Released - Acquitted,2940,209,3149
JHARKHAND,2005,Under trials Released - Released on appeal,3216,137,3353
JHARKHAND,2005,Under trials Released - Released on bail,34230,996,35226
JHARKHAND,2005,Under trials Released - Transferred to other States,1738,66,1804
JHARKHAND,2005,Under trials Released - Extradited,186,1,187
JHARKHAND,2005,Under trials Released - Other releases (transferred to Mental/Civil hospital),34,0,34
JHARKHAND,2005,Total Under trials Released,42344,1409,43753
JHARKHAND,2005,Detenus Released - Released on completion of detention period,0,0,0
JHARKHAND,2005,Detenus Released - Released before completion of detention period,0,0,0
JHARKHAND,2005,Detenus Released - Released on bail,1,0,1
JHARKHAND,2005,Detenus Released - Other releases (temporary transfer etc.),10,0,10
JHARKHAND,2005,Total Detenus Released,11,0,11
JHARKHAND,2006,Convicts Released - Released after completion of conviction,1101,26,1127
JHARKHAND,2006,Convicts Released - Premature release,28,0,28
JHARKHAND,2006,Convicts Released - Released on appeal,2258,115,2373
JHARKHAND,2006,Convicts Released - Released on bail,2655,186,2841
JHARKHAND,2006,Convicts Released - Pardons,49,5,54
JHARKHAND,2006,Convicts Released - Transferred to other States,211,3,214
JHARKHAND,2006,"Convicts Released - Other Releases (due to illness, transferred to Mental hospital)",44,2,46
JHARKHAND,2006,Total Convicts Released,6346,337,6683
JHARKHAND,2006,Under trials Released - Acquitted,3613,261,3874
JHARKHAND,2006,Under trials Released - Released on appeal,3621,164,3785
JHARKHAND,2006,Under trials Released - Released on bail,49432,1305,50737
JHARKHAND,2006,Under trials Released - Transferred to other States,1346,25,1371
JHARKHAND,2006,Under trials Released - Extradited,88,2,90
JHARKHAND,2006,Under trials Released - Other releases (transferred to Mental/Civil hospital),38,1,39
JHARKHAND,2006,Total Under trials Released,58138,1758,59896
JHARKHAND,2006,Detenus Released - Released on completion of detention period,0,0,0
JHARKHAND,2006,Detenus Released - Released before completion of detention period,0,0,0
JHARKHAND,2006,Detenus Released - Released on bail,1,0,1
JHARKHAND,2006,Detenus Released - Other releases (temporary transfer etc.),0,0,0
JHARKHAND,2006,Total Detenus Released,1,0,1
JHARKHAND,2007,Convicts Released - Released after completion of conviction,1346,24,1370
JHARKHAND,2007,Convicts Released - Premature release,106,0,106
JHARKHAND,2007,Convicts Released - Released on appeal,1486,64,1550
JHARKHAND,2007,Convicts Released - Released on bail,2033,96,2129
JHARKHAND,2007,Convicts Released - Pardons,107,0,107
JHARKHAND,2007,Convicts Released - Transferred to other States,77,1,78
JHARKHAND,2007,"Convicts Released - Other Releases (due to illness, transferred to Mental hospital)",382,5,387
JHARKHAND,2007,Total Convicts Released,5537,190,5727
JHARKHAND,2007,Under trials Released - Acquitted,2761,123,2884
JHARKHAND,2007,Under trials Released - Released on appeal,5586,85,5671
JHARKHAND,2007,Under trials Released - Released on bail,43012,973,43985
JHARKHAND,2007,Under trials Released - Transferred to other States,1265,21,1286
JHARKHAND,2007,Under trials Released - Extradited,52,0,52
JHARKHAND,2007,Under trials Released - Other releases (transferred to Mental/Civil hospital),101,2,103
JHARKHAND,2007,Total Under trials Released,52777,1204,53981
JHARKHAND,2007,Detenus Released - Released on completion of detention period,0,0,0
JHARKHAND,2007,Detenus Released - Released before completion of detention period,0,0,0
JHARKHAND,2007,Detenus Released - Released on bail,1,0,1
JHARKHAND,2007,Detenus Released - Other releases (temporary transfer etc.),0,0,0
JHARKHAND,2007,Total Detenus Released,1,0,1
JHARKHAND,2008,Convicts Released - Released after completion of conviction,1307,27,1334
JHARKHAND,2008,Convicts Released - Premature release,46,0,46
JHARKHAND,2008,Convicts Released - Released on appeal,855,50,905
JHARKHAND,2008,Convicts Released - Released on bail,2564,114,2678
JHARKHAND,2008,Convicts Released - Pardons,0,0,0
JHARKHAND,2008,Convicts Released - Transferred to other States,249,4,253
JHARKHAND,2008,"Convicts Released - Other Releases (due to illness, transferred to Mental hospital)",251,15,266
JHARKHAND,2008,Total Convicts Released,5272,210,5482
JHARKHAND,2008,Under trials Released - Acquitted,2209,121,2330
JHARKHAND,2008,Under trials Released - Released on appeal,1317,31,1348
JHARKHAND,2008,Under trials Released - Released on bail,35021,1383,36404
JHARKHAND,2008,Under trials Released - Transferred to other States,374,6,380
JHARKHAND,2008,Under trials Released - Extradited,0,0,0
JHARKHAND,2008,Under trials Released - Other releases (transferred to Mental/Civil hospital),66,3,69
JHARKHAND,2008,Total Under trials Released,38987,1544,40531
JHARKHAND,2008,Detenus Released - Released on completion of detention period,0,0,0
JHARKHAND,2008,Detenus Released - Released before completion of detention period,3,0,3
JHARKHAND,2008,Detenus Released - Released on bail,0,0,0
JHARKHAND,2008,Detenus Released - Other releases (temporary transfer etc.),0,0,0
JHARKHAND,2008,Total Detenus Released,3,0,3
JHARKHAND,2009,Convicts Released - Released after completion of conviction,982,12,994
JHARKHAND,2009,Convicts Released - Premature release,68,2,70
JHARKHAND,2009,Convicts Released - Released on appeal,818,19,837
JHARKHAND,2009,Convicts Released - Released on bail,2766,118,2884
JHARKHAND,2009,Convicts Released - Pardons,0,0,0
JHARKHAND,2009,Convicts Released - Transferred to other States,487,7,494
JHARKHAND,2009,"Convicts Released - Other Releases (due to illness, transferred to Mental hospital)",53,2,55
JHARKHAND,2009,Total Convicts Released,5174,160,5334
JHARKHAND,2009,Under trials Released - Acquitted,2566,176,2742
JHARKHAND,2009,Under trials Released - Released on appeal,1333,42,1375
JHARKHAND,2009,Under trials Released - Released on bail,35456,1484,36940
JHARKHAND,2009,Under trials Released - Transferred to other States,282,3,285
JHARKHAND,2009,Under trials Released - Extradited,1,0,1
JHARKHAND,2009,Under trials Released - Other releases (transferred to Mental/Civil hospital),3975,150,4125
JHARKHAND,2009,Total Under trials Released,43613,1855,45468
JHARKHAND,2009,Detenus Released - Released on completion of detention period,0,0,0
JHARKHAND,2009,Detenus Released - Released before completion of detention period,0,0,0
JHARKHAND,2009,Detenus Released - Released on bail,0,0,0
JHARKHAND,2009,Detenus Released - Other releases (temporary transfer etc.),0,0,0
JHARKHAND,2009,Total Detenus Released,0,0,0
JHARKHAND,2010,Convicts Released - Released after completion of conviction,909,23,932
JHARKHAND,2010,Convicts Released - Premature release,138,21,159
JHARKHAND,2010,Convicts Released - Released on appeal,211,21,232
JHARKHAND,2010,Convicts Released - Released on bail,2424,142,2566
JHARKHAND,2010,Convicts Released - Pardons,0,0,0
JHARKHAND,2010,Convicts Released - Transferred to other States,81,5,86
JHARKHAND,2010,"Convicts Released - Other Releases (due to illness, transferred to Mental hospital)",108,1,109
JHARKHAND,2010,Total Convicts Released,3871,213,4084
JHARKHAND,2010,Under trials Released - Acquitted,2849,154,3003
JHARKHAND,2010,Under trials Released - Released on appeal,859,25,884
JHARKHAND,2010,Under trials Released - Released on bail,33391,1393,34784
JHARKHAND,2010,Under trials Released - Transferred to other States,189,1,190
JHARKHAND,2010,Under trials Released - Extradited,0,0,0
JHARKHAND,2010,Under trials Released - Other releases (transferred to Mental/Civil hospital),246,4,250
JHARKHAND,2010,Total Under trials Released,37534,1577,39111
JHARKHAND,2010,Detenus Released - Released on completion of detention period,2,0,2
JHARKHAND,2010,Detenus Released - Released before completion of detention period,0,0,0
JHARKHAND,2010,Detenus Released - Released on bail,4,0,4
JHARKHAND,2010,Detenus Released - Other releases (temporary transfer etc.),0,0,0
JHARKHAND,2010,Total Detenus Released,6,0,6
JHARKHAND,2011,Convicts Released - Released after completion of conviction,1040,24,1064
JHARKHAND,2011,Convicts Released - Premature release,323,6,329
JHARKHAND,2011,Convicts Released - Released on appeal,389,41,430
JHARKHAND,2011,Convicts Released - Released on bail,2170,99,2269
JHARKHAND,2011,Convicts Released - Pardons,0,0,0
JHARKHAND,2011,Convicts Released - Transferred to other States,25,1,26
JHARKHAND,2011,"Convicts Released - Other Releases (due to illness, transferred to Mental hospital)",371,2,373
JHARKHAND,2011,Total Convicts Released,4318,173,4491
JHARKHAND,2011,Under trials Released - Acquitted,2467,139,2606
JHARKHAND,2011,Under trials Released - Released on appeal,834,18,852
JHARKHAND,2011,Under trials Released - Released on bail,34436,1337,35773
JHARKHAND,2011,Under trials Released - Transferred to other States,143,3,146
JHARKHAND,2011,Under trials Released - Extradited,0,0,0
JHARKHAND,2011,Under trials Released - Other releases (transferred to Mental/Civil hospital),187,0,187
JHARKHAND,2011,Total Under trials Released,38067,1497,39564
JHARKHAND,2011,Detenus Released - Released on completion of detention period,9,0,9
JHARKHAND,2011,Detenus Released - Released before completion of detention period,1,0,1
JHARKHAND,2011,Detenus Released - Released on bail,0,0,0
JHARKHAND,2011,Detenus Released - Other releases (temporary transfer etc.),0,0,0
JHARKHAND,2011,Total Detenus Released,10,0,10
JHARKHAND,2012,Convicts Released - Released after completion of conviction,812,20,832
JHARKHAND,2012,Convicts Released - Premature release,235,13,248
JHARKHAND,2012,Convicts Released - Released on appeal,307,22,329
JHARKHAND,2012,Convicts Released - Released on bail,1899,109,2008
JHARKHAND,2012,Convicts Released - Pardons,0,0,0
JHARKHAND,2012,Convicts Released - Transferred to other States,126,7,133
JHARKHAND,2012,"Convicts Released - Other Releases (due to illness, transferred to Mental hospital)",154,20,174
JHARKHAND,2012,Total Convicts Released,3533,191,3724
JHARKHAND,2012,Under trials Released - Acquitted,3040,247,3287
JHARKHAND,2012,Under trials Released - Released on appeal,1401,56,1457
JHARKHAND,2012,Under trials Released - Released on bail,34920,1700,36620
JHARKHAND,2012,Under trials Released - Transferred to other States,326,3,329
JHARKHAND,2012,Under trials Released - Extradited,0,0,0
JHARKHAND,2012,Under trials Released - Other releases (transferred to Mental/Civil hospital),151,0,151
JHARKHAND,2012,Total Under trials Released,39838,2006,41844
JHARKHAND,2012,Detenus Released - Released on completion of detention period,39,0,39
JHARKHAND,2012,Detenus Released - Released before completion of detention period,0,0,0
JHARKHAND,2012,Detenus Released - Released on bail,5,0,5
JHARKHAND,2012,Detenus Released - Other releases (temporary transfer etc.),0,0,0
JHARKHAND,2012,Total Detenus Released,44,0,44
KARNATAKA,2001,Convicts Released - Released after completion of conviction,5137,231,5368
KARNATAKA,2001,Convicts Released - Premature release,108,5,113
KARNATAKA,2001,Convicts Released - Released on appeal,22,0,22
KARNATAKA,2001,Convicts Released - Released on bail,331,12,343
KARNATAKA,2001,Convicts Released - Pardons,0,0,0
KARNATAKA,2001,Convicts Released - Transferred to other States,0,0,0
KARNATAKA,2001,"Convicts Released - Other Releases (due to illness, transferred to Mental hospital)",6,0,6
KARNATAKA,2001,Total Convicts Released,5604,248,5852
KARNATAKA,2001,Under trials Released - Acquitted,731,12,743
KARNATAKA,2001,Under trials Released - Released on appeal,67,4,71
KARNATAKA,2001,Under trials Released - Released on bail,8347,44,8391
KARNATAKA,2001,Under trials Released - Transferred to other States,3,0,3
KARNATAKA,2001,Under trials Released - Extradited,0,0,0
KARNATAKA,2001,Under trials Released - Other releases (transferred to Mental/Civil hospital),10,0,10
KARNATAKA,2001,Total Under trials Released,9158,60,9218
KARNATAKA,2001,Detenus Released - Released on completion of detention period,37,0,37
KARNATAKA,2001,Detenus Released - Released before completion of detention period,0,0,0
KARNATAKA,2001,Detenus Released - Released on bail,2,0,2
KARNATAKA,2001,Detenus Released - Other releases (temporary transfer etc.),0,0,0
KARNATAKA,2001,Total Detenus Released,39,0,39
KARNATAKA,2002,Convicts Released - Released after completion of conviction,3471,211,3682
KARNATAKA,2002,Convicts Released - Premature release,0,0,0
KARNATAKA,2002,Convicts Released - Released on appeal,77,2,79
KARNATAKA,2002,Convicts Released - Released on bail,426,16,442
KARNATAKA,2002,Convicts Released - Pardons,0,0,0
KARNATAKA,2002,Convicts Released - Transferred to other States,12,0,12
KARNATAKA,2002,"Convicts Released - Other Releases (due to illness, transferred to Mental hospital)",37,2,39
KARNATAKA,2002,Total Convicts Released,4023,231,4254
KARNATAKA,2002,Under trials Released - Acquitted,2577,17,2594
KARNATAKA,2002,Under trials Released - Released on appeal,0,0,0
KARNATAKA,2002,Under trials Released - Released on bail,27133,443,27576
KARNATAKA,2002,Under trials Released - Transferred to other States,6,0,6
KARNATAKA,2002,Under trials Released - Extradited,0,0,0
KARNATAKA,2002,Under trials Released - Other releases (transferred to Mental/Civil hospital),79,4,83
KARNATAKA,2002,Total Under trials Released,29795,464,30259
KARNATAKA,2002,Detenus Released - Released on completion of detention period,12,0,12
KARNATAKA,2002,Detenus Released - Released before completion of detention period,0,0,0
KARNATAKA,2002,Detenus Released - Released on bail,0,0,0
KARNATAKA,2002,Detenus Released - Other releases (temporary transfer etc.),0,0,0
KARNATAKA,2002,Total Detenus Released,12,0,12
KARNATAKA,2003,Convicts Released - Released after completion of conviction,3736,237,3973
KARNATAKA,2003,Convicts Released - Premature release,91,4,95
KARNATAKA,2003,Convicts Released - Released on appeal,81,9,90
KARNATAKA,2003,Convicts Released - Released on bail,448,19,467
KARNATAKA,2003,Convicts Released - Pardons,0,0,0
KARNATAKA,2003,Convicts Released - Transferred to other States,13,0,13
KARNATAKA,2003,"Convicts Released - Other Releases (due to illness, transferred to Mental hospital)",3,0,3
KARNATAKA,2003,Total Convicts Released,4372,269,4641
KARNATAKA,2003,Under trials Released - Acquitted,2138,12,2150
KARNATAKA,2003,Under trials Released - Released on appeal,0,0,0
KARNATAKA,2003,Under trials Released - Released on bail,31313,489,31802
KARNATAKA,2003,Under trials Released - Transferred to other States,7,0,7
KARNATAKA,2003,Under trials Released - Extradited,0,0,0
KARNATAKA,2003,Under trials Released - Other releases (transferred to Mental/Civil hospital),2,0,2
KARNATAKA,2003,Total Under trials Released,33460,501,33961
KARNATAKA,2003,Detenus Released - Released on completion of detention period,16,0,16
KARNATAKA,2003,Detenus Released - Released before completion of detention period,0,0,0
KARNATAKA,2003,Detenus Released - Released on bail,0,0,0
KARNATAKA,2003,Detenus Released - Other releases (temporary transfer etc.),0,0,0
KARNATAKA,2003,Total Detenus Released,16,0,16
KARNATAKA,2004,Convicts Released - Released after completion of conviction,3841,241,4082
KARNATAKA,2004,Convicts Released - Premature release,102,4,106
KARNATAKA,2004,Convicts Released - Released on appeal,87,8,95
KARNATAKA,2004,Convicts Released - Released on bail,473,19,492
KARNATAKA,2004,Convicts Released - Pardons,0,0,0
KARNATAKA,2004,Convicts Released - Transferred to other States,8,0,8
KARNATAKA,2004,"Convicts Released - Other Releases (due to illness, transferred to Mental hospital)",2,0,2
KARNATAKA,2004,Total Convicts Released,4513,272,4785
KARNATAKA,2004,Under trials Released - Acquitted,2276,13,2289
KARNATAKA,2004,Under trials Released - Released on appeal,0,0,0
KARNATAKA,2004,Under trials Released - Released on bail,30723,471,31194
KARNATAKA,2004,Under trials Released - Transferred to other States,6,0,6
KARNATAKA,2004,Under trials Released - Extradited,0,0,0
KARNATAKA,2004,Under trials Released - Other releases (transferred to Mental/Civil hospital),3,0,3
KARNATAKA,2004,Total Under trials Released,33008,484,33492
KARNATAKA,2004,Detenus Released - Released on completion of detention period,11,0,11
KARNATAKA,2004,Detenus Released - Released before completion of detention period,0,0,0
KARNATAKA,2004,Detenus Released - Released on bail,0,0,0
KARNATAKA,2004,Detenus Released - Other releases (temporary transfer etc.),0,0,0
KARNATAKA,2004,Total Detenus Released,11,0,11
KARNATAKA,2005,Convicts Released - Released after completion of conviction,3971,264,4235
KARNATAKA,2005,Convicts Released - Premature release,144,19,163
KARNATAKA,2005,Convicts Released - Released on appeal,98,6,104
KARNATAKA,2005,Convicts Released - Released on bail,506,22,528
KARNATAKA,2005,Convicts Released - Pardons,0,0,0
KARNATAKA,2005,Convicts Released - Transferred to other States,12,0,12
KARNATAKA,2005,"Convicts Released - Other Releases (due to illness, transferred to Mental hospital)",4,0,4
KARNATAKA,2005,Total Convicts Released,4735,311,5046
KARNATAKA,2005,Under trials Released - Acquitted,2349,16,2365
KARNATAKA,2005,Under trials Released - Released on appeal,0,0,0
KARNATAKA,2005,Under trials Released - Released on bail,32449,497,32946
KARNATAKA,2005,Under trials Released - Transferred to other States,8,0,8
KARNATAKA,2005,Under trials Released - Extradited,0,0,0
KARNATAKA,2005,Under trials Released - Other releases (transferred to Mental/Civil hospital),4,0,4
KARNATAKA,2005,Total Under trials Released,34810,513,35323
KARNATAKA,2005,Detenus Released - Released on completion of detention period,12,0,12
KARNATAKA,2005,Detenus Released - Released before completion of detention period,0,0,0
KARNATAKA,2005,Detenus Released - Released on bail,0,0,0
KARNATAKA,2005,Detenus Released - Other releases (temporary transfer etc.),0,0,0
KARNATAKA,2005,Total Detenus Released,12,0,12
KARNATAKA,2006,Convicts Released - Released after completion of conviction,4027,271,4298
KARNATAKA,2006,Convicts Released - Premature release,355,15,370
KARNATAKA,2006,Convicts Released - Released on appeal,83,3,86
KARNATAKA,2006,Convicts Released - Released on bail,577,21,598
KARNATAKA,2006,Convicts Released - Pardons,0,0,0
KARNATAKA,2006,Convicts Released - Transferred to other States,11,0,11
KARNATAKA,2006,"Convicts Released - Other Releases (due to illness, transferred to Mental hospital)",9,0,9
KARNATAKA,2006,Total Convicts Released,5062,310,5372
KARNATAKA,2006,Under trials Released - Acquitted,1901,11,1912
KARNATAKA,2006,Under trials Released - Released on appeal,0,0,0
KARNATAKA,2006,Under trials Released - Released on bail,31973,463,32436
KARNATAKA,2006,Under trials Released - Transferred to other States,27,0,27
KARNATAKA,2006,Under trials Released - Extradited,0,0,0
KARNATAKA,2006,Under trials Released - Other releases (transferred to Mental/Civil hospital),7,0,7
KARNATAKA,2006,Total Under trials Released,33908,474,34382
KARNATAKA,2006,Detenus Released - Released on completion of detention period,15,0,15
KARNATAKA,2006,Detenus Released - Released before completion of detention period,0,0,0
KARNATAKA,2006,Detenus Released - Released on bail,0,0,0
KARNATAKA,2006,Detenus Released - Other releases (temporary transfer etc.),0,0,0
KARNATAKA,2006,Total Detenus Released,15,0,15
KARNATAKA,2007,Convicts Released - Released after completion of conviction,4174,287,4461
KARNATAKA,2007,Convicts Released - Premature release,0,0,0
KARNATAKA,2007,Convicts Released - Released on appeal,112,6,118
KARNATAKA,2007,Convicts Released - Released on bail,684,28,712
KARNATAKA,2007,Convicts Released - Pardons,7,0,7
KARNATAKA,2007,Convicts Released - Transferred to other States,0,0,0
KARNATAKA,2007,"Convicts Released - Other Releases (due to illness, transferred to Mental hospital)",3,0,3
KARNATAKA,2007,Total Convicts Released,4980,321,5301
KARNATAKA,2007,Under trials Released - Acquitted,1976,16,1992
KARNATAKA,2007,Under trials Released - Released on appeal,2,0,2
KARNATAKA,2007,Under trials Released - Released on bail,32046,421,32467
KARNATAKA,2007,Under trials Released - Transferred to other States,1,0,1
KARNATAKA,2007,Under trials Released - Extradited,0,0,0
KARNATAKA,2007,Under trials Released - Other releases (transferred to Mental/Civil hospital),1,0,1
KARNATAKA,2007,Total Under trials Released,34026,437,34463
KARNATAKA,2007,Detenus Released - Released on completion of detention period,13,0,13
KARNATAKA,2007,Detenus Released - Released before completion of detention period,0,0,0
KARNATAKA,2007,Detenus Released - Released on bail,0,0,0
KARNATAKA,2007,Detenus Released - Other releases (temporary transfer etc.),0,0,0
KARNATAKA,2007,Total Detenus Released,13,0,13
KARNATAKA,2008,Convicts Released - Released after completion of conviction,4398,287,4685
KARNATAKA,2008,Convicts Released - Premature release,0,0,0
KARNATAKA,2008,Convicts Released - Released on appeal,137,6,143
KARNATAKA,2008,Convicts Released - Released on bail,697,31,728
KARNATAKA,2008,Convicts Released - Pardons,4,2,6
KARNATAKA,2008,Convicts Released - Transferred to other States,0,0,0
KARNATAKA,2008,"Convicts Released - Other Releases (due to illness, transferred to Mental hospital)",2,0,2
KARNATAKA,2008,Total Convicts Released,5238,326,5564
KARNATAKA,2008,Under trials Released - Acquitted,2011,14,2025
KARNATAKA,2008,Under trials Released - Released on appeal,2,0,2
KARNATAKA,2008,Under trials Released - Released on bail,33147,421,33568
KARNATAKA,2008,Under trials Released - Transferred to other States,1,0,1
KARNATAKA,2008,Under trials Released - Extradited,0,0,0
KARNATAKA,2008,Under trials Released - Other releases (transferred to Mental/Civil hospital),1,0,1
KARNATAKA,2008,Total Under trials Released,35162,435,35597
KARNATAKA,2008,Detenus Released - Released on completion of detention period,14,0,14
KARNATAKA,2008,Detenus Released - Released before completion of detention period,0,0,0
KARNATAKA,2008,Detenus Released - Released on bail,0,0,0
KARNATAKA,2008,Detenus Released - Other releases (temporary transfer etc.),0,0,0
KARNATAKA,2008,Total Detenus Released,14,0,14
KARNATAKA,2009,Convicts Released - Released after completion of conviction,12431,367,12798
KARNATAKA,2009,Convicts Released - Premature release,0,0,0
KARNATAKA,2009,Convicts Released - Released on appeal,121,4,125
KARNATAKA,2009,Convicts Released - Released on bail,701,22,723
KARNATAKA,2009,Convicts Released - Pardons,4,2,6
KARNATAKA,2009,Convicts Released - Transferred to other States,0,0,0
KARNATAKA,2009,"Convicts Released - Other Releases (due to illness, transferred to Mental hospital)",3,0,3
KARNATAKA,2009,Total Convicts Released,13260,395,13655
KARNATAKA,2009,Under trials Released - Acquitted,2196,11,2207
KARNATAKA,2009,Under trials Released - Released on appeal,6,0,6
KARNATAKA,2009,Under trials Released - Released on bail,32211,401,32612
KARNATAKA,2009,Under trials Released - Transferred to other States,3,0,3
KARNATAKA,2009,Under trials Released - Extradited,0,0,0
KARNATAKA,2009,Under trials Released - Other releases (transferred to Mental/Civil hospital),2,0,2
KARNATAKA,2009,Total Under trials Released,34418,412,34830
KARNATAKA,2009,Detenus Released - Released on completion of detention period,11,0,11
KARNATAKA,2009,Detenus Released - Released before completion of detention period,0,0,0
KARNATAKA,2009,Detenus Released - Released on bail,0,0,0
KARNATAKA,2009,Detenus Released - Other releases (temporary transfer etc.),0,0,0
KARNATAKA,2009,Total Detenus Released,11,0,11
KARNATAKA,2010,Convicts Released - Released after completion of conviction,30174,303,30477
KARNATAKA,2010,Convicts Released - Premature release,0,0,0
KARNATAKA,2010,Convicts Released - Released on appeal,119,2,121
KARNATAKA,2010,Convicts Released - Released on bail,649,17,666
KARNATAKA,2010,Convicts Released - Pardons,1,0,1
KARNATAKA,2010,Convicts Released - Transferred to other States,0,0,0
KARNATAKA,2010,"Convicts Released - Other Releases (due to illness, transferred to Mental hospital)",3,0,3
KARNATAKA,2010,Total Convicts Released,30946,322,31268
KARNATAKA,2010,Under trials Released - Acquitted,2267,8,2275
KARNATAKA,2010,Under trials Released - Released on appeal,7,0,7
KARNATAKA,2010,Under trials Released - Released on bail,34117,463,34580
KARNATAKA,2010,Under trials Released - Transferred to other States,3,0,3
KARNATAKA,2010,Under trials Released - Extradited,0,0,0
KARNATAKA,2010,Under trials Released - Other releases (transferred to Mental/Civil hospital),3,0,3
KARNATAKA,2010,Total Under trials Released,36397,471,36868
KARNATAKA,2010,Detenus Released - Released on completion of detention period,10,2,12
KARNATAKA,2010,Detenus Released - Released before completion of detention period,0,0,0
KARNATAKA,2010,Detenus Released - Released on bail,0,0,0
KARNATAKA,2010,Detenus Released - Other releases (temporary transfer etc.),0,0,0
KARNATAKA,2010,Total Detenus Released,10,2,12
KARNATAKA,2011,Convicts Released - Released after completion of conviction,25829,263,26092
KARNATAKA,2011,Convicts Released - Premature release,0,0,0
KARNATAKA,2011,Convicts Released - Released on appeal,149,7,156
KARNATAKA,2011,Convicts Released - Released on bail,697,27,724
KARNATAKA,2011,Convicts Released - Pardons,0,0,0
KARNATAKA,2011,Convicts Released - Transferred to other States,22,0,22
KARNATAKA,2011,"Convicts Released - Other Releases (due to illness, transferred to Mental hospital)",11,0,11
KARNATAKA,2011,Total Convicts Released,26708,297,27005
KARNATAKA,2011,Under trials Released - Acquitted,3714,27,3741
KARNATAKA,2011,Under trials Released - Released on appeal,6,0,6
KARNATAKA,2011,Under trials Released - Released on bail,36226,479,36705
KARNATAKA,2011,Under trials Released - Transferred to other States,7,0,7
KARNATAKA,2011,Under trials Released - Extradited,0,0,0
KARNATAKA,2011,Under trials Released - Other releases (transferred to Mental/Civil hospital),3,0,3
KARNATAKA,2011,Total Under trials Released,39956,506,40462
KARNATAKA,2011,Detenus Released - Released on completion of detention period,9,2,11
KARNATAKA,2011,Detenus Released - Released before completion of detention period,0,0,0
KARNATAKA,2011,Detenus Released - Released on bail,0,0,0
KARNATAKA,2011,Detenus Released - Other releases (temporary transfer etc.),0,0,0
KARNATAKA,2011,Total Detenus Released,9,2,11
KARNATAKA,2012,Convicts Released - Released after completion of conviction,30093,274,30367
KARNATAKA,2012,Convicts Released - Premature release,2,0,2
KARNATAKA,2012,Convicts Released - Released on appeal,90,9,99
KARNATAKA,2012,Convicts Released - Released on bail,610,41,651
KARNATAKA,2012,Convicts Released - Pardons,0,0,0
KARNATAKA,2012,Convicts Released - Transferred to other States,22,0,22
KARNATAKA,2012,"Convicts Released - Other Releases (due to illness, transferred to Mental hospital)",37,2,39
KARNATAKA,2012,Total Convicts Released,30854,326,31180
KARNATAKA,2012,Under trials Released - Acquitted,3117,48,3165
KARNATAKA,2012,Under trials Released - Released on appeal,17,0,17
KARNATAKA,2012,Under trials Released - Released on bail,31751,473,32224
KARNATAKA,2012,Under trials Released - Transferred to other States,18,2,20
KARNATAKA,2012,Under trials Released - Extradited,0,0,0
KARNATAKA,2012,Under trials Released - Other releases (transferred to Mental/Civil hospital),9,0,9
KARNATAKA,2012,Total Under trials Released,34912,523,35435
KARNATAKA,2012,Detenus Released - Released on completion of detention period,9,2,11
KARNATAKA,2012,Detenus Released - Released before completion of detention period,6,0,6
KARNATAKA,2012,Detenus Released - Released on bail,11,0,11
KARNATAKA,2012,Detenus Released - Other releases (temporary transfer etc.),0,0,0
KARNATAKA,2012,Total Detenus Released,26,2,28
KERALA,2001,Convicts Released - Released after completion of conviction,589,50,639
KERALA,2001,Convicts Released - Premature release,117,0,117
KERALA,2001,Convicts Released - Released on appeal,139,9,148
KERALA,2001,Convicts Released - Released on bail,198,5,203
KERALA,2001,Convicts Released - Pardons,0,0,0
KERALA,2001,Convicts Released - Transferred to other States,4,0,4
KERALA,2001,"Convicts Released - Other Releases (due to illness, transferred to Mental hospital)",31,0,31
KERALA,2001,Total Convicts Released,1078,64,1142
KERALA,2001,Under trials Released - Acquitted,140,25,165
KERALA,2001,Under trials Released - Released on appeal,17,5,22
KERALA,2001,Under trials Released - Released on bail,1216,76,1292
KERALA,2001,Under trials Released - Transferred to other States,0,0,0
KERALA,2001,Under trials Released - Extradited,0,0,0
KERALA,2001,Under trials Released - Other releases (transferred to Mental/Civil hospital),12,3,15
KERALA,2001,Total Under trials Released,1385,109,1494
KERALA,2001,Detenus Released - Released on completion of detention period,2,0,2
KERALA,2001,Detenus Released - Released before completion of detention period,0,0,0
KERALA,2001,Detenus Released - Released on bail,2,0,2
KERALA,2001,Detenus Released - Other releases (temporary transfer etc.),0,0,0
KERALA,2001,Total Detenus Released,4,0,4
KERALA,2002,Convicts Released - Released after completion of conviction,535,32,567
KERALA,2002,Convicts Released - Premature release,126,0,126
KERALA,2002,Convicts Released - Released on appeal,118,6,124
KERALA,2002,Convicts Released - Released on bail,158,4,162
KERALA,2002,Convicts Released - Pardons,0,0,0
KERALA,2002,Convicts Released - Transferred to other States,2,0,2
KERALA,2002,"Convicts Released - Other Releases (due to illness, transferred to Mental hospital)",24,0,24
KERALA,2002,Total Convicts Released,963,42,1005
KERALA,2002,Under trials Released - Acquitted,112,18,130
KERALA,2002,Under trials Released - Released on appeal,8,3,11
KERALA,2002,Under trials Released - Released on bail,1192,58,1250
KERALA,2002,Under trials Released - Transferred to other States,0,0,0
KERALA,2002,Under trials Released - Extradited,0,0,0
KERALA,2002,Under trials Released - Other releases (transferred to Mental/Civil hospital),10,1,11
KERALA,2002,Total Under trials Released,1322,80,1402
KERALA,2002,Detenus Released - Released on completion of detention period,1,0,1
KERALA,2002,Detenus Released - Released before completion of detention period,0,0,0
KERALA,2002,Detenus Released - Released on bail,1,0,1
KERALA,2002,Detenus Released - Other releases (temporary transfer etc.),1,0,1
KERALA,2002,Total Detenus Released,3,0,3
KERALA,2003,Convicts Released - Released after completion of conviction,831,76,907
KERALA,2003,Convicts Released - Premature release,0,0,0
KERALA,2003,Convicts Released - Released on appeal,203,13,216
KERALA,2003,Convicts Released - Released on bail,551,55,606
KERALA,2003,Convicts Released - Pardons,0,0,0
KERALA,2003,Convicts Released - Transferred to other States,0,0,0
KERALA,2003,"Convicts Released - Other Releases (due to illness, transferred to Mental hospital)",11,4,15
KERALA,2003,Total Convicts Released,1596,148,1744
KERALA,2003,Under trials Released - Acquitted,547,24,571
KERALA,2003,Under trials Released - Released on appeal,9,0,9
KERALA,2003,Under trials Released - Released on bail,5498,628,6126
KERALA,2003,Under trials Released - Transferred to other States,0,0,0
KERALA,2003,Under trials Released - Extradited,0,0,0
KERALA,2003,Under trials Released - Other releases (transferred to Mental/Civil hospital),18,0,18
KERALA,2003,Total Under trials Released,6072,652,6724
KERALA,2003,Detenus Released - Released on completion of detention period,6,0,6
KERALA,2003,Detenus Released - Released before completion of detention period,3,0,3
KERALA,2003,Detenus Released - Released on bail,0,0,0
KERALA,2003,Detenus Released - Other releases (temporary transfer etc.),0,0,0
KERALA,2003,Total Detenus Released,9,0,9
KERALA,2004,Convicts Released - Released after completion of conviction,177,22,199
KERALA,2004,Convicts Released - Premature release,0,0,0
KERALA,2004,Convicts Released - Released on appeal,203,13,216
KERALA,2004,Convicts Released - Released on bail,651,68,719
KERALA,2004,Convicts Released - Pardons,0,0,0
KERALA,2004,Convicts Released - Transferred to other States,0,0,0
KERALA,2004,"Convicts Released - Other Releases (due to illness, transferred to Mental hospital)",16,4,20
KERALA,2004,Total Convicts Released,1047,107,1154
KERALA,2004,Under trials Released - Acquitted,547,28,575
KERALA,2004,Under trials Released - Released on appeal,0,0,0
KERALA,2004,Under trials Released - Released on bail,5498,712,6210
KERALA,2004,Under trials Released - Transferred to other States,0,0,0
KERALA,2004,Under trials Released - Extradited,0,0,0
KERALA,2004,Under trials Released - Other releases (transferred to Mental/Civil hospital),41,0,41
KERALA,2004,Total Under trials Released,6086,740,6826
KERALA,2004,Detenus Released - Released on completion of detention period,0,0,0
KERALA,2004,Detenus Released - Released before completion of detention period,0,0,0
KERALA,2004,Detenus Released - Released on bail,0,0,0
KERALA,2004,Detenus Released - Other releases (temporary transfer etc.),0,0,0
KERALA,2004,Total Detenus Released,0,0,0
KERALA,2005,Convicts Released - Released after completion of conviction,0,0,0
KERALA,2005,Convicts Released - Premature release,0,0,0
KERALA,2005,Convicts Released - Released on appeal,4,0,4
KERALA,2005,Convicts Released - Released on bail,0,0,0
KERALA,2005,Convicts Released - Pardons,0,0,0
KERALA,2005,Convicts Released - Transferred to other States,0,0,0
KERALA,2005,"Convicts Released - Other Releases (due to illness, transferred to Mental hospital)",0,0,0
KERALA,2005,Total Convicts Released,4,0,4
KERALA,2005,Under trials Released - Acquitted,0,0,0
KERALA,2005,Under trials Released - Released on appeal,0,0,0
KERALA,2005,Under trials Released - Released on bail,0,0,0
KERALA,2005,Under trials Released - Transferred to other States,0,0,0
KERALA,2005,Under trials Released - Extradited,0,0,0
KERALA,2005,Under trials Released - Other releases (transferred to Mental/Civil hospital),15,1,16
KERALA,2005,Total Under trials Released,15,1,16
KERALA,2005,Detenus Released - Released on completion of detention period,0,0,0
KERALA,2005,Detenus Released - Released before completion of detention period,0,0,0
KERALA,2005,Detenus Released - Released on bail,0,0,0
KERALA,2005,Detenus Released - Other releases (temporary transfer etc.),0,0,0
KERALA,2005,Total Detenus Released,0,0,0
KERALA,2006,Convicts Released - Released after completion of conviction,3654,233,3887
KERALA,2006,Convicts Released - Premature release,0,0,0
KERALA,2006,Convicts Released - Released on appeal,368,22,390
KERALA,2006,Convicts Released - Released on bail,1228,76,1304
KERALA,2006,Convicts Released - Pardons,0,0,0
KERALA,2006,Convicts Released - Transferred to other States,1,0,1
KERALA,2006,"Convicts Released - Other Releases (due to illness, transferred to Mental hospital)",24,3,27
KERALA,2006,Total Convicts Released,5275,334,5609
KERALA,2006,Under trials Released - Acquitted,2802,130,2932
KERALA,2006,Under trials Released - Released on appeal,740,19,759
KERALA,2006,Under trials Released - Released on bail,27112,887,27999
KERALA,2006,Under trials Released - Transferred to other States,0,0,0
KERALA,2006,Under trials Released - Extradited,0,0,0
KERALA,2006,Under trials Released - Other releases (transferred to Mental/Civil hospital),26,1,27
KERALA,2006,Total Under trials Released,30680,1037,31717
KERALA,2006,Detenus Released - Released on completion of detention period,17,0,17
KERALA,2006,Detenus Released - Released before completion of detention period,36,0,36
KERALA,2006,Detenus Released - Released on bail,0,0,0
KERALA,2006,Detenus Released - Other releases (temporary transfer etc.),0,0,0
KERALA,2006,Total Detenus Released,53,0,53
KERALA,2007,Convicts Released - Released after completion of conviction,3475,198,3673
KERALA,2007,Convicts Released - Premature release,0,0,0
KERALA,2007,Convicts Released - Released on appeal,344,27,371
KERALA,2007,Convicts Released - Released on bail,1268,71,1339
KERALA,2007,Convicts Released - Pardons,0,0,0
KERALA,2007,Convicts Released - Transferred to other States,0,0,0
KERALA,2007,"Convicts Released - Other Releases (due to illness, transferred to Mental hospital)",35,4,39
KERALA,2007,Total Convicts Released,5122,300,5422
KERALA,2007,Under trials Released - Acquitted,2951,142,3093
KERALA,2007,Under trials Released - Released on appeal,723,21,744
KERALA,2007,Under trials Released - Released on bail,26632,798,27430
KERALA,2007,Under trials Released - Transferred to other States,0,0,0
KERALA,2007,Under trials Released - Extradited,0,0,0
KERALA,2007,Under trials Released - Other releases (transferred to Mental/Civil hospital),32,2,34
KERALA,2007,Total Under trials Released,30338,963,31301
KERALA,2007,Detenus Released - Released on completion of detention period,15,0,15
KERALA,2007,Detenus Released - Released before completion of detention period,30,0,30
KERALA,2007,Detenus Released - Released on bail,0,0,0
KERALA,2007,Detenus Released - Other releases (temporary transfer etc.),0,0,0
KERALA,2007,Total Detenus Released,45,0,45
KERALA,2008,Convicts Released - Released after completion of conviction,3215,184,3399
KERALA,2008,Convicts Released - Premature release,151,0,151
KERALA,2008,Convicts Released - Released on appeal,285,23,308
KERALA,2008,Convicts Released - Released on bail,1312,53,1365
KERALA,2008,Convicts Released - Pardons,0,0,0
KERALA,2008,Convicts Released - Transferred to other States,0,0,0
KERALA,2008,"Convicts Released - Other Releases (due to illness, transferred to Mental hospital)",8,2,10
KERALA,2008,Total Convicts Released,4971,262,5233
KERALA,2008,Under trials Released - Acquitted,3015,133,3148
KERALA,2008,Under trials Released - Released on appeal,690,18,708
KERALA,2008,Under trials Released - Released on bail,24986,712,25698
KERALA,2008,Under trials Released - Transferred to other States,0,0,0
KERALA,2008,Under trials Released - Extradited,0,0,0
KERALA,2008,Under trials Released - Other releases (transferred to Mental/Civil hospital),21,3,24
KERALA,2008,Total Under trials Released,28712,866,29578
KERALA,2008,Detenus Released - Released on completion of detention period,11,0,11
KERALA,2008,Detenus Released - Released before completion of detention period,21,0,21
KERALA,2008,Detenus Released - Released on bail,0,0,0
KERALA,2008,Detenus Released - Other releases (temporary transfer etc.),0,0,0
KERALA,2008,Total Detenus Released,32,0,32
KERALA,2009,Convicts Released - Released after completion of conviction,4375,118,4493
KERALA,2009,Convicts Released - Premature release,172,2,174
KERALA,2009,Convicts Released - Released on appeal,112,10,122
KERALA,2009,Convicts Released - Released on bail,856,31,887
KERALA,2009,Convicts Released - Pardons,27,2,29
KERALA,2009,Convicts Released - Transferred to other States,0,0,0
KERALA,2009,"Convicts Released - Other Releases (due to illness, transferred to Mental hospital)",58,0,58
KERALA,2009,Total Convicts Released,5600,163,5763
KERALA,2009,Under trials Released - Acquitted,2694,260,2954
KERALA,2009,Under trials Released - Released on appeal,1527,20,1547
KERALA,2009,Under trials Released - Released on bail,31099,1911,33010
KERALA,2009,Under trials Released - Transferred to other States,0,0,0
KERALA,2009,Under trials Released - Extradited,0,0,0
KERALA,2009,Under trials Released - Other releases (transferred to Mental/Civil hospital),1528,115,1643
KERALA,2009,Total Under trials Released,36848,2306,39154
KERALA,2009,Detenus Released - Released on completion of detention period,59,0,59
KERALA,2009,Detenus Released - Released before completion of detention period,43,0,43
KERALA,2009,Detenus Released - Released on bail,30,0,30
KERALA,2009,Detenus Released - Other releases (temporary transfer etc.),0,0,0
KERALA,2009,Total Detenus Released,132,0,132
KERALA,2010,Convicts Released - Released after completion of conviction,8518,328,8846
KERALA,2010,Convicts Released - Premature release,260,0,260
KERALA,2010,Convicts Released - Released on appeal,370,12,382
KERALA,2010,Convicts Released - Released on bail,0,0,0
KERALA,2010,Convicts Released - Pardons,0,0,0
KERALA,2010,Convicts Released - Transferred to other States,0,0,0
KERALA,2010,"Convicts Released - Other Releases (due to illness, transferred to Mental hospital)",0,0,0
KERALA,2010,Total Convicts Released,9148,340,9488
KERALA,2010,Under trials Released - Acquitted,6200,405,6605
KERALA,2010,Under trials Released - Released on appeal,5200,204,5404
KERALA,2010,Under trials Released - Released on bail,8724,3512,12236
KERALA,2010,Under trials Released - Transferred to other States,0,0,0
KERALA,2010,Under trials Released - Extradited,0,0,0
KERALA,2010,Under trials Released - Other releases (transferred to Mental/Civil hospital),0,0,0
KERALA,2010,Total Under trials Released,20124,4121,24245
KERALA,2010,Detenus Released - Released on completion of detention period,37,0,37
KERALA,2010,Detenus Released - Released before completion of detention period,29,0,29
KERALA,2010,Detenus Released - Released on bail,20,0,20
KERALA,2010,Detenus Released - Other releases (temporary transfer etc.),0,0,0
KERALA,2010,Total Detenus Released,86,0,86
KERALA,2011,Convicts Released - Released after completion of conviction,4962,428,5390
KERALA,2011,Convicts Released - Premature release,209,2,211
KERALA,2011,Convicts Released - Released on appeal,1265,0,1265
KERALA,2011,Convicts Released - Released on bail,363,1,364
KERALA,2011,Convicts Released - Pardons,0,0,0
KERALA,2011,Convicts Released - Transferred to other States,0,0,0
KERALA,2011,"Convicts Released - Other Releases (due to illness, transferred to Mental hospital)",2,1,3
KERALA,2011,Total Convicts Released,6801,432,7233
KERALA,2011,Under trials Released - Acquitted,5943,384,6327
KERALA,2011,Under trials Released - Released on appeal,6541,843,7384
KERALA,2011,Under trials Released - Released on bail,6532,2182,8714
KERALA,2011,Under trials Released - Transferred to other States,0,0,0
KERALA,2011,Under trials Released - Extradited,0,0,0
KERALA,2011,Under trials Released - Other releases (transferred to Mental/Civil hospital),10,2,12
KERALA,2011,Total Under trials Released,19026,3411,22437
KERALA,2011,Detenus Released - Released on completion of detention period,3,0,3
KERALA,2011,Detenus Released - Released before completion of detention period,12,0,12
KERALA,2011,Detenus Released - Released on bail,1,0,1
KERALA,2011,Detenus Released - Other releases (temporary transfer etc.),1,0,1
KERALA,2011,Total Detenus Released,17,0,17
KERALA,2012,Convicts Released - Released after completion of conviction,5064,492,5556
KERALA,2012,Convicts Released - Premature release,21,0,21
KERALA,2012,Convicts Released - Released on appeal,1532,4,1536
KERALA,2012,Convicts Released - Released on bail,434,6,440
KERALA,2012,Convicts Released - Pardons,0,0,0
KERALA,2012,Convicts Released - Transferred to other States,0,0,0
KERALA,2012,"Convicts Released - Other Releases (due to illness, transferred to Mental hospital)",6,2,8
KERALA,2012,Total Convicts Released,7057,504,7561
KERALA,2012,Under trials Released - Acquitted,5945,345,6290
KERALA,2012,Under trials Released - Released on appeal,6548,845,7393
KERALA,2012,Under trials Released - Released on bail,6538,2183,8721
KERALA,2012,Under trials Released - Transferred to other States,0,0,0
KERALA,2012,Under trials Released - Extradited,0,0,0
KERALA,2012,Under trials Released - Other releases (transferred to Mental/Civil hospital),11,3,14
KERALA,2012,Total Under trials Released,19042,3376,22418
KERALA,2012,Detenus Released - Released on completion of detention period,9,0,9
KERALA,2012,Detenus Released - Released before completion of detention period,0,0,0
KERALA,2012,Detenus Released - Released on bail,0,0,0
KERALA,2012,Detenus Released - Other releases (temporary transfer etc.),0,0,0
KERALA,2012,Total Detenus Released,9,0,9
MADHYA PRADESH,2001,Convicts Released - Released after completion of conviction,4754,102,4856
MADHYA PRADESH,2001,Convicts Released - Premature release,162,3,165
MADHYA PRADESH,2001,Convicts Released - Released on appeal,316,9,325
MADHYA PRADESH,2001,Convicts Released - Released on bail,4126,189,4315
MADHYA PRADESH,2001,Convicts Released - Pardons,9,0,9
MADHYA PRADESH,2001,Convicts Released - Transferred to other States,41,0,41
MADHYA PRADESH,2001,"Convicts Released - Other Releases (due to illness, transferred to Mental hospital)",1028,25,1053
MADHYA PRADESH,2001,Total Convicts Released,10436,328,10764
MADHYA PRADESH,2001,Under trials Released - Acquitted,4613,125,4738
MADHYA PRADESH,2001,Under trials Released - Released on appeal,86,0,86
MADHYA PRADESH,2001,Under trials Released - Released on bail,76894,1944,78838
MADHYA PRADESH,2001,Under trials Released - Transferred to other States,114,25,139
MADHYA PRADESH,2001,Under trials Released - Extradited,145,2,147
MADHYA PRADESH,2001,Under trials Released - Other releases (transferred to Mental/Civil hospital),124,0,124
MADHYA PRADESH,2001,Total Under trials Released,81976,2096,84072
MADHYA PRADESH,2001,Detenus Released - Released on completion of detention period,18,0,18
MADHYA PRADESH,2001,Detenus Released - Released before completion of detention period,18,0,18
MADHYA PRADESH,2001,Detenus Released - Released on bail,0,0,0
MADHYA PRADESH,2001,Detenus Released - Other releases (temporary transfer etc.),2,0,2
MADHYA PRADESH,2001,Total Detenus Released,38,0,38
MADHYA PRADESH,2002,Convicts Released - Released after completion of conviction,7183,100,7283
MADHYA PRADESH,2002,Convicts Released - Premature release,410,12,422
MADHYA PRADESH,2002,Convicts Released - Released on appeal,1160,19,1179
MADHYA PRADESH,2002,Convicts Released - Released on bail,6447,181,6628
MADHYA PRADESH,2002,Convicts Released - Pardons,714,16,730
MADHYA PRADESH,2002,Convicts Released - Transferred to other States,895,8,903
MADHYA PRADESH,2002,"Convicts Released - Other Releases (due to illness, transferred to Mental hospital)",593,13,606
MADHYA PRADESH,2002,Total Convicts Released,17402,349,17751
MADHYA PRADESH,2002,Under trials Released - Acquitted,6086,181,6267
MADHYA PRADESH,2002,Under trials Released - Released on appeal,892,18,910
MADHYA PRADESH,2002,Under trials Released - Released on bail,11697,2438,14135
MADHYA PRADESH,2002,Under trials Released - Transferred to other States,594,9,603
MADHYA PRADESH,2002,Under trials Released - Extradited,1090,19,1109
MADHYA PRADESH,2002,Under trials Released - Other releases (transferred to Mental/Civil hospital),543,15,558
MADHYA PRADESH,2002,Total Under trials Released,20902,2680,23582
MADHYA PRADESH,2002,Detenus Released - Released on completion of detention period,23,0,23
MADHYA PRADESH,2002,Detenus Released - Released before completion of detention period,16,0,16
MADHYA PRADESH,2002,Detenus Released - Released on bail,0,0,0
MADHYA PRADESH,2002,Detenus Released - Other releases (temporary transfer etc.),0,0,0
MADHYA PRADESH,2002,Total Detenus Released,39,0,39
MADHYA PRADESH,2003,Convicts Released - Released after completion of conviction,7416,92,7508
MADHYA PRADESH,2003,Convicts Released - Premature release,484,9,493
MADHYA PRADESH,2003,Convicts Released - Released on appeal,1278,20,1298
MADHYA PRADESH,2003,Convicts Released - Released on bail,7494,196,7690
MADHYA PRADESH,2003,Convicts Released - Pardons,558,5,563
MADHYA PRADESH,2003,Convicts Released - Transferred to other States,246,3,249
MADHYA PRADESH,2003,"Convicts Released - Other Releases (due to illness, transferred to Mental hospital)",1356,13,1369
MADHYA PRADESH,2003,Total Convicts Released,18832,338,19170
MADHYA PRADESH,2003,Under trials Released - Acquitted,5642,162,5804
MADHYA PRADESH,2003,Under trials Released - Released on appeal,960,19,979
MADHYA PRADESH,2003,Under trials Released - Released on bail,97755,3024,100779
MADHYA PRADESH,2003,Under trials Released - Transferred to other States,377,3,380
MADHYA PRADESH,2003,Under trials Released - Extradited,9,0,9
MADHYA PRADESH,2003,Under trials Released - Other releases (transferred to Mental/Civil hospital),765,10,775
MADHYA PRADESH,2003,Total Under trials Released,105508,3218,108726
MADHYA PRADESH,2003,Detenus Released - Released on completion of detention period,61,0,61
MADHYA PRADESH,2003,Detenus Released - Released before completion of detention period,63,0,63
MADHYA PRADESH,2003,Detenus Released - Released on bail,0,0,0
MADHYA PRADESH,2003,Detenus Released - Other releases (temporary transfer etc.),28,0,28
MADHYA PRADESH,2003,Total Detenus Released,152,0,152
MADHYA PRADESH,2004,Convicts Released - Released after completion of conviction,6773,65,6838
MADHYA PRADESH,2004,Convicts Released - Premature release,620,30,650
MADHYA PRADESH,2004,Convicts Released - Released on appeal,1583,41,1624
MADHYA PRADESH,2004,Convicts Released - Released on bail,3671,114,3785
MADHYA PRADESH,2004,Convicts Released - Pardons,925,3,928
MADHYA PRADESH,2004,Convicts Released - Transferred to other States,713,1,714
MADHYA PRADESH,2004,"Convicts Released - Other Releases (due to illness, transferred to Mental hospital)",869,18,887
MADHYA PRADESH,2004,Total Convicts Released,15154,272,15426
MADHYA PRADESH,2004,Under trials Released - Acquitted,7229,551,7780
MADHYA PRADESH,2004,Under trials Released - Released on appeal,14595,452,15047
MADHYA PRADESH,2004,Under trials Released - Released on bail,89129,2223,91352
MADHYA PRADESH,2004,Under trials Released - Transferred to other States,248,2,250
MADHYA PRADESH,2004,Under trials Released - Extradited,241,1,242
MADHYA PRADESH,2004,Under trials Released - Other releases (transferred to Mental/Civil hospital),7513,226,7739
MADHYA PRADESH,2004,Total Under trials Released,118955,3455,122410
MADHYA PRADESH,2004,Detenus Released - Released on completion of detention period,45,0,45
MADHYA PRADESH,2004,Detenus Released - Released before completion of detention period,54,0,54
MADHYA PRADESH,2004,Detenus Released - Released on bail,12,0,12
MADHYA PRADESH,2004,Detenus Released - Other releases (temporary transfer etc.),1,0,1
MADHYA PRADESH,2004,Total Detenus Released,112,0,112
MADHYA PRADESH,2005,Convicts Released - Released after completion of conviction,7074,93,7167
MADHYA PRADESH,2005,Convicts Released - Premature release,502,30,532
MADHYA PRADESH,2005,Convicts Released - Released on appeal,3087,82,3169
MADHYA PRADESH,2005,Convicts Released - Released on bail,6630,215,6845
MADHYA PRADESH,2005,Convicts Released - Pardons,220,5,225
MADHYA PRADESH,2005,Convicts Released - Transferred to other States,576,18,594
MADHYA PRADESH,2005,"Convicts Released - Other Releases (due to illness, transferred to Mental hospital)",1306,29,1335
MADHYA PRADESH,2005,Total Convicts Released,19395,472,19867
MADHYA PRADESH,2005,Under trials Released - Acquitted,6396,108,6504
MADHYA PRADESH,2005,Under trials Released - Released on appeal,663,6,669
MADHYA PRADESH,2005,Under trials Released - Released on bail,105908,2674,108582
MADHYA PRADESH,2005,Under trials Released - Transferred to other States,1136,17,1153
MADHYA PRADESH,2005,Under trials Released - Extradited,79,0,79
MADHYA PRADESH,2005,Under trials Released - Other releases (transferred to Mental/Civil hospital),847,1,848
MADHYA PRADESH,2005,Total Under trials Released,115029,2806,117835
MADHYA PRADESH,2005,Detenus Released - Released on completion of detention period,4,0,4
MADHYA PRADESH,2005,Detenus Released - Released before completion of detention period,81,0,81
MADHYA PRADESH,2005,Detenus Released - Released on bail,0,0,0
MADHYA PRADESH,2005,Detenus Released - Other releases (temporary transfer etc.),55,0,55
MADHYA PRADESH,2005,Total Detenus Released,140,0,140
MADHYA PRADESH,2006,Convicts Released - Released after completion of conviction,7959,123,8082
MADHYA PRADESH,2006,Convicts Released - Premature release,170,1,171
MADHYA PRADESH,2006,Convicts Released - Released on appeal,1206,26,1232
MADHYA PRADESH,2006,Convicts Released - Released on bail,7064,195,7259
MADHYA PRADESH,2006,Convicts Released - Pardons,274,18,292
MADHYA PRADESH,2006,Convicts Released - Transferred to other States,665,5,670
MADHYA PRADESH,2006,"Convicts Released - Other Releases (due to illness, transferred to Mental hospital)",428,5,433
MADHYA PRADESH,2006,Total Convicts Released,17766,373,18139
MADHYA PRADESH,2006,Under trials Released - Acquitted,7328,132,7460
MADHYA PRADESH,2006,Under trials Released - Released on appeal,84,5,89
MADHYA PRADESH,2006,Under trials Released - Released on bail,89622,2809,92431
MADHYA PRADESH,2006,Under trials Released - Transferred to other States,513,2,515
MADHYA PRADESH,2006,Under trials Released - Extradited,294,0,294
MADHYA PRADESH,2006,Under trials Released - Other releases (transferred to Mental/Civil hospital),494,8,502
MADHYA PRADESH,2006,Total Under trials Released,98335,2956,101291
MADHYA PRADESH,2006,Detenus Released - Released on completion of detention period,24,0,24
MADHYA PRADESH,2006,Detenus Released - Released before completion of detention period,52,9,61
MADHYA PRADESH,2006,Detenus Released - Released on bail,2,0,2
MADHYA PRADESH,2006,Detenus Released - Other releases (temporary transfer etc.),1,0,1
MADHYA PRADESH,2006,Total Detenus Released,79,9,88
MADHYA PRADESH,2007,Convicts Released - Released after completion of conviction,7058,162,7220
MADHYA PRADESH,2007,Convicts Released - Premature release,239,5,244
MADHYA PRADESH,2007,Convicts Released - Released on appeal,1261,38,1299
MADHYA PRADESH,2007,Convicts Released - Released on bail,8851,262,9113
MADHYA PRADESH,2007,Convicts Released - Pardons,161,0,161
MADHYA PRADESH,2007,Convicts Released - Transferred to other States,638,19,657
MADHYA PRADESH,2007,"Convicts Released - Other Releases (due to illness, transferred to Mental hospital)",385,16,401
MADHYA PRADESH,2007,Total Convicts Released,18593,502,19095
MADHYA PRADESH,2007,Under trials Released - Acquitted,6117,186,6303
MADHYA PRADESH,2007,Under trials Released - Released on appeal,111,12,123
MADHYA PRADESH,2007,Under trials Released - Released on bail,97632,2816,100448
MADHYA PRADESH,2007,Under trials Released - Transferred to other States,820,4,824
MADHYA PRADESH,2007,Under trials Released - Extradited,319,2,321
MADHYA PRADESH,2007,Under trials Released - Other releases (transferred to Mental/Civil hospital),212,3,215
MADHYA PRADESH,2007,Total Under trials Released,105211,3023,108234
MADHYA PRADESH,2007,Detenus Released - Released on completion of detention period,37,0,37
MADHYA PRADESH,2007,Detenus Released - Released before completion of detention period,45,0,45
MADHYA PRADESH,2007,Detenus Released - Released on bail,24,0,24
MADHYA PRADESH,2007,Detenus Released - Other releases (temporary transfer etc.),0,0,0
MADHYA PRADESH,2007,Total Detenus Released,106,0,106
MADHYA PRADESH,2008,Convicts Released - Released after completion of conviction,6771,143,6914
MADHYA PRADESH,2008,Convicts Released - Premature release,218,1,219
MADHYA PRADESH,2008,Convicts Released - Released on appeal,1331,31,1362
MADHYA PRADESH,2008,Convicts Released - Released on bail,8392,286,8678
MADHYA PRADESH,2008,Convicts Released - Pardons,383,8,391
MADHYA PRADESH,2008,Convicts Released - Transferred to other States,671,16,687
MADHYA PRADESH,2008,"Convicts Released - Other Releases (due to illness, transferred to Mental hospital)",229,4,233
MADHYA PRADESH,2008,Total Convicts Released,17995,489,18484
MADHYA PRADESH,2008,Under trials Released - Acquitted,4426,116,4542
MADHYA PRADESH,2008,Under trials Released - Released on appeal,1142,51,1193
MADHYA PRADESH,2008,Under trials Released - Released on bail,110879,3004,113883
MADHYA PRADESH,2008,Under trials Released - Transferred to other States,965,3,968
MADHYA PRADESH,2008,Under trials Released - Extradited,130,0,130
MADHYA PRADESH,2008,Under trials Released - Other releases (transferred to Mental/Civil hospital),372,9,381
MADHYA PRADESH,2008,Total Under trials Released,117914,3183,121097
MADHYA PRADESH,2008,Detenus Released - Released on completion of detention period,37,0,37
MADHYA PRADESH,2008,Detenus Released - Released before completion of detention period,102,0,102
MADHYA PRADESH,2008,Detenus Released - Released on bail,2,0,2
MADHYA PRADESH,2008,Detenus Released - Other releases (temporary transfer etc.),1,0,1
MADHYA PRADESH,2008,Total Detenus Released,142,0,142
MADHYA PRADESH,2009,Convicts Released - Released after completion of conviction,4561,112,4673
MADHYA PRADESH,2009,Convicts Released - Premature release,330,2,332
MADHYA PRADESH,2009,Convicts Released - Released on appeal,1542,32,1574
MADHYA PRADESH,2009,Convicts Released - Released on bail,7719,298,8017
MADHYA PRADESH,2009,Convicts Released - Pardons,153,0,153
MADHYA PRADESH,2009,Convicts Released - Transferred to other States,627,17,644
MADHYA PRADESH,2009,"Convicts Released - Other Releases (due to illness, transferred to Mental hospital)",322,11,333
MADHYA PRADESH,2009,Total Convicts Released,15254,472,15726
MADHYA PRADESH,2009,Under trials Released - Acquitted,4006,127,4133
MADHYA PRADESH,2009,Under trials Released - Released on appeal,981,55,1036
MADHYA PRADESH,2009,Under trials Released - Released on bail,106318,3815,110133
MADHYA PRADESH,2009,Under trials Released - Transferred to other States,413,6,419
MADHYA PRADESH,2009,Under trials Released - Extradited,40,0,40
MADHYA PRADESH,2009,Under trials Released - Other releases (transferred to Mental/Civil hospital),766,8,774
MADHYA PRADESH,2009,Total Under trials Released,112524,4011,116535
MADHYA PRADESH,2009,Detenus Released - Released on completion of detention period,67,0,67
MADHYA PRADESH,2009,Detenus Released - Released before completion of detention period,58,0,58
MADHYA PRADESH,2009,Detenus Released - Released on bail,3,0,3
MADHYA PRADESH,2009,Detenus Released - Other releases (temporary transfer etc.),8,0,8
MADHYA PRADESH,2009,Total Detenus Released,136,0,136
MADHYA PRADESH,2010,Convicts Released - Released after completion of conviction,5347,125,5472
MADHYA PRADESH,2010,Convicts Released - Premature release,913,9,922
MADHYA PRADESH,2010,Convicts Released - Released on appeal,1493,31,1524
MADHYA PRADESH,2010,Convicts Released - Released on bail,7580,280,7860
MADHYA PRADESH,2010,Convicts Released - Pardons,0,0,0
MADHYA PRADESH,2010,Convicts Released - Transferred to other States,184,8,192
MADHYA PRADESH,2010,"Convicts Released - Other Releases (due to illness, transferred to Mental hospital)",766,36,802
MADHYA PRADESH,2010,Total Convicts Released,16283,489,16772
MADHYA PRADESH,2010,Under trials Released - Acquitted,4986,148,5134
MADHYA PRADESH,2010,Under trials Released - Released on appeal,1459,59,1518
MADHYA PRADESH,2010,Under trials Released - Released on bail,103309,2855,106164
MADHYA PRADESH,2010,Under trials Released - Transferred to other States,549,1,550
MADHYA PRADESH,2010,Under trials Released - Extradited,0,0,0
MADHYA PRADESH,2010,Under trials Released - Other releases (transferred to Mental/Civil hospital),978,17,995
MADHYA PRADESH,2010,Total Under trials Released,111281,3080,114361
MADHYA PRADESH,2010,Detenus Released - Released on completion of detention period,49,0,49
MADHYA PRADESH,2010,Detenus Released - Released before completion of detention period,229,0,229
MADHYA PRADESH,2010,Detenus Released - Released on bail,2,0,2
MADHYA PRADESH,2010,Detenus Released - Other releases (temporary transfer etc.),1,0,1
MADHYA PRADESH,2010,Total Detenus Released,281,0,281
MADHYA PRADESH,2011,Convicts Released - Released after completion of conviction,3125,95,3220
MADHYA PRADESH,2011,Convicts Released - Premature release,310,11,321
MADHYA PRADESH,2011,Convicts Released - Released on appeal,555,29,584
MADHYA PRADESH,2011,Convicts Released - Released on bail,5595,252,5847
MADHYA PRADESH,2011,Convicts Released - Pardons,1,0,1
MADHYA PRADESH,2011,Convicts Released - Transferred to other States,25,0,25
MADHYA PRADESH,2011,"Convicts Released - Other Releases (due to illness, transferred to Mental hospital)",1443,20,1463
MADHYA PRADESH,2011,Total Convicts Released,11054,407,11461
MADHYA PRADESH,2011,Under trials Released - Acquitted,4763,180,4943
MADHYA PRADESH,2011,Under trials Released - Released on appeal,673,0,673
MADHYA PRADESH,2011,Under trials Released - Released on bail,94149,2933,97082
MADHYA PRADESH,2011,Under trials Released - Transferred to other States,194,1,195
MADHYA PRADESH,2011,Under trials Released - Extradited,0,0,0
MADHYA PRADESH,2011,Under trials Released - Other releases (transferred to Mental/Civil hospital),1350,2,1352
MADHYA PRADESH,2011,Total Under trials Released,101129,3116,104245
MADHYA PRADESH,2011,Detenus Released - Released on completion of detention period,26,0,26
MADHYA PRADESH,2011,Detenus Released - Released before completion of detention period,278,0,278
MADHYA PRADESH,2011,Detenus Released - Released on bail,0,0,0
MADHYA PRADESH,2011,Detenus Released - Other releases (temporary transfer etc.),30,0,30
MADHYA PRADESH,2011,Total Detenus Released,334,0,334
MADHYA PRADESH,2012,Convicts Released - Released after completion of conviction,3932,76,4008
MADHYA PRADESH,2012,Convicts Released - Premature release,355,2,357
MADHYA PRADESH,2012,Convicts Released - Released on appeal,790,67,857
MADHYA PRADESH,2012,Convicts Released - Released on bail,7005,276,7281
MADHYA PRADESH,2012,Convicts Released - Pardons,2,0,2
MADHYA PRADESH,2012,Convicts Released - Transferred to other States,19,0,19
MADHYA PRADESH,2012,"Convicts Released - Other Releases (due to illness, transferred to Mental hospital)",1666,43,1709
MADHYA PRADESH,2012,Total Convicts Released,13769,464,14233
MADHYA PRADESH,2012,Under trials Released - Acquitted,5212,117,5329
MADHYA PRADESH,2012,Under trials Released - Released on appeal,223,3,226
MADHYA PRADESH,2012,Under trials Released - Released on bail,115883,2961,118844
MADHYA PRADESH,2012,Under trials Released - Transferred to other States,182,5,187
MADHYA PRADESH,2012,Under trials Released - Extradited,0,0,0
MADHYA PRADESH,2012,Under trials Released - Other releases (transferred to Mental/Civil hospital),734,17,751
MADHYA PRADESH,2012,Total Under trials Released,122234,3103,125337
MADHYA PRADESH,2012,Detenus Released - Released on completion of detention period,89,0,89
MADHYA PRADESH,2012,Detenus Released - Released before completion of detention period,239,0,239
MADHYA PRADESH,2012,Detenus Released - Released on bail,14,0,14
MADHYA PRADESH,2012,Detenus Released - Other releases (temporary transfer etc.),14,0,14
MADHYA PRADESH,2012,Total Detenus Released,356,0,356
MAHARASHTRA,2001,Convicts Released - Released after completion of conviction,27007,645,27652
MAHARASHTRA,2001,Convicts Released - Premature release,2,0,2
MAHARASHTRA,2001,Convicts Released - Released on appeal,402,12,414
MAHARASHTRA,2001,Convicts Released - Released on bail,1249,62,1311
MAHARASHTRA,2001,Convicts Released - Pardons,0,0,0
MAHARASHTRA,2001,Convicts Released - Transferred to other States,3976,304,4280
MAHARASHTRA,2001,"Convicts Released - Other Releases (due to illness, transferred to Mental hospital)",3886,87,3973
MAHARASHTRA,2001,Total Convicts Released,36522,1110,37632
MAHARASHTRA,2001,Under trials Released - Acquitted,5062,252,5314
MAHARASHTRA,2001,Under trials Released - Released on appeal,185,26,211
MAHARASHTRA,2001,Under trials Released - Released on bail,76989,4780,81769
MAHARASHTRA,2001,Under trials Released - Transferred to other States,9599,1104,10703
MAHARASHTRA,2001,Under trials Released - Extradited,8640,242,8882
MAHARASHTRA,2001,Under trials Released - Other releases (transferred to Mental/Civil hospital),2364,161,2525
MAHARASHTRA,2001,Total Under trials Released,102839,6565,109404
MAHARASHTRA,2001,Detenus Released - Released on completion of detention period,380,5,385
MAHARASHTRA,2001,Detenus Released - Released before completion of detention period,112,2,114
MAHARASHTRA,2001,Detenus Released - Released on bail,0,0,0
MAHARASHTRA,2001,Detenus Released - Other releases (temporary transfer etc.),1772,7,1779
MAHARASHTRA,2001,Total Detenus Released,2264,14,2278
MAHARASHTRA,2002,Convicts Released - Released after completion of conviction,34230,676,34906
MAHARASHTRA,2002,Convicts Released - Premature release,0,0,0
MAHARASHTRA,2002,Convicts Released - Released on appeal,329,9,338
MAHARASHTRA,2002,Convicts Released - Released on bail,1323,83,1406
MAHARASHTRA,2002,Convicts Released - Pardons,0,0,0
MAHARASHTRA,2002,Convicts Released - Transferred to other States,4083,214,4297
MAHARASHTRA,2002,"Convicts Released - Other Releases (due to illness, transferred to Mental hospital)",1645,36,1681
MAHARASHTRA,2002,Total Convicts Released,41610,1018,42628
MAHARASHTRA,2002,Under trials Released - Acquitted,4525,150,4675
MAHARASHTRA,2002,Under trials Released - Released on appeal,193,10,203
MAHARASHTRA,2002,Under trials Released - Released on bail,73234,5008,78242
MAHARASHTRA,2002,Under trials Released - Transferred to other States,9416,1550,10966
MAHARASHTRA,2002,Under trials Released - Extradited,8156,249,8405
MAHARASHTRA,2002,Under trials Released - Other releases (transferred to Mental/Civil hospital),2385,51,2436
MAHARASHTRA,2002,Total Under trials Released,97909,7018,104927
MAHARASHTRA,2002,Detenus Released - Released on completion of detention period,334,2,336
MAHARASHTRA,2002,Detenus Released - Released before completion of detention period,68,0,68
MAHARASHTRA,2002,Detenus Released - Released on bail,1,0,1
MAHARASHTRA,2002,Detenus Released - Other releases (temporary transfer etc.),1397,33,1430
MAHARASHTRA,2002,Total Detenus Released,1800,35,1835
MAHARASHTRA,2003,Convicts Released - Released after completion of conviction,26811,615,27426
MAHARASHTRA,2003,Convicts Released - Premature release,5,1,6
MAHARASHTRA,2003,Convicts Released - Released on appeal,270,12,282
MAHARASHTRA,2003,Convicts Released - Released on bail,1436,133,1569
MAHARASHTRA,2003,Convicts Released - Pardons,0,0,0
MAHARASHTRA,2003,Convicts Released - Transferred to other States,3911,401,4312
MAHARASHTRA,2003,"Convicts Released - Other Releases (due to illness, transferred to Mental hospital)",1720,48,1768
MAHARASHTRA,2003,Total Convicts Released,34153,1210,35363
MAHARASHTRA,2003,Under trials Released - Acquitted,10397,506,10903
MAHARASHTRA,2003,Under trials Released - Released on appeal,0,0,0
MAHARASHTRA,2003,Under trials Released - Released on bail,65895,4215,70110
MAHARASHTRA,2003,Under trials Released - Transferred to other States,9541,708,10249
MAHARASHTRA,2003,Under trials Released - Extradited,0,0,0
MAHARASHTRA,2003,Under trials Released - Other releases (transferred to Mental/Civil hospital),12809,492,13301
MAHARASHTRA,2003,Total Under trials Released,98642,5921,104563
MAHARASHTRA,2003,Detenus Released - Released on completion of detention period,53,8,61
MAHARASHTRA,2003,Detenus Released - Released before completion of detention period,58,17,75
MAHARASHTRA,2003,Detenus Released - Released on bail,192,7,199
MAHARASHTRA,2003,Detenus Released - Other releases (temporary transfer etc.),1727,20,1747
MAHARASHTRA,2003,Total Detenus Released,2030,52,2082
MAHARASHTRA,2004,Convicts Released - Released after completion of conviction,27861,868,28729
MAHARASHTRA,2004,Convicts Released - Premature release,8,0,8
MAHARASHTRA,2004,Convicts Released - Released on appeal,291,18,309
MAHARASHTRA,2004,Convicts Released - Released on bail,1413,133,1546
MAHARASHTRA,2004,Convicts Released - Pardons,0,0,0
MAHARASHTRA,2004,Convicts Released - Transferred to other States,2,0,2
MAHARASHTRA,2004,"Convicts Released - Other Releases (due to illness, transferred to Mental hospital)",7460,595,8055
MAHARASHTRA,2004,Total Convicts Released,37035,1614,38649
MAHARASHTRA,2004,Under trials Released - Acquitted,5487,179,5666
MAHARASHTRA,2004,Under trials Released - Released on appeal,0,0,0
MAHARASHTRA,2004,Under trials Released - Released on bail,74454,4820,79274
MAHARASHTRA,2004,Under trials Released - Transferred to other States,0,0,0
MAHARASHTRA,2004,Under trials Released - Extradited,0,0,0
MAHARASHTRA,2004,Under trials Released - Other releases (transferred to Mental/Civil hospital),23840,678,24518
MAHARASHTRA,2004,Total Under trials Released,103781,5677,109458
MAHARASHTRA,2004,Detenus Released - Released on completion of detention period,65,0,65
MAHARASHTRA,2004,Detenus Released - Released before completion of detention period,18,0,18
MAHARASHTRA,2004,Detenus Released - Released on bail,0,0,0
MAHARASHTRA,2004,Detenus Released - Other releases (temporary transfer etc.),564,1,565
MAHARASHTRA,2004,Total Detenus Released,647,1,648
MAHARASHTRA,2005,Convicts Released - Released after completion of conviction,27356,954,28310
MAHARASHTRA,2005,Convicts Released - Premature release,36,1,37
MAHARASHTRA,2005,Convicts Released - Released on appeal,536,22,558
MAHARASHTRA,2005,Convicts Released - Released on bail,1287,108,1395
MAHARASHTRA,2005,Convicts Released - Pardons,0,0,0
MAHARASHTRA,2005,Convicts Released - Transferred to other States,4,0,4
MAHARASHTRA,2005,"Convicts Released - Other Releases (due to illness, transferred to Mental hospital)",8122,655,8777
MAHARASHTRA,2005,Total Convicts Released,37341,1740,39081
MAHARASHTRA,2005,Under trials Released - Acquitted,4985,178,5163
MAHARASHTRA,2005,Under trials Released - Released on appeal,0,0,0
MAHARASHTRA,2005,Under trials Released - Released on bail,77816,5693,83509
MAHARASHTRA,2005,Under trials Released - Transferred to other States,0,0,0
MAHARASHTRA,2005,Under trials Released - Extradited,0,0,0
MAHARASHTRA,2005,Under trials Released - Other releases (transferred to Mental/Civil hospital),22632,958,23590
MAHARASHTRA,2005,Total Under trials Released,105433,6829,112262
MAHARASHTRA,2005,Detenus Released - Released on completion of detention period,42,0,42
MAHARASHTRA,2005,Detenus Released - Released before completion of detention period,0,0,0
MAHARASHTRA,2005,Detenus Released - Released on bail,0,0,0
MAHARASHTRA,2005,Detenus Released - Other releases (temporary transfer etc.),709,1,710
MAHARASHTRA,2005,Total Detenus Released,751,1,752
MAHARASHTRA,2006,Convicts Released - Released after completion of conviction,28447,771,29218
MAHARASHTRA,2006,Convicts Released - Premature release,0,0,0
MAHARASHTRA,2006,Convicts Released - Released on appeal,568,37,605
MAHARASHTRA,2006,Convicts Released - Released on bail,1167,117,1284
MAHARASHTRA,2006,Convicts Released - Pardons,124,7,131
MAHARASHTRA,2006,Convicts Released - Transferred to other States,5,4,9
MAHARASHTRA,2006,"Convicts Released - Other Releases (due to illness, transferred to Mental hospital)",7728,474,8202
MAHARASHTRA,2006,Total Convicts Released,38039,1410,39449
MAHARASHTRA,2006,Under trials Released - Acquitted,5558,134,5692
MAHARASHTRA,2006,Under trials Released - Released on appeal,0,0,0
MAHARASHTRA,2006,Under trials Released - Released on bail,82772,6643,89415
MAHARASHTRA,2006,Under trials Released - Transferred to other States,13,0,13
MAHARASHTRA,2006,Under trials Released - Extradited,0,0,0
MAHARASHTRA,2006,Under trials Released - Other releases (transferred to Mental/Civil hospital),20499,664,21163
MAHARASHTRA,2006,Total Under trials Released,108842,7441,116283
MAHARASHTRA,2006,Detenus Released - Released on completion of detention period,85,2,87
MAHARASHTRA,2006,Detenus Released - Released before completion of detention period,0,0,0
MAHARASHTRA,2006,Detenus Released - Released on bail,10,0,10
MAHARASHTRA,2006,Detenus Released - Other releases (temporary transfer etc.),1033,0,1033
MAHARASHTRA,2006,Total Detenus Released,1128,2,1130
MAHARASHTRA,2007,Convicts Released - Released after completion of conviction,25996,798,26794
MAHARASHTRA,2007,Convicts Released - Premature release,41,2,43
MAHARASHTRA,2007,Convicts Released - Released on appeal,378,9,387
MAHARASHTRA,2007,Convicts Released - Released on bail,1424,99,1523
MAHARASHTRA,2007,Convicts Released - Pardons,0,0,0
MAHARASHTRA,2007,Convicts Released - Transferred to other States,5,1,6
MAHARASHTRA,2007,"Convicts Released - Other Releases (due to illness, transferred to Mental hospital)",6168,427,6595
MAHARASHTRA,2007,Total Convicts Released,34012,1336,35348
MAHARASHTRA,2007,Under trials Released - Acquitted,4720,161,4881
MAHARASHTRA,2007,Under trials Released - Released on appeal,1342,0,1342
MAHARASHTRA,2007,Under trials Released - Released on bail,82996,6003,88999
MAHARASHTRA,2007,Under trials Released - Transferred to other States,9,0,9
MAHARASHTRA,2007,Under trials Released - Extradited,0,0,0
MAHARASHTRA,2007,Under trials Released - Other releases (transferred to Mental/Civil hospital),20782,752,21534
MAHARASHTRA,2007,Total Under trials Released,109849,6916,116765
MAHARASHTRA,2007,Detenus Released - Released on completion of detention period,146,0,146
MAHARASHTRA,2007,Detenus Released - Released before completion of detention period,6,1,7
MAHARASHTRA,2007,Detenus Released - Released on bail,49,0,49
MAHARASHTRA,2007,Detenus Released - Other releases (temporary transfer etc.),771,2,773
MAHARASHTRA,2007,Total Detenus Released,972,3,975
MAHARASHTRA,2008,Convicts Released - Released after completion of conviction,21542,659,22201
MAHARASHTRA,2008,Convicts Released - Premature release,90,4,94
MAHARASHTRA,2008,Convicts Released - Released on appeal,392,14,406
MAHARASHTRA,2008,Convicts Released - Released on bail,1388,117,1505
MAHARASHTRA,2008,Convicts Released - Pardons,0,0,0
MAHARASHTRA,2008,Convicts Released - Transferred to other States,0,0,0
MAHARASHTRA,2008,"Convicts Released - Other Releases (due to illness, transferred to Mental hospital)",6710,806,7516
MAHARASHTRA,2008,Total Convicts Released,30122,1600,31722
MAHARASHTRA,2008,Under trials Released - Acquitted,4855,217,5072
MAHARASHTRA,2008,Under trials Released - Released on appeal,0,0,0
MAHARASHTRA,2008,Under trials Released - Released on bail,90333,5980,96313
MAHARASHTRA,2008,Under trials Released - Transferred to other States,0,0,0
MAHARASHTRA,2008,Under trials Released - Extradited,0,0,0
MAHARASHTRA,2008,Under trials Released - Other releases (transferred to Mental/Civil hospital),19552,831,20383
MAHARASHTRA,2008,Total Under trials Released,114740,7028,121768
MAHARASHTRA,2008,Detenus Released - Released on completion of detention period,40,0,40
MAHARASHTRA,2008,Detenus Released - Released before completion of detention period,0,0,0
MAHARASHTRA,2008,Detenus Released - Released on bail,26,0,26
MAHARASHTRA,2008,Detenus Released - Other releases (temporary transfer etc.),401,4,405
MAHARASHTRA,2008,Total Detenus Released,467,4,471
MAHARASHTRA,2009,Convicts Released - Released after completion of conviction,19848,769,20617
MAHARASHTRA,2009,Convicts Released - Premature release,199,13,212
MAHARASHTRA,2009,Convicts Released - Released on appeal,467,17,484
MAHARASHTRA,2009,Convicts Released - Released on bail,1318,66,1384
MAHARASHTRA,2009,Convicts Released - Pardons,0,0,0
MAHARASHTRA,2009,Convicts Released - Transferred to other States,0,0,0
MAHARASHTRA,2009,"Convicts Released - Other Releases (due to illness, transferred to Mental hospital)",7643,689,8332
MAHARASHTRA,2009,Total Convicts Released,29475,1554,31029
MAHARASHTRA,2009,Under trials Released - Acquitted,4550,146,4696
MAHARASHTRA,2009,Under trials Released - Released on appeal,0,0,0
MAHARASHTRA,2009,Under trials Released - Released on bail,76268,6085,82353
MAHARASHTRA,2009,Under trials Released - Transferred to other States,0,0,0
MAHARASHTRA,2009,Under trials Released - Extradited,0,0,0
MAHARASHTRA,2009,Under trials Released - Other releases (transferred to Mental/Civil hospital),21857,837,22694
MAHARASHTRA,2009,Total Under trials Released,102675,7068,109743
MAHARASHTRA,2009,Detenus Released - Released on completion of detention period,66,0,66
MAHARASHTRA,2009,Detenus Released - Released before completion of detention period,0,0,0
MAHARASHTRA,2009,Detenus Released - Released on bail,15,0,15
MAHARASHTRA,2009,Detenus Released - Other releases (temporary transfer etc.),231,0,231
MAHARASHTRA,2009,Total Detenus Released,312,0,312
MAHARASHTRA,2010,Convicts Released - Released after completion of conviction,15940,588,16528
MAHARASHTRA,2010,Convicts Released - Premature release,43,1,44
MAHARASHTRA,2010,Convicts Released - Released on appeal,476,22,498
MAHARASHTRA,2010,Convicts Released - Released on bail,1475,135,1610
MAHARASHTRA,2010,Convicts Released - Pardons,0,0,0
MAHARASHTRA,2010,Convicts Released - Transferred to other States,0,0,0
MAHARASHTRA,2010,"Convicts Released - Other Releases (due to illness, transferred to Mental hospital)",6007,510,6517
MAHARASHTRA,2010,Total Convicts Released,23941,1256,25197
MAHARASHTRA,2010,Under trials Released - Acquitted,4990,329,5319
MAHARASHTRA,2010,Under trials Released - Released on appeal,0,0,0
MAHARASHTRA,2010,Under trials Released - Released on bail,68475,5481,73956
MAHARASHTRA,2010,Under trials Released - Transferred to other States,4,0,4
MAHARASHTRA,2010,Under trials Released - Extradited,0,0,0
MAHARASHTRA,2010,Under trials Released - Other releases (transferred to Mental/Civil hospital),20677,1499,22176
MAHARASHTRA,2010,Total Under trials Released,94146,7309,101455
MAHARASHTRA,2010,Detenus Released - Released on completion of detention period,25,0,25
MAHARASHTRA,2010,Detenus Released - Released before completion of detention period,0,0,0
MAHARASHTRA,2010,Detenus Released - Released on bail,28,0,28
MAHARASHTRA,2010,Detenus Released - Other releases (temporary transfer etc.),82,0,82
MAHARASHTRA,2010,Total Detenus Released,135,0,135
MAHARASHTRA,2011,Convicts Released - Released after completion of conviction,10219,299,10518
MAHARASHTRA,2011,Convicts Released - Premature release,60,7,67
MAHARASHTRA,2011,Convicts Released - Released on appeal,837,71,908
MAHARASHTRA,2011,Convicts Released - Released on bail,1668,95,1763
MAHARASHTRA,2011,Convicts Released - Pardons,0,0,0
MAHARASHTRA,2011,Convicts Released - Transferred to other States,0,0,0
MAHARASHTRA,2011,"Convicts Released - Other Releases (due to illness, transferred to Mental hospital)",5654,345,5999
MAHARASHTRA,2011,Total Convicts Released,18438,817,19255
MAHARASHTRA,2011,Under trials Released - Acquitted,4208,301,4509
MAHARASHTRA,2011,Under trials Released - Released on appeal,0,0,0
MAHARASHTRA,2011,Under trials Released - Released on bail,70069,5479,75548
MAHARASHTRA,2011,Under trials Released - Transferred to other States,0,0,0
MAHARASHTRA,2011,Under trials Released - Extradited,0,0,0
MAHARASHTRA,2011,Under trials Released - Other releases (transferred to Mental/Civil hospital),17185,740,17925
MAHARASHTRA,2011,Total Under trials Released,91462,6520,97982
MAHARASHTRA,2011,Detenus Released - Released on completion of detention period,22,0,22
MAHARASHTRA,2011,Detenus Released - Released before completion of detention period,0,0,0
MAHARASHTRA,2011,Detenus Released - Released on bail,27,0,27
MAHARASHTRA,2011,Detenus Released - Other releases (temporary transfer etc.),51,3,54
MAHARASHTRA,2011,Total Detenus Released,100,3,103
MAHARASHTRA,2012,Convicts Released - Released after completion of conviction,8172,292,8464
MAHARASHTRA,2012,Convicts Released - Premature release,251,21,272
MAHARASHTRA,2012,Convicts Released - Released on appeal,1163,48,1211
MAHARASHTRA,2012,Convicts Released - Released on bail,1738,112,1850
MAHARASHTRA,2012,Convicts Released - Pardons,100,0,100
MAHARASHTRA,2012,Convicts Released - Transferred to other States,1,0,1
MAHARASHTRA,2012,"Convicts Released - Other Releases (due to illness, transferred to Mental hospital)",8916,467,9383
MAHARASHTRA,2012,Total Convicts Released,20341,940,21281
MAHARASHTRA,2012,Under trials Released - Acquitted,3876,264,4140
MAHARASHTRA,2012,Under trials Released - Released on appeal,0,0,0
MAHARASHTRA,2012,Under trials Released - Released on bail,66987,5112,72099
MAHARASHTRA,2012,Under trials Released - Transferred to other States,1,0,1
MAHARASHTRA,2012,Under trials Released - Extradited,0,0,0
MAHARASHTRA,2012,Under trials Released - Other releases (transferred to Mental/Civil hospital),16833,649,17482
MAHARASHTRA,2012,Total Under trials Released,87697,6025,93722
MAHARASHTRA,2012,Detenus Released - Released on completion of detention period,15,0,15
MAHARASHTRA,2012,Detenus Released - Released before completion of detention period,10,0,10
MAHARASHTRA,2012,Detenus Released - Released on bail,5,0,5
MAHARASHTRA,2012,Detenus Released - Other releases (temporary transfer etc.),59,0,59
MAHARASHTRA,2012,Total Detenus Released,89,0,89
MANIPUR,2001,Convicts Released - Released after completion of conviction,4,0,4
MANIPUR,2001,Convicts Released - Premature release,2,1,3
MANIPUR,2001,Convicts Released - Released on appeal,0,0,0
MANIPUR,2001,Convicts Released - Released on bail,3,0,3
MANIPUR,2001,Convicts Released - Pardons,0,0,0
MANIPUR,2001,Convicts Released - Transferred to other States,0,0,0
MANIPUR,2001,"Convicts Released - Other Releases (due to illness, transferred to Mental hospital)",0,0,0
MANIPUR,2001,Total Convicts Released,9,1,10
MANIPUR,2001,Under trials Released - Acquitted,0,0,0
MANIPUR,2001,Under trials Released - Released on appeal,0,0,0
MANIPUR,2001,Under trials Released - Released on bail,1232,159,1391
MANIPUR,2001,Under trials Released - Transferred to other States,0,0,0
MANIPUR,2001,Under trials Released - Extradited,0,0,0
MANIPUR,2001,Under trials Released - Other releases (transferred to Mental/Civil hospital),38,2,40
MANIPUR,2001,Total Under trials Released,1270,161,1431
MANIPUR,2001,Detenus Released - Released on completion of detention period,47,3,50
MANIPUR,2001,Detenus Released - Released before completion of detention period,6,3,9
MANIPUR,2001,Detenus Released - Released on bail,0,0,0
MANIPUR,2001,Detenus Released - Other releases (temporary transfer etc.),1,0,1
MANIPUR,2001,Total Detenus Released,54,6,60
MANIPUR,2002,Convicts Released - Released after completion of conviction,2,0,2
MANIPUR,2002,Convicts Released - Premature release,0,0,0
MANIPUR,2002,Convicts Released - Released on appeal,1,0,1
MANIPUR,2002,Convicts Released - Released on bail,2,0,2
MANIPUR,2002,Convicts Released - Pardons,0,0,0
MANIPUR,2002,Convicts Released - Transferred to other States,1,0,1
MANIPUR,2002,"Convicts Released - Other Releases (due to illness, transferred to Mental hospital)",0,0,0
MANIPUR,2002,Total Convicts Released,6,0,6
MANIPUR,2002,Under trials Released - Acquitted,2,0,2
MANIPUR,2002,Under trials Released - Released on appeal,0,0,0
MANIPUR,2002,Under trials Released - Released on bail,1118,64,1182
MANIPUR,2002,Under trials Released - Transferred to other States,0,0,0
MANIPUR,2002,Under trials Released - Extradited,0,0,0
MANIPUR,2002,Under trials Released - Other releases (transferred to Mental/Civil hospital),0,0,0
MANIPUR,2002,Total Under trials Released,1120,64,1184
MANIPUR,2002,Detenus Released - Released on completion of detention period,74,11,85
MANIPUR,2002,Detenus Released - Released before completion of detention period,12,1,13
MANIPUR,2002,Detenus Released - Released on bail,0,0,0
MANIPUR,2002,Detenus Released - Other releases (temporary transfer etc.),0,0,0
MANIPUR,2002,Total Detenus Released,86,12,98
MANIPUR,2003,Convicts Released - Released after completion of conviction,11,0,11
MANIPUR,2003,Convicts Released - Premature release,0,0,0
MANIPUR,2003,Convicts Released - Released on appeal,0,0,0
MANIPUR,2003,Convicts Released - Released on bail,0,0,0
MANIPUR,2003,Convicts Released - Pardons,0,0,0
MANIPUR,2003,Convicts Released - Transferred to other States,2,0,2
MANIPUR,2003,"Convicts Released - Other Releases (due to illness, transferred to Mental hospital)",0,0,0
MANIPUR,2003,Total Convicts Released,13,0,13
MANIPUR,2003,Under trials Released - Acquitted,16,0,16
MANIPUR,2003,Under trials Released - Released on appeal,0,0,0
MANIPUR,2003,Under trials Released - Released on bail,1089,73,1162
MANIPUR,2003,Under trials Released - Transferred to other States,0,0,0
MANIPUR,2003,Under trials Released - Extradited,0,0,0
MANIPUR,2003,Under trials Released - Other releases (transferred to Mental/Civil hospital),27,0,27
MANIPUR,2003,Total Under trials Released,1132,73,1205
MANIPUR,2003,Detenus Released - Released on completion of detention period,101,8,109
MANIPUR,2003,Detenus Released - Released before completion of detention period,19,1,20
MANIPUR,2003,Detenus Released - Released on bail,0,0,0
MANIPUR,2003,Detenus Released - Other releases (temporary transfer etc.),3,0,3
MANIPUR,2003,Total Detenus Released,123,9,132
MANIPUR,2004,Convicts Released - Released after completion of conviction,0,0,0
MANIPUR,2004,Convicts Released - Premature release,0,0,0
MANIPUR,2004,Convicts Released - Released on appeal,0,1,1
MANIPUR,2004,Convicts Released - Released on bail,1,0,1
MANIPUR,2004,Convicts Released - Pardons,0,0,0
MANIPUR,2004,Convicts Released - Transferred to other States,0,0,0
MANIPUR,2004,"Convicts Released - Other Releases (due to illness, transferred to Mental hospital)",27,0,27
MANIPUR,2004,Total Convicts Released,28,1,29
MANIPUR,2004,Under trials Released - Acquitted,6,0,6
MANIPUR,2004,Under trials Released - Released on appeal,0,0,0
MANIPUR,2004,Under trials Released - Released on bail,1260,119,1379
MANIPUR,2004,Under trials Released - Transferred to other States,19,0,19
MANIPUR,2004,Under trials Released - Extradited,0,0,0
MANIPUR,2004,Under trials Released - Other releases (transferred to Mental/Civil hospital),13,0,13
MANIPUR,2004,Total Under trials Released,1298,119,1417
MANIPUR,2004,Detenus Released - Released on completion of detention period,144,35,179
MANIPUR,2004,Detenus Released - Released before completion of detention period,14,0,14
MANIPUR,2004,Detenus Released - Released on bail,0,0,0
MANIPUR,2004,Detenus Released - Other releases (temporary transfer etc.),2,0,2
MANIPUR,2004,Total Detenus Released,160,35,195
MANIPUR,2005,Convicts Released - Released after completion of conviction,6,0,6
MANIPUR,2005,Convicts Released - Premature release,0,0,0
MANIPUR,2005,Convicts Released - Released on appeal,0,0,0
MANIPUR,2005,Convicts Released - Released on bail,0,0,0
MANIPUR,2005,Convicts Released - Pardons,0,0,0
MANIPUR,2005,Convicts Released - Transferred to other States,1,0,1
MANIPUR,2005,"Convicts Released - Other Releases (due to illness, transferred to Mental hospital)",1,0,1
MANIPUR,2005,Total Convicts Released,8,0,8
MANIPUR,2005,Under trials Released - Acquitted,4,1,5
MANIPUR,2005,Under trials Released - Released on appeal,0,0,0
MANIPUR,2005,Under trials Released - Released on bail,1256,366,1622
MANIPUR,2005,Under trials Released - Transferred to other States,38,6,44
MANIPUR,2005,Under trials Released - Extradited,17,0,17
MANIPUR,2005,Under trials Released - Other releases (transferred to Mental/Civil hospital),0,0,0
MANIPUR,2005,Total Under trials Released,1315,373,1688
MANIPUR,2005,Detenus Released - Released on completion of detention period,45,0,45
MANIPUR,2005,Detenus Released - Released before completion of detention period,42,3,45
MANIPUR,2005,Detenus Released - Released on bail,0,0,0
MANIPUR,2005,Detenus Released - Other releases (temporary transfer etc.),7,0,7
MANIPUR,2005,Total Detenus Released,94,3,97
MANIPUR,2006,Convicts Released - Released after completion of conviction,8,0,8
MANIPUR,2006,Convicts Released - Premature release,0,0,0
MANIPUR,2006,Convicts Released - Released on appeal,0,0,0
MANIPUR,2006,Convicts Released - Released on bail,0,0,0
MANIPUR,2006,Convicts Released - Pardons,0,0,0
MANIPUR,2006,Convicts Released - Transferred to other States,0,0,0
MANIPUR,2006,"Convicts Released - Other Releases (due to illness, transferred to Mental hospital)",2,0,2
MANIPUR,2006,Total Convicts Released,10,0,10
MANIPUR,2006,Under trials Released - Acquitted,1,0,1
MANIPUR,2006,Under trials Released - Released on appeal,0,0,0
MANIPUR,2006,Under trials Released - Released on bail,1250,88,1338
MANIPUR,2006,Under trials Released - Transferred to other States,0,0,0
MANIPUR,2006,Under trials Released - Extradited,0,0,0
MANIPUR,2006,Under trials Released - Other releases (transferred to Mental/Civil hospital),12,0,12
MANIPUR,2006,Total Under trials Released,1263,88,1351
MANIPUR,2006,Detenus Released - Released on completion of detention period,111,8,119
MANIPUR,2006,Detenus Released - Released before completion of detention period,23,0,23
MANIPUR,2006,Detenus Released - Released on bail,0,0,0
MANIPUR,2006,Detenus Released - Other releases (temporary transfer etc.),1,0,1
MANIPUR,2006,Total Detenus Released,135,8,143
MANIPUR,2007,Convicts Released - Released after completion of conviction,3,0,3
MANIPUR,2007,Convicts Released - Premature release,0,0,0
MANIPUR,2007,Convicts Released - Released on appeal,0,0,0
MANIPUR,2007,Convicts Released - Released on bail,0,0,0
MANIPUR,2007,Convicts Released - Pardons,0,0,0
MANIPUR,2007,Convicts Released - Transferred to other States,3,0,3
MANIPUR,2007,"Convicts Released - Other Releases (due to illness, transferred to Mental hospital)",0,0,0
MANIPUR,2007,Total Convicts Released,6,0,6
MANIPUR,2007,Under trials Released - Acquitted,2,0,2
MANIPUR,2007,Under trials Released - Released on appeal,0,0,0
MANIPUR,2007,Under trials Released - Released on bail,1041,50,1091
MANIPUR,2007,Under trials Released - Transferred to other States,15,0,15
MANIPUR,2007,Under trials Released - Extradited,0,0,0
MANIPUR,2007,Under trials Released - Other releases (transferred to Mental/Civil hospital),11,0,11
MANIPUR,2007,Total Under trials Released,1069,50,1119
MANIPUR,2007,Detenus Released - Released on completion of detention period,19,0,19
MANIPUR,2007,Detenus Released - Released before completion of detention period,43,1,44
MANIPUR,2007,Detenus Released - Released on bail,0,0,0
MANIPUR,2007,Detenus Released - Other releases (temporary transfer etc.),11,0,11
MANIPUR,2007,Total Detenus Released,73,1,74
MANIPUR,2008,Convicts Released - Released after completion of conviction,39,0,39
MANIPUR,2008,Convicts Released - Premature release,0,0,0
MANIPUR,2008,Convicts Released - Released on appeal,0,0,0
MANIPUR,2008,Convicts Released - Released on bail,0,0,0
MANIPUR,2008,Convicts Released - Pardons,0,0,0
MANIPUR,2008,Convicts Released - Transferred to other States,1,0,1
MANIPUR,2008,"Convicts Released - Other Releases (due to illness, transferred to Mental hospital)",0,0,0
MANIPUR,2008,Total Convicts Released,40,0,40
MANIPUR,2008,Under trials Released - Acquitted,1,0,1
MANIPUR,2008,Under trials Released - Released on appeal,0,0,0
MANIPUR,2008,Under trials Released - Released on bail,1124,64,1188
MANIPUR,2008,Under trials Released - Transferred to other States,7,0,7
MANIPUR,2008,Under trials Released - Extradited,0,0,0
MANIPUR,2008,Under trials Released - Other releases (transferred to Mental/Civil hospital),16,0,16
MANIPUR,2008,Total Under trials Released,1148,64,1212
MANIPUR,2008,Detenus Released - Released on completion of detention period,155,7,162
MANIPUR,2008,Detenus Released - Released before completion of detention period,12,0,12
MANIPUR,2008,Detenus Released - Released on bail,0,0,0
MANIPUR,2008,Detenus Released - Other releases (temporary transfer etc.),15,0,15
MANIPUR,2008,Total Detenus Released,182,7,189
MANIPUR,2009,Convicts Released - Released after completion of conviction,41,0,41
MANIPUR,2009,Convicts Released - Premature release,0,0,0
MANIPUR,2009,Convicts Released - Released on appeal,0,0,0
MANIPUR,2009,Convicts Released - Released on bail,0,0,0
MANIPUR,2009,Convicts Released - Pardons,0,0,0
MANIPUR,2009,Convicts Released - Transferred to other States,7,0,7
MANIPUR,2009,"Convicts Released - Other Releases (due to illness, transferred to Mental hospital)",0,0,0
MANIPUR,2009,Total Convicts Released,48,0,48
MANIPUR,2009,Under trials Released - Acquitted,0,0,0
MANIPUR,2009,Under trials Released - Released on appeal,0,0,0
MANIPUR,2009,Under trials Released - Released on bail,1067,140,1207
MANIPUR,2009,Under trials Released - Transferred to other States,18,0,18
MANIPUR,2009,Under trials Released - Extradited,0,0,0
MANIPUR,2009,Under trials Released - Other releases (transferred to Mental/Civil hospital),6,0,6
MANIPUR,2009,Total Under trials Released,1091,140,1231
MANIPUR,2009,Detenus Released - Released on completion of detention period,161,31,192
MANIPUR,2009,Detenus Released - Released before completion of detention period,3,12,15
MANIPUR,2009,Detenus Released - Released on bail,0,0,0
MANIPUR,2009,Detenus Released - Other releases (temporary transfer etc.),30,0,30
MANIPUR,2009,Total Detenus Released,194,43,237
MANIPUR,2010,Convicts Released - Released after completion of conviction,42,5,47
MANIPUR,2010,Convicts Released - Premature release,0,0,0
MANIPUR,2010,Convicts Released - Released on appeal,0,0,0
MANIPUR,2010,Convicts Released - Released on bail,0,0,0
MANIPUR,2010,Convicts Released - Pardons,0,0,0
MANIPUR,2010,Convicts Released - Transferred to other States,0,0,0
MANIPUR,2010,"Convicts Released - Other Releases (due to illness, transferred to Mental hospital)",0,0,0
MANIPUR,2010,Total Convicts Released,42,5,47
MANIPUR,2010,Under trials Released - Acquitted,1,0,1
MANIPUR,2010,Under trials Released - Released on appeal,0,0,0
MANIPUR,2010,Under trials Released - Released on bail,1118,123,1241
MANIPUR,2010,Under trials Released - Transferred to other States,0,1,1
MANIPUR,2010,Under trials Released - Extradited,0,0,0
MANIPUR,2010,Under trials Released - Other releases (transferred to Mental/Civil hospital),0,10,10
MANIPUR,2010,Total Under trials Released,1119,134,1253
MANIPUR,2010,Detenus Released - Released on completion of detention period,170,10,180
MANIPUR,2010,Detenus Released - Released before completion of detention period,0,13,13
MANIPUR,2010,Detenus Released - Released on bail,0,1,1
MANIPUR,2010,Detenus Released - Other releases (temporary transfer etc.),0,0,0
MANIPUR,2010,Total Detenus Released,170,24,194
MANIPUR,2011,Convicts Released - Released after completion of conviction,30,0,30
MANIPUR,2011,Convicts Released - Premature release,0,0,0
MANIPUR,2011,Convicts Released - Released on appeal,0,0,0
MANIPUR,2011,Convicts Released - Released on bail,0,0,0
MANIPUR,2011,Convicts Released - Pardons,0,0,0
MANIPUR,2011,Convicts Released - Transferred to other States,0,0,0
MANIPUR,2011,"Convicts Released - Other Releases (due to illness, transferred to Mental hospital)",0,0,0
MANIPUR,2011,Total Convicts Released,30,0,30
MANIPUR,2011,Under trials Released - Acquitted,30,0,30
MANIPUR,2011,Under trials Released - Released on appeal,0,0,0
MANIPUR,2011,Under trials Released - Released on bail,1490,193,1683
MANIPUR,2011,Under trials Released - Transferred to other States,0,0,0
MANIPUR,2011,Under trials Released - Extradited,0,0,0
MANIPUR,2011,Under trials Released - Other releases (transferred to Mental/Civil hospital),0,9,9
MANIPUR,2011,Total Under trials Released,1520,202,1722
MANIPUR,2011,Detenus Released - Released on completion of detention period,249,28,277
MANIPUR,2011,Detenus Released - Released before completion of detention period,0,12,12
MANIPUR,2011,Detenus Released - Released on bail,0,0,0
MANIPUR,2011,Detenus Released - Other releases (temporary transfer etc.),0,0,0
MANIPUR,2011,Total Detenus Released,249,40,289
MANIPUR,2012,Convicts Released - Released after completion of conviction,42,0,42
MANIPUR,2012,Convicts Released - Premature release,2,0,2
MANIPUR,2012,Convicts Released - Released on appeal,0,0,0
MANIPUR,2012,Convicts Released - Released on bail,0,0,0
MANIPUR,2012,Convicts Released - Pardons,0,0,0
MANIPUR,2012,Convicts Released - Transferred to other States,0,0,0
MANIPUR,2012,"Convicts Released - Other Releases (due to illness, transferred to Mental hospital)",22,0,22
MANIPUR,2012,Total Convicts Released,66,0,66
MANIPUR,2012,Under trials Released - Acquitted,74,2,76
MANIPUR,2012,Under trials Released - Released on appeal,0,0,0
MANIPUR,2012,Under trials Released - Released on bail,1501,110,1611
MANIPUR,2012,Under trials Released - Transferred to other States,24,0,24
MANIPUR,2012,Under trials Released - Extradited,0,0,0
MANIPUR,2012,Under trials Released - Other releases (transferred to Mental/Civil hospital),0,6,6
MANIPUR,2012,Total Under trials Released,1599,118,1717
MANIPUR,2012,Detenus Released - Released on completion of detention period,105,8,113
MANIPUR,2012,Detenus Released - Released before completion of detention period,109,13,122
MANIPUR,2012,Detenus Released - Released on bail,0,0,0
MANIPUR,2012,Detenus Released - Other releases (temporary transfer etc.),0,0,0
MANIPUR,2012,Total Detenus Released,214,21,235
MEGHALAYA,2001,Convicts Released - Released after completion of conviction,47,2,49
MEGHALAYA,2001,Convicts Released - Premature release,0,0,0
MEGHALAYA,2001,Convicts Released - Released on appeal,0,0,0
MEGHALAYA,2001,Convicts Released - Released on bail,0,0,0
MEGHALAYA,2001,Convicts Released - Pardons,0,0,0
MEGHALAYA,2001,Convicts Released - Transferred to other States,0,0,0
MEGHALAYA,2001,"Convicts Released - Other Releases (due to illness, transferred to Mental hospital)",0,0,0
MEGHALAYA,2001,Total Convicts Released,47,2,49
MEGHALAYA,2001,Under trials Released - Acquitted,58,1,59
MEGHALAYA,2001,Under trials Released - Released on appeal,0,0,0
MEGHALAYA,2001,Under trials Released - Released on bail,772,19,791
MEGHALAYA,2001,Under trials Released - Transferred to other States,1,0,1
MEGHALAYA,2001,Under trials Released - Extradited,0,0,0
MEGHALAYA,2001,Under trials Released - Other releases (transferred to Mental/Civil hospital),6,0,6
MEGHALAYA,2001,Total Under trials Released,837,20,857
MEGHALAYA,2001,Detenus Released - Released on completion of detention period,2,0,2
MEGHALAYA,2001,Detenus Released - Released before completion of detention period,1,0,1
MEGHALAYA,2001,Detenus Released - Released on bail,1,0,1
MEGHALAYA,2001,Detenus Released - Other releases (temporary transfer etc.),0,0,0
MEGHALAYA,2001,Total Detenus Released,4,0,4
MEGHALAYA,2002,Convicts Released - Released after completion of conviction,75,0,75
MEGHALAYA,2002,Convicts Released - Premature release,0,0,0
MEGHALAYA,2002,Convicts Released - Released on appeal,0,0,0
MEGHALAYA,2002,Convicts Released - Released on bail,0,0,0
MEGHALAYA,2002,Convicts Released - Pardons,0,0,0
MEGHALAYA,2002,Convicts Released - Transferred to other States,0,0,0
MEGHALAYA,2002,"Convicts Released - Other Releases (due to illness, transferred to Mental hospital)",0,0,0
MEGHALAYA,2002,Total Convicts Released,75,0,75
MEGHALAYA,2002,Under trials Released - Acquitted,65,4,69
MEGHALAYA,2002,Under trials Released - Released on appeal,0,0,0
MEGHALAYA,2002,Under trials Released - Released on bail,2449,36,2485
MEGHALAYA,2002,Under trials Released - Transferred to other States,36,0,36
MEGHALAYA,2002,Under trials Released - Extradited,0,0,0
MEGHALAYA,2002,Under trials Released - Other releases (transferred to Mental/Civil hospital),0,0,0
MEGHALAYA,2002,Total Under trials Released,2550,40,2590
MEGHALAYA,2002,Detenus Released - Released on completion of detention period,3,0,3
MEGHALAYA,2002,Detenus Released - Released before completion of detention period,5,0,5
MEGHALAYA,2002,Detenus Released - Released on bail,0,0,0
MEGHALAYA,2002,Detenus Released - Other releases (temporary transfer etc.),0,0,0
MEGHALAYA,2002,Total Detenus Released,8,0,8
MEGHALAYA,2003,Convicts Released - Released after completion of conviction,63,2,65
MEGHALAYA,2003,Convicts Released - Premature release,0,0,0
MEGHALAYA,2003,Convicts Released - Released on appeal,0,0,0
MEGHALAYA,2003,Convicts Released - Released on bail,2,0,2
MEGHALAYA,2003,Convicts Released - Pardons,0,0,0
MEGHALAYA,2003,Convicts Released - Transferred to other States,0,0,0
MEGHALAYA,2003,"Convicts Released - Other Releases (due to illness, transferred to Mental hospital)",0,0,0
MEGHALAYA,2003,Total Convicts Released,65,2,67
MEGHALAYA,2003,Under trials Released - Acquitted,72,0,72
MEGHALAYA,2003,Under trials Released - Released on appeal,0,0,0
MEGHALAYA,2003,Under trials Released - Released on bail,1154,2,1156
MEGHALAYA,2003,Under trials Released - Transferred to other States,6,0,6
MEGHALAYA,2003,Under trials Released - Extradited,0,0,0
MEGHALAYA,2003,Under trials Released - Other releases (transferred to Mental/Civil hospital),0,0,0
MEGHALAYA,2003,Total Under trials Released,1232,2,1234
MEGHALAYA,2003,Detenus Released - Released on completion of detention period,1,0,1
MEGHALAYA,2003,Detenus Released - Released before completion of detention period,3,0,3
MEGHALAYA,2003,Detenus Released - Released on bail,6,0,6
MEGHALAYA,2003,Detenus Released - Other releases (temporary transfer etc.),0,0,0
MEGHALAYA,2003,Total Detenus Released,10,0,10
MEGHALAYA,2004,Convicts Released - Released after completion of conviction,61,0,61
MEGHALAYA,2004,Convicts Released - Premature release,0,0,0
MEGHALAYA,2004,Convicts Released - Released on appeal,0,0,0
MEGHALAYA,2004,Convicts Released - Released on bail,0,0,0
MEGHALAYA,2004,Convicts Released - Pardons,0,0,0
MEGHALAYA,2004,Convicts Released - Transferred to other States,0,0,0
MEGHALAYA,2004,"Convicts Released - Other Releases (due to illness, transferred to Mental hospital)",0,0,0
MEGHALAYA,2004,Total Convicts Released,61,0,61
MEGHALAYA,2004,Under trials Released - Acquitted,76,2,78
MEGHALAYA,2004,Under trials Released - Released on appeal,0,0,0
MEGHALAYA,2004,Under trials Released - Released on bail,1225,18,1243
MEGHALAYA,2004,Under trials Released - Transferred to other States,10,0,10
MEGHALAYA,2004,Under trials Released - Extradited,0,0,0
MEGHALAYA,2004,Under trials Released - Other releases (transferred to Mental/Civil hospital),6,0,6
MEGHALAYA,2004,Total Under trials Released,1317,20,1337
MEGHALAYA,2004,Detenus Released - Released on completion of detention period,0,0,0
MEGHALAYA,2004,Detenus Released - Released before completion of detention period,0,0,0
MEGHALAYA,2004,Detenus Released - Released on bail,0,0,0
MEGHALAYA,2004,Detenus Released - Other releases (temporary transfer etc.),5,0,5
MEGHALAYA,2004,Total Detenus Released,5,0,5
MEGHALAYA,2005,Convicts Released - Released after completion of conviction,54,0,54
MEGHALAYA,2005,Convicts Released - Premature release,0,0,0
MEGHALAYA,2005,Convicts Released - Released on appeal,0,0,0
MEGHALAYA,2005,Convicts Released - Released on bail,1,0,1
MEGHALAYA,2005,Convicts Released - Pardons,0,0,0
MEGHALAYA,2005,Convicts Released - Transferred to other States,0,0,0
MEGHALAYA,2005,"Convicts Released - Other Releases (due to illness, transferred to Mental hospital)",0,0,0
MEGHALAYA,2005,Total Convicts Released,55,0,55
MEGHALAYA,2005,Under trials Released - Acquitted,0,0,0
MEGHALAYA,2005,Under trials Released - Released on appeal,682,0,682
MEGHALAYA,2005,Under trials Released - Released on bail,407,3,410
MEGHALAYA,2005,Under trials Released - Transferred to other States,0,0,0
MEGHALAYA,2005,Under trials Released - Extradited,0,0,0
MEGHALAYA,2005,Under trials Released - Other releases (transferred to Mental/Civil hospital),0,0,0
MEGHALAYA,2005,Total Under trials Released,1089,3,1092
MEGHALAYA,2005,Detenus Released - Released on completion of detention period,3,0,3
MEGHALAYA,2005,Detenus Released - Released before completion of detention period,0,0,0
MEGHALAYA,2005,Detenus Released - Released on bail,0,0,0
MEGHALAYA,2005,Detenus Released - Other releases (temporary transfer etc.),1,0,1
MEGHALAYA,2005,Total Detenus Released,4,0,4
MEGHALAYA,2006,Convicts Released - Released after completion of conviction,125,7,132
MEGHALAYA,2006,Convicts Released - Premature release,3,4,7
MEGHALAYA,2006,Convicts Released - Released on appeal,4,1,5
MEGHALAYA,2006,Convicts Released - Released on bail,0,0,0
MEGHALAYA,2006,Convicts Released - Pardons,0,0,0
MEGHALAYA,2006,Convicts Released - Transferred to other States,0,0,0
MEGHALAYA,2006,"Convicts Released - Other Releases (due to illness, transferred to Mental hospital)",0,0,0
MEGHALAYA,2006,Total Convicts Released,132,12,144
MEGHALAYA,2006,Under trials Released - Acquitted,82,6,88
MEGHALAYA,2006,Under trials Released - Released on appeal,4,0,4
MEGHALAYA,2006,Under trials Released - Released on bail,1418,18,1436
MEGHALAYA,2006,Under trials Released - Transferred to other States,4,0,4
MEGHALAYA,2006,Under trials Released - Extradited,0,0,0
MEGHALAYA,2006,Under trials Released - Other releases (transferred to Mental/Civil hospital),6,0,6
MEGHALAYA,2006,Total Under trials Released,1514,24,1538
MEGHALAYA,2006,Detenus Released - Released on completion of detention period,4,0,4
MEGHALAYA,2006,Detenus Released - Released before completion of detention period,0,0,0
MEGHALAYA,2006,Detenus Released - Released on bail,1,0,1
MEGHALAYA,2006,Detenus Released - Other releases (temporary transfer etc.),5,0,5
MEGHALAYA,2006,Total Detenus Released,10,0,10
MEGHALAYA,2007,Convicts Released - Released after completion of conviction,77,0,77
MEGHALAYA,2007,Convicts Released - Premature release,0,0,0
MEGHALAYA,2007,Convicts Released - Released on appeal,2054,0,2054
MEGHALAYA,2007,Convicts Released - Released on bail,0,0,0
MEGHALAYA,2007,Convicts Released - Pardons,0,0,0
MEGHALAYA,2007,Convicts Released - Transferred to other States,0,0,0
MEGHALAYA,2007,"Convicts Released - Other Releases (due to illness, transferred to Mental hospital)",40,0,40
MEGHALAYA,2007,Total Convicts Released,2171,0,2171
MEGHALAYA,2007,Under trials Released - Acquitted,92,10,102
MEGHALAYA,2007,Under trials Released - Released on appeal,11,0,11
MEGHALAYA,2007,Under trials Released - Released on bail,1516,0,1516
MEGHALAYA,2007,Under trials Released - Transferred to other States,13,0,13
MEGHALAYA,2007,Under trials Released - Extradited,0,0,0
MEGHALAYA,2007,Under trials Released - Other releases (transferred to Mental/Civil hospital),0,0,0
MEGHALAYA,2007,Total Under trials Released,1632,10,1642
MEGHALAYA,2007,Detenus Released - Released on completion of detention period,1,0,1
MEGHALAYA,2007,Detenus Released - Released before completion of detention period,4,0,4
MEGHALAYA,2007,Detenus Released - Released on bail,0,0,0
MEGHALAYA,2007,Detenus Released - Other releases (temporary transfer etc.),0,0,0
MEGHALAYA,2007,Total Detenus Released,5,0,5
MEGHALAYA,2008,Convicts Released - Released after completion of conviction,62,0,62
MEGHALAYA,2008,Convicts Released - Premature release,1,0,1
MEGHALAYA,2008,Convicts Released - Released on appeal,0,0,0
MEGHALAYA,2008,Convicts Released - Released on bail,3,0,3
MEGHALAYA,2008,Convicts Released - Pardons,0,0,0
MEGHALAYA,2008,Convicts Released - Transferred to other States,0,0,0
MEGHALAYA,2008,"Convicts Released - Other Releases (due to illness, transferred to Mental hospital)",0,0,0
MEGHALAYA,2008,Total Convicts Released,66,0,66
MEGHALAYA,2008,Under trials Released - Acquitted,112,12,124
MEGHALAYA,2008,Under trials Released - Released on appeal,0,0,0
MEGHALAYA,2008,Under trials Released - Released on bail,1995,30,2025
MEGHALAYA,2008,Under trials Released - Transferred to other States,11,0,11
MEGHALAYA,2008,Under trials Released - Extradited,3,0,3
MEGHALAYA,2008,Under trials Released - Other releases (transferred to Mental/Civil hospital),4,0,4
MEGHALAYA,2008,Total Under trials Released,2125,42,2167
MEGHALAYA,2008,Detenus Released - Released on completion of detention period,2,0,2
MEGHALAYA,2008,Detenus Released - Released before completion of detention period,7,0,7
MEGHALAYA,2008,Detenus Released - Released on bail,0,0,0
MEGHALAYA,2008,Detenus Released - Other releases (temporary transfer etc.),4,0,4
MEGHALAYA,2008,Total Detenus Released,13,0,13
MEGHALAYA,2009,Convicts Released - Released after completion of conviction,108,1,109
MEGHALAYA,2009,Convicts Released - Premature release,0,0,0
MEGHALAYA,2009,Convicts Released - Released on appeal,0,0,0
MEGHALAYA,2009,Convicts Released - Released on bail,0,0,0
MEGHALAYA,2009,Convicts Released - Pardons,0,0,0
MEGHALAYA,2009,Convicts Released - Transferred to other States,0,0,0
MEGHALAYA,2009,"Convicts Released - Other Releases (due to illness, transferred to Mental hospital)",0,0,0
MEGHALAYA,2009,Total Convicts Released,108,1,109
MEGHALAYA,2009,Under trials Released - Acquitted,68,4,72
MEGHALAYA,2009,Under trials Released - Released on appeal,18,0,18
MEGHALAYA,2009,Under trials Released - Released on bail,624,45,669
MEGHALAYA,2009,Under trials Released - Transferred to other States,10,0,10
MEGHALAYA,2009,Under trials Released - Extradited,0,0,0
MEGHALAYA,2009,Under trials Released - Other releases (transferred to Mental/Civil hospital),0,0,0
MEGHALAYA,2009,Total Under trials Released,720,49,769
MEGHALAYA,2009,Detenus Released - Released on completion of detention period,10,0,10
MEGHALAYA,2009,Detenus Released - Released before completion of detention period,2,0,2
MEGHALAYA,2009,Detenus Released - Released on bail,2,0,2
MEGHALAYA,2009,Detenus Released - Other releases (temporary transfer etc.),0,0,0
MEGHALAYA,2009,Total Detenus Released,14,0,14
MEGHALAYA,2010,Convicts Released - Released after completion of conviction,54,0,54
MEGHALAYA,2010,Convicts Released - Premature release,0,0,0
MEGHALAYA,2010,Convicts Released - Released on appeal,9,2,11
MEGHALAYA,2010,Convicts Released - Released on bail,0,0,0
MEGHALAYA,2010,Convicts Released - Pardons,0,0,0
MEGHALAYA,2010,Convicts Released - Transferred to other States,0,0,0
MEGHALAYA,2010,"Convicts Released - Other Releases (due to illness, transferred to Mental hospital)",0,0,0
MEGHALAYA,2010,Total Convicts Released,63,2,65
MEGHALAYA,2010,Under trials Released - Acquitted,69,0,69
MEGHALAYA,2010,Under trials Released - Released on appeal,36,0,36
MEGHALAYA,2010,Under trials Released - Released on bail,1099,19,1118
MEGHALAYA,2010,Under trials Released - Transferred to other States,0,0,0
MEGHALAYA,2010,Under trials Released - Extradited,5,0,5
MEGHALAYA,2010,Under trials Released - Other releases (transferred to Mental/Civil hospital),0,0,0
MEGHALAYA,2010,Total Under trials Released,1209,19,1228
MEGHALAYA,2010,Detenus Released - Released on completion of detention period,3,0,3
MEGHALAYA,2010,Detenus Released - Released before completion of detention period,0,0,0
MEGHALAYA,2010,Detenus Released - Released on bail,0,0,0
MEGHALAYA,2010,Detenus Released - Other releases (temporary transfer etc.),0,0,0
MEGHALAYA,2010,Total Detenus Released,3,0,3
MEGHALAYA,2011,Convicts Released - Released after completion of conviction,19,0,19
MEGHALAYA,2011,Convicts Released - Premature release,0,0,0
MEGHALAYA,2011,Convicts Released - Released on appeal,0,0,0
MEGHALAYA,2011,Convicts Released - Released on bail,1,0,1
MEGHALAYA,2011,Convicts Released - Pardons,0,0,0
MEGHALAYA,2011,Convicts Released - Transferred to other States,0,0,0
MEGHALAYA,2011,"Convicts Released - Other Releases (due to illness, transferred to Mental hospital)",2,0,2
MEGHALAYA,2011,Total Convicts Released,22,0,22
MEGHALAYA,2011,Under trials Released - Acquitted,9,0,9
MEGHALAYA,2011,Under trials Released - Released on appeal,80,0,80
MEGHALAYA,2011,Under trials Released - Released on bail,1082,29,1111
MEGHALAYA,2011,Under trials Released - Transferred to other States,7,0,7
MEGHALAYA,2011,Under trials Released - Extradited,0,0,0
MEGHALAYA,2011,Under trials Released - Other releases (transferred to Mental/Civil hospital),40,0,40
MEGHALAYA,2011,Total Under trials Released,1218,29,1247
MEGHALAYA,2011,Detenus Released - Released on completion of detention period,0,0,0
MEGHALAYA,2011,Detenus Released - Released before completion of detention period,0,0,0
MEGHALAYA,2011,Detenus Released - Released on bail,3,0,3
MEGHALAYA,2011,Detenus Released - Other releases (temporary transfer etc.),0,0,0
MEGHALAYA,2011,Total Detenus Released,3,0,3
MEGHALAYA,2012,Convicts Released - Released after completion of conviction,51,0,51
MEGHALAYA,2012,Convicts Released - Premature release,0,0,0
MEGHALAYA,2012,Convicts Released - Released on appeal,0,0,0
MEGHALAYA,2012,Convicts Released - Released on bail,0,0,0
MEGHALAYA,2012,Convicts Released - Pardons,0,0,0
MEGHALAYA,2012,Convicts Released - Transferred to other States,0,0,0
MEGHALAYA,2012,"Convicts Released - Other Releases (due to illness, transferred to Mental hospital)",0,0,0
MEGHALAYA,2012,Total Convicts Released,51,0,51
MEGHALAYA,2012,Under trials Released - Acquitted,4,0,4
MEGHALAYA,2012,Under trials Released - Released on appeal,69,0,69
MEGHALAYA,2012,Under trials Released - Released on bail,1357,20,1377
MEGHALAYA,2012,Under trials Released - Transferred to other States,11,0,11
MEGHALAYA,2012,Under trials Released - Extradited,0,0,0
MEGHALAYA,2012,Under trials Released - Other releases (transferred to Mental/Civil hospital),1,0,1
MEGHALAYA,2012,Total Under trials Released,1442,20,1462
MEGHALAYA,2012,Detenus Released - Released on completion of detention period,0,0,0
MEGHALAYA,2012,Detenus Released - Released before completion of detention period,1,0,1
MEGHALAYA,2012,Detenus Released - Released on bail,3,0,3
MEGHALAYA,2012,Detenus Released - Other releases (temporary transfer etc.),1,0,1
MEGHALAYA,2012,Total Detenus Released,5,0,5
MIZORAM,2001,Convicts Released - Released after completion of conviction,2417,489,2906
MIZORAM,2001,Convicts Released - Premature release,31,7,38
MIZORAM,2001,Convicts Released - Released on appeal,10,2,12
MIZORAM,2001,Convicts Released - Released on bail,66,19,85
MIZORAM,2001,Convicts Released - Pardons,0,0,0
MIZORAM,2001,Convicts Released - Transferred to other States,2,0,2
MIZORAM,2001,"Convicts Released - Other Releases (due to illness, transferred to Mental hospital)",0,0,0
MIZORAM,2001,Total Convicts Released,2526,517,3043
MIZORAM,2001,Under trials Released - Acquitted,94,11,105
MIZORAM,2001,Under trials Released - Released on appeal,0,0,0
MIZORAM,2001,Under trials Released - Released on bail,2383,800,3183
MIZORAM,2001,Under trials Released - Transferred to other States,0,0,0
MIZORAM,2001,Under trials Released - Extradited,0,0,0
MIZORAM,2001,Under trials Released - Other releases (transferred to Mental/Civil hospital),0,0,0
MIZORAM,2001,Total Under trials Released,2477,811,3288
MIZORAM,2001,Detenus Released - Released on completion of detention period,0,0,0
MIZORAM,2001,Detenus Released - Released before completion of detention period,0,0,0
MIZORAM,2001,Detenus Released - Released on bail,0,0,0
MIZORAM,2001,Detenus Released - Other releases (temporary transfer etc.),0,0,0
MIZORAM,2001,Total Detenus Released,0,0,0
MIZORAM,2002,Convicts Released - Released after completion of conviction,3259,460,3719
MIZORAM,2002,Convicts Released - Premature release,2,0,2
MIZORAM,2002,Convicts Released - Released on appeal,63,21,84
MIZORAM,2002,Convicts Released - Released on bail,141,21,162
MIZORAM,2002,Convicts Released - Pardons,0,0,0
MIZORAM,2002,Convicts Released - Transferred to other States,0,0,0
MIZORAM,2002,"Convicts Released - Other Releases (due to illness, transferred to Mental hospital)",0,0,0
MIZORAM,2002,Total Convicts Released,3465,502,3967
MIZORAM,2002,Under trials Released - Acquitted,18,5,23
MIZORAM,2002,Under trials Released - Released on appeal,8,2,10
MIZORAM,2002,Under trials Released - Released on bail,150,20,170
MIZORAM,2002,Under trials Released - Transferred to other States,0,0,0
MIZORAM,2002,Under trials Released - Extradited,0,0,0
MIZORAM,2002,Under trials Released - Other releases (transferred to Mental/Civil hospital),0,0,0
MIZORAM,2002,Total Under trials Released,176,27,203
MIZORAM,2002,Detenus Released - Released on completion of detention period,0,0,0
MIZORAM,2002,Detenus Released - Released before completion of detention period,0,0,0
MIZORAM,2002,Detenus Released - Released on bail,0,0,0
MIZORAM,2002,Detenus Released - Other releases (temporary transfer etc.),0,0,0
MIZORAM,2002,Total Detenus Released,0,0,0
MIZORAM,2003,Convicts Released - Released after completion of conviction,3206,483,3689
MIZORAM,2003,Convicts Released - Premature release,0,0,0
MIZORAM,2003,Convicts Released - Released on appeal,253,57,310
MIZORAM,2003,Convicts Released - Released on bail,40,12,52
MIZORAM,2003,Convicts Released - Pardons,0,0,0
MIZORAM,2003,Convicts Released - Transferred to other States,0,0,0
MIZORAM,2003,"Convicts Released - Other Releases (due to illness, transferred to Mental hospital)",0,0,0
MIZORAM,2003,Total Convicts Released,3499,552,4051
MIZORAM,2003,Under trials Released - Acquitted,249,41,290
MIZORAM,2003,Under trials Released - Released on appeal,5,0,5
MIZORAM,2003,Under trials Released - Released on bail,2752,537,3289
MIZORAM,2003,Under trials Released - Transferred to other States,0,0,0
MIZORAM,2003,Under trials Released - Extradited,0,0,0
MIZORAM,2003,Under trials Released - Other releases (transferred to Mental/Civil hospital),3,0,3
MIZORAM,2003,Total Under trials Released,3009,578,3587
MIZORAM,2003,Detenus Released - Released on completion of detention period,0,0,0
MIZORAM,2003,Detenus Released - Released before completion of detention period,0,0,0
MIZORAM,2003,Detenus Released - Released on bail,0,0,0
MIZORAM,2003,Detenus Released - Other releases (temporary transfer etc.),0,0,0
MIZORAM,2003,Total Detenus Released,0,0,0
MIZORAM,2004,Convicts Released - Released after completion of conviction,3338,510,3848
MIZORAM,2004,Convicts Released - Premature release,0,0,0
MIZORAM,2004,Convicts Released - Released on appeal,277,67,344
MIZORAM,2004,Convicts Released - Released on bail,0,0,0
MIZORAM,2004,Convicts Released - Pardons,0,0,0
MIZORAM,2004,Convicts Released - Transferred to other States,1,0,1
MIZORAM,2004,"Convicts Released - Other Releases (due to illness, transferred to Mental hospital)",0,0,0
MIZORAM,2004,Total Convicts Released,3616,577,4193
MIZORAM,2004,Under trials Released - Acquitted,195,41,236
MIZORAM,2004,Under trials Released - Released on appeal,0,0,0
MIZORAM,2004,Under trials Released - Released on bail,3206,850,4056
MIZORAM,2004,Under trials Released - Transferred to other States,0,0,0
MIZORAM,2004,Under trials Released - Extradited,0,0,0
MIZORAM,2004,Under trials Released - Other releases (transferred to Mental/Civil hospital),0,0,0
MIZORAM,2004,Total Under trials Released,3401,891,4292
MIZORAM,2004,Detenus Released - Released on completion of detention period,0,0,0
MIZORAM,2004,Detenus Released - Released before completion of detention period,0,0,0
MIZORAM,2004,Detenus Released - Released on bail,0,0,0
MIZORAM,2004,Detenus Released - Other releases (temporary transfer etc.),0,0,0
MIZORAM,2004,Total Detenus Released,0,0,0
MIZORAM,2005,Convicts Released - Released after completion of conviction,3125,559,3684
MIZORAM,2005,Convicts Released - Premature release,0,0,0
MIZORAM,2005,Convicts Released - Released on appeal,66,28,94
MIZORAM,2005,Convicts Released - Released on bail,45,4,49
MIZORAM,2005,Convicts Released - Pardons,0,0,0
MIZORAM,2005,Convicts Released - Transferred to other States,0,0,0
MIZORAM,2005,"Convicts Released - Other Releases (due to illness, transferred to Mental hospital)",0,0,0
MIZORAM,2005,Total Convicts Released,3236,591,3827
MIZORAM,2005,Under trials Released - Acquitted,307,53,360
MIZORAM,2005,Under trials Released - Released on appeal,302,134,436
MIZORAM,2005,Under trials Released - Released on bail,482,146,628
MIZORAM,2005,Under trials Released - Transferred to other States,0,0,0
MIZORAM,2005,Under trials Released - Extradited,0,0,0
MIZORAM,2005,Under trials Released - Other releases (transferred to Mental/Civil hospital),0,0,0
MIZORAM,2005,Total Under trials Released,1091,333,1424
MIZORAM,2005,Detenus Released - Released on completion of detention period,0,0,0
MIZORAM,2005,Detenus Released - Released before completion of detention period,0,0,0
MIZORAM,2005,Detenus Released - Released on bail,0,0,0
MIZORAM,2005,Detenus Released - Other releases (temporary transfer etc.),0,0,0
MIZORAM,2005,Total Detenus Released,0,0,0
MIZORAM,2006,Convicts Released - Released after completion of conviction,2732,566,3298
MIZORAM,2006,Convicts Released - Premature release,63,13,76
MIZORAM,2006,Convicts Released - Released on appeal,35,10,45
MIZORAM,2006,Convicts Released - Released on bail,0,0,0
MIZORAM,2006,Convicts Released - Pardons,0,0,0
MIZORAM,2006,Convicts Released - Transferred to other States,2,0,2
MIZORAM,2006,"Convicts Released - Other Releases (due to illness, transferred to Mental hospital)",0,0,0
MIZORAM,2006,Total Convicts Released,2832,589,3421
MIZORAM,2006,Under trials Released - Acquitted,202,19,221
MIZORAM,2006,Under trials Released - Released on appeal,7,0,7
MIZORAM,2006,Under trials Released - Released on bail,1878,762,2640
MIZORAM,2006,Under trials Released - Transferred to other States,3,0,3
MIZORAM,2006,Under trials Released - Extradited,0,0,0
MIZORAM,2006,Under trials Released - Other releases (transferred to Mental/Civil hospital),0,0,0
MIZORAM,2006,Total Under trials Released,2090,781,2871
MIZORAM,2006,Detenus Released - Released on completion of detention period,0,0,0
MIZORAM,2006,Detenus Released - Released before completion of detention period,0,0,0
MIZORAM,2006,Detenus Released - Released on bail,0,0,0
MIZORAM,2006,Detenus Released - Other releases (temporary transfer etc.),0,0,0
MIZORAM,2006,Total Detenus Released,0,0,0
MIZORAM,2007,Convicts Released - Released after completion of conviction,2596,399,2995
MIZORAM,2007,Convicts Released - Premature release,27,4,31
MIZORAM,2007,Convicts Released - Released on appeal,125,41,166
MIZORAM,2007,Convicts Released - Released on bail,11,1,12
MIZORAM,2007,Convicts Released - Pardons,15,0,15
MIZORAM,2007,Convicts Released - Transferred to other States,3,0,3
MIZORAM,2007,"Convicts Released - Other Releases (due to illness, transferred to Mental hospital)",16,2,18
MIZORAM,2007,Total Convicts Released,2793,447,3240
MIZORAM,2007,Under trials Released - Acquitted,89,8,97
MIZORAM,2007,Under trials Released - Released on appeal,15,9,24
MIZORAM,2007,Under trials Released - Released on bail,1985,677,2662
MIZORAM,2007,Under trials Released - Transferred to other States,4,1,5
MIZORAM,2007,Under trials Released - Extradited,30,0,30
MIZORAM,2007,Under trials Released - Other releases (transferred to Mental/Civil hospital),20,10,30
MIZORAM,2007,Total Under trials Released,2143,705,2848
MIZORAM,2007,Detenus Released - Released on completion of detention period,0,0,0
MIZORAM,2007,Detenus Released - Released before completion of detention period,0,0,0
MIZORAM,2007,Detenus Released - Released on bail,0,0,0
MIZORAM,2007,Detenus Released - Other releases (temporary transfer etc.),0,0,0
MIZORAM,2007,Total Detenus Released,0,0,0
MIZORAM,2008,Convicts Released - Released after completion of conviction,2533,408,2941
MIZORAM,2008,Convicts Released - Premature release,9,2,11
MIZORAM,2008,Convicts Released - Released on appeal,146,23,169
MIZORAM,2008,Convicts Released - Released on bail,4,1,5
MIZORAM,2008,Convicts Released - Pardons,14,0,14
MIZORAM,2008,Convicts Released - Transferred to other States,2,0,2
MIZORAM,2008,"Convicts Released - Other Releases (due to illness, transferred to Mental hospital)",0,0,0
MIZORAM,2008,Total Convicts Released,2708,434,3142
MIZORAM,2008,Under trials Released - Acquitted,85,10,95
MIZORAM,2008,Under trials Released - Released on appeal,254,351,605
MIZORAM,2008,Under trials Released - Released on bail,1458,399,1857
MIZORAM,2008,Under trials Released - Transferred to other States,0,0,0
MIZORAM,2008,Under trials Released - Extradited,0,0,0
MIZORAM,2008,Under trials Released - Other releases (transferred to Mental/Civil hospital),0,0,0
MIZORAM,2008,Total Under trials Released,1797,760,2557
MIZORAM,2008,Detenus Released - Released on completion of detention period,0,0,0
MIZORAM,2008,Detenus Released - Released before completion of detention period,0,0,0
MIZORAM,2008,Detenus Released - Released on bail,0,0,0
MIZORAM,2008,Detenus Released - Other releases (temporary transfer etc.),0,0,0
MIZORAM,2008,Total Detenus Released,0,0,0
MIZORAM,2009,Convicts Released - Released after completion of conviction,2299,369,2668
MIZORAM,2009,Convicts Released - Premature release,61,10,71
MIZORAM,2009,Convicts Released - Released on appeal,103,38,141
MIZORAM,2009,Convicts Released - Released on bail,35,5,40
MIZORAM,2009,Convicts Released - Pardons,0,0,0
MIZORAM,2009,Convicts Released - Transferred to other States,0,0,0
MIZORAM,2009,"Convicts Released - Other Releases (due to illness, transferred to Mental hospital)",1,0,1
MIZORAM,2009,Total Convicts Released,2499,422,2921
MIZORAM,2009,Under trials Released - Acquitted,54,6,60
MIZORAM,2009,Under trials Released - Released on appeal,127,7,134
MIZORAM,2009,Under trials Released - Released on bail,2165,655,2820
MIZORAM,2009,Under trials Released - Transferred to other States,2,0,2
MIZORAM,2009,Under trials Released - Extradited,8,0,8
MIZORAM,2009,Under trials Released - Other releases (transferred to Mental/Civil hospital),0,0,0
MIZORAM,2009,Total Under trials Released,2356,668,3024
MIZORAM,2009,Detenus Released - Released on completion of detention period,0,0,0
MIZORAM,2009,Detenus Released - Released before completion of detention period,0,0,0
MIZORAM,2009,Detenus Released - Released on bail,0,0,0
MIZORAM,2009,Detenus Released - Other releases (temporary transfer etc.),0,0,0
MIZORAM,2009,Total Detenus Released,0,0,0
MIZORAM,2010,Convicts Released - Released after completion of conviction,1695,321,2016
MIZORAM,2010,Convicts Released - Premature release,0,0,0
MIZORAM,2010,Convicts Released - Released on appeal,109,19,128
MIZORAM,2010,Convicts Released - Released on bail,21,7,28
MIZORAM,2010,Convicts Released - Pardons,8,0,8
MIZORAM,2010,Convicts Released - Transferred to other States,0,0,0
MIZORAM,2010,"Convicts Released - Other Releases (due to illness, transferred to Mental hospital)",0,0,0
MIZORAM,2010,Total Convicts Released,1833,347,2180
MIZORAM,2010,Under trials Released - Acquitted,73,6,79
MIZORAM,2010,Under trials Released - Released on appeal,155,25,180
MIZORAM,2010,Under trials Released - Released on bail,2517,725,3242
MIZORAM,2010,Under trials Released - Transferred to other States,0,0,0
MIZORAM,2010,Under trials Released - Extradited,0,0,0
MIZORAM,2010,Under trials Released - Other releases (transferred to Mental/Civil hospital),0,0,0
MIZORAM,2010,Total Under trials Released,2745,756,3501
MIZORAM,2010,Detenus Released - Released on completion of detention period,0,0,0
MIZORAM,2010,Detenus Released - Released before completion of detention period,0,0,0
MIZORAM,2010,Detenus Released - Released on bail,0,0,0
MIZORAM,2010,Detenus Released - Other releases (temporary transfer etc.),0,0,0
MIZORAM,2010,Total Detenus Released,0,0,0
MIZORAM,2011,Convicts Released - Released after completion of conviction,1628,292,1920
MIZORAM,2011,Convicts Released - Premature release,0,0,0
MIZORAM,2011,Convicts Released - Released on appeal,21,9,30
MIZORAM,2011,Convicts Released - Released on bail,0,0,0
MIZORAM,2011,Convicts Released - Pardons,0,0,0
MIZORAM,2011,Convicts Released - Transferred to other States,3,0,3
MIZORAM,2011,"Convicts Released - Other Releases (due to illness, transferred to Mental hospital)",0,0,0
MIZORAM,2011,Total Convicts Released,1652,301,1953
MIZORAM,2011,Under trials Released - Acquitted,173,43,216
MIZORAM,2011,Under trials Released - Released on appeal,110,11,121
MIZORAM,2011,Under trials Released - Released on bail,2167,737,2904
MIZORAM,2011,Under trials Released - Transferred to other States,0,0,0
MIZORAM,2011,Under trials Released - Extradited,0,0,0
MIZORAM,2011,Under trials Released - Other releases (transferred to Mental/Civil hospital),0,0,0
MIZORAM,2011,Total Under trials Released,2450,791,3241
MIZORAM,2011,Detenus Released - Released on completion of detention period,0,0,0
MIZORAM,2011,Detenus Released - Released before completion of detention period,0,0,0
MIZORAM,2011,Detenus Released - Released on bail,0,0,0
MIZORAM,2011,Detenus Released - Other releases (temporary transfer etc.),0,0,0
MIZORAM,2011,Total Detenus Released,0,0,0
MIZORAM,2012,Convicts Released - Released after completion of conviction,1895,225,2120
MIZORAM,2012,Convicts Released - Premature release,0,0,0
MIZORAM,2012,Convicts Released - Released on appeal,16,7,23
MIZORAM,2012,Convicts Released - Released on bail,31,11,42
MIZORAM,2012,Convicts Released - Pardons,0,0,0
MIZORAM,2012,Convicts Released - Transferred to other States,0,0,0
MIZORAM,2012,"Convicts Released - Other Releases (due to illness, transferred to Mental hospital)",0,0,0
MIZORAM,2012,Total Convicts Released,1942,243,2185
MIZORAM,2012,Under trials Released - Acquitted,144,16,160
MIZORAM,2012,Under trials Released - Released on appeal,17,7,24
MIZORAM,2012,Under trials Released - Released on bail,1945,452,2397
MIZORAM,2012,Under trials Released - Transferred to other States,2,0,2
MIZORAM,2012,Under trials Released - Extradited,0,0,0
MIZORAM,2012,Under trials Released - Other releases (transferred to Mental/Civil hospital),22,0,22
MIZORAM,2012,Total Under trials Released,2130,475,2605
MIZORAM,2012,Detenus Released - Released on completion of detention period,0,0,0
MIZORAM,2012,Detenus Released - Released before completion of detention period,0,0,0
MIZORAM,2012,Detenus Released - Released on bail,0,0,0
MIZORAM,2012,Detenus Released - Other releases (temporary transfer etc.),0,0,0
MIZORAM,2012,Total Detenus Released,0,0,0
NAGALAND,2001,Convicts Released - Released after completion of conviction,13,1,14
NAGALAND,2001,Convicts Released - Premature release,0,0,0
NAGALAND,2001,Convicts Released - Released on appeal,0,0,0
NAGALAND,2001,Convicts Released - Released on bail,0,0,0
NAGALAND,2001,Convicts Released - Pardons,0,0,0
NAGALAND,2001,Convicts Released - Transferred to other States,0,0,0
NAGALAND,2001,"Convicts Released - Other Releases (due to illness, transferred to Mental hospital)",0,0,0
NAGALAND,2001,Total Convicts Released,13,1,14
NAGALAND,2001,Under trials Released - Acquitted,0,0,0
NAGALAND,2001,Under trials Released - Released on appeal,0,0,0
NAGALAND,2001,Under trials Released - Released on bail,172,36,208
NAGALAND,2001,Under trials Released - Transferred to other States,1,0,1
NAGALAND,2001,Under trials Released - Extradited,0,0,0
NAGALAND,2001,Under trials Released - Other releases (transferred to Mental/Civil hospital),0,0,0
NAGALAND,2001,Total Under trials Released,173,36,209
NAGALAND,2001,Detenus Released - Released on completion of detention period,15,0,15
NAGALAND,2001,Detenus Released - Released before completion of detention period,0,0,0
NAGALAND,2001,Detenus Released - Released on bail,2,0,2
NAGALAND,2001,Detenus Released - Other releases (temporary transfer etc.),0,0,0
NAGALAND,2001,Total Detenus Released,17,0,17
NAGALAND,2002,Convicts Released - Released after completion of conviction,30,0,30
NAGALAND,2002,Convicts Released - Premature release,0,0,0
NAGALAND,2002,Convicts Released - Released on appeal,0,0,0
NAGALAND,2002,Convicts Released - Released on bail,7,1,8
NAGALAND,2002,Convicts Released - Pardons,0,0,0
NAGALAND,2002,Convicts Released - Transferred to other States,0,0,0
NAGALAND,2002,"Convicts Released - Other Releases (due to illness, transferred to Mental hospital)",0,0,0
NAGALAND,2002,Total Convicts Released,37,1,38
NAGALAND,2002,Under trials Released - Acquitted,0,0,0
NAGALAND,2002,Under trials Released - Released on appeal,0,0,0
NAGALAND,2002,Under trials Released - Released on bail,121,3,124
NAGALAND,2002,Under trials Released - Transferred to other States,0,0,0
NAGALAND,2002,Under trials Released - Extradited,0,0,0
NAGALAND,2002,Under trials Released - Other releases (transferred to Mental/Civil hospital),0,0,0
NAGALAND,2002,Total Under trials Released,121,3,124
NAGALAND,2002,Detenus Released - Released on completion of detention period,8,0,8
NAGALAND,2002,Detenus Released - Released before completion of detention period,0,0,0
NAGALAND,2002,Detenus Released - Released on bail,0,0,0
NAGALAND,2002,Detenus Released - Other releases (temporary transfer etc.),0,0,0
NAGALAND,2002,Total Detenus Released,8,0,8
NAGALAND,2003,Convicts Released - Released after completion of conviction,4,0,4
NAGALAND,2003,Convicts Released - Premature release,0,0,0
NAGALAND,2003,Convicts Released - Released on appeal,0,0,0
NAGALAND,2003,Convicts Released - Released on bail,0,0,0
NAGALAND,2003,Convicts Released - Pardons,0,0,0
NAGALAND,2003,Convicts Released - Transferred to other States,0,0,0
NAGALAND,2003,"Convicts Released - Other Releases (due to illness, transferred to Mental hospital)",0,0,0
NAGALAND,2003,Total Convicts Released,4,0,4
NAGALAND,2003,Under trials Released - Acquitted,0,0,0
NAGALAND,2003,Under trials Released - Released on appeal,0,0,0
NAGALAND,2003,Under trials Released - Released on bail,161,0,161
NAGALAND,2003,Under trials Released - Transferred to other States,0,0,0
NAGALAND,2003,Under trials Released - Extradited,0,0,0
NAGALAND,2003,Under trials Released - Other releases (transferred to Mental/Civil hospital),0,0,0
NAGALAND,2003,Total Under trials Released,161,0,161
NAGALAND,2003,Detenus Released - Released on completion of detention period,52,0,52
NAGALAND,2003,Detenus Released - Released before completion of detention period,0,0,0
NAGALAND,2003,Detenus Released - Released on bail,0,0,0
NAGALAND,2003,Detenus Released - Other releases (temporary transfer etc.),0,0,0
NAGALAND,2003,Total Detenus Released,52,0,52
NAGALAND,2004,Convicts Released - Released after completion of conviction,0,0,0
NAGALAND,2004,Convicts Released - Premature release,0,0,0
NAGALAND,2004,Convicts Released - Released on appeal,0,0,0
NAGALAND,2004,Convicts Released - Released on bail,0,0,0
NAGALAND,2004,Convicts Released - Pardons,0,0,0
NAGALAND,2004,Convicts Released - Transferred to other States,0,0,0
NAGALAND,2004,"Convicts Released - Other Releases (due to illness, transferred to Mental hospital)",0,0,0
NAGALAND,2004,Total Convicts Released,0,0,0
NAGALAND,2004,Under trials Released - Acquitted,0,0,0
NAGALAND,2004,Under trials Released - Released on appeal,8,0,8
NAGALAND,2004,Under trials Released - Released on bail,18,0,18
NAGALAND,2004,Under trials Released - Transferred to other States,0,0,0
NAGALAND,2004,Under trials Released - Extradited,0,0,0
NAGALAND,2004,Under trials Released - Other releases (transferred to Mental/Civil hospital),0,0,0
NAGALAND,2004,Total Under trials Released,26,0,26
NAGALAND,2004,Detenus Released - Released on completion of detention period,34,0,34
NAGALAND,2004,Detenus Released - Released before completion of detention period,0,0,0
NAGALAND,2004,Detenus Released - Released on bail,0,0,0
NAGALAND,2004,Detenus Released - Other releases (temporary transfer etc.),0,0,0
NAGALAND,2004,Total Detenus Released,34,0,34
NAGALAND,2005,Convicts Released - Released after completion of conviction,0,0,0
NAGALAND,2005,Convicts Released - Premature release,0,0,0
NAGALAND,2005,Convicts Released - Released on appeal,0,0,0
NAGALAND,2005,Convicts Released - Released on bail,0,0,0
NAGALAND,2005,Convicts Released - Pardons,0,0,0
NAGALAND,2005,Convicts Released - Transferred to other States,0,0,0
NAGALAND,2005,"Convicts Released - Other Releases (due to illness, transferred to Mental hospital)",0,0,0
NAGALAND,2005,Total Convicts Released,0,0,0
NAGALAND,2005,Under trials Released - Acquitted,0,0,0
NAGALAND,2005,Under trials Released - Released on appeal,8,0,8
NAGALAND,2005,Under trials Released - Released on bail,30,6,36
NAGALAND,2005,Under trials Released - Transferred to other States,0,0,0
NAGALAND,2005,Under trials Released - Extradited,0,0,0
NAGALAND,2005,Under trials Released - Other releases (transferred to Mental/Civil hospital),0,0,0
NAGALAND,2005,Total Under trials Released,38,6,44
NAGALAND,2005,Detenus Released - Released on completion of detention period,44,0,44
NAGALAND,2005,Detenus Released - Released before completion of detention period,0,0,0
NAGALAND,2005,Detenus Released - Released on bail,0,0,0
NAGALAND,2005,Detenus Released - Other releases (temporary transfer etc.),0,0,0
NAGALAND,2005,Total Detenus Released,44,0,44
NAGALAND,2006,Convicts Released - Released after completion of conviction,2,0,2
NAGALAND,2006,Convicts Released - Premature release,0,0,0
NAGALAND,2006,Convicts Released - Released on appeal,0,0,0
NAGALAND,2006,Convicts Released - Released on bail,0,0,0
NAGALAND,2006,Convicts Released - Pardons,0,0,0
NAGALAND,2006,Convicts Released - Transferred to other States,0,0,0
NAGALAND,2006,"Convicts Released - Other Releases (due to illness, transferred to Mental hospital)",0,0,0
NAGALAND,2006,Total Convicts Released,2,0,2
NAGALAND,2006,Under trials Released - Acquitted,0,0,0
NAGALAND,2006,Under trials Released - Released on appeal,0,0,0
NAGALAND,2006,Under trials Released - Released on bail,32,7,39
NAGALAND,2006,Under trials Released - Transferred to other States,0,0,0
NAGALAND,2006,Under trials Released - Extradited,0,0,0
NAGALAND,2006,Under trials Released - Other releases (transferred to Mental/Civil hospital),0,0,0
NAGALAND,2006,Total Under trials Released,32,7,39
NAGALAND,2006,Detenus Released - Released on completion of detention period,0,0,0
NAGALAND,2006,Detenus Released - Released before completion of detention period,0,0,0
NAGALAND,2006,Detenus Released - Released on bail,0,0,0
NAGALAND,2006,Detenus Released - Other releases (temporary transfer etc.),0,0,0
NAGALAND,2006,Total Detenus Released,0,0,0
NAGALAND,2007,Convicts Released - Released after completion of conviction,6,1,7
NAGALAND,2007,Convicts Released - Premature release,0,0,0
NAGALAND,2007,Convicts Released - Released on appeal,0,0,0
NAGALAND,2007,Convicts Released - Released on bail,2,1,3
NAGALAND,2007,Convicts Released - Pardons,0,0,0
NAGALAND,2007,Convicts Released - Transferred to other States,0,0,0
NAGALAND,2007,"Convicts Released - Other Releases (due to illness, transferred to Mental hospital)",0,0,0
NAGALAND,2007,Total Convicts Released,8,2,10
NAGALAND,2007,Under trials Released - Acquitted,0,0,0
NAGALAND,2007,Under trials Released - Released on appeal,0,0,0
NAGALAND,2007,Under trials Released - Released on bail,61,5,66
NAGALAND,2007,Under trials Released - Transferred to other States,0,0,0
NAGALAND,2007,Under trials Released - Extradited,0,0,0
NAGALAND,2007,Under trials Released - Other releases (transferred to Mental/Civil hospital),0,0,0
NAGALAND,2007,Total Under trials Released,61,5,66
NAGALAND,2007,Detenus Released - Released on completion of detention period,2,0,2
NAGALAND,2007,Detenus Released - Released before completion of detention period,0,0,0
NAGALAND,2007,Detenus Released - Released on bail,0,0,0
NAGALAND,2007,Detenus Released - Other releases (temporary transfer etc.),0,0,0
NAGALAND,2007,Total Detenus Released,2,0,2
NAGALAND,2008,Convicts Released - Released after completion of conviction,23,0,23
NAGALAND,2008,Convicts Released - Premature release,0,0,0
NAGALAND,2008,Convicts Released - Released on appeal,0,0,0
NAGALAND,2008,Convicts Released - Released on bail,0,0,0
NAGALAND,2008,Convicts Released - Pardons,0,0,0
NAGALAND,2008,Convicts Released - Transferred to other States,1,0,1
NAGALAND,2008,"Convicts Released - Other Releases (due to illness, transferred to Mental hospital)",0,0,0
NAGALAND,2008,Total Convicts Released,24,0,24
NAGALAND,2008,Under trials Released - Acquitted,0,0,0
NAGALAND,2008,Under trials Released - Released on appeal,217,5,222
NAGALAND,2008,Under trials Released - Released on bail,28,2,30
NAGALAND,2008,Under trials Released - Transferred to other States,0,0,0
NAGALAND,2008,Under trials Released - Extradited,0,0,0
NAGALAND,2008,Under trials Released - Other releases (transferred to Mental/Civil hospital),0,0,0
NAGALAND,2008,Total Under trials Released,245,7,252
NAGALAND,2008,Detenus Released - Released on completion of detention period,0,0,0
NAGALAND,2008,Detenus Released - Released before completion of detention period,0,0,0
NAGALAND,2008,Detenus Released - Released on bail,0,0,0
NAGALAND,2008,Detenus Released - Other releases (temporary transfer etc.),0,0,0
NAGALAND,2008,Total Detenus Released,0,0,0
NAGALAND,2009,Convicts Released - Released after completion of conviction,47,0,47
NAGALAND,2009,Convicts Released - Premature release,0,0,0
NAGALAND,2009,Convicts Released - Released on appeal,0,0,0
NAGALAND,2009,Convicts Released - Released on bail,0,0,0
NAGALAND,2009,Convicts Released - Pardons,0,0,0
NAGALAND,2009,Convicts Released - Transferred to other States,0,0,0
NAGALAND,2009,"Convicts Released - Other Releases (due to illness, transferred to Mental hospital)",0,0,0
NAGALAND,2009,Total Convicts Released,47,0,47
NAGALAND,2009,Under trials Released - Acquitted,0,0,0
NAGALAND,2009,Under trials Released - Released on appeal,231,11,242
NAGALAND,2009,Under trials Released - Released on bail,43,7,50
NAGALAND,2009,Under trials Released - Transferred to other States,0,0,0
NAGALAND,2009,Under trials Released - Extradited,0,0,0
NAGALAND,2009,Under trials Released - Other releases (transferred to Mental/Civil hospital),0,0,0
NAGALAND,2009,Total Under trials Released,274,18,292
NAGALAND,2009,Detenus Released - Released on completion of detention period,21,0,21
NAGALAND,2009,Detenus Released - Released before completion of detention period,0,0,0
NAGALAND,2009,Detenus Released - Released on bail,0,0,0
NAGALAND,2009,Detenus Released - Other releases (temporary transfer etc.),0,0,0
NAGALAND,2009,Total Detenus Released,21,0,21
NAGALAND,2010,Convicts Released - Released after completion of conviction,12,0,12
NAGALAND,2010,Convicts Released - Premature release,0,0,0
NAGALAND,2010,Convicts Released - Released on appeal,0,0,0
NAGALAND,2010,Convicts Released - Released on bail,0,0,0
NAGALAND,2010,Convicts Released - Pardons,0,0,0
NAGALAND,2010,Convicts Released - Transferred to other States,0,0,0
NAGALAND,2010,"Convicts Released - Other Releases (due to illness, transferred to Mental hospital)",0,0,0
NAGALAND,2010,Total Convicts Released,12,0,12
NAGALAND,2010,Under trials Released - Acquitted,0,0,0
NAGALAND,2010,Under trials Released - Released on appeal,61,1,62
NAGALAND,2010,Under trials Released - Released on bail,42,3,45
NAGALAND,2010,Under trials Released - Transferred to other States,0,0,0
NAGALAND,2010,Under trials Released - Extradited,0,0,0
NAGALAND,2010,Under trials Released - Other releases (transferred to Mental/Civil hospital),2,0,2
NAGALAND,2010,Total Under trials Released,105,4,109
NAGALAND,2010,Detenus Released - Released on completion of detention period,16,0,16
NAGALAND,2010,Detenus Released - Released before completion of detention period,0,0,0
NAGALAND,2010,Detenus Released - Released on bail,0,0,0
NAGALAND,2010,Detenus Released - Other releases (temporary transfer etc.),0,0,0
NAGALAND,2010,Total Detenus Released,16,0,16
NAGALAND,2011,Convicts Released - Released after completion of conviction,130,4,134
NAGALAND,2011,Convicts Released - Premature release,12,0,12
NAGALAND,2011,Convicts Released - Released on appeal,0,0,0
NAGALAND,2011,Convicts Released - Released on bail,3,0,3
NAGALAND,2011,Convicts Released - Pardons,2,0,2
NAGALAND,2011,Convicts Released - Transferred to other States,0,0,0
NAGALAND,2011,"Convicts Released - Other Releases (due to illness, transferred to Mental hospital)",0,0,0
NAGALAND,2011,Total Convicts Released,147,4,151
NAGALAND,2011,Under trials Released - Acquitted,275,17,292
NAGALAND,2011,Under trials Released - Released on appeal,20,1,21
NAGALAND,2011,Under trials Released - Released on bail,739,18,757
NAGALAND,2011,Under trials Released - Transferred to other States,6,0,6
NAGALAND,2011,Under trials Released - Extradited,0,0,0
NAGALAND,2011,Under trials Released - Other releases (transferred to Mental/Civil hospital),98,0,98
NAGALAND,2011,Total Under trials Released,1138,36,1174
NAGALAND,2011,Detenus Released - Released on completion of detention period,33,3,36
NAGALAND,2011,Detenus Released - Released before completion of detention period,0,0,0
NAGALAND,2011,Detenus Released - Released on bail,8,12,20
NAGALAND,2011,Detenus Released - Other releases (temporary transfer etc.),58,0,58
NAGALAND,2011,Total Detenus Released,99,15,114
NAGALAND,2012,Convicts Released - Released after completion of conviction,140,1,141
NAGALAND,2012,Convicts Released - Premature release,1,0,1
NAGALAND,2012,Convicts Released - Released on appeal,0,0,0
NAGALAND,2012,Convicts Released - Released on bail,1,0,1
NAGALAND,2012,Convicts Released - Pardons,0,0,0
NAGALAND,2012,Convicts Released - Transferred to other States,1,0,1
NAGALAND,2012,"Convicts Released - Other Releases (due to illness, transferred to Mental hospital)",13,0,13
NAGALAND,2012,Total Convicts Released,156,1,157
NAGALAND,2012,Under trials Released - Acquitted,388,27,415
NAGALAND,2012,Under trials Released - Released on appeal,206,11,217
NAGALAND,2012,Under trials Released - Released on bail,764,39,803
NAGALAND,2012,Under trials Released - Transferred to other States,0,0,0
NAGALAND,2012,Under trials Released - Extradited,0,0,0
NAGALAND,2012,Under trials Released - Other releases (transferred to Mental/Civil hospital),218,2,220
NAGALAND,2012,Total Under trials Released,1576,79,1655
NAGALAND,2012,Detenus Released - Released on completion of detention period,106,11,117
NAGALAND,2012,Detenus Released - Released before completion of detention period,0,0,0
NAGALAND,2012,Detenus Released - Released on bail,7,5,12
NAGALAND,2012,Detenus Released - Other releases (temporary transfer etc.),9,0,9
NAGALAND,2012,Total Detenus Released,122,16,138
ORISSA,2001,Convicts Released - Released after completion of conviction,1603,29,1632
ORISSA,2001,Convicts Released - Premature release,62,4,66
ORISSA,2001,Convicts Released - Released on appeal,162,5,167
ORISSA,2001,Convicts Released - Released on bail,646,15,661
ORISSA,2001,Convicts Released - Pardons,67,0,67
ORISSA,2001,Convicts Released - Transferred to other States,91,1,92
ORISSA,2001,"Convicts Released - Other Releases (due to illness, transferred to Mental hospital)",280,23,303
ORISSA,2001,Total Convicts Released,2911,77,2988
ORISSA,2001,Under trials Released - Acquitted,4051,124,4175
ORISSA,2001,Under trials Released - Released on appeal,726,21,747
ORISSA,2001,Under trials Released - Released on bail,46322,1467,47789
ORISSA,2001,Under trials Released - Transferred to other States,182,8,190
ORISSA,2001,Under trials Released - Extradited,398,12,410
ORISSA,2001,Under trials Released - Other releases (transferred to Mental/Civil hospital),348,4,352
ORISSA,2001,Total Under trials Released,52027,1636,53663
ORISSA,2001,Detenus Released - Released on completion of detention period,38,0,38
ORISSA,2001,Detenus Released - Released before completion of detention period,14,0,14
ORISSA,2001,Detenus Released - Released on bail,0,0,0
ORISSA,2001,Detenus Released - Other releases (temporary transfer etc.),7,0,7
ORISSA,2001,Total Detenus Released,59,0,59
ORISSA,2002,Convicts Released - Released after completion of conviction,1613,36,1649
ORISSA,2002,Convicts Released - Premature release,64,2,66
ORISSA,2002,Convicts Released - Released on appeal,202,12,214
ORISSA,2002,Convicts Released - Released on bail,787,17,804
ORISSA,2002,Convicts Released - Pardons,105,1,106
ORISSA,2002,Convicts Released - Transferred to other States,217,5,222
ORISSA,2002,"Convicts Released - Other Releases (due to illness, transferred to Mental hospital)",92,0,92
ORISSA,2002,Total Convicts Released,3080,73,3153
ORISSA,2002,Under trials Released - Acquitted,3644,124,3768
ORISSA,2002,Under trials Released - Released on appeal,4528,156,4684
ORISSA,2002,Under trials Released - Released on bail,32534,1438,33972
ORISSA,2002,Under trials Released - Transferred to other States,444,12,456
ORISSA,2002,Under trials Released - Extradited,269,4,273
ORISSA,2002,Under trials Released - Other releases (transferred to Mental/Civil hospital),51,1,52
ORISSA,2002,Total Under trials Released,41470,1735,43205
ORISSA,2002,Detenus Released - Released on completion of detention period,30,1,31
ORISSA,2002,Detenus Released - Released before completion of detention period,16,0,16
ORISSA,2002,Detenus Released - Released on bail,0,0,0
ORISSA,2002,Detenus Released - Other releases (temporary transfer etc.),11,0,11
ORISSA,2002,Total Detenus Released,57,1,58
ORISSA,2003,Convicts Released - Released after completion of conviction,1822,28,1850
ORISSA,2003,Convicts Released - Premature release,107,0,107
ORISSA,2003,Convicts Released - Released on appeal,234,15,249
ORISSA,2003,Convicts Released - Released on bail,811,10,821
ORISSA,2003,Convicts Released - Pardons,93,1,94
ORISSA,2003,Convicts Released - Transferred to other States,185,6,191
ORISSA,2003,"Convicts Released - Other Releases (due to illness, transferred to Mental hospital)",102,6,108
ORISSA,2003,Total Convicts Released,3354,66,3420
ORISSA,2003,Under trials Released - Acquitted,3712,113,3825
ORISSA,2003,Under trials Released - Released on appeal,4603,139,4742
ORISSA,2003,Under trials Released - Released on bail,30034,1631,31665
ORISSA,2003,Under trials Released - Transferred to other States,421,7,428
ORISSA,2003,Under trials Released - Extradited,185,2,187
ORISSA,2003,Under trials Released - Other releases (transferred to Mental/Civil hospital),106,18,124
ORISSA,2003,Total Under trials Released,39061,1910,40971
ORISSA,2003,Detenus Released - Released on completion of detention period,32,1,33
ORISSA,2003,Detenus Released - Released before completion of detention period,18,0,18
ORISSA,2003,Detenus Released - Released on bail,0,0,0
ORISSA,2003,Detenus Released - Other releases (temporary transfer etc.),11,0,11
ORISSA,2003,Total Detenus Released,61,1,62
ORISSA,2004,Convicts Released - Released after completion of conviction,1480,15,1495
ORISSA,2004,Convicts Released - Premature release,48,0,48
ORISSA,2004,Convicts Released - Released on appeal,107,7,114
ORISSA,2004,Convicts Released - Released on bail,839,37,876
ORISSA,2004,Convicts Released - Pardons,104,0,104
ORISSA,2004,Convicts Released - Transferred to other States,552,4,556
ORISSA,2004,"Convicts Released - Other Releases (due to illness, transferred to Mental hospital)",143,0,143
ORISSA,2004,Total Convicts Released,3273,63,3336
ORISSA,2004,Under trials Released - Acquitted,3778,79,3857
ORISSA,2004,Under trials Released - Released on appeal,199,0,199
ORISSA,2004,Under trials Released - Released on bail,42143,1923,44066
ORISSA,2004,Under trials Released - Transferred to other States,925,6,931
ORISSA,2004,Under trials Released - Extradited,801,74,875
ORISSA,2004,Under trials Released - Other releases (transferred to Mental/Civil hospital),1535,67,1602
ORISSA,2004,Total Under trials Released,49381,2149,51530
ORISSA,2004,Detenus Released - Released on completion of detention period,8,0,8
ORISSA,2004,Detenus Released - Released before completion of detention period,9,0,9
ORISSA,2004,Detenus Released - Released on bail,0,0,0
ORISSA,2004,Detenus Released - Other releases (temporary transfer etc.),10,0,10
ORISSA,2004,Total Detenus Released,27,0,27
ORISSA,2005,Convicts Released - Released after completion of conviction,1260,12,1272
ORISSA,2005,Convicts Released - Premature release,8,0,8
ORISSA,2005,Convicts Released - Released on appeal,162,0,162
ORISSA,2005,Convicts Released - Released on bail,911,26,937
ORISSA,2005,Convicts Released - Pardons,0,0,0
ORISSA,2005,Convicts Released - Transferred to other States,563,11,574
ORISSA,2005,"Convicts Released - Other Releases (due to illness, transferred to Mental hospital)",69,2,71
ORISSA,2005,Total Convicts Released,2973,51,3024
ORISSA,2005,Under trials Released - Acquitted,2826,88,2914
ORISSA,2005,Under trials Released - Released on appeal,0,0,0
ORISSA,2005,Under trials Released - Released on bail,47008,1880,48888
ORISSA,2005,Under trials Released - Transferred to other States,342,0,342
ORISSA,2005,Under trials Released - Extradited,756,3,759
ORISSA,2005,Under trials Released - Other releases (transferred to Mental/Civil hospital),124,3,127
ORISSA,2005,Total Under trials Released,51056,1974,53030
ORISSA,2005,Detenus Released - Released on completion of detention period,4,0,4
ORISSA,2005,Detenus Released - Released before completion of detention period,1,0,1
ORISSA,2005,Detenus Released - Released on bail,0,0,0
ORISSA,2005,Detenus Released - Other releases (temporary transfer etc.),0,0,0
ORISSA,2005,Total Detenus Released,5,0,5
ORISSA,2006,Convicts Released - Released after completion of conviction,1347,15,1362
ORISSA,2006,Convicts Released - Premature release,77,2,79
ORISSA,2006,Convicts Released - Released on appeal,183,0,183
ORISSA,2006,Convicts Released - Released on bail,948,31,979
ORISSA,2006,Convicts Released - Pardons,0,0,0
ORISSA,2006,Convicts Released - Transferred to other States,522,8,530
ORISSA,2006,"Convicts Released - Other Releases (due to illness, transferred to Mental hospital)",74,2,76
ORISSA,2006,Total Convicts Released,3151,58,3209
ORISSA,2006,Under trials Released - Acquitted,2945,97,3042
ORISSA,2006,Under trials Released - Released on appeal,0,0,0
ORISSA,2006,Under trials Released - Released on bail,46324,1932,48256
ORISSA,2006,Under trials Released - Transferred to other States,312,0,312
ORISSA,2006,Under trials Released - Extradited,641,3,644
ORISSA,2006,Under trials Released - Other releases (transferred to Mental/Civil hospital),109,2,111
ORISSA,2006,Total Under trials Released,50331,2034,52365
ORISSA,2006,Detenus Released - Released on completion of detention period,2,0,2
ORISSA,2006,Detenus Released - Released before completion of detention period,0,0,0
ORISSA,2006,Detenus Released - Released on bail,0,0,0
ORISSA,2006,Detenus Released - Other releases (temporary transfer etc.),0,0,0
ORISSA,2006,Total Detenus Released,2,0,2
ORISSA,2007,Convicts Released - Released after completion of conviction,1542,21,1563
ORISSA,2007,Convicts Released - Premature release,52,0,52
ORISSA,2007,Convicts Released - Released on appeal,96,0,96
ORISSA,2007,Convicts Released - Released on bail,1053,35,1088
ORISSA,2007,Convicts Released - Pardons,0,0,0
ORISSA,2007,Convicts Released - Transferred to other States,22,0,22
ORISSA,2007,"Convicts Released - Other Releases (due to illness, transferred to Mental hospital)",82,2,84
ORISSA,2007,Total Convicts Released,2847,58,2905
ORISSA,2007,Under trials Released - Acquitted,3215,112,3327
ORISSA,2007,Under trials Released - Released on appeal,0,0,0
ORISSA,2007,Under trials Released - Released on bail,54143,2217,56360
ORISSA,2007,Under trials Released - Transferred to other States,0,0,0
ORISSA,2007,Under trials Released - Extradited,701,3,704
ORISSA,2007,Under trials Released - Other releases (transferred to Mental/Civil hospital),124,3,127
ORISSA,2007,Total Under trials Released,58183,2335,60518
ORISSA,2007,Detenus Released - Released on completion of detention period,2,0,2
ORISSA,2007,Detenus Released - Released before completion of detention period,0,0,0
ORISSA,2007,Detenus Released - Released on bail,0,0,0
ORISSA,2007,Detenus Released - Other releases (temporary transfer etc.),0,0,0
ORISSA,2007,Total Detenus Released,2,0,2
ORISSA,2008,Convicts Released - Released after completion of conviction,1114,13,1127
ORISSA,2008,Convicts Released - Premature release,46,0,46
ORISSA,2008,Convicts Released - Released on appeal,213,0,213
ORISSA,2008,Convicts Released - Released on bail,1048,52,1100
ORISSA,2008,Convicts Released - Pardons,0,0,0
ORISSA,2008,Convicts Released - Transferred to other States,346,2,348
ORISSA,2008,"Convicts Released - Other Releases (due to illness, transferred to Mental hospital)",74,2,76
ORISSA,2008,Total Convicts Released,2841,69,2910
ORISSA,2008,Under trials Released - Acquitted,3196,63,3259
ORISSA,2008,Under trials Released - Released on appeal,0,0,0
ORISSA,2008,Under trials Released - Released on bail,41234,1759,42993
ORISSA,2008,Under trials Released - Transferred to other States,21,0,21
ORISSA,2008,Under trials Released - Extradited,362,1,363
ORISSA,2008,Under trials Released - Other releases (transferred to Mental/Civil hospital),82,0,82
ORISSA,2008,Total Under trials Released,44895,1823,46718
ORISSA,2008,Detenus Released - Released on completion of detention period,0,0,0
ORISSA,2008,Detenus Released - Released before completion of detention period,0,0,0
ORISSA,2008,Detenus Released - Released on bail,0,0,0
ORISSA,2008,Detenus Released - Other releases (temporary transfer etc.),0,0,0
ORISSA,2008,Total Detenus Released,0,0,0
ORISSA,2009,Convicts Released - Released after completion of conviction,1032,11,1043
ORISSA,2009,Convicts Released - Premature release,144,2,146
ORISSA,2009,Convicts Released - Released on appeal,201,0,201
ORISSA,2009,Convicts Released - Released on bail,1267,52,1319
ORISSA,2009,Convicts Released - Pardons,0,0,0
ORISSA,2009,Convicts Released - Transferred to other States,201,1,202
ORISSA,2009,"Convicts Released - Other Releases (due to illness, transferred to Mental hospital)",56,0,56
ORISSA,2009,Total Convicts Released,2901,66,2967
ORISSA,2009,Under trials Released - Acquitted,2932,56,2988
ORISSA,2009,Under trials Released - Released on appeal,0,0,0
ORISSA,2009,Under trials Released - Released on bail,41111,1423,42534
ORISSA,2009,Under trials Released - Transferred to other States,15,0,15
ORISSA,2009,Under trials Released - Extradited,228,1,229
ORISSA,2009,Under trials Released - Other releases (transferred to Mental/Civil hospital),71,0,71
ORISSA,2009,Total Under trials Released,44357,1480,45837
ORISSA,2009,Detenus Released - Released on completion of detention period,0,0,0
ORISSA,2009,Detenus Released - Released before completion of detention period,0,0,0
ORISSA,2009,Detenus Released - Released on bail,0,0,0
ORISSA,2009,Detenus Released - Other releases (temporary transfer etc.),0,0,0
ORISSA,2009,Total Detenus Released,0,0,0
ORISSA,2010,Convicts Released - Released after completion of conviction,935,8,943
ORISSA,2010,Convicts Released - Premature release,122,1,123
ORISSA,2010,Convicts Released - Released on appeal,56,0,56
ORISSA,2010,Convicts Released - Released on bail,1129,72,1201
ORISSA,2010,Convicts Released - Pardons,0,0,0
ORISSA,2010,Convicts Released - Transferred to other States,123,0,123
ORISSA,2010,"Convicts Released - Other Releases (due to illness, transferred to Mental hospital)",38,0,38
ORISSA,2010,Total Convicts Released,2403,81,2484
ORISSA,2010,Under trials Released - Acquitted,2932,56,2988
ORISSA,2010,Under trials Released - Released on appeal,0,0,0
ORISSA,2010,Under trials Released - Released on bail,41111,1423,42534
ORISSA,2010,Under trials Released - Transferred to other States,10,0,10
ORISSA,2010,Under trials Released - Extradited,0,0,0
ORISSA,2010,Under trials Released - Other releases (transferred to Mental/Civil hospital),304,1,305
ORISSA,2010,Total Under trials Released,44357,1480,45837
ORISSA,2010,Detenus Released - Released on completion of detention period,0,0,0
ORISSA,2010,Detenus Released - Released before completion of detention period,0,0,0
ORISSA,2010,Detenus Released - Released on bail,0,0,0
ORISSA,2010,Detenus Released - Other releases (temporary transfer etc.),0,0,0
ORISSA,2010,Total Detenus Released,0,0,0
ORISSA,2011,Convicts Released - Released after completion of conviction,845,20,865
ORISSA,2011,Convicts Released - Premature release,93,0,93
ORISSA,2011,Convicts Released - Released on appeal,222,11,233
ORISSA,2011,Convicts Released - Released on bail,794,26,820
ORISSA,2011,Convicts Released - Pardons,0,0,0
ORISSA,2011,Convicts Released - Transferred to other States,123,0,123
ORISSA,2011,"Convicts Released - Other Releases (due to illness, transferred to Mental hospital)",43,1,44
ORISSA,2011,Total Convicts Released,2120,58,2178
ORISSA,2011,Under trials Released - Acquitted,2629,52,2681
ORISSA,2011,Under trials Released - Released on appeal,0,0,0
ORISSA,2011,Under trials Released - Released on bail,42449,3386,45835
ORISSA,2011,Under trials Released - Transferred to other States,15,0,15
ORISSA,2011,Under trials Released - Extradited,0,0,0
ORISSA,2011,Under trials Released - Other releases (transferred to Mental/Civil hospital),44,9,53
ORISSA,2011,Total Under trials Released,45137,3447,48584
ORISSA,2011,Detenus Released - Released on completion of detention period,0,0,0
ORISSA,2011,Detenus Released - Released before completion of detention period,0,0,0
ORISSA,2011,Detenus Released - Released on bail,0,0,0
ORISSA,2011,Detenus Released - Other releases (temporary transfer etc.),0,0,0
ORISSA,2011,Total Detenus Released,0,0,0
ORISSA,2012,Convicts Released - Released after completion of conviction,855,20,875
ORISSA,2012,Convicts Released - Premature release,97,0,97
ORISSA,2012,Convicts Released - Released on appeal,194,11,205
ORISSA,2012,Convicts Released - Released on bail,847,26,873
ORISSA,2012,Convicts Released - Pardons,0,0,0
ORISSA,2012,Convicts Released - Transferred to other States,103,0,103
ORISSA,2012,"Convicts Released - Other Releases (due to illness, transferred to Mental hospital)",63,1,64
ORISSA,2012,Total Convicts Released,2159,58,2217
ORISSA,2012,Under trials Released - Acquitted,2527,50,2577
ORISSA,2012,Under trials Released - Released on appeal,0,0,0
ORISSA,2012,Under trials Released - Released on bail,41219,1423,42642
ORISSA,2012,Under trials Released - Transferred to other States,15,0,15
ORISSA,2012,Under trials Released - Extradited,0,0,0
ORISSA,2012,Under trials Released - Other releases (transferred to Mental/Civil hospital),72,7,79
ORISSA,2012,Total Under trials Released,43833,1480,45313
ORISSA,2012,Detenus Released - Released on completion of detention period,0,0,0
ORISSA,2012,Detenus Released - Released before completion of detention period,0,0,0
ORISSA,2012,Detenus Released - Released on bail,0,0,0
ORISSA,2012,Detenus Released - Other releases (temporary transfer etc.),0,0,0
ORISSA,2012,Total Detenus Released,0,0,0
PUNJAB,2001,Convicts Released - Released after completion of conviction,218,20,238
PUNJAB,2001,Convicts Released - Premature release,110,12,122
PUNJAB,2001,Convicts Released - Released on appeal,65,4,69
PUNJAB,2001,Convicts Released - Released on bail,156,8,164
PUNJAB,2001,Convicts Released - Pardons,45,3,48
PUNJAB,2001,Convicts Released - Transferred to other States,7,0,7
PUNJAB,2001,"Convicts Released - Other Releases (due to illness, transferred to Mental hospital)",456,45,501
PUNJAB,2001,Total Convicts Released,1057,92,1149
PUNJAB,2001,Under trials Released - Acquitted,1256,127,1383
PUNJAB,2001,Under trials Released - Released on appeal,1425,156,1581
PUNJAB,2001,Under trials Released - Released on bail,1642,245,1887
PUNJAB,2001,Under trials Released - Transferred to other States,0,0,0
PUNJAB,2001,Under trials Released - Extradited,0,0,0
PUNJAB,2001,Under trials Released - Other releases (transferred to Mental/Civil hospital),118,16,134
PUNJAB,2001,Total Under trials Released,4441,544,4985
PUNJAB,2001,Detenus Released - Released on completion of detention period,112,0,112
PUNJAB,2001,Detenus Released - Released before completion of detention period,0,0,0
PUNJAB,2001,Detenus Released - Released on bail,0,0,0
PUNJAB,2001,Detenus Released - Other releases (temporary transfer etc.),10,0,10
PUNJAB,2001,Total Detenus Released,122,0,122
PUNJAB,2002,Convicts Released - Released after completion of conviction,651,5,656
PUNJAB,2002,Convicts Released - Premature release,15,1,16
PUNJAB,2002,Convicts Released - Released on appeal,349,47,396
PUNJAB,2002,Convicts Released - Released on bail,272,83,355
PUNJAB,2002,Convicts Released - Pardons,253,0,253
PUNJAB,2002,Convicts Released - Transferred to other States,97,0,97
PUNJAB,2002,"Convicts Released - Other Releases (due to illness, transferred to Mental hospital)",0,0,0
PUNJAB,2002,Total Convicts Released,1637,136,1773
PUNJAB,2002,Under trials Released - Acquitted,817,41,858
PUNJAB,2002,Under trials Released - Released on appeal,762,420,1182
PUNJAB,2002,Under trials Released - Released on bail,338,317,655
PUNJAB,2002,Under trials Released - Transferred to other States,196,0,196
PUNJAB,2002,Under trials Released - Extradited,181,0,181
PUNJAB,2002,Under trials Released - Other releases (transferred to Mental/Civil hospital),209,0,209
PUNJAB,2002,Total Under trials Released,2503,778,3281
PUNJAB,2002,Detenus Released - Released on completion of detention period,0,0,0
PUNJAB,2002,Detenus Released - Released before completion of detention period,0,0,0
PUNJAB,2002,Detenus Released - Released on bail,0,0,0
PUNJAB,2002,Detenus Released - Other releases (temporary transfer etc.),0,0,0
PUNJAB,2002,Total Detenus Released,0,0,0
PUNJAB,2003,Convicts Released - Released after completion of conviction,329,83,412
PUNJAB,2003,Convicts Released - Premature release,10,1,11
PUNJAB,2003,Convicts Released - Released on appeal,132,2,134
PUNJAB,2003,Convicts Released - Released on bail,108,13,121
PUNJAB,2003,Convicts Released - Pardons,256,18,274
PUNJAB,2003,Convicts Released - Transferred to other States,125,0,125
PUNJAB,2003,"Convicts Released - Other Releases (due to illness, transferred to Mental hospital)",0,0,0
PUNJAB,2003,Total Convicts Released,960,117,1077
PUNJAB,2003,Under trials Released - Acquitted,850,47,897
PUNJAB,2003,Under trials Released - Released on appeal,662,321,983
PUNJAB,2003,Under trials Released - Released on bail,330,307,637
PUNJAB,2003,Under trials Released - Transferred to other States,190,0,190
PUNJAB,2003,Under trials Released - Extradited,181,0,181
PUNJAB,2003,Under trials Released - Other releases (transferred to Mental/Civil hospital),200,0,200
PUNJAB,2003,Total Under trials Released,2413,675,3088
PUNJAB,2003,Detenus Released - Released on completion of detention period,0,0,0
PUNJAB,2003,Detenus Released - Released before completion of detention period,0,0,0
PUNJAB,2003,Detenus Released - Released on bail,0,0,0
PUNJAB,2003,Detenus Released - Other releases (temporary transfer etc.),0,0,0
PUNJAB,2003,Total Detenus Released,0,0,0
PUNJAB,2004,Convicts Released - Released after completion of conviction,461,86,547
PUNJAB,2004,Convicts Released - Premature release,122,3,125
PUNJAB,2004,Convicts Released - Released on appeal,126,10,136
PUNJAB,2004,Convicts Released - Released on bail,431,43,474
PUNJAB,2004,Convicts Released - Pardons,0,0,0
PUNJAB,2004,Convicts Released - Transferred to other States,255,0,255
PUNJAB,2004,"Convicts Released - Other Releases (due to illness, transferred to Mental hospital)",136,0,136
PUNJAB,2004,Total Convicts Released,1531,142,1673
PUNJAB,2004,Under trials Released - Acquitted,735,40,775
PUNJAB,2004,Under trials Released - Released on appeal,698,315,1013
PUNJAB,2004,Under trials Released - Released on bail,377,318,695
PUNJAB,2004,Under trials Released - Transferred to other States,168,0,168
PUNJAB,2004,Under trials Released - Extradited,196,0,196
PUNJAB,2004,Under trials Released - Other releases (transferred to Mental/Civil hospital),207,0,207
PUNJAB,2004,Total Under trials Released,2381,673,3054
PUNJAB,2004,Detenus Released - Released on completion of detention period,0,0,0
PUNJAB,2004,Detenus Released - Released before completion of detention period,0,0,0
PUNJAB,2004,Detenus Released - Released on bail,0,0,0
PUNJAB,2004,Detenus Released - Other releases (temporary transfer etc.),0,0,0
PUNJAB,2004,Total Detenus Released,0,0,0
PUNJAB,2005,Convicts Released - Released after completion of conviction,425,80,505
PUNJAB,2005,Convicts Released - Premature release,40,2,42
PUNJAB,2005,Convicts Released - Released on appeal,145,12,157
PUNJAB,2005,Convicts Released - Released on bail,158,15,173
PUNJAB,2005,Convicts Released - Pardons,2,0,2
PUNJAB,2005,Convicts Released - Transferred to other States,0,0,0
PUNJAB,2005,"Convicts Released - Other Releases (due to illness, transferred to Mental hospital)",148,0,148
PUNJAB,2005,Total Convicts Released,918,109,1027
PUNJAB,2005,Under trials Released - Acquitted,740,45,785
PUNJAB,2005,Under trials Released - Released on appeal,702,289,991
PUNJAB,2005,Under trials Released - Released on bail,368,320,688
PUNJAB,2005,Under trials Released - Transferred to other States,165,0,165
PUNJAB,2005,Under trials Released - Extradited,190,0,190
PUNJAB,2005,Under trials Released - Other releases (transferred to Mental/Civil hospital),206,0,206
PUNJAB,2005,Total Under trials Released,2371,654,3025
PUNJAB,2005,Detenus Released - Released on completion of detention period,0,0,0
PUNJAB,2005,Detenus Released - Released before completion of detention period,0,0,0
PUNJAB,2005,Detenus Released - Released on bail,0,0,0
PUNJAB,2005,Detenus Released - Other releases (temporary transfer etc.),0,0,0
PUNJAB,2005,Total Detenus Released,0,0,0
PUNJAB,2006,Convicts Released - Released after completion of conviction,465,73,538
PUNJAB,2006,Convicts Released - Premature release,47,7,54
PUNJAB,2006,Convicts Released - Released on appeal,137,9,146
PUNJAB,2006,Convicts Released - Released on bail,163,13,176
PUNJAB,2006,Convicts Released - Pardons,1,0,1
PUNJAB,2006,Convicts Released - Transferred to other States,0,0,0
PUNJAB,2006,"Convicts Released - Other Releases (due to illness, transferred to Mental hospital)",137,0,137
PUNJAB,2006,Total Convicts Released,950,102,1052
PUNJAB,2006,Under trials Released - Acquitted,763,37,800
PUNJAB,2006,Under trials Released - Released on appeal,753,279,1032
PUNJAB,2006,Under trials Released - Released on bail,357,288,645
PUNJAB,2006,Under trials Released - Transferred to other States,123,0,123
PUNJAB,2006,Under trials Released - Extradited,177,0,177
PUNJAB,2006,Under trials Released - Other releases (transferred to Mental/Civil hospital),286,0,286
PUNJAB,2006,Total Under trials Released,2459,604,3063
PUNJAB,2006,Detenus Released - Released on completion of detention period,0,0,0
PUNJAB,2006,Detenus Released - Released before completion of detention period,0,0,0
PUNJAB,2006,Detenus Released - Released on bail,0,0,0
PUNJAB,2006,Detenus Released - Other releases (temporary transfer etc.),0,0,0
PUNJAB,2006,Total Detenus Released,0,0,0
PUNJAB,2007,Convicts Released - Released after completion of conviction,493,67,560
PUNJAB,2007,Convicts Released - Premature release,74,6,80
PUNJAB,2007,Convicts Released - Released on appeal,123,7,130
PUNJAB,2007,Convicts Released - Released on bail,174,11,185
PUNJAB,2007,Convicts Released - Pardons,1,0,1
PUNJAB,2007,Convicts Released - Transferred to other States,0,0,0
PUNJAB,2007,"Convicts Released - Other Releases (due to illness, transferred to Mental hospital)",197,0,197
PUNJAB,2007,Total Convicts Released,1062,91,1153
PUNJAB,2007,Under trials Released - Acquitted,441,18,459
PUNJAB,2007,Under trials Released - Released on appeal,647,187,834
PUNJAB,2007,Under trials Released - Released on bail,373,143,516
PUNJAB,2007,Under trials Released - Transferred to other States,5,0,5
PUNJAB,2007,Under trials Released - Extradited,134,0,134
PUNJAB,2007,Under trials Released - Other releases (transferred to Mental/Civil hospital),273,0,273
PUNJAB,2007,Total Under trials Released,1873,348,2221
PUNJAB,2007,Detenus Released - Released on completion of detention period,0,0,0
PUNJAB,2007,Detenus Released - Released before completion of detention period,0,0,0
PUNJAB,2007,Detenus Released - Released on bail,0,0,0
PUNJAB,2007,Detenus Released - Other releases (temporary transfer etc.),0,0,0
PUNJAB,2007,Total Detenus Released,0,0,0
PUNJAB,2008,Convicts Released - Released after completion of conviction,497,71,568
PUNJAB,2008,Convicts Released - Premature release,125,10,135
PUNJAB,2008,Convicts Released - Released on appeal,121,4,125
PUNJAB,2008,Convicts Released - Released on bail,194,10,204
PUNJAB,2008,Convicts Released - Pardons,0,1,1
PUNJAB,2008,Convicts Released - Transferred to other States,0,0,0
PUNJAB,2008,"Convicts Released - Other Releases (due to illness, transferred to Mental hospital)",0,0,0
PUNJAB,2008,Total Convicts Released,937,96,1033
PUNJAB,2008,Under trials Released - Acquitted,450,22,472
PUNJAB,2008,Under trials Released - Released on appeal,650,42,692
PUNJAB,2008,Under trials Released - Released on bail,370,142,512
PUNJAB,2008,Under trials Released - Transferred to other States,0,0,0
PUNJAB,2008,Under trials Released - Extradited,130,0,130
PUNJAB,2008,Under trials Released - Other releases (transferred to Mental/Civil hospital),260,0,260
PUNJAB,2008,Total Under trials Released,1860,206,2066
PUNJAB,2008,Detenus Released - Released on completion of detention period,0,0,0
PUNJAB,2008,Detenus Released - Released before completion of detention period,0,0,0
PUNJAB,2008,Detenus Released - Released on bail,0,0,0
PUNJAB,2008,Detenus Released - Other releases (temporary transfer etc.),0,0,0
PUNJAB,2008,Total Detenus Released,0,0,0
PUNJAB,2009,Convicts Released - Released after completion of conviction,976,99,1075
PUNJAB,2009,Convicts Released - Premature release,371,79,450
PUNJAB,2009,Convicts Released - Released on appeal,1389,70,1459
PUNJAB,2009,Convicts Released - Released on bail,1912,135,2047
PUNJAB,2009,Convicts Released - Pardons,0,0,0
PUNJAB,2009,Convicts Released - Transferred to other States,0,0,0
PUNJAB,2009,"Convicts Released - Other Releases (due to illness, transferred to Mental hospital)",266,56,322
PUNJAB,2009,Total Convicts Released,4914,439,5353
PUNJAB,2009,Under trials Released - Acquitted,998,69,1067
PUNJAB,2009,Under trials Released - Released on appeal,1017,92,1109
PUNJAB,2009,Under trials Released - Released on bail,919,201,1120
PUNJAB,2009,Under trials Released - Transferred to other States,0,0,0
PUNJAB,2009,Under trials Released - Extradited,0,0,0
PUNJAB,2009,Under trials Released - Other releases (transferred to Mental/Civil hospital),212,15,227
PUNJAB,2009,Total Under trials Released,3146,377,3523
PUNJAB,2009,Detenus Released - Released on completion of detention period,0,0,0
PUNJAB,2009,Detenus Released - Released before completion of detention period,0,0,0
PUNJAB,2009,Detenus Released - Released on bail,0,0,0
PUNJAB,2009,Detenus Released - Other releases (temporary transfer etc.),0,0,0
PUNJAB,2009,Total Detenus Released,0,0,0
PUNJAB,2010,Convicts Released - Released after completion of conviction,985,104,1089
PUNJAB,2010,Convicts Released - Premature release,381,78,459
PUNJAB,2010,Convicts Released - Released on appeal,1449,81,1530
PUNJAB,2010,Convicts Released - Released on bail,2503,196,2699
PUNJAB,2010,Convicts Released - Pardons,0,0,0
PUNJAB,2010,Convicts Released - Transferred to other States,1,0,1
PUNJAB,2010,"Convicts Released - Other Releases (due to illness, transferred to Mental hospital)",238,39,277
PUNJAB,2010,Total Convicts Released,5557,498,6055
PUNJAB,2010,Under trials Released - Acquitted,1019,75,1094
PUNJAB,2010,Under trials Released - Released on appeal,1335,206,1541
PUNJAB,2010,Under trials Released - Released on bail,1451,288,1739
PUNJAB,2010,Under trials Released - Transferred to other States,0,0,0
PUNJAB,2010,Under trials Released - Extradited,0,0,0
PUNJAB,2010,Under trials Released - Other releases (transferred to Mental/Civil hospital),220,10,230
PUNJAB,2010,Total Under trials Released,4025,579,4604
PUNJAB,2010,Detenus Released - Released on completion of detention period,0,0,0
PUNJAB,2010,Detenus Released - Released before completion of detention period,0,0,0
PUNJAB,2010,Detenus Released - Released on bail,0,0,0
PUNJAB,2010,Detenus Released - Other releases (temporary transfer etc.),0,0,0
PUNJAB,2010,Total Detenus Released,0,0,0
PUNJAB,2011,Convicts Released - Released after completion of conviction,997,109,1106
PUNJAB,2011,Convicts Released - Premature release,388,81,469
PUNJAB,2011,Convicts Released - Released on appeal,1473,86,1559
PUNJAB,2011,Convicts Released - Released on bail,2514,202,2716
PUNJAB,2011,Convicts Released - Pardons,0,0,0
PUNJAB,2011,Convicts Released - Transferred to other States,2,0,2
PUNJAB,2011,"Convicts Released - Other Releases (due to illness, transferred to Mental hospital)",758,37,795
PUNJAB,2011,Total Convicts Released,6132,515,6647
PUNJAB,2011,Under trials Released - Acquitted,1026,76,1102
PUNJAB,2011,Under trials Released - Released on appeal,1345,211,1556
PUNJAB,2011,Under trials Released - Released on bail,1463,296,1759
PUNJAB,2011,Under trials Released - Transferred to other States,0,0,0
PUNJAB,2011,Under trials Released - Extradited,0,0,0
PUNJAB,2011,Under trials Released - Other releases (transferred to Mental/Civil hospital),224,9,233
PUNJAB,2011,Total Under trials Released,4058,592,4650
PUNJAB,2011,Detenus Released - Released on completion of detention period,4,0,4
PUNJAB,2011,Detenus Released - Released before completion of detention period,0,0,0
PUNJAB,2011,Detenus Released - Released on bail,0,0,0
PUNJAB,2011,Detenus Released - Other releases (temporary transfer etc.),0,0,0
PUNJAB,2011,Total Detenus Released,4,0,4
PUNJAB,2012,Convicts Released - Released after completion of conviction,4028,182,4210
PUNJAB,2012,Convicts Released - Premature release,64,3,67
PUNJAB,2012,Convicts Released - Released on appeal,331,38,369
PUNJAB,2012,Convicts Released - Released on bail,3122,258,3380
PUNJAB,2012,Convicts Released - Pardons,0,0,0
PUNJAB,2012,Convicts Released - Transferred to other States,16,0,16
PUNJAB,2012,"Convicts Released - Other Releases (due to illness, transferred to Mental hospital)",356,10,366
PUNJAB,2012,Total Convicts Released,7917,491,8408
PUNJAB,2012,Under trials Released - Acquitted,5210,308,5518
PUNJAB,2012,Under trials Released - Released on appeal,938,54,992
PUNJAB,2012,Under trials Released - Released on bail,35909,3340,39249
PUNJAB,2012,Under trials Released - Transferred to other States,15,0,15
PUNJAB,2012,Under trials Released - Extradited,0,0,0
PUNJAB,2012,Under trials Released - Other releases (transferred to Mental/Civil hospital),1805,154,1959
PUNJAB,2012,Total Under trials Released,43877,3856,47733
PUNJAB,2012,Detenus Released - Released on completion of detention period,0,0,0
PUNJAB,2012,Detenus Released - Released before completion of detention period,8,0,8
PUNJAB,2012,Detenus Released - Released on bail,0,0,0
PUNJAB,2012,Detenus Released - Other releases (temporary transfer etc.),0,0,0
PUNJAB,2012,Total Detenus Released,8,0,8
RAJASTHAN,2001,Convicts Released - Released after completion of conviction,3180,73,3253
RAJASTHAN,2001,Convicts Released - Premature release,46,0,46
RAJASTHAN,2001,Convicts Released - Released on appeal,552,3,555
RAJASTHAN,2001,Convicts Released - Released on bail,3113,62,3175
RAJASTHAN,2001,Convicts Released - Pardons,69,0,69
RAJASTHAN,2001,Convicts Released - Transferred to other States,92,2,94
RAJASTHAN,2001,"Convicts Released - Other Releases (due to illness, transferred to Mental hospital)",2019,168,2187
RAJASTHAN,2001,Total Convicts Released,9071,308,9379
RAJASTHAN,2001,Under trials Released - Acquitted,4536,141,4677
RAJASTHAN,2001,Under trials Released - Released on appeal,167,7,174
RAJASTHAN,2001,Under trials Released - Released on bail,71536,2284,73820
RAJASTHAN,2001,Under trials Released - Transferred to other States,122,14,136
RAJASTHAN,2001,Under trials Released - Extradited,0,0,0
RAJASTHAN,2001,Under trials Released - Other releases (transferred to Mental/Civil hospital),1580,50,1630
RAJASTHAN,2001,Total Under trials Released,77941,2496,80437
RAJASTHAN,2001,Detenus Released - Released on completion of detention period,10,1,11
RAJASTHAN,2001,Detenus Released - Released before completion of detention period,8,0,8
RAJASTHAN,2001,Detenus Released - Released on bail,1,0,1
RAJASTHAN,2001,Detenus Released - Other releases (temporary transfer etc.),7,0,7
RAJASTHAN,2001,Total Detenus Released,26,1,27
RAJASTHAN,2002,Convicts Released - Released after completion of conviction,2861,79,2940
RAJASTHAN,2002,Convicts Released - Premature release,76,3,79
RAJASTHAN,2002,Convicts Released - Released on appeal,647,27,674
RAJASTHAN,2002,Convicts Released - Released on bail,4500,157,4657
RAJASTHAN,2002,Convicts Released - Pardons,24,0,24
RAJASTHAN,2002,Convicts Released - Transferred to other States,58,3,61
RAJASTHAN,2002,"Convicts Released - Other Releases (due to illness, transferred to Mental hospital)",23,3,26
RAJASTHAN,2002,Total Convicts Released,8189,272,8461
RAJASTHAN,2002,Under trials Released - Acquitted,5219,135,5354
RAJASTHAN,2002,Under trials Released - Released on appeal,353,0,353
RAJASTHAN,2002,Under trials Released - Released on bail,67672,2116,69788
RAJASTHAN,2002,Under trials Released - Transferred to other States,148,2,150
RAJASTHAN,2002,Under trials Released - Extradited,0,0,0
RAJASTHAN,2002,Under trials Released - Other releases (transferred to Mental/Civil hospital),30,0,30
RAJASTHAN,2002,Total Under trials Released,73422,2253,75675
RAJASTHAN,2002,Detenus Released - Released on completion of detention period,2,0,2
RAJASTHAN,2002,Detenus Released - Released before completion of detention period,5,0,5
RAJASTHAN,2002,Detenus Released - Released on bail,0,0,0
RAJASTHAN,2002,Detenus Released - Other releases (temporary transfer etc.),4,0,4
RAJASTHAN,2002,Total Detenus Released,11,0,11
RAJASTHAN,2003,Convicts Released - Released after completion of conviction,2833,80,2913
RAJASTHAN,2003,Convicts Released - Premature release,167,5,172
RAJASTHAN,2003,Convicts Released - Released on appeal,531,25,556
RAJASTHAN,2003,Convicts Released - Released on bail,4297,178,4475
RAJASTHAN,2003,Convicts Released - Pardons,21,0,21
RAJASTHAN,2003,Convicts Released - Transferred to other States,86,7,93
RAJASTHAN,2003,"Convicts Released - Other Releases (due to illness, transferred to Mental hospital)",35,5,40
RAJASTHAN,2003,Total Convicts Released,7970,300,8270
RAJASTHAN,2003,Under trials Released - Acquitted,6259,177,6436
RAJASTHAN,2003,Under trials Released - Released on appeal,630,103,733
RAJASTHAN,2003,Under trials Released - Released on bail,63811,1957,65768
RAJASTHAN,2003,Under trials Released - Transferred to other States,489,41,530
RAJASTHAN,2003,Under trials Released - Extradited,25,0,25
RAJASTHAN,2003,Under trials Released - Other releases (transferred to Mental/Civil hospital),43,10,53
RAJASTHAN,2003,Total Under trials Released,71257,2288,73545
RAJASTHAN,2003,Detenus Released - Released on completion of detention period,3,0,3
RAJASTHAN,2003,Detenus Released - Released before completion of detention period,3,0,3
RAJASTHAN,2003,Detenus Released - Released on bail,5,0,5
RAJASTHAN,2003,Detenus Released - Other releases (temporary transfer etc.),0,0,0
RAJASTHAN,2003,Total Detenus Released,11,0,11
RAJASTHAN,2004,Convicts Released - Released after completion of conviction,2929,24,2953
RAJASTHAN,2004,Convicts Released - Premature release,371,2,373
RAJASTHAN,2004,Convicts Released - Released on appeal,642,2,644
RAJASTHAN,2004,Convicts Released - Released on bail,3797,133,3930
RAJASTHAN,2004,Convicts Released - Pardons,58,0,58
RAJASTHAN,2004,Convicts Released - Transferred to other States,302,14,316
RAJASTHAN,2004,"Convicts Released - Other Releases (due to illness, transferred to Mental hospital)",62,2,64
RAJASTHAN,2004,Total Convicts Released,8161,177,8338
RAJASTHAN,2004,Under trials Released - Acquitted,5702,179,5881
RAJASTHAN,2004,Under trials Released - Released on appeal,181,11,192
RAJASTHAN,2004,Under trials Released - Released on bail,70147,1991,72138
RAJASTHAN,2004,Under trials Released - Transferred to other States,342,47,389
RAJASTHAN,2004,Under trials Released - Extradited,1,0,1
RAJASTHAN,2004,Under trials Released - Other releases (transferred to Mental/Civil hospital),25,19,44
RAJASTHAN,2004,Total Under trials Released,76398,2247,78645
RAJASTHAN,2004,Detenus Released - Released on completion of detention period,3,0,3
RAJASTHAN,2004,Detenus Released - Released before completion of detention period,4,0,4
RAJASTHAN,2004,Detenus Released - Released on bail,0,0,0
RAJASTHAN,2004,Detenus Released - Other releases (temporary transfer etc.),1,0,1
RAJASTHAN,2004,Total Detenus Released,8,0,8
RAJASTHAN,2005,Convicts Released - Released after completion of conviction,2787,72,2859
RAJASTHAN,2005,Convicts Released - Premature release,222,2,224
RAJASTHAN,2005,Convicts Released - Released on appeal,419,1,420
RAJASTHAN,2005,Convicts Released - Released on bail,4000,173,4173
RAJASTHAN,2005,Convicts Released - Pardons,313,2,315
RAJASTHAN,2005,Convicts Released - Transferred to other States,78,4,82
RAJASTHAN,2005,"Convicts Released - Other Releases (due to illness, transferred to Mental hospital)",126,14,140
RAJASTHAN,2005,Total Convicts Released,7945,268,8213
RAJASTHAN,2005,Under trials Released - Acquitted,5000,231,5231
RAJASTHAN,2005,Under trials Released - Released on appeal,189,0,189
RAJASTHAN,2005,Under trials Released - Released on bail,68296,2555,70851
RAJASTHAN,2005,Under trials Released - Transferred to other States,406,82,488
RAJASTHAN,2005,Under trials Released - Extradited,25,3,28
RAJASTHAN,2005,Under trials Released - Other releases (transferred to Mental/Civil hospital),22,8,30
RAJASTHAN,2005,Total Under trials Released,73938,2879,76817
RAJASTHAN,2005,Detenus Released - Released on completion of detention period,18,0,18
RAJASTHAN,2005,Detenus Released - Released before completion of detention period,2,0,2
RAJASTHAN,2005,Detenus Released - Released on bail,2,0,2
RAJASTHAN,2005,Detenus Released - Other releases (temporary transfer etc.),42,0,42
RAJASTHAN,2005,Total Detenus Released,64,0,64
RAJASTHAN,2006,Convicts Released - Released after completion of conviction,3089,34,3123
RAJASTHAN,2006,Convicts Released - Premature release,44,1,45
RAJASTHAN,2006,Convicts Released - Released on appeal,291,11,302
RAJASTHAN,2006,Convicts Released - Released on bail,4835,213,5048
RAJASTHAN,2006,Convicts Released - Pardons,0,0,0
RAJASTHAN,2006,Convicts Released - Transferred to other States,35,0,35
RAJASTHAN,2006,"Convicts Released - Other Releases (due to illness, transferred to Mental hospital)",95,5,100
RAJASTHAN,2006,Total Convicts Released,8389,264,8653
RAJASTHAN,2006,Under trials Released - Acquitted,4701,213,4914
RAJASTHAN,2006,Under trials Released - Released on appeal,660,29,689
RAJASTHAN,2006,Under trials Released - Released on bail,75853,2746,78599
RAJASTHAN,2006,Under trials Released - Transferred to other States,118,1,119
RAJASTHAN,2006,Under trials Released - Extradited,24,0,24
RAJASTHAN,2006,Under trials Released - Other releases (transferred to Mental/Civil hospital),42,14,56
RAJASTHAN,2006,Total Under trials Released,81398,3003,84401
RAJASTHAN,2006,Detenus Released - Released on completion of detention period,5,0,5
RAJASTHAN,2006,Detenus Released - Released before completion of detention period,0,0,0
RAJASTHAN,2006,Detenus Released - Released on bail,0,0,0
RAJASTHAN,2006,Detenus Released - Other releases (temporary transfer etc.),1,0,1
RAJASTHAN,2006,Total Detenus Released,6,0,6
RAJASTHAN,2007,Convicts Released - Released after completion of conviction,2619,62,2681
RAJASTHAN,2007,Convicts Released - Premature release,58,0,58
RAJASTHAN,2007,Convicts Released - Released on appeal,381,34,415
RAJASTHAN,2007,Convicts Released - Released on bail,5194,203,5397
RAJASTHAN,2007,Convicts Released - Pardons,251,0,251
RAJASTHAN,2007,Convicts Released - Transferred to other States,374,9,383
RAJASTHAN,2007,"Convicts Released - Other Releases (due to illness, transferred to Mental hospital)",68,21,89
RAJASTHAN,2007,Total Convicts Released,8945,329,9274
RAJASTHAN,2007,Under trials Released - Acquitted,4432,302,4734
RAJASTHAN,2007,Under trials Released - Released on appeal,2718,35,2753
RAJASTHAN,2007,Under trials Released - Released on bail,73054,3391,76445
RAJASTHAN,2007,Under trials Released - Transferred to other States,482,97,579
RAJASTHAN,2007,Under trials Released - Extradited,2,0,2
RAJASTHAN,2007,Under trials Released - Other releases (transferred to Mental/Civil hospital),94,10,104
RAJASTHAN,2007,Total Under trials Released,80782,3835,84617
RAJASTHAN,2007,Detenus Released - Released on completion of detention period,16,0,16
RAJASTHAN,2007,Detenus Released - Released before completion of detention period,6,0,6
RAJASTHAN,2007,Detenus Released - Released on bail,415,0,415
RAJASTHAN,2007,Detenus Released - Other releases (temporary transfer etc.),4,0,4
RAJASTHAN,2007,Total Detenus Released,441,0,441
RAJASTHAN,2008,Convicts Released - Released after completion of conviction,2253,22,2275
RAJASTHAN,2008,Convicts Released - Premature release,178,3,181
RAJASTHAN,2008,Convicts Released - Released on appeal,564,16,580
RAJASTHAN,2008,Convicts Released - Released on bail,4836,225,5061
RAJASTHAN,2008,Convicts Released - Pardons,50,0,50
RAJASTHAN,2008,Convicts Released - Transferred to other States,197,4,201
RAJASTHAN,2008,"Convicts Released - Other Releases (due to illness, transferred to Mental hospital)",1116,32,1148
RAJASTHAN,2008,Total Convicts Released,9194,302,9496
RAJASTHAN,2008,Under trials Released - Acquitted,6134,316,6450
RAJASTHAN,2008,Under trials Released - Released on appeal,2503,80,2583
RAJASTHAN,2008,Under trials Released - Released on bail,75357,2842,78199
RAJASTHAN,2008,Under trials Released - Transferred to other States,1268,131,1399
RAJASTHAN,2008,Under trials Released - Extradited,0,0,0
RAJASTHAN,2008,Under trials Released - Other releases (transferred to Mental/Civil hospital),249,22,271
RAJASTHAN,2008,Total Under trials Released,85511,3391,88902
RAJASTHAN,2008,Detenus Released - Released on completion of detention period,5,0,5
RAJASTHAN,2008,Detenus Released - Released before completion of detention period,20,0,20
RAJASTHAN,2008,Detenus Released - Released on bail,23,0,23
RAJASTHAN,2008,Detenus Released - Other releases (temporary transfer etc.),8,0,8
RAJASTHAN,2008,Total Detenus Released,56,0,56
RAJASTHAN,2009,Convicts Released - Released after completion of conviction,2275,87,2362
RAJASTHAN,2009,Convicts Released - Premature release,60,3,63
RAJASTHAN,2009,Convicts Released - Released on appeal,601,17,618
RAJASTHAN,2009,Convicts Released - Released on bail,4705,251,4956
RAJASTHAN,2009,Convicts Released - Pardons,3,0,3
RAJASTHAN,2009,Convicts Released - Transferred to other States,274,11,285
RAJASTHAN,2009,"Convicts Released - Other Releases (due to illness, transferred to Mental hospital)",312,18,330
RAJASTHAN,2009,Total Convicts Released,8230,387,8617
RAJASTHAN,2009,Under trials Released - Acquitted,4540,227,4767
RAJASTHAN,2009,Under trials Released - Released on appeal,3507,124,3631
RAJASTHAN,2009,Under trials Released - Released on bail,67291,2794,70085
RAJASTHAN,2009,Under trials Released - Transferred to other States,584,62,646
RAJASTHAN,2009,Under trials Released - Extradited,1,0,1
RAJASTHAN,2009,Under trials Released - Other releases (transferred to Mental/Civil hospital),260,25,285
RAJASTHAN,2009,Total Under trials Released,76183,3232,79415
RAJASTHAN,2009,Detenus Released - Released on completion of detention period,18,0,18
RAJASTHAN,2009,Detenus Released - Released before completion of detention period,10,0,10
RAJASTHAN,2009,Detenus Released - Released on bail,4,0,4
RAJASTHAN,2009,Detenus Released - Other releases (temporary transfer etc.),6,0,6
RAJASTHAN,2009,Total Detenus Released,38,0,38
RAJASTHAN,2010,Convicts Released - Released after completion of conviction,1945,10,1955
RAJASTHAN,2010,Convicts Released - Premature release,26,1,27
RAJASTHAN,2010,Convicts Released - Released on appeal,650,22,672
RAJASTHAN,2010,Convicts Released - Released on bail,4362,156,4518
RAJASTHAN,2010,Convicts Released - Pardons,26,3,29
RAJASTHAN,2010,Convicts Released - Transferred to other States,45,5,50
RAJASTHAN,2010,"Convicts Released - Other Releases (due to illness, transferred to Mental hospital)",726,30,756
RAJASTHAN,2010,Total Convicts Released,7780,227,8007
RAJASTHAN,2010,Under trials Released - Acquitted,5844,194,6038
RAJASTHAN,2010,Under trials Released - Released on appeal,1000,41,1041
RAJASTHAN,2010,Under trials Released - Released on bail,74040,2808,76848
RAJASTHAN,2010,Under trials Released - Transferred to other States,109,0,109
RAJASTHAN,2010,Under trials Released - Extradited,1,0,1
RAJASTHAN,2010,Under trials Released - Other releases (transferred to Mental/Civil hospital),759,214,973
RAJASTHAN,2010,Total Under trials Released,81753,3257,85010
RAJASTHAN,2010,Detenus Released - Released on completion of detention period,144,0,144
RAJASTHAN,2010,Detenus Released - Released before completion of detention period,2,0,2
RAJASTHAN,2010,Detenus Released - Released on bail,443,0,443
RAJASTHAN,2010,Detenus Released - Other releases (temporary transfer etc.),19,0,19
RAJASTHAN,2010,Total Detenus Released,608,0,608
RAJASTHAN,2011,Convicts Released - Released after completion of conviction,2357,7,2364
RAJASTHAN,2011,Convicts Released - Premature release,17,0,17
RAJASTHAN,2011,Convicts Released - Released on appeal,855,13,868
RAJASTHAN,2011,Convicts Released - Released on bail,5057,226,5283
RAJASTHAN,2011,Convicts Released - Pardons,0,1,1
RAJASTHAN,2011,Convicts Released - Transferred to other States,0,0,0
RAJASTHAN,2011,"Convicts Released - Other Releases (due to illness, transferred to Mental hospital)",822,44,866
RAJASTHAN,2011,Total Convicts Released,9108,291,9399
RAJASTHAN,2011,Under trials Released - Acquitted,5395,183,5578
RAJASTHAN,2011,Under trials Released - Released on appeal,1789,63,1852
RAJASTHAN,2011,Under trials Released - Released on bail,76054,2738,78792
RAJASTHAN,2011,Under trials Released - Transferred to other States,0,0,0
RAJASTHAN,2011,Under trials Released - Extradited,0,0,0
RAJASTHAN,2011,Under trials Released - Other releases (transferred to Mental/Civil hospital),1223,243,1466
RAJASTHAN,2011,Total Under trials Released,84461,3227,87688
RAJASTHAN,2011,Detenus Released - Released on completion of detention period,3,0,3
RAJASTHAN,2011,Detenus Released - Released before completion of detention period,3,0,3
RAJASTHAN,2011,Detenus Released - Released on bail,5,0,5
RAJASTHAN,2011,Detenus Released - Other releases (temporary transfer etc.),0,0,0
RAJASTHAN,2011,Total Detenus Released,11,0,11
RAJASTHAN,2012,Convicts Released - Released after completion of conviction,1653,18,1671
RAJASTHAN,2012,Convicts Released - Premature release,100,0,100
RAJASTHAN,2012,Convicts Released - Released on appeal,967,7,974
RAJASTHAN,2012,Convicts Released - Released on bail,2310,464,2774
RAJASTHAN,2012,Convicts Released - Pardons,9,2,11
RAJASTHAN,2012,Convicts Released - Transferred to other States,3,0,3
RAJASTHAN,2012,"Convicts Released - Other Releases (due to illness, transferred to Mental hospital)",609,17,626
RAJASTHAN,2012,Total Convicts Released,5651,508,6159
RAJASTHAN,2012,Under trials Released - Acquitted,5090,164,5254
RAJASTHAN,2012,Under trials Released - Released on appeal,5596,120,5716
RAJASTHAN,2012,Under trials Released - Released on bail,67418,2781,70199
RAJASTHAN,2012,Under trials Released - Transferred to other States,0,0,0
RAJASTHAN,2012,Under trials Released - Extradited,0,0,0
RAJASTHAN,2012,Under trials Released - Other releases (transferred to Mental/Civil hospital),251,33,284
RAJASTHAN,2012,Total Under trials Released,78355,3098,81453
RAJASTHAN,2012,Detenus Released - Released on completion of detention period,3,0,3
RAJASTHAN,2012,Detenus Released - Released before completion of detention period,2,0,2
RAJASTHAN,2012,Detenus Released - Released on bail,0,0,0
RAJASTHAN,2012,Detenus Released - Other releases (temporary transfer etc.),0,0,0
RAJASTHAN,2012,Total Detenus Released,5,0,5
SIKKIM,2001,Convicts Released - Released after completion of conviction,17,0,17
SIKKIM,2001,Convicts Released - Premature release,4,2,6
SIKKIM,2001,Convicts Released - Released on appeal,0,0,0
SIKKIM,2001,Convicts Released - Released on bail,1,0,1
SIKKIM,2001,Convicts Released - Pardons,0,0,0
SIKKIM,2001,Convicts Released - Transferred to other States,0,0,0
SIKKIM,2001,"Convicts Released - Other Releases (due to illness, transferred to Mental hospital)",0,0,0
SIKKIM,2001,Total Convicts Released,22,2,24
SIKKIM,2001,Under trials Released - Acquitted,24,0,24
SIKKIM,2001,Under trials Released - Released on appeal,37,1,38
SIKKIM,2001,Under trials Released - Released on bail,25,0,25
SIKKIM,2001,Under trials Released - Transferred to other States,0,0,0
SIKKIM,2001,Under trials Released - Extradited,0,0,0
SIKKIM,2001,Under trials Released - Other releases (transferred to Mental/Civil hospital),0,0,0
SIKKIM,2001,Total Under trials Released,86,1,87
SIKKIM,2001,Detenus Released - Released on completion of detention period,0,0,0
SIKKIM,2001,Detenus Released - Released before completion of detention period,0,0,0
SIKKIM,2001,Detenus Released - Released on bail,0,0,0
SIKKIM,2001,Detenus Released - Other releases (temporary transfer etc.),0,0,0
SIKKIM,2001,Total Detenus Released,0,0,0
SIKKIM,2002,Convicts Released - Released after completion of conviction,0,0,0
SIKKIM,2002,Convicts Released - Premature release,0,0,0
SIKKIM,2002,Convicts Released - Released on appeal,0,0,0
SIKKIM,2002,Convicts Released - Released on bail,0,0,0
SIKKIM,2002,Convicts Released - Pardons,0,0,0
SIKKIM,2002,Convicts Released - Transferred to other States,0,0,0
SIKKIM,2002,"Convicts Released - Other Releases (due to illness, transferred to Mental hospital)",0,0,0
SIKKIM,2002,Total Convicts Released,0,0,0
SIKKIM,2002,Under trials Released - Acquitted,0,0,0
SIKKIM,2002,Under trials Released - Released on appeal,0,0,0
SIKKIM,2002,Under trials Released - Released on bail,0,0,0
SIKKIM,2002,Under trials Released - Transferred to other States,0,0,0
SIKKIM,2002,Under trials Released - Extradited,0,0,0
SIKKIM,2002,Under trials Released - Other releases (transferred to Mental/Civil hospital),0,0,0
SIKKIM,2002,Total Under trials Released,0,0,0
SIKKIM,2002,Detenus Released - Released on completion of detention period,0,0,0
SIKKIM,2002,Detenus Released - Released before completion of detention period,0,0,0
SIKKIM,2002,Detenus Released - Released on bail,0,0,0
SIKKIM,2002,Detenus Released - Other releases (temporary transfer etc.),0,0,0
SIKKIM,2002,Total Detenus Released,0,0,0
SIKKIM,2003,Convicts Released - Released after completion of conviction,34,0,34
SIKKIM,2003,Convicts Released - Premature release,1,0,1
SIKKIM,2003,Convicts Released - Released on appeal,1,0,1
SIKKIM,2003,Convicts Released - Released on bail,0,0,0
SIKKIM,2003,Convicts Released - Pardons,0,0,0
SIKKIM,2003,Convicts Released - Transferred to other States,0,0,0
SIKKIM,2003,"Convicts Released - Other Releases (due to illness, transferred to Mental hospital)",4,0,4
SIKKIM,2003,Total Convicts Released,40,0,40
SIKKIM,2003,Under trials Released - Acquitted,10,0,10
SIKKIM,2003,Under trials Released - Released on appeal,0,0,0
SIKKIM,2003,Under trials Released - Released on bail,82,0,82
SIKKIM,2003,Under trials Released - Transferred to other States,0,0,0
SIKKIM,2003,Under trials Released - Extradited,0,0,0
SIKKIM,2003,Under trials Released - Other releases (transferred to Mental/Civil hospital),0,0,0
SIKKIM,2003,Total Under trials Released,92,0,92
SIKKIM,2003,Detenus Released - Released on completion of detention period,0,0,0
SIKKIM,2003,Detenus Released - Released before completion of detention period,0,0,0
SIKKIM,2003,Detenus Released - Released on bail,0,0,0
SIKKIM,2003,Detenus Released - Other releases (temporary transfer etc.),0,0,0
SIKKIM,2003,Total Detenus Released,0,0,0
SIKKIM,2004,Convicts Released - Released after completion of conviction,52,1,53
SIKKIM,2004,Convicts Released - Premature release,0,0,0
SIKKIM,2004,Convicts Released - Released on appeal,0,0,0
SIKKIM,2004,Convicts Released - Released on bail,0,0,0
SIKKIM,2004,Convicts Released - Pardons,0,0,0
SIKKIM,2004,Convicts Released - Transferred to other States,1,0,1
SIKKIM,2004,"Convicts Released - Other Releases (due to illness, transferred to Mental hospital)",0,0,0
SIKKIM,2004,Total Convicts Released,53,1,54
SIKKIM,2004,Under trials Released - Acquitted,7,0,7
SIKKIM,2004,Under trials Released - Released on appeal,0,0,0
SIKKIM,2004,Under trials Released - Released on bail,87,3,90
SIKKIM,2004,Under trials Released - Transferred to other States,0,0,0
SIKKIM,2004,Under trials Released - Extradited,0,0,0
SIKKIM,2004,Under trials Released - Other releases (transferred to Mental/Civil hospital),0,0,0
SIKKIM,2004,Total Under trials Released,94,3,97
SIKKIM,2004,Detenus Released - Released on completion of detention period,0,0,0
SIKKIM,2004,Detenus Released - Released before completion of detention period,0,0,0
SIKKIM,2004,Detenus Released - Released on bail,0,0,0
SIKKIM,2004,Detenus Released - Other releases (temporary transfer etc.),0,0,0
SIKKIM,2004,Total Detenus Released,0,0,0
SIKKIM,2005,Convicts Released - Released after completion of conviction,40,0,40
SIKKIM,2005,Convicts Released - Premature release,0,0,0
SIKKIM,2005,Convicts Released - Released on appeal,0,0,0
SIKKIM,2005,Convicts Released - Released on bail,0,0,0
SIKKIM,2005,Convicts Released - Pardons,0,0,0
SIKKIM,2005,Convicts Released - Transferred to other States,0,0,0
SIKKIM,2005,"Convicts Released - Other Releases (due to illness, transferred to Mental hospital)",0,0,0
SIKKIM,2005,Total Convicts Released,40,0,40
SIKKIM,2005,Under trials Released - Acquitted,14,0,14
SIKKIM,2005,Under trials Released - Released on appeal,0,0,0
SIKKIM,2005,Under trials Released - Released on bail,172,6,178
SIKKIM,2005,Under trials Released - Transferred to other States,0,0,0
SIKKIM,2005,Under trials Released - Extradited,0,0,0
SIKKIM,2005,Under trials Released - Other releases (transferred to Mental/Civil hospital),0,0,0
SIKKIM,2005,Total Under trials Released,186,6,192
SIKKIM,2005,Detenus Released - Released on completion of detention period,0,0,0
SIKKIM,2005,Detenus Released - Released before completion of detention period,0,0,0
SIKKIM,2005,Detenus Released - Released on bail,0,0,0
SIKKIM,2005,Detenus Released - Other releases (temporary transfer etc.),0,0,0
SIKKIM,2005,Total Detenus Released,0,0,0
SIKKIM,2006,Convicts Released - Released after completion of conviction,54,3,57
SIKKIM,2006,Convicts Released - Premature release,0,0,0
SIKKIM,2006,Convicts Released - Released on appeal,0,0,0
SIKKIM,2006,Convicts Released - Released on bail,0,0,0
SIKKIM,2006,Convicts Released - Pardons,0,0,0
SIKKIM,2006,Convicts Released - Transferred to other States,0,0,0
SIKKIM,2006,"Convicts Released - Other Releases (due to illness, transferred to Mental hospital)",0,0,0
SIKKIM,2006,Total Convicts Released,54,3,57
SIKKIM,2006,Under trials Released - Acquitted,17,0,17
SIKKIM,2006,Under trials Released - Released on appeal,0,0,0
SIKKIM,2006,Under trials Released - Released on bail,215,8,223
SIKKIM,2006,Under trials Released - Transferred to other States,0,0,0
SIKKIM,2006,Under trials Released - Extradited,0,0,0
SIKKIM,2006,Under trials Released - Other releases (transferred to Mental/Civil hospital),0,0,0
SIKKIM,2006,Total Under trials Released,232,8,240
SIKKIM,2006,Detenus Released - Released on completion of detention period,0,0,0
SIKKIM,2006,Detenus Released - Released before completion of detention period,0,0,0
SIKKIM,2006,Detenus Released - Released on bail,0,0,0
SIKKIM,2006,Detenus Released - Other releases (temporary transfer etc.),0,0,0
SIKKIM,2006,Total Detenus Released,0,0,0
SIKKIM,2007,Convicts Released - Released after completion of conviction,72,6,78
SIKKIM,2007,Convicts Released - Premature release,1,0,1
SIKKIM,2007,Convicts Released - Released on appeal,2,0,2
SIKKIM,2007,Convicts Released - Released on bail,3,2,5
SIKKIM,2007,Convicts Released - Pardons,0,0,0
SIKKIM,2007,Convicts Released - Transferred to other States,1,0,1
SIKKIM,2007,"Convicts Released - Other Releases (due to illness, transferred to Mental hospital)",0,0,0
SIKKIM,2007,Total Convicts Released,79,8,87
SIKKIM,2007,Under trials Released - Acquitted,18,3,21
SIKKIM,2007,Under trials Released - Released on appeal,0,0,0
SIKKIM,2007,Under trials Released - Released on bail,246,8,254
SIKKIM,2007,Under trials Released - Transferred to other States,0,0,0
SIKKIM,2007,Under trials Released - Extradited,0,0,0
SIKKIM,2007,Under trials Released - Other releases (transferred to Mental/Civil hospital),0,0,0
SIKKIM,2007,Total Under trials Released,264,11,275
SIKKIM,2007,Detenus Released - Released on completion of detention period,0,0,0
SIKKIM,2007,Detenus Released - Released before completion of detention period,0,0,0
SIKKIM,2007,Detenus Released - Released on bail,0,0,0
SIKKIM,2007,Detenus Released - Other releases (temporary transfer etc.),0,0,0
SIKKIM,2007,Total Detenus Released,0,0,0
SIKKIM,2008,Convicts Released - Released after completion of conviction,77,1,78
SIKKIM,2008,Convicts Released - Premature release,0,0,0
SIKKIM,2008,Convicts Released - Released on appeal,2,0,2
SIKKIM,2008,Convicts Released - Released on bail,5,0,5
SIKKIM,2008,Convicts Released - Pardons,0,0,0
SIKKIM,2008,Convicts Released - Transferred to other States,2,0,2
SIKKIM,2008,"Convicts Released - Other Releases (due to illness, transferred to Mental hospital)",0,0,0
SIKKIM,2008,Total Convicts Released,86,1,87
SIKKIM,2008,Under trials Released - Acquitted,23,1,24
SIKKIM,2008,Under trials Released - Released on appeal,0,0,0
SIKKIM,2008,Under trials Released - Released on bail,297,18,315
SIKKIM,2008,Under trials Released - Transferred to other States,0,0,0
SIKKIM,2008,Under trials Released - Extradited,0,0,0
SIKKIM,2008,Under trials Released - Other releases (transferred to Mental/Civil hospital),0,0,0
SIKKIM,2008,Total Under trials Released,320,19,339
SIKKIM,2008,Detenus Released - Released on completion of detention period,0,0,0
SIKKIM,2008,Detenus Released - Released before completion of detention period,0,0,0
SIKKIM,2008,Detenus Released - Released on bail,0,0,0
SIKKIM,2008,Detenus Released - Other releases (temporary transfer etc.),0,0,0
SIKKIM,2008,Total Detenus Released,0,0,0
SIKKIM,2009,Convicts Released - Released after completion of conviction,103,5,108
SIKKIM,2009,Convicts Released - Premature release,0,0,0
SIKKIM,2009,Convicts Released - Released on appeal,0,0,0
SIKKIM,2009,Convicts Released - Released on bail,4,0,4
SIKKIM,2009,Convicts Released - Pardons,0,0,0
SIKKIM,2009,Convicts Released - Transferred to other States,0,0,0
SIKKIM,2009,"Convicts Released - Other Releases (due to illness, transferred to Mental hospital)",0,0,0
SIKKIM,2009,Total Convicts Released,107,5,112
SIKKIM,2009,Under trials Released - Acquitted,38,0,38
SIKKIM,2009,Under trials Released - Released on appeal,0,0,0
SIKKIM,2009,Under trials Released - Released on bail,261,21,282
SIKKIM,2009,Under trials Released - Transferred to other States,0,0,0
SIKKIM,2009,Under trials Released - Extradited,0,0,0
SIKKIM,2009,Under trials Released - Other releases (transferred to Mental/Civil hospital),0,0,0
SIKKIM,2009,Total Under trials Released,299,21,320
SIKKIM,2009,Detenus Released - Released on completion of detention period,0,0,0
SIKKIM,2009,Detenus Released - Released before completion of detention period,0,0,0
SIKKIM,2009,Detenus Released - Released on bail,0,0,0
SIKKIM,2009,Detenus Released - Other releases (temporary transfer etc.),0,0,0
SIKKIM,2009,Total Detenus Released,0,0,0
SIKKIM,2010,Convicts Released - Released after completion of conviction,78,2,80
SIKKIM,2010,Convicts Released - Premature release,0,0,0
SIKKIM,2010,Convicts Released - Released on appeal,3,0,3
SIKKIM,2010,Convicts Released - Released on bail,2,0,2
SIKKIM,2010,Convicts Released - Pardons,0,0,0
SIKKIM,2010,Convicts Released - Transferred to other States,0,0,0
SIKKIM,2010,"Convicts Released - Other Releases (due to illness, transferred to Mental hospital)",0,0,0
SIKKIM,2010,Total Convicts Released,83,2,85
SIKKIM,2010,Under trials Released - Acquitted,33,0,33
SIKKIM,2010,Under trials Released - Released on appeal,0,0,0
SIKKIM,2010,Under trials Released - Released on bail,273,12,285
SIKKIM,2010,Under trials Released - Transferred to other States,0,0,0
SIKKIM,2010,Under trials Released - Extradited,0,0,0
SIKKIM,2010,Under trials Released - Other releases (transferred to Mental/Civil hospital),0,0,0
SIKKIM,2010,Total Under trials Released,306,12,318
SIKKIM,2010,Detenus Released - Released on completion of detention period,0,0,0
SIKKIM,2010,Detenus Released - Released before completion of detention period,0,0,0
SIKKIM,2010,Detenus Released - Released on bail,0,0,0
SIKKIM,2010,Detenus Released - Other releases (temporary transfer etc.),0,0,0
SIKKIM,2010,Total Detenus Released,0,0,0
SIKKIM,2011,Convicts Released - Released after completion of conviction,61,3,64
SIKKIM,2011,Convicts Released - Premature release,0,0,0
SIKKIM,2011,Convicts Released - Released on appeal,0,0,0
SIKKIM,2011,Convicts Released - Released on bail,0,0,0
SIKKIM,2011,Convicts Released - Pardons,0,0,0
SIKKIM,2011,Convicts Released - Transferred to other States,0,0,0
SIKKIM,2011,"Convicts Released - Other Releases (due to illness, transferred to Mental hospital)",0,0,0
SIKKIM,2011,Total Convicts Released,61,3,64
SIKKIM,2011,Under trials Released - Acquitted,25,0,25
SIKKIM,2011,Under trials Released - Released on appeal,0,0,0
SIKKIM,2011,Under trials Released - Released on bail,226,10,236
SIKKIM,2011,Under trials Released - Transferred to other States,0,0,0
SIKKIM,2011,Under trials Released - Extradited,0,0,0
SIKKIM,2011,Under trials Released - Other releases (transferred to Mental/Civil hospital),0,0,0
SIKKIM,2011,Total Under trials Released,251,10,261
SIKKIM,2011,Detenus Released - Released on completion of detention period,0,0,0
SIKKIM,2011,Detenus Released - Released before completion of detention period,0,0,0
SIKKIM,2011,Detenus Released - Released on bail,0,0,0
SIKKIM,2011,Detenus Released - Other releases (temporary transfer etc.),0,0,0
SIKKIM,2011,Total Detenus Released,0,0,0
SIKKIM,2012,Convicts Released - Released after completion of conviction,72,1,73
SIKKIM,2012,Convicts Released - Premature release,0,0,0
SIKKIM,2012,Convicts Released - Released on appeal,2,0,2
SIKKIM,2012,Convicts Released - Released on bail,4,1,5
SIKKIM,2012,Convicts Released - Pardons,0,0,0
SIKKIM,2012,Convicts Released - Transferred to other States,0,0,0
SIKKIM,2012,"Convicts Released - Other Releases (due to illness, transferred to Mental hospital)",0,0,0
SIKKIM,2012,Total Convicts Released,78,2,80
SIKKIM,2012,Under trials Released - Acquitted,32,1,33
SIKKIM,2012,Under trials Released - Released on appeal,0,0,0
SIKKIM,2012,Under trials Released - Released on bail,273,5,278
SIKKIM,2012,Under trials Released - Transferred to other States,0,0,0
SIKKIM,2012,Under trials Released - Extradited,0,0,0
SIKKIM,2012,Under trials Released - Other releases (transferred to Mental/Civil hospital),0,0,0
SIKKIM,2012,Total Under trials Released,305,6,311
SIKKIM,2012,Detenus Released - Released on completion of detention period,0,0,0
SIKKIM,2012,Detenus Released - Released before completion of detention period,0,0,0
SIKKIM,2012,Detenus Released - Released on bail,0,0,0
SIKKIM,2012,Detenus Released - Other releases (temporary transfer etc.),0,0,0
SIKKIM,2012,Total Detenus Released,0,0,0
TAMILNADU,2001,Convicts Released - Released after completion of conviction,4417,213,4630
TAMILNADU,2001,Convicts Released - Premature release,568,12,580
TAMILNADU,2001,Convicts Released - Released on appeal,103,10,113
TAMILNADU,2001,Convicts Released - Released on bail,1147,70,1217
TAMILNADU,2001,Convicts Released - Pardons,83,0,83
TAMILNADU,2001,Convicts Released - Transferred to other States,145,8,153
TAMILNADU,2001,"Convicts Released - Other Releases (due to illness, transferred to Mental hospital)",251,0,251
TAMILNADU,2001,Total Convicts Released,6714,313,7027
TAMILNADU,2001,Under trials Released - Acquitted,357,12,369
TAMILNADU,2001,Under trials Released - Released on appeal,0,0,0
TAMILNADU,2001,Under trials Released - Released on bail,10347,82,10429
TAMILNADU,2001,Under trials Released - Transferred to other States,5,1,6
TAMILNADU,2001,Under trials Released - Extradited,132,0,132
TAMILNADU,2001,Under trials Released - Other releases (transferred to Mental/Civil hospital),0,0,0
TAMILNADU,2001,Total Under trials Released,10841,95,10936
TAMILNADU,2001,Detenus Released - Released on completion of detention period,1420,74,1494
TAMILNADU,2001,Detenus Released - Released before completion of detention period,0,0,0
TAMILNADU,2001,Detenus Released - Released on bail,0,0,0
TAMILNADU,2001,Detenus Released - Other releases (temporary transfer etc.),0,0,0
TAMILNADU,2001,Total Detenus Released,1420,74,1494
TAMILNADU,2002,Convicts Released - Released after completion of conviction,4865,224,5089
TAMILNADU,2002,Convicts Released - Premature release,16,0,16
TAMILNADU,2002,Convicts Released - Released on appeal,222,11,233
TAMILNADU,2002,Convicts Released - Released on bail,1247,102,1349
TAMILNADU,2002,Convicts Released - Pardons,27,0,27
TAMILNADU,2002,Convicts Released - Transferred to other States,314,4,318
TAMILNADU,2002,"Convicts Released - Other Releases (due to illness, transferred to Mental hospital)",3,0,3
TAMILNADU,2002,Total Convicts Released,6694,341,7035
TAMILNADU,2002,Under trials Released - Acquitted,487,13,500
TAMILNADU,2002,Under trials Released - Released on appeal,7458,0,7458
TAMILNADU,2002,Under trials Released - Released on bail,3693,118,3811
TAMILNADU,2002,Under trials Released - Transferred to other States,0,0,0
TAMILNADU,2002,Under trials Released - Extradited,132,0,132
TAMILNADU,2002,Under trials Released - Other releases (transferred to Mental/Civil hospital),12,0,12
TAMILNADU,2002,Total Under trials Released,11782,131,11913
TAMILNADU,2002,Detenus Released - Released on completion of detention period,532,150,682
TAMILNADU,2002,Detenus Released - Released before completion of detention period,518,0,518
TAMILNADU,2002,Detenus Released - Released on bail,55,0,55
TAMILNADU,2002,Detenus Released - Other releases (temporary transfer etc.),67,111,178
TAMILNADU,2002,Total Detenus Released,1172,261,1433
TAMILNADU,2003,Convicts Released - Released after completion of conviction,4965,225,5190
TAMILNADU,2003,Convicts Released - Premature release,18,0,18
TAMILNADU,2003,Convicts Released - Released on appeal,225,13,238
TAMILNADU,2003,Convicts Released - Released on bail,1260,115,1375
TAMILNADU,2003,Convicts Released - Pardons,29,0,29
TAMILNADU,2003,Convicts Released - Transferred to other States,315,5,320
TAMILNADU,2003,"Convicts Released - Other Releases (due to illness, transferred to Mental hospital)",4,0,4
TAMILNADU,2003,Total Convicts Released,6816,358,7174
TAMILNADU,2003,Under trials Released - Acquitted,497,14,511
TAMILNADU,2003,Under trials Released - Released on appeal,7516,0,7516
TAMILNADU,2003,Under trials Released - Released on bail,3817,121,3938
TAMILNADU,2003,Under trials Released - Transferred to other States,0,0,0
TAMILNADU,2003,Under trials Released - Extradited,135,0,135
TAMILNADU,2003,Under trials Released - Other releases (transferred to Mental/Civil hospital),14,0,14
TAMILNADU,2003,Total Under trials Released,11979,135,12114
TAMILNADU,2003,Detenus Released - Released on completion of detention period,0,0,0
TAMILNADU,2003,Detenus Released - Released before completion of detention period,0,0,0
TAMILNADU,2003,Detenus Released - Released on bail,0,0,0
TAMILNADU,2003,Detenus Released - Other releases (temporary transfer etc.),0,0,0
TAMILNADU,2003,Total Detenus Released,0,0,0
TAMILNADU,2004,Convicts Released - Released after completion of conviction,2796,176,2972
TAMILNADU,2004,Convicts Released - Premature release,42,0,42
TAMILNADU,2004,Convicts Released - Released on appeal,537,17,554
TAMILNADU,2004,Convicts Released - Released on bail,1467,127,1594
TAMILNADU,2004,Convicts Released - Pardons,0,0,0
TAMILNADU,2004,Convicts Released - Transferred to other States,4,0,4
TAMILNADU,2004,"Convicts Released - Other Releases (due to illness, transferred to Mental hospital)",0,25,25
TAMILNADU,2004,Total Convicts Released,4846,345,5191
TAMILNADU,2004,Under trials Released - Acquitted,0,0,0
TAMILNADU,2004,Under trials Released - Released on appeal,1013,79,1092
TAMILNADU,2004,Under trials Released - Released on bail,50,2,52
TAMILNADU,2004,Under trials Released - Transferred to other States,3664,103,3767
TAMILNADU,2004,Under trials Released - Extradited,0,0,0
TAMILNADU,2004,Under trials Released - Other releases (transferred to Mental/Civil hospital),0,0,0
TAMILNADU,2004,Total Under trials Released,4727,184,4911
TAMILNADU,2004,Detenus Released - Released on completion of detention period,270,46,316
TAMILNADU,2004,Detenus Released - Released before completion of detention period,140,16,156
TAMILNADU,2004,Detenus Released - Released on bail,0,0,0
TAMILNADU,2004,Detenus Released - Other releases (temporary transfer etc.),0,0,0
TAMILNADU,2004,Total Detenus Released,410,62,472
TAMILNADU,2005,Convicts Released - Released after completion of conviction,5017,268,5285
TAMILNADU,2005,Convicts Released - Premature release,906,0,906
TAMILNADU,2005,Convicts Released - Released on appeal,605,87,692
TAMILNADU,2005,Convicts Released - Released on bail,180,0,180
TAMILNADU,2005,Convicts Released - Pardons,0,0,0
TAMILNADU,2005,Convicts Released - Transferred to other States,0,0,0
TAMILNADU,2005,"Convicts Released - Other Releases (due to illness, transferred to Mental hospital)",5,0,5
TAMILNADU,2005,Total Convicts Released,6713,355,7068
TAMILNADU,2005,Under trials Released - Acquitted,884,62,946
TAMILNADU,2005,Under trials Released - Released on appeal,1123,2,1125
TAMILNADU,2005,Under trials Released - Released on bail,10163,68,10231
TAMILNADU,2005,Under trials Released - Transferred to other States,0,15,15
TAMILNADU,2005,Under trials Released - Extradited,0,0,0
TAMILNADU,2005,Under trials Released - Other releases (transferred to Mental/Civil hospital),0,0,0
TAMILNADU,2005,Total Under trials Released,12170,147,12317
TAMILNADU,2005,Detenus Released - Released on completion of detention period,250,40,290
TAMILNADU,2005,Detenus Released - Released before completion of detention period,150,18,168
TAMILNADU,2005,Detenus Released - Released on bail,0,0,0
TAMILNADU,2005,Detenus Released - Other releases (temporary transfer etc.),0,0,0
TAMILNADU,2005,Total Detenus Released,400,58,458
TAMILNADU,2006,Convicts Released - Released after completion of conviction,5025,270,5295
TAMILNADU,2006,Convicts Released - Premature release,460,16,476
TAMILNADU,2006,Convicts Released - Released on appeal,610,91,701
TAMILNADU,2006,Convicts Released - Released on bail,170,0,170
TAMILNADU,2006,Convicts Released - Pardons,0,0,0
TAMILNADU,2006,Convicts Released - Transferred to other States,0,0,0
TAMILNADU,2006,"Convicts Released - Other Releases (due to illness, transferred to Mental hospital)",5,0,5
TAMILNADU,2006,Total Convicts Released,6270,377,6647
TAMILNADU,2006,Under trials Released - Acquitted,772,67,839
TAMILNADU,2006,Under trials Released - Released on appeal,1117,3,1120
TAMILNADU,2006,Under trials Released - Released on bail,10170,72,10242
TAMILNADU,2006,Under trials Released - Transferred to other States,0,0,0
TAMILNADU,2006,Under trials Released - Extradited,0,0,0
TAMILNADU,2006,Under trials Released - Other releases (transferred to Mental/Civil hospital),0,0,0
TAMILNADU,2006,Total Under trials Released,12059,142,12201
TAMILNADU,2006,Detenus Released - Released on completion of detention period,260,45,305
TAMILNADU,2006,Detenus Released - Released before completion of detention period,165,17,182
TAMILNADU,2006,Detenus Released - Released on bail,0,0,0
TAMILNADU,2006,Detenus Released - Other releases (temporary transfer etc.),0,0,0
TAMILNADU,2006,Total Detenus Released,425,62,487
TAMILNADU,2007,Convicts Released - Released after completion of conviction,1802,165,1967
TAMILNADU,2007,Convicts Released - Premature release,212,5,217
TAMILNADU,2007,Convicts Released - Released on appeal,234,16,250
TAMILNADU,2007,Convicts Released - Released on bail,1407,139,1546
TAMILNADU,2007,Convicts Released - Pardons,0,3,3
TAMILNADU,2007,Convicts Released - Transferred to other States,0,0,0
TAMILNADU,2007,"Convicts Released - Other Releases (due to illness, transferred to Mental hospital)",561,24,585
TAMILNADU,2007,Total Convicts Released,4216,352,4568
TAMILNADU,2007,Under trials Released - Acquitted,751,23,774
TAMILNADU,2007,Under trials Released - Released on appeal,0,2,2
TAMILNADU,2007,Under trials Released - Released on bail,12383,72,12455
TAMILNADU,2007,Under trials Released - Transferred to other States,0,0,0
TAMILNADU,2007,Under trials Released - Extradited,0,0,0
TAMILNADU,2007,Under trials Released - Other releases (transferred to Mental/Civil hospital),0,0,0
TAMILNADU,2007,Total Under trials Released,13134,97,13231
TAMILNADU,2007,Detenus Released - Released on completion of detention period,0,0,0
TAMILNADU,2007,Detenus Released - Released before completion of detention period,0,0,0
TAMILNADU,2007,Detenus Released - Released on bail,0,0,0
TAMILNADU,2007,Detenus Released - Other releases (temporary transfer etc.),0,0,0
TAMILNADU,2007,Total Detenus Released,0,0,0
TAMILNADU,2008,Convicts Released - Released after completion of conviction,2076,182,2258
TAMILNADU,2008,Convicts Released - Premature release,1379,22,1401
TAMILNADU,2008,Convicts Released - Released on appeal,178,17,195
TAMILNADU,2008,Convicts Released - Released on bail,1039,81,1120
TAMILNADU,2008,Convicts Released - Pardons,5,16,21
TAMILNADU,2008,Convicts Released - Transferred to other States,268,5,273
TAMILNADU,2008,"Convicts Released - Other Releases (due to illness, transferred to Mental hospital)",4825,323,5148
TAMILNADU,2008,Total Convicts Released,9770,646,10416
TAMILNADU,2008,Under trials Released - Acquitted,754,1313,2067
TAMILNADU,2008,Under trials Released - Released on appeal,0,0,0
TAMILNADU,2008,Under trials Released - Released on bail,41877,3143,45020
TAMILNADU,2008,Under trials Released - Transferred to other States,0,0,0
TAMILNADU,2008,Under trials Released - Extradited,0,0,0
TAMILNADU,2008,Under trials Released - Other releases (transferred to Mental/Civil hospital),0,0,0
TAMILNADU,2008,Total Under trials Released,42631,4456,47087
TAMILNADU,2008,Detenus Released - Released on completion of detention period,724,21,745
TAMILNADU,2008,Detenus Released - Released before completion of detention period,89,0,89
TAMILNADU,2008,Detenus Released - Released on bail,21251,8262,29513
TAMILNADU,2008,Detenus Released - Other releases (temporary transfer etc.),7,2,9
TAMILNADU,2008,Total Detenus Released,22071,8285,30356
TAMILNADU,2009,Convicts Released - Released after completion of conviction,2883,240,3123
TAMILNADU,2009,Convicts Released - Premature release,10,0,10
TAMILNADU,2009,Convicts Released - Released on appeal,270,28,298
TAMILNADU,2009,Convicts Released - Released on bail,881,43,924
TAMILNADU,2009,Convicts Released - Pardons,1,0,1
TAMILNADU,2009,Convicts Released - Transferred to other States,64,0,64
TAMILNADU,2009,"Convicts Released - Other Releases (due to illness, transferred to Mental hospital)",401,65,466
TAMILNADU,2009,Total Convicts Released,4510,376,4886
TAMILNADU,2009,Under trials Released - Acquitted,1184,868,2052
TAMILNADU,2009,Under trials Released - Released on appeal,120,0,120
TAMILNADU,2009,Under trials Released - Released on bail,46030,7904,53934
TAMILNADU,2009,Under trials Released - Transferred to other States,3,0,3
TAMILNADU,2009,Under trials Released - Extradited,0,0,0
TAMILNADU,2009,Under trials Released - Other releases (transferred to Mental/Civil hospital),71,0,71
TAMILNADU,2009,Total Under trials Released,47408,8772,56180
TAMILNADU,2009,Detenus Released - Released on completion of detention period,383,0,383
TAMILNADU,2009,Detenus Released - Released before completion of detention period,18,0,18
TAMILNADU,2009,Detenus Released - Released on bail,2,0,2
TAMILNADU,2009,Detenus Released - Other releases (temporary transfer etc.),0,0,0
TAMILNADU,2009,Total Detenus Released,403,0,403
TAMILNADU,2010,Convicts Released - Released after completion of conviction,3854,132,3986
TAMILNADU,2010,Convicts Released - Premature release,15,1,16
TAMILNADU,2010,Convicts Released - Released on appeal,229,13,242
TAMILNADU,2010,Convicts Released - Released on bail,604,28,632
TAMILNADU,2010,Convicts Released - Pardons,1,0,1
TAMILNADU,2010,Convicts Released - Transferred to other States,4,6,10
TAMILNADU,2010,"Convicts Released - Other Releases (due to illness, transferred to Mental hospital)",76,23,99
TAMILNADU,2010,Total Convicts Released,4783,203,4986
TAMILNADU,2010,Under trials Released - Acquitted,1235,12,1247
TAMILNADU,2010,Under trials Released - Released on appeal,88,0,88
TAMILNADU,2010,Under trials Released - Released on bail,58462,5718,64180
TAMILNADU,2010,Under trials Released - Transferred to other States,0,0,0
TAMILNADU,2010,Under trials Released - Extradited,0,1,1
TAMILNADU,2010,Under trials Released - Other releases (transferred to Mental/Civil hospital),92,18,110
TAMILNADU,2010,Total Under trials Released,59877,5749,65626
TAMILNADU,2010,Detenus Released - Released on completion of detention period,393,15,408
TAMILNADU,2010,Detenus Released - Released before completion of detention period,31,0,31
TAMILNADU,2010,Detenus Released - Released on bail,0,0,0
TAMILNADU,2010,Detenus Released - Other releases (temporary transfer etc.),0,0,0
TAMILNADU,2010,Total Detenus Released,424,15,439
TAMILNADU,2011,Convicts Released - Released after completion of conviction,2427,121,2548
TAMILNADU,2011,Convicts Released - Premature release,4,0,4
TAMILNADU,2011,Convicts Released - Released on appeal,433,23,456
TAMILNADU,2011,Convicts Released - Released on bail,1095,72,1167
TAMILNADU,2011,Convicts Released - Pardons,0,0,0
TAMILNADU,2011,Convicts Released - Transferred to other States,4,0,4
TAMILNADU,2011,"Convicts Released - Other Releases (due to illness, transferred to Mental hospital)",65,1,66
TAMILNADU,2011,Total Convicts Released,4028,217,4245
TAMILNADU,2011,Under trials Released - Acquitted,1254,116,1370
TAMILNADU,2011,Under trials Released - Released on appeal,46,0,46
TAMILNADU,2011,Under trials Released - Released on bail,52211,6571,58782
TAMILNADU,2011,Under trials Released - Transferred to other States,0,0,0
TAMILNADU,2011,Under trials Released - Extradited,0,0,0
TAMILNADU,2011,Under trials Released - Other releases (transferred to Mental/Civil hospital),43,36,79
TAMILNADU,2011,Total Under trials Released,53554,6723,60277
TAMILNADU,2011,Detenus Released - Released on completion of detention period,132,14,146
TAMILNADU,2011,Detenus Released - Released before completion of detention period,760,37,797
TAMILNADU,2011,Detenus Released - Released on bail,0,0,0
TAMILNADU,2011,Detenus Released - Other releases (temporary transfer etc.),0,0,0
TAMILNADU,2011,Total Detenus Released,892,51,943
TAMILNADU,2012,Convicts Released - Released after completion of conviction,1904,83,1987
TAMILNADU,2012,Convicts Released - Premature release,31,31,62
TAMILNADU,2012,Convicts Released - Released on appeal,849,20,869
TAMILNADU,2012,Convicts Released - Released on bail,610,64,674
TAMILNADU,2012,Convicts Released - Pardons,0,0,0
TAMILNADU,2012,Convicts Released - Transferred to other States,4,8,12
TAMILNADU,2012,"Convicts Released - Other Releases (due to illness, transferred to Mental hospital)",315,0,315
TAMILNADU,2012,Total Convicts Released,3713,206,3919
TAMILNADU,2012,Under trials Released - Acquitted,864,134,998
TAMILNADU,2012,Under trials Released - Released on appeal,0,0,0
TAMILNADU,2012,Under trials Released - Released on bail,60847,5782,66629
TAMILNADU,2012,Under trials Released - Transferred to other States,0,0,0
TAMILNADU,2012,Under trials Released - Extradited,0,0,0
TAMILNADU,2012,Under trials Released - Other releases (transferred to Mental/Civil hospital),25,1,26
TAMILNADU,2012,Total Under trials Released,61736,5917,67653
TAMILNADU,2012,Detenus Released - Released on completion of detention period,1640,0,1640
TAMILNADU,2012,Detenus Released - Released before completion of detention period,1539,38,1577
TAMILNADU,2012,Detenus Released - Released on bail,0,0,0
TAMILNADU,2012,Detenus Released - Other releases (temporary transfer etc.),11,0,11
TAMILNADU,2012,Total Detenus Released,3190,38,3228
TRIPURA,2001,Convicts Released - Released after completion of conviction,309,2,311
TRIPURA,2001,Convicts Released - Premature release,29,0,29
TRIPURA,2001,Convicts Released - Released on appeal,171,0,171
TRIPURA,2001,Convicts Released - Released on bail,445,2,447
TRIPURA,2001,Convicts Released - Pardons,0,0,0
TRIPURA,2001,Convicts Released - Transferred to other States,0,0,0
TRIPURA,2001,"Convicts Released - Other Releases (due to illness, transferred to Mental hospital)",0,0,0
TRIPURA,2001,Total Convicts Released,954,4,958
TRIPURA,2001,Under trials Released - Acquitted,28,4,32
TRIPURA,2001,Under trials Released - Released on appeal,50,2,52
TRIPURA,2001,Under trials Released - Released on bail,22,1,23
TRIPURA,2001,Under trials Released - Transferred to other States,0,0,0
TRIPURA,2001,Under trials Released - Extradited,0,0,0
TRIPURA,2001,Under trials Released - Other releases (transferred to Mental/Civil hospital),50,0,50
TRIPURA,2001,Total Under trials Released,150,7,157
TRIPURA,2001,Detenus Released - Released on completion of detention period,1,0,1
TRIPURA,2001,Detenus Released - Released before completion of detention period,0,0,0
TRIPURA,2001,Detenus Released - Released on bail,0,0,0
TRIPURA,2001,Detenus Released - Other releases (temporary transfer etc.),2,0,2
TRIPURA,2001,Total Detenus Released,3,0,3
TRIPURA,2002,Convicts Released - Released after completion of conviction,435,5,440
TRIPURA,2002,Convicts Released - Premature release,25,1,26
TRIPURA,2002,Convicts Released - Released on appeal,30,2,32
TRIPURA,2002,Convicts Released - Released on bail,92,0,92
TRIPURA,2002,Convicts Released - Pardons,7,0,7
TRIPURA,2002,Convicts Released - Transferred to other States,107,0,107
TRIPURA,2002,"Convicts Released - Other Releases (due to illness, transferred to Mental hospital)",0,0,0
TRIPURA,2002,Total Convicts Released,696,8,704
TRIPURA,2002,Under trials Released - Acquitted,35,5,40
TRIPURA,2002,Under trials Released - Released on appeal,87,4,91
TRIPURA,2002,Under trials Released - Released on bail,25,2,27
TRIPURA,2002,Under trials Released - Transferred to other States,5,0,5
TRIPURA,2002,Under trials Released - Extradited,6,0,6
TRIPURA,2002,Under trials Released - Other releases (transferred to Mental/Civil hospital),39,0,39
TRIPURA,2002,Total Under trials Released,197,11,208
TRIPURA,2002,Detenus Released - Released on completion of detention period,18,0,18
TRIPURA,2002,Detenus Released - Released before completion of detention period,0,0,0
TRIPURA,2002,Detenus Released - Released on bail,0,0,0
TRIPURA,2002,Detenus Released - Other releases (temporary transfer etc.),0,0,0
TRIPURA,2002,Total Detenus Released,18,0,18
TRIPURA,2003,Convicts Released - Released after completion of conviction,364,7,371
TRIPURA,2003,Convicts Released - Premature release,40,1,41
TRIPURA,2003,Convicts Released - Released on appeal,50,1,51
TRIPURA,2003,Convicts Released - Released on bail,75,0,75
TRIPURA,2003,Convicts Released - Pardons,4,0,4
TRIPURA,2003,Convicts Released - Transferred to other States,91,0,91
TRIPURA,2003,"Convicts Released - Other Releases (due to illness, transferred to Mental hospital)",0,0,0
TRIPURA,2003,Total Convicts Released,624,9,633
TRIPURA,2003,Under trials Released - Acquitted,44,4,48
TRIPURA,2003,Under trials Released - Released on appeal,99,1,100
TRIPURA,2003,Under trials Released - Released on bail,53,2,55
TRIPURA,2003,Under trials Released - Transferred to other States,8,3,11
TRIPURA,2003,Under trials Released - Extradited,9,0,9
TRIPURA,2003,Under trials Released - Other releases (transferred to Mental/Civil hospital),14,0,14
TRIPURA,2003,Total Under trials Released,227,10,237
TRIPURA,2003,Detenus Released - Released on completion of detention period,4,0,4
TRIPURA,2003,Detenus Released - Released before completion of detention period,0,0,0
TRIPURA,2003,Detenus Released - Released on bail,0,0,0
TRIPURA,2003,Detenus Released - Other releases (temporary transfer etc.),0,0,0
TRIPURA,2003,Total Detenus Released,4,0,4
TRIPURA,2004,Convicts Released - Released after completion of conviction,556,30,586
TRIPURA,2004,Convicts Released - Premature release,8,0,8
TRIPURA,2004,Convicts Released - Released on appeal,18,0,18
TRIPURA,2004,Convicts Released - Released on bail,14,2,16
TRIPURA,2004,Convicts Released - Pardons,3,0,3
TRIPURA,2004,Convicts Released - Transferred to other States,24,0,24
TRIPURA,2004,"Convicts Released - Other Releases (due to illness, transferred to Mental hospital)",0,0,0
TRIPURA,2004,Total Convicts Released,623,32,655
TRIPURA,2004,Under trials Released - Acquitted,104,10,114
TRIPURA,2004,Under trials Released - Released on appeal,0,0,0
TRIPURA,2004,Under trials Released - Released on bail,81,0,81
TRIPURA,2004,Under trials Released - Transferred to other States,10,0,10
TRIPURA,2004,Under trials Released - Extradited,12,0,12
TRIPURA,2004,Under trials Released - Other releases (transferred to Mental/Civil hospital),7,0,7
TRIPURA,2004,Total Under trials Released,214,10,224
TRIPURA,2004,Detenus Released - Released on completion of detention period,0,0,0
TRIPURA,2004,Detenus Released - Released before completion of detention period,0,0,0
TRIPURA,2004,Detenus Released - Released on bail,0,0,0
TRIPURA,2004,Detenus Released - Other releases (temporary transfer etc.),0,0,0
TRIPURA,2004,Total Detenus Released,0,0,0
TRIPURA,2005,Convicts Released - Released after completion of conviction,669,72,741
TRIPURA,2005,Convicts Released - Premature release,0,0,0
TRIPURA,2005,Convicts Released - Released on appeal,24,0,24
TRIPURA,2005,Convicts Released - Released on bail,46,1,47
TRIPURA,2005,Convicts Released - Pardons,1,0,1
TRIPURA,2005,Convicts Released - Transferred to other States,1,0,1
TRIPURA,2005,"Convicts Released - Other Releases (due to illness, transferred to Mental hospital)",45,0,45
TRIPURA,2005,Total Convicts Released,786,73,859
TRIPURA,2005,Under trials Released - Acquitted,190,12,202
TRIPURA,2005,Under trials Released - Released on appeal,81,0,81
TRIPURA,2005,Under trials Released - Released on bail,283,55,338
TRIPURA,2005,Under trials Released - Transferred to other States,4,0,4
TRIPURA,2005,Under trials Released - Extradited,0,0,0
TRIPURA,2005,Under trials Released - Other releases (transferred to Mental/Civil hospital),6,0,6
TRIPURA,2005,Total Under trials Released,564,67,631
TRIPURA,2005,Detenus Released - Released on completion of detention period,0,0,0
TRIPURA,2005,Detenus Released - Released before completion of detention period,0,0,0
TRIPURA,2005,Detenus Released - Released on bail,0,0,0
TRIPURA,2005,Detenus Released - Other releases (temporary transfer etc.),0,0,0
TRIPURA,2005,Total Detenus Released,0,0,0
TRIPURA,2006,Convicts Released - Released after completion of conviction,510,55,565
TRIPURA,2006,Convicts Released - Premature release,9,0,9
TRIPURA,2006,Convicts Released - Released on appeal,35,8,43
TRIPURA,2006,Convicts Released - Released on bail,91,8,99
TRIPURA,2006,Convicts Released - Pardons,0,0,0
TRIPURA,2006,Convicts Released - Transferred to other States,40,0,40
TRIPURA,2006,"Convicts Released - Other Releases (due to illness, transferred to Mental hospital)",6,0,6
TRIPURA,2006,Total Convicts Released,691,71,762
TRIPURA,2006,Under trials Released - Acquitted,200,8,208
TRIPURA,2006,Under trials Released - Released on appeal,100,7,107
TRIPURA,2006,Under trials Released - Released on bail,300,55,355
TRIPURA,2006,Under trials Released - Transferred to other States,20,0,20
TRIPURA,2006,Under trials Released - Extradited,11,0,11
TRIPURA,2006,Under trials Released - Other releases (transferred to Mental/Civil hospital),10,0,10
TRIPURA,2006,Total Under trials Released,641,70,711
TRIPURA,2006,Detenus Released - Released on completion of detention period,0,0,0
TRIPURA,2006,Detenus Released - Released before completion of detention period,0,0,0
TRIPURA,2006,Detenus Released - Released on bail,0,0,0
TRIPURA,2006,Detenus Released - Other releases (temporary transfer etc.),0,0,0
TRIPURA,2006,Total Detenus Released,0,0,0
TRIPURA,2007,Convicts Released - Released after completion of conviction,525,47,572
TRIPURA,2007,Convicts Released - Premature release,8,0,8
TRIPURA,2007,Convicts Released - Released on appeal,3,0,3
TRIPURA,2007,Convicts Released - Released on bail,48,5,53
TRIPURA,2007,Convicts Released - Pardons,0,0,0
TRIPURA,2007,Convicts Released - Transferred to other States,0,0,0
TRIPURA,2007,"Convicts Released - Other Releases (due to illness, transferred to Mental hospital)",0,0,0
TRIPURA,2007,Total Convicts Released,584,52,636
TRIPURA,2007,Under trials Released - Acquitted,544,22,566
TRIPURA,2007,Under trials Released - Released on appeal,71,0,71
TRIPURA,2007,Under trials Released - Released on bail,3201,212,3413
TRIPURA,2007,Under trials Released - Transferred to other States,19,0,19
TRIPURA,2007,Under trials Released - Extradited,36,3,39
TRIPURA,2007,Under trials Released - Other releases (transferred to Mental/Civil hospital),19,3,22
TRIPURA,2007,Total Under trials Released,3890,240,4130
TRIPURA,2007,Detenus Released - Released on completion of detention period,0,0,0
TRIPURA,2007,Detenus Released - Released before completion of detention period,1,0,1
TRIPURA,2007,Detenus Released - Released on bail,0,0,0
TRIPURA,2007,Detenus Released - Other releases (temporary transfer etc.),0,0,0
TRIPURA,2007,Total Detenus Released,1,0,1
TRIPURA,2008,Convicts Released - Released after completion of conviction,285,32,317
TRIPURA,2008,Convicts Released - Premature release,14,0,14
TRIPURA,2008,Convicts Released - Released on appeal,54,0,54
TRIPURA,2008,Convicts Released - Released on bail,55,4,59
TRIPURA,2008,Convicts Released - Pardons,0,0,0
TRIPURA,2008,Convicts Released - Transferred to other States,32,1,33
TRIPURA,2008,"Convicts Released - Other Releases (due to illness, transferred to Mental hospital)",14,0,14
TRIPURA,2008,Total Convicts Released,454,37,491
TRIPURA,2008,Under trials Released - Acquitted,323,11,334
TRIPURA,2008,Under trials Released - Released on appeal,110,0,110
TRIPURA,2008,Under trials Released - Released on bail,360,10,370
TRIPURA,2008,Under trials Released - Transferred to other States,86,0,86
TRIPURA,2008,Under trials Released - Extradited,46,3,49
TRIPURA,2008,Under trials Released - Other releases (transferred to Mental/Civil hospital),0,0,0
TRIPURA,2008,Total Under trials Released,925,24,949
TRIPURA,2008,Detenus Released - Released on completion of detention period,0,0,0
TRIPURA,2008,Detenus Released - Released before completion of detention period,0,0,0
TRIPURA,2008,Detenus Released - Released on bail,0,0,0
TRIPURA,2008,Detenus Released - Other releases (temporary transfer etc.),0,0,0
TRIPURA,2008,Total Detenus Released,0,0,0
TRIPURA,2009,Convicts Released - Released after completion of conviction,1318,25,1343
TRIPURA,2009,Convicts Released - Premature release,33,3,36
TRIPURA,2009,Convicts Released - Released on appeal,64,4,68
TRIPURA,2009,Convicts Released - Released on bail,36,3,39
TRIPURA,2009,Convicts Released - Pardons,0,0,0
TRIPURA,2009,Convicts Released - Transferred to other States,6,0,6
TRIPURA,2009,"Convicts Released - Other Releases (due to illness, transferred to Mental hospital)",75,0,75
TRIPURA,2009,Total Convicts Released,1532,35,1567
TRIPURA,2009,Under trials Released - Acquitted,184,6,190
TRIPURA,2009,Under trials Released - Released on appeal,2,0,2
TRIPURA,2009,Under trials Released - Released on bail,729,21,750
TRIPURA,2009,Under trials Released - Transferred to other States,1,1,2
TRIPURA,2009,Under trials Released - Extradited,0,0,0
TRIPURA,2009,Under trials Released - Other releases (transferred to Mental/Civil hospital),74,2,76
TRIPURA,2009,Total Under trials Released,990,30,1020
TRIPURA,2009,Detenus Released - Released on completion of detention period,0,0,0
TRIPURA,2009,Detenus Released - Released before completion of detention period,0,0,0
TRIPURA,2009,Detenus Released - Released on bail,0,0,0
TRIPURA,2009,Detenus Released - Other releases (temporary transfer etc.),0,0,0
TRIPURA,2009,Total Detenus Released,0,0,0
TRIPURA,2010,Convicts Released - Released after completion of conviction,1041,30,1071
TRIPURA,2010,Convicts Released - Premature release,29,0,29
TRIPURA,2010,Convicts Released - Released on appeal,141,0,141
TRIPURA,2010,Convicts Released - Released on bail,40,5,45
TRIPURA,2010,Convicts Released - Pardons,0,0,0
TRIPURA,2010,Convicts Released - Transferred to other States,1,0,1
TRIPURA,2010,"Convicts Released - Other Releases (due to illness, transferred to Mental hospital)",8,0,8
TRIPURA,2010,Total Convicts Released,1260,35,1295
TRIPURA,2010,Under trials Released - Acquitted,185,3,188
TRIPURA,2010,Under trials Released - Released on appeal,54,0,54
TRIPURA,2010,Under trials Released - Released on bail,842,22,864
TRIPURA,2010,Under trials Released - Transferred to other States,2,1,3
TRIPURA,2010,Under trials Released - Extradited,0,0,0
TRIPURA,2010,Under trials Released - Other releases (transferred to Mental/Civil hospital),11,0,11
TRIPURA,2010,Total Under trials Released,1094,26,1120
TRIPURA,2010,Detenus Released - Released on completion of detention period,0,0,0
TRIPURA,2010,Detenus Released - Released before completion of detention period,0,0,0
TRIPURA,2010,Detenus Released - Released on bail,0,0,0
TRIPURA,2010,Detenus Released - Other releases (temporary transfer etc.),0,0,0
TRIPURA,2010,Total Detenus Released,0,0,0
TRIPURA,2011,Convicts Released - Released after completion of conviction,1209,42,1251
TRIPURA,2011,Convicts Released - Premature release,7,0,7
TRIPURA,2011,Convicts Released - Released on appeal,50,0,50
TRIPURA,2011,Convicts Released - Released on bail,33,2,35
TRIPURA,2011,Convicts Released - Pardons,0,0,0
TRIPURA,2011,Convicts Released - Transferred to other States,2,0,2
TRIPURA,2011,"Convicts Released - Other Releases (due to illness, transferred to Mental hospital)",0,0,0
TRIPURA,2011,Total Convicts Released,1301,44,1345
TRIPURA,2011,Under trials Released - Acquitted,325,7,332
TRIPURA,2011,Under trials Released - Released on appeal,16,0,16
TRIPURA,2011,Under trials Released - Released on bail,903,36,939
TRIPURA,2011,Under trials Released - Transferred to other States,0,0,0
TRIPURA,2011,Under trials Released - Extradited,0,0,0
TRIPURA,2011,Under trials Released - Other releases (transferred to Mental/Civil hospital),0,0,0
TRIPURA,2011,Total Under trials Released,1244,43,1287
TRIPURA,2011,Detenus Released - Released on completion of detention period,0,0,0
TRIPURA,2011,Detenus Released - Released before completion of detention period,0,0,0
TRIPURA,2011,Detenus Released - Released on bail,0,0,0
TRIPURA,2011,Detenus Released - Other releases (temporary transfer etc.),0,0,0
TRIPURA,2011,Total Detenus Released,0,0,0
TRIPURA,2012,Convicts Released - Released after completion of conviction,1303,11,1314
TRIPURA,2012,Convicts Released - Premature release,10,0,10
TRIPURA,2012,Convicts Released - Released on appeal,28,2,30
TRIPURA,2012,Convicts Released - Released on bail,23,2,25
TRIPURA,2012,Convicts Released - Pardons,0,0,0
TRIPURA,2012,Convicts Released - Transferred to other States,0,0,0
TRIPURA,2012,"Convicts Released - Other Releases (due to illness, transferred to Mental hospital)",0,0,0
TRIPURA,2012,Total Convicts Released,1364,15,1379
TRIPURA,2012,Under trials Released - Acquitted,315,5,320
TRIPURA,2012,Under trials Released - Released on appeal,11,0,11
TRIPURA,2012,Under trials Released - Released on bail,893,45,938
TRIPURA,2012,Under trials Released - Transferred to other States,0,0,0
TRIPURA,2012,Under trials Released - Extradited,0,0,0
TRIPURA,2012,Under trials Released - Other releases (transferred to Mental/Civil hospital),0,0,0
TRIPURA,2012,Total Under trials Released,1219,50,1269
TRIPURA,2012,Detenus Released - Released on completion of detention period,0,0,0
TRIPURA,2012,Detenus Released - Released before completion of detention period,0,0,0
TRIPURA,2012,Detenus Released - Released on bail,0,0,0
TRIPURA,2012,Detenus Released - Other releases (temporary transfer etc.),0,0,0
TRIPURA,2012,Total Detenus Released,0,0,0
UTTAR PRADESH,2001,Convicts Released - Released after completion of conviction,21449,71,21520
UTTAR PRADESH,2001,Convicts Released - Premature release,32,2,34
UTTAR PRADESH,2001,Convicts Released - Released on appeal,1595,21,1616
UTTAR PRADESH,2001,Convicts Released - Released on bail,13239,490,13729
UTTAR PRADESH,2001,Convicts Released - Pardons,95,1,96
UTTAR PRADESH,2001,Convicts Released - Transferred to other States,294,0,294
UTTAR PRADESH,2001,"Convicts Released - Other Releases (due to illness, transferred to Mental hospital)",477,9,486
UTTAR PRADESH,2001,Total Convicts Released,37181,594,37775
UTTAR PRADESH,2001,Under trials Released - Acquitted,6453,217,6670
UTTAR PRADESH,2001,Under trials Released - Released on appeal,9743,258,10001
UTTAR PRADESH,2001,Under trials Released - Released on bail,193978,5466,199444
UTTAR PRADESH,2001,Under trials Released - Transferred to other States,720,1,721
UTTAR PRADESH,2001,Under trials Released - Extradited,0,0,0
UTTAR PRADESH,2001,Under trials Released - Other releases (transferred to Mental/Civil hospital),381,0,381
UTTAR PRADESH,2001,Total Under trials Released,211275,5942,217217
UTTAR PRADESH,2001,Detenus Released - Released on completion of detention period,97,0,97
UTTAR PRADESH,2001,Detenus Released - Released before completion of detention period,166,3,169
UTTAR PRADESH,2001,Detenus Released - Released on bail,5235,82,5317
UTTAR PRADESH,2001,Detenus Released - Other releases (temporary transfer etc.),13,0,13
UTTAR PRADESH,2001,Total Detenus Released,5511,85,5596
UTTAR PRADESH,2002,Convicts Released - Released after completion of conviction,26700,419,27119
UTTAR PRADESH,2002,Convicts Released - Premature release,1291,14,1305
UTTAR PRADESH,2002,Convicts Released - Released on appeal,10122,149,10271
UTTAR PRADESH,2002,Convicts Released - Released on bail,17676,759,18435
UTTAR PRADESH,2002,Convicts Released - Pardons,1028,40,1068
UTTAR PRADESH,2002,Convicts Released - Transferred to other States,279,4,283
UTTAR PRADESH,2002,"Convicts Released - Other Releases (due to illness, transferred to Mental hospital)",323,5,328
UTTAR PRADESH,2002,Total Convicts Released,57419,1390,58809
UTTAR PRADESH,2002,Under trials Released - Acquitted,5984,204,6188
UTTAR PRADESH,2002,Under trials Released - Released on appeal,13261,277,13538
UTTAR PRADESH,2002,Under trials Released - Released on bail,171250,4848,176098
UTTAR PRADESH,2002,Under trials Released - Transferred to other States,319,3,322
UTTAR PRADESH,2002,Under trials Released - Extradited,1,1,2
UTTAR PRADESH,2002,Under trials Released - Other releases (transferred to Mental/Civil hospital),2389,76,2465
UTTAR PRADESH,2002,Total Under trials Released,193204,5409,198613
UTTAR PRADESH,2002,Detenus Released - Released on completion of detention period,294,0,294
UTTAR PRADESH,2002,Detenus Released - Released before completion of detention period,398,7,405
UTTAR PRADESH,2002,Detenus Released - Released on bail,381,21,402
UTTAR PRADESH,2002,Detenus Released - Other releases (temporary transfer etc.),96,0,96
UTTAR PRADESH,2002,Total Detenus Released,1169,28,1197
UTTAR PRADESH,2003,Convicts Released - Released after completion of conviction,22153,561,22714
UTTAR PRADESH,2003,Convicts Released - Premature release,976,4,980
UTTAR PRADESH,2003,Convicts Released - Released on appeal,5813,113,5926
UTTAR PRADESH,2003,Convicts Released - Released on bail,18936,700,19636
UTTAR PRADESH,2003,Convicts Released - Pardons,564,28,592
UTTAR PRADESH,2003,Convicts Released - Transferred to other States,194,2,196
UTTAR PRADESH,2003,"Convicts Released - Other Releases (due to illness, transferred to Mental hospital)",1148,5,1153
UTTAR PRADESH,2003,Total Convicts Released,49784,1413,51197
UTTAR PRADESH,2003,Under trials Released - Acquitted,12490,396,12886
UTTAR PRADESH,2003,Under trials Released - Released on appeal,19520,526,20046
UTTAR PRADESH,2003,Under trials Released - Released on bail,142737,4188,146925
UTTAR PRADESH,2003,Under trials Released - Transferred to other States,20904,521,21425
UTTAR PRADESH,2003,Under trials Released - Extradited,7,0,7
UTTAR PRADESH,2003,Under trials Released - Other releases (transferred to Mental/Civil hospital),59,1,60
UTTAR PRADESH,2003,Total Under trials Released,195717,5632,201349
UTTAR PRADESH,2003,Detenus Released - Released on completion of detention period,3471,124,3595
UTTAR PRADESH,2003,Detenus Released - Released before completion of detention period,310,2,312
UTTAR PRADESH,2003,Detenus Released - Released on bail,956,29,985
UTTAR PRADESH,2003,Detenus Released - Other releases (temporary transfer etc.),373,1,374
UTTAR PRADESH,2003,Total Detenus Released,5110,156,5266
UTTAR PRADESH,2004,Convicts Released - Released after completion of conviction,22521,518,23039
UTTAR PRADESH,2004,Convicts Released - Premature release,601,31,632
UTTAR PRADESH,2004,Convicts Released - Released on appeal,6163,66,6229
UTTAR PRADESH,2004,Convicts Released - Released on bail,18326,683,19009
UTTAR PRADESH,2004,Convicts Released - Pardons,9076,136,9212
UTTAR PRADESH,2004,Convicts Released - Transferred to other States,896,17,913
UTTAR PRADESH,2004,"Convicts Released - Other Releases (due to illness, transferred to Mental hospital)",719,0,719
UTTAR PRADESH,2004,Total Convicts Released,58302,1451,59753
UTTAR PRADESH,2004,Under trials Released - Acquitted,15496,595,16091
UTTAR PRADESH,2004,Under trials Released - Released on appeal,11731,307,12038
UTTAR PRADESH,2004,Under trials Released - Released on bail,128610,3538,132148
UTTAR PRADESH,2004,Under trials Released - Transferred to other States,20056,455,20511
UTTAR PRADESH,2004,Under trials Released - Extradited,54,0,54
UTTAR PRADESH,2004,Under trials Released - Other releases (transferred to Mental/Civil hospital),12,0,12
UTTAR PRADESH,2004,Total Under trials Released,175959,4895,180854
UTTAR PRADESH,2004,Detenus Released - Released on completion of detention period,364,8,372
UTTAR PRADESH,2004,Detenus Released - Released before completion of detention period,197,0,197
UTTAR PRADESH,2004,Detenus Released - Released on bail,5214,270,5484
UTTAR PRADESH,2004,Detenus Released - Other releases (temporary transfer etc.),115,0,115
UTTAR PRADESH,2004,Total Detenus Released,5890,278,6168
UTTAR PRADESH,2005,Convicts Released - Released after completion of conviction,40651,175,40826
UTTAR PRADESH,2005,Convicts Released - Premature release,211,2,213
UTTAR PRADESH,2005,Convicts Released - Released on appeal,6262,208,6470
UTTAR PRADESH,2005,Convicts Released - Released on bail,25386,875,26261
UTTAR PRADESH,2005,Convicts Released - Pardons,778,27,805
UTTAR PRADESH,2005,Convicts Released - Transferred to other States,154,31,185
UTTAR PRADESH,2005,"Convicts Released - Other Releases (due to illness, transferred to Mental hospital)",1244,13,1257
UTTAR PRADESH,2005,Total Convicts Released,74686,1331,76017
UTTAR PRADESH,2005,Under trials Released - Acquitted,10092,355,10447
UTTAR PRADESH,2005,Under trials Released - Released on appeal,17015,555,17570
UTTAR PRADESH,2005,Under trials Released - Released on bail,132372,8916,141288
UTTAR PRADESH,2005,Under trials Released - Transferred to other States,26002,514,26516
UTTAR PRADESH,2005,Under trials Released - Extradited,71,0,71
UTTAR PRADESH,2005,Under trials Released - Other releases (transferred to Mental/Civil hospital),20,0,20
UTTAR PRADESH,2005,Total Under trials Released,185572,10340,195912
UTTAR PRADESH,2005,Detenus Released - Released on completion of detention period,109,0,109
UTTAR PRADESH,2005,Detenus Released - Released before completion of detention period,182,3,185
UTTAR PRADESH,2005,Detenus Released - Released on bail,314,0,314
UTTAR PRADESH,2005,Detenus Released - Other releases (temporary transfer etc.),5,0,5
UTTAR PRADESH,2005,Total Detenus Released,610,3,613
UTTAR PRADESH,2006,Convicts Released - Released after completion of conviction,32065,215,32280
UTTAR PRADESH,2006,Convicts Released - Premature release,2414,178,2592
UTTAR PRADESH,2006,Convicts Released - Released on appeal,5511,146,5657
UTTAR PRADESH,2006,Convicts Released - Released on bail,27896,923,28819
UTTAR PRADESH,2006,Convicts Released - Pardons,493,16,509
UTTAR PRADESH,2006,Convicts Released - Transferred to other States,430,7,437
UTTAR PRADESH,2006,"Convicts Released - Other Releases (due to illness, transferred to Mental hospital)",841,0,841
UTTAR PRADESH,2006,Total Convicts Released,69650,1485,71135
UTTAR PRADESH,2006,Under trials Released - Acquitted,9292,255,9547
UTTAR PRADESH,2006,Under trials Released - Released on appeal,22369,479,22848
UTTAR PRADESH,2006,Under trials Released - Released on bail,192090,4691,196781
UTTAR PRADESH,2006,Under trials Released - Transferred to other States,9182,206,9388
UTTAR PRADESH,2006,Under trials Released - Extradited,0,0,0
UTTAR PRADESH,2006,Under trials Released - Other releases (transferred to Mental/Civil hospital),9,0,9
UTTAR PRADESH,2006,Total Under trials Released,232942,5631,238573
UTTAR PRADESH,2006,Detenus Released - Released on completion of detention period,92,0,92
UTTAR PRADESH,2006,Detenus Released - Released before completion of detention period,143,0,143
UTTAR PRADESH,2006,Detenus Released - Released on bail,82,0,82
UTTAR PRADESH,2006,Detenus Released - Other releases (temporary transfer etc.),15,0,15
UTTAR PRADESH,2006,Total Detenus Released,332,0,332
UTTAR PRADESH,2007,Convicts Released - Released after completion of conviction,36915,433,37348
UTTAR PRADESH,2007,Convicts Released - Premature release,5144,95,5239
UTTAR PRADESH,2007,Convicts Released - Released on appeal,3102,104,3206
UTTAR PRADESH,2007,Convicts Released - Released on bail,30300,1003,31303
UTTAR PRADESH,2007,Convicts Released - Pardons,2475,55,2530
UTTAR PRADESH,2007,Convicts Released - Transferred to other States,414,1,415
UTTAR PRADESH,2007,"Convicts Released - Other Releases (due to illness, transferred to Mental hospital)",642,2,644
UTTAR PRADESH,2007,Total Convicts Released,78992,1693,80685
UTTAR PRADESH,2007,Under trials Released - Acquitted,10644,892,11536
UTTAR PRADESH,2007,Under trials Released - Released on appeal,16173,652,16825
UTTAR PRADESH,2007,Under trials Released - Released on bail,169680,5285,174965
UTTAR PRADESH,2007,Under trials Released - Transferred to other States,8626,817,9443
UTTAR PRADESH,2007,Under trials Released - Extradited,7071,288,7359
UTTAR PRADESH,2007,Under trials Released - Other releases (transferred to Mental/Civil hospital),6,1,7
UTTAR PRADESH,2007,Total Under trials Released,212200,7935,220135
UTTAR PRADESH,2007,Detenus Released - Released on completion of detention period,3873,127,4000
UTTAR PRADESH,2007,Detenus Released - Released before completion of detention period,229,1,230
UTTAR PRADESH,2007,Detenus Released - Released on bail,94,11,105
UTTAR PRADESH,2007,Detenus Released - Other releases (temporary transfer etc.),17,0,17
UTTAR PRADESH,2007,Total Detenus Released,4213,139,4352
UTTAR PRADESH,2008,Convicts Released - Released after completion of conviction,36962,642,37604
UTTAR PRADESH,2008,Convicts Released - Premature release,6,0,6
UTTAR PRADESH,2008,Convicts Released - Released on appeal,4086,174,4260
UTTAR PRADESH,2008,Convicts Released - Released on bail,33712,1230,34942
UTTAR PRADESH,2008,Convicts Released - Pardons,2,0,2
UTTAR PRADESH,2008,Convicts Released - Transferred to other States,820,18,838
UTTAR PRADESH,2008,"Convicts Released - Other Releases (due to illness, transferred to Mental hospital)",550,5,555
UTTAR PRADESH,2008,Total Convicts Released,76138,2069,78207
UTTAR PRADESH,2008,Under trials Released - Acquitted,24953,1203,26156
UTTAR PRADESH,2008,Under trials Released - Released on appeal,29574,1667,31241
UTTAR PRADESH,2008,Under trials Released - Released on bail,186341,5306,191647
UTTAR PRADESH,2008,Under trials Released - Transferred to other States,9035,1075,10110
UTTAR PRADESH,2008,Under trials Released - Extradited,817,12,829
UTTAR PRADESH,2008,Under trials Released - Other releases (transferred to Mental/Civil hospital),331,69,400
UTTAR PRADESH,2008,Total Under trials Released,251051,9332,260383
UTTAR PRADESH,2008,Detenus Released - Released on completion of detention period,216,2,218
UTTAR PRADESH,2008,Detenus Released - Released before completion of detention period,253,0,253
UTTAR PRADESH,2008,Detenus Released - Released on bail,3206,52,3258
UTTAR PRADESH,2008,Detenus Released - Other releases (temporary transfer etc.),5,0,5
UTTAR PRADESH,2008,Total Detenus Released,3680,54,3734
UTTAR PRADESH,2009,Convicts Released - Released after completion of conviction,28636,138,28774
UTTAR PRADESH,2009,Convicts Released - Premature release,95,0,95
UTTAR PRADESH,2009,Convicts Released - Released on appeal,5956,86,6042
UTTAR PRADESH,2009,Convicts Released - Released on bail,22098,564,22662
UTTAR PRADESH,2009,Convicts Released - Pardons,40,0,40
UTTAR PRADESH,2009,Convicts Released - Transferred to other States,704,4,708
UTTAR PRADESH,2009,"Convicts Released - Other Releases (due to illness, transferred to Mental hospital)",0,0,0
UTTAR PRADESH,2009,Total Convicts Released,57529,792,58321
UTTAR PRADESH,2009,Under trials Released - Acquitted,9519,571,10090
UTTAR PRADESH,2009,Under trials Released - Released on appeal,22351,856,23207
UTTAR PRADESH,2009,Under trials Released - Released on bail,255596,8365,263961
UTTAR PRADESH,2009,Under trials Released - Transferred to other States,470,0,470
UTTAR PRADESH,2009,Under trials Released - Extradited,0,0,0
UTTAR PRADESH,2009,Under trials Released - Other releases (transferred to Mental/Civil hospital),0,0,0
UTTAR PRADESH,2009,Total Under trials Released,287936,9792,297728
UTTAR PRADESH,2009,Detenus Released - Released on completion of detention period,217,1,218
UTTAR PRADESH,2009,Detenus Released - Released before completion of detention period,658,1,659
UTTAR PRADESH,2009,Detenus Released - Released on bail,25,0,25
UTTAR PRADESH,2009,Detenus Released - Other releases (temporary transfer etc.),2,0,2
UTTAR PRADESH,2009,Total Detenus Released,902,2,904
UTTAR PRADESH,2010,Convicts Released - Released after completion of conviction,29360,147,29507
UTTAR PRADESH,2010,Convicts Released - Premature release,14,2,16
UTTAR PRADESH,2010,Convicts Released - Released on appeal,6065,97,6162
UTTAR PRADESH,2010,Convicts Released - Released on bail,23108,604,23712
UTTAR PRADESH,2010,Convicts Released - Pardons,9,0,9
UTTAR PRADESH,2010,Convicts Released - Transferred to other States,822,7,829
UTTAR PRADESH,2010,"Convicts Released - Other Releases (due to illness, transferred to Mental hospital)",0,0,0
UTTAR PRADESH,2010,Total Convicts Released,59378,857,60235
UTTAR PRADESH,2010,Under trials Released - Acquitted,9818,619,10437
UTTAR PRADESH,2010,Under trials Released - Released on appeal,23011,918,23929
UTTAR PRADESH,2010,Under trials Released - Released on bail,266930,8710,275640
UTTAR PRADESH,2010,Under trials Released - Transferred to other States,491,0,491
UTTAR PRADESH,2010,Under trials Released - Extradited,0,0,0
UTTAR PRADESH,2010,Under trials Released - Other releases (transferred to Mental/Civil hospital),0,0,0
UTTAR PRADESH,2010,Total Under trials Released,300250,10247,310497
UTTAR PRADESH,2010,Detenus Released - Released on completion of detention period,305,3,308
UTTAR PRADESH,2010,Detenus Released - Released before completion of detention period,691,2,693
UTTAR PRADESH,2010,Detenus Released - Released on bail,29,0,29
UTTAR PRADESH,2010,Detenus Released - Other releases (temporary transfer etc.),3,0,3
UTTAR PRADESH,2010,Total Detenus Released,1028,5,1033
UTTAR PRADESH,2011,Convicts Released - Released after completion of conviction,29212,151,29363
UTTAR PRADESH,2011,Convicts Released - Premature release,225,25,250
UTTAR PRADESH,2011,Convicts Released - Released on appeal,6083,93,6176
UTTAR PRADESH,2011,Convicts Released - Released on bail,23192,597,23789
UTTAR PRADESH,2011,Convicts Released - Pardons,5,0,5
UTTAR PRADESH,2011,Convicts Released - Transferred to other States,189,1,190
UTTAR PRADESH,2011,"Convicts Released - Other Releases (due to illness, transferred to Mental hospital)",0,0,0
UTTAR PRADESH,2011,Total Convicts Released,58906,867,59773
UTTAR PRADESH,2011,Under trials Released - Acquitted,9712,633,10345
UTTAR PRADESH,2011,Under trials Released - Released on appeal,23101,923,24024
UTTAR PRADESH,2011,Under trials Released - Released on bail,262804,8205,271009
UTTAR PRADESH,2011,Under trials Released - Transferred to other States,423,0,423
UTTAR PRADESH,2011,Under trials Released - Extradited,0,0,0
UTTAR PRADESH,2011,Under trials Released - Other releases (transferred to Mental/Civil hospital),0,0,0
UTTAR PRADESH,2011,Total Under trials Released,296040,9761,305801
UTTAR PRADESH,2011,Detenus Released - Released on completion of detention period,309,2,311
UTTAR PRADESH,2011,Detenus Released - Released before completion of detention period,672,3,675
UTTAR PRADESH,2011,Detenus Released - Released on bail,33,4,37
UTTAR PRADESH,2011,Detenus Released - Other releases (temporary transfer etc.),0,0,0
UTTAR PRADESH,2011,Total Detenus Released,1014,9,1023
UTTAR PRADESH,2012,Convicts Released - Released after completion of conviction,27184,146,27330
UTTAR PRADESH,2012,Convicts Released - Premature release,118,17,135
UTTAR PRADESH,2012,Convicts Released - Released on appeal,6198,87,6285
UTTAR PRADESH,2012,Convicts Released - Released on bail,28201,543,28744
UTTAR PRADESH,2012,Convicts Released - Pardons,26,2,28
UTTAR PRADESH,2012,Convicts Released - Transferred to other States,187,1,188
UTTAR PRADESH,2012,"Convicts Released - Other Releases (due to illness, transferred to Mental hospital)",0,0,0
UTTAR PRADESH,2012,Total Convicts Released,61914,796,62710
UTTAR PRADESH,2012,Under trials Released - Acquitted,9610,602,10212
UTTAR PRADESH,2012,Under trials Released - Released on appeal,22806,896,23702
UTTAR PRADESH,2012,Under trials Released - Released on bail,272102,8105,280207
UTTAR PRADESH,2012,Under trials Released - Transferred to other States,412,0,412
UTTAR PRADESH,2012,Under trials Released - Extradited,0,0,0
UTTAR PRADESH,2012,Under trials Released - Other releases (transferred to Mental/Civil hospital),0,0,0
UTTAR PRADESH,2012,Total Under trials Released,304930,9603,314533
UTTAR PRADESH,2012,Detenus Released - Released on completion of detention period,304,3,307
UTTAR PRADESH,2012,Detenus Released - Released before completion of detention period,646,6,652
UTTAR PRADESH,2012,Detenus Released - Released on bail,31,3,34
UTTAR PRADESH,2012,Detenus Released - Other releases (temporary transfer etc.),0,0,0
UTTAR PRADESH,2012,Total Detenus Released,981,12,993
UTTARANCHAL,2001,Convicts Released - Released after completion of conviction,355,1,356
UTTARANCHAL,2001,Convicts Released - Premature release,6,0,6
UTTARANCHAL,2001,Convicts Released - Released on appeal,28,3,31
UTTARANCHAL,2001,Convicts Released - Released on bail,395,16,411
UTTARANCHAL,2001,Convicts Released - Pardons,0,0,0
UTTARANCHAL,2001,Convicts Released - Transferred to other States,36,0,36
UTTARANCHAL,2001,"Convicts Released - Other Releases (due to illness, transferred to Mental hospital)",0,0,0
UTTARANCHAL,2001,Total Convicts Released,820,20,840
UTTARANCHAL,2001,Under trials Released - Acquitted,754,253,1007
UTTARANCHAL,2001,Under trials Released - Released on appeal,342,0,342
UTTARANCHAL,2001,Under trials Released - Released on bail,6511,564,7075
UTTARANCHAL,2001,Under trials Released - Transferred to other States,409,1,410
UTTARANCHAL,2001,Under trials Released - Extradited,0,0,0
UTTARANCHAL,2001,Under trials Released - Other releases (transferred to Mental/Civil hospital),2,0,2
UTTARANCHAL,2001,Total Under trials Released,8018,818,8836
UTTARANCHAL,2001,Detenus Released - Released on completion of detention period,0,0,0
UTTARANCHAL,2001,Detenus Released - Released before completion of detention period,0,0,0
UTTARANCHAL,2001,Detenus Released - Released on bail,0,0,0
UTTARANCHAL,2001,Detenus Released - Other releases (temporary transfer etc.),0,0,0
UTTARANCHAL,2001,Total Detenus Released,0,0,0
UTTARANCHAL,2002,Convicts Released - Released after completion of conviction,372,4,376
UTTARANCHAL,2002,Convicts Released - Premature release,11,0,11
UTTARANCHAL,2002,Convicts Released - Released on appeal,41,7,48
UTTARANCHAL,2002,Convicts Released - Released on bail,403,21,424
UTTARANCHAL,2002,Convicts Released - Pardons,0,0,0
UTTARANCHAL,2002,Convicts Released - Transferred to other States,22,0,22
UTTARANCHAL,2002,"Convicts Released - Other Releases (due to illness, transferred to Mental hospital)",0,0,0
UTTARANCHAL,2002,Total Convicts Released,849,32,881
UTTARANCHAL,2002,Under trials Released - Acquitted,643,238,881
UTTARANCHAL,2002,Under trials Released - Released on appeal,282,0,282
UTTARANCHAL,2002,Under trials Released - Released on bail,6444,557,7001
UTTARANCHAL,2002,Under trials Released - Transferred to other States,372,0,372
UTTARANCHAL,2002,Under trials Released - Extradited,0,0,0
UTTARANCHAL,2002,Under trials Released - Other releases (transferred to Mental/Civil hospital),0,0,0
UTTARANCHAL,2002,Total Under trials Released,7741,795,8536
UTTARANCHAL,2002,Detenus Released - Released on completion of detention period,0,0,0
UTTARANCHAL,2002,Detenus Released - Released before completion of detention period,0,0,0
UTTARANCHAL,2002,Detenus Released - Released on bail,0,0,0
UTTARANCHAL,2002,Detenus Released - Other releases (temporary transfer etc.),0,0,0
UTTARANCHAL,2002,Total Detenus Released,0,0,0
UTTARANCHAL,2003,Convicts Released - Released after completion of conviction,327,17,344
UTTARANCHAL,2003,Convicts Released - Premature release,27,0,27
UTTARANCHAL,2003,Convicts Released - Released on appeal,85,2,87
UTTARANCHAL,2003,Convicts Released - Released on bail,353,19,372
UTTARANCHAL,2003,Convicts Released - Pardons,125,0,125
UTTARANCHAL,2003,Convicts Released - Transferred to other States,29,0,29
UTTARANCHAL,2003,"Convicts Released - Other Releases (due to illness, transferred to Mental hospital)",11,0,11
UTTARANCHAL,2003,Total Convicts Released,957,38,995
UTTARANCHAL,2003,Under trials Released - Acquitted,161,4,165
UTTARANCHAL,2003,Under trials Released - Released on appeal,375,12,387
UTTARANCHAL,2003,Under trials Released - Released on bail,5371,190,5561
UTTARANCHAL,2003,Under trials Released - Transferred to other States,1663,127,1790
UTTARANCHAL,2003,Under trials Released - Extradited,48,0,48
UTTARANCHAL,2003,Under trials Released - Other releases (transferred to Mental/Civil hospital),2,0,2
UTTARANCHAL,2003,Total Under trials Released,7620,333,7953
UTTARANCHAL,2003,Detenus Released - Released on completion of detention period,0,0,0
UTTARANCHAL,2003,Detenus Released - Released before completion of detention period,0,0,0
UTTARANCHAL,2003,Detenus Released - Released on bail,0,0,0
UTTARANCHAL,2003,Detenus Released - Other releases (temporary transfer etc.),0,0,0
UTTARANCHAL,2003,Total Detenus Released,0,0,0
UTTARANCHAL,2004,Convicts Released - Released after completion of conviction,413,22,435
UTTARANCHAL,2004,Convicts Released - Premature release,0,0,0
UTTARANCHAL,2004,Convicts Released - Released on appeal,116,3,119
UTTARANCHAL,2004,Convicts Released - Released on bail,396,27,423
UTTARANCHAL,2004,Convicts Released - Pardons,36,0,36
UTTARANCHAL,2004,Convicts Released - Transferred to other States,0,0,0
UTTARANCHAL,2004,"Convicts Released - Other Releases (due to illness, transferred to Mental hospital)",11,0,11
UTTARANCHAL,2004,Total Convicts Released,972,52,1024
UTTARANCHAL,2004,Under trials Released - Acquitted,0,0,0
UTTARANCHAL,2004,Under trials Released - Released on appeal,213,16,229
UTTARANCHAL,2004,Under trials Released - Released on bail,419,17,436
UTTARANCHAL,2004,Under trials Released - Transferred to other States,5914,238,6152
UTTARANCHAL,2004,Under trials Released - Extradited,1412,29,1441
UTTARANCHAL,2004,Under trials Released - Other releases (transferred to Mental/Civil hospital),5,0,5
UTTARANCHAL,2004,Total Under trials Released,7963,300,8263
UTTARANCHAL,2004,Detenus Released - Released on completion of detention period,0,0,0
UTTARANCHAL,2004,Detenus Released - Released before completion of detention period,0,0,0
UTTARANCHAL,2004,Detenus Released - Released on bail,0,0,0
UTTARANCHAL,2004,Detenus Released - Other releases (temporary transfer etc.),0,0,0
UTTARANCHAL,2004,Total Detenus Released,0,0,0
UTTARANCHAL,2005,Convicts Released - Released after completion of conviction,1148,19,1167
UTTARANCHAL,2005,Convicts Released - Premature release,2,0,2
UTTARANCHAL,2005,Convicts Released - Released on appeal,69,6,75
UTTARANCHAL,2005,Convicts Released - Released on bail,184,28,212
UTTARANCHAL,2005,Convicts Released - Pardons,0,0,0
UTTARANCHAL,2005,Convicts Released - Transferred to other States,20,0,20
UTTARANCHAL,2005,"Convicts Released - Other Releases (due to illness, transferred to Mental hospital)",8,0,8
UTTARANCHAL,2005,Total Convicts Released,1431,53,1484
UTTARANCHAL,2005,Under trials Released - Acquitted,306,64,370
UTTARANCHAL,2005,Under trials Released - Released on appeal,165,7,172
UTTARANCHAL,2005,Under trials Released - Released on bail,9937,287,10224
UTTARANCHAL,2005,Under trials Released - Transferred to other States,77,0,77
UTTARANCHAL,2005,Under trials Released - Extradited,0,0,0
UTTARANCHAL,2005,Under trials Released - Other releases (transferred to Mental/Civil hospital),0,0,0
UTTARANCHAL,2005,Total Under trials Released,10485,358,10843
UTTARANCHAL,2005,Detenus Released - Released on completion of detention period,0,0,0
UTTARANCHAL,2005,Detenus Released - Released before completion of detention period,0,0,0
UTTARANCHAL,2005,Detenus Released - Released on bail,0,0,0
UTTARANCHAL,2005,Detenus Released - Other releases (temporary transfer etc.),0,0,0
UTTARANCHAL,2005,Total Detenus Released,0,0,0
UTTARANCHAL,2006,Convicts Released - Released after completion of conviction,1069,47,1116
UTTARANCHAL,2006,Convicts Released - Premature release,29,0,29
UTTARANCHAL,2006,Convicts Released - Released on appeal,82,5,87
UTTARANCHAL,2006,Convicts Released - Released on bail,916,27,943
UTTARANCHAL,2006,Convicts Released - Pardons,0,0,0
UTTARANCHAL,2006,Convicts Released - Transferred to other States,26,0,26
UTTARANCHAL,2006,"Convicts Released - Other Releases (due to illness, transferred to Mental hospital)",19,0,19
UTTARANCHAL,2006,Total Convicts Released,2141,79,2220
UTTARANCHAL,2006,Under trials Released - Acquitted,1822,33,1855
UTTARANCHAL,2006,Under trials Released - Released on appeal,672,35,707
UTTARANCHAL,2006,Under trials Released - Released on bail,8698,300,8998
UTTARANCHAL,2006,Under trials Released - Transferred to other States,219,0,219
UTTARANCHAL,2006,Under trials Released - Extradited,47,1,48
UTTARANCHAL,2006,Under trials Released - Other releases (transferred to Mental/Civil hospital),1,0,1
UTTARANCHAL,2006,Total Under trials Released,11459,369,11828
UTTARANCHAL,2006,Detenus Released - Released on completion of detention period,2,0,2
UTTARANCHAL,2006,Detenus Released - Released before completion of detention period,0,0,0
UTTARANCHAL,2006,Detenus Released - Released on bail,0,0,0
UTTARANCHAL,2006,Detenus Released - Other releases (temporary transfer etc.),0,0,0
UTTARANCHAL,2006,Total Detenus Released,2,0,2
UTTARANCHAL,2007,Convicts Released - Released after completion of conviction,743,21,764
UTTARANCHAL,2007,Convicts Released - Premature release,0,0,0
UTTARANCHAL,2007,Convicts Released - Released on appeal,462,7,469
UTTARANCHAL,2007,Convicts Released - Released on bail,427,16,443
UTTARANCHAL,2007,Convicts Released - Pardons,718,4,722
UTTARANCHAL,2007,Convicts Released - Transferred to other States,15,1,16
UTTARANCHAL,2007,"Convicts Released - Other Releases (due to illness, transferred to Mental hospital)",20,1,21
UTTARANCHAL,2007,Total Convicts Released,2385,50,2435
UTTARANCHAL,2007,Under trials Released - Acquitted,1075,58,1133
UTTARANCHAL,2007,Under trials Released - Released on appeal,62,14,76
UTTARANCHAL,2007,Under trials Released - Released on bail,10653,385,11038
UTTARANCHAL,2007,Under trials Released - Transferred to other States,397,1,398
UTTARANCHAL,2007,Under trials Released - Extradited,0,0,0
UTTARANCHAL,2007,Under trials Released - Other releases (transferred to Mental/Civil hospital),26,9,35
UTTARANCHAL,2007,Total Under trials Released,12213,467,12680
UTTARANCHAL,2007,Detenus Released - Released on completion of detention period,0,0,0
UTTARANCHAL,2007,Detenus Released - Released before completion of detention period,0,0,0
UTTARANCHAL,2007,Detenus Released - Released on bail,0,0,0
UTTARANCHAL,2007,Detenus Released - Other releases (temporary transfer etc.),0,0,0
UTTARANCHAL,2007,Total Detenus Released,0,0,0
UTTARANCHAL,2008,Convicts Released - Released after completion of conviction,693,3,696
UTTARANCHAL,2008,Convicts Released - Premature release,1,0,1
UTTARANCHAL,2008,Convicts Released - Released on appeal,78,13,91
UTTARANCHAL,2008,Convicts Released - Released on bail,344,14,358
UTTARANCHAL,2008,Convicts Released - Pardons,0,0,0
UTTARANCHAL,2008,Convicts Released - Transferred to other States,0,0,0
UTTARANCHAL,2008,"Convicts Released - Other Releases (due to illness, transferred to Mental hospital)",0,0,0
UTTARANCHAL,2008,Total Convicts Released,1116,30,1146
UTTARANCHAL,2008,Under trials Released - Acquitted,1752,54,1806
UTTARANCHAL,2008,Under trials Released - Released on appeal,220,24,244
UTTARANCHAL,2008,Under trials Released - Released on bail,8000,699,8699
UTTARANCHAL,2008,Under trials Released - Transferred to other States,390,5,395
UTTARANCHAL,2008,Under trials Released - Extradited,0,0,0
UTTARANCHAL,2008,Under trials Released - Other releases (transferred to Mental/Civil hospital),0,0,0
UTTARANCHAL,2008,Total Under trials Released,10362,782,11144
UTTARANCHAL,2008,Detenus Released - Released on completion of detention period,0,0,0
UTTARANCHAL,2008,Detenus Released - Released before completion of detention period,0,0,0
UTTARANCHAL,2008,Detenus Released - Released on bail,0,0,0
UTTARANCHAL,2008,Detenus Released - Other releases (temporary transfer etc.),0,0,0
UTTARANCHAL,2008,Total Detenus Released,0,0,0
UTTARANCHAL,2009,Convicts Released - Released after completion of conviction,815,9,824
UTTARANCHAL,2009,Convicts Released - Premature release,3,0,3
UTTARANCHAL,2009,Convicts Released - Released on appeal,101,9,110
UTTARANCHAL,2009,Convicts Released - Released on bail,214,17,231
UTTARANCHAL,2009,Convicts Released - Pardons,20,0,20
UTTARANCHAL,2009,Convicts Released - Transferred to other States,4,0,4
UTTARANCHAL,2009,"Convicts Released - Other Releases (due to illness, transferred to Mental hospital)",0,0,0
UTTARANCHAL,2009,Total Convicts Released,1157,35,1192
UTTARANCHAL,2009,Under trials Released - Acquitted,1781,44,1825
UTTARANCHAL,2009,Under trials Released - Released on appeal,24,0,24
UTTARANCHAL,2009,Under trials Released - Released on bail,10446,326,10772
UTTARANCHAL,2009,Under trials Released - Transferred to other States,503,1,504
UTTARANCHAL,2009,Under trials Released - Extradited,0,0,0
UTTARANCHAL,2009,Under trials Released - Other releases (transferred to Mental/Civil hospital),32,1,33
UTTARANCHAL,2009,Total Under trials Released,12786,372,13158
UTTARANCHAL,2009,Detenus Released - Released on completion of detention period,0,0,0
UTTARANCHAL,2009,Detenus Released - Released before completion of detention period,0,0,0
UTTARANCHAL,2009,Detenus Released - Released on bail,0,0,0
UTTARANCHAL,2009,Detenus Released - Other releases (temporary transfer etc.),0,0,0
UTTARANCHAL,2009,Total Detenus Released,0,0,0
UTTARANCHAL,2010,Convicts Released - Released after completion of conviction,370,10,380
UTTARANCHAL,2010,Convicts Released - Premature release,15,0,15
UTTARANCHAL,2010,Convicts Released - Released on appeal,10,2,12
UTTARANCHAL,2010,Convicts Released - Released on bail,823,28,851
UTTARANCHAL,2010,Convicts Released - Pardons,5,0,5
UTTARANCHAL,2010,Convicts Released - Transferred to other States,25,1,26
UTTARANCHAL,2010,"Convicts Released - Other Releases (due to illness, transferred to Mental hospital)",3,0,3
UTTARANCHAL,2010,Total Convicts Released,1251,41,1292
UTTARANCHAL,2010,Under trials Released - Acquitted,730,25,755
UTTARANCHAL,2010,Under trials Released - Released on appeal,936,5,941
UTTARANCHAL,2010,Under trials Released - Released on bail,5482,213,5695
UTTARANCHAL,2010,Under trials Released - Transferred to other States,80,1,81
UTTARANCHAL,2010,Under trials Released - Extradited,0,0,0
UTTARANCHAL,2010,Under trials Released - Other releases (transferred to Mental/Civil hospital),36,0,36
UTTARANCHAL,2010,Total Under trials Released,7264,244,7508
UTTARANCHAL,2010,Detenus Released - Released on completion of detention period,0,0,0
UTTARANCHAL,2010,Detenus Released - Released before completion of detention period,0,0,0
UTTARANCHAL,2010,Detenus Released - Released on bail,0,0,0
UTTARANCHAL,2010,Detenus Released - Other releases (temporary transfer etc.),0,0,0
UTTARANCHAL,2010,Total Detenus Released,0,0,0
UTTARANCHAL,2011,Convicts Released - Released after completion of conviction,907,33,940
UTTARANCHAL,2011,Convicts Released - Premature release,20,1,21
UTTARANCHAL,2011,Convicts Released - Released on appeal,15,1,16
UTTARANCHAL,2011,Convicts Released - Released on bail,380,15,395
UTTARANCHAL,2011,Convicts Released - Pardons,6,0,6
UTTARANCHAL,2011,Convicts Released - Transferred to other States,24,1,25
UTTARANCHAL,2011,"Convicts Released - Other Releases (due to illness, transferred to Mental hospital)",0,0,0
UTTARANCHAL,2011,Total Convicts Released,1352,51,1403
UTTARANCHAL,2011,Under trials Released - Acquitted,630,30,660
UTTARANCHAL,2011,Under trials Released - Released on appeal,740,20,760
UTTARANCHAL,2011,Under trials Released - Released on bail,7322,202,7524
UTTARANCHAL,2011,Under trials Released - Transferred to other States,70,0,70
UTTARANCHAL,2011,Under trials Released - Extradited,0,0,0
UTTARANCHAL,2011,Under trials Released - Other releases (transferred to Mental/Civil hospital),0,0,0
UTTARANCHAL,2011,Total Under trials Released,8762,252,9014
UTTARANCHAL,2011,Detenus Released - Released on completion of detention period,0,0,0
UTTARANCHAL,2011,Detenus Released - Released before completion of detention period,0,0,0
UTTARANCHAL,2011,Detenus Released - Released on bail,0,0,0
UTTARANCHAL,2011,Detenus Released - Other releases (temporary transfer etc.),0,0,0
UTTARANCHAL,2011,Total Detenus Released,0,0,0
UTTARANCHAL,2012,Convicts Released - Released after completion of conviction,1096,2,1098
UTTARANCHAL,2012,Convicts Released - Premature release,14,3,17
UTTARANCHAL,2012,Convicts Released - Released on appeal,90,4,94
UTTARANCHAL,2012,Convicts Released - Released on bail,279,24,303
UTTARANCHAL,2012,Convicts Released - Pardons,0,0,0
UTTARANCHAL,2012,Convicts Released - Transferred to other States,6,0,6
UTTARANCHAL,2012,"Convicts Released - Other Releases (due to illness, transferred to Mental hospital)",0,0,0
UTTARANCHAL,2012,Total Convicts Released,1485,33,1518
UTTARANCHAL,2012,Under trials Released - Acquitted,720,39,759
UTTARANCHAL,2012,Under trials Released - Released on appeal,784,21,805
UTTARANCHAL,2012,Under trials Released - Released on bail,8120,210,8330
UTTARANCHAL,2012,Under trials Released - Transferred to other States,80,0,80
UTTARANCHAL,2012,Under trials Released - Extradited,0,0,0
UTTARANCHAL,2012,Under trials Released - Other releases (transferred to Mental/Civil hospital),0,0,0
UTTARANCHAL,2012,Total Under trials Released,9704,270,9974
UTTARANCHAL,2012,Detenus Released - Released on completion of detention period,0,0,0
UTTARANCHAL,2012,Detenus Released - Released before completion of detention period,0,0,0
UTTARANCHAL,2012,Detenus Released - Released on bail,0,0,0
UTTARANCHAL,2012,Detenus Released - Other releases (temporary transfer etc.),0,0,0
UTTARANCHAL,2012,Total Detenus Released,0,0,0
WEST BENGAL,2001,Convicts Released - Released after completion of conviction,21457,461,21918
WEST BENGAL,2001,Convicts Released - Premature release,40,0,40
WEST BENGAL,2001,Convicts Released - Released on appeal,13,11,24
WEST BENGAL,2001,Convicts Released - Released on bail,2169,147,2316
WEST BENGAL,2001,Convicts Released - Pardons,3,0,3
WEST BENGAL,2001,Convicts Released - Transferred to other States,53,0,53
WEST BENGAL,2001,"Convicts Released - Other Releases (due to illness, transferred to Mental hospital)",0,0,0
WEST BENGAL,2001,Total Convicts Released,23735,619,24354
WEST BENGAL,2001,Under trials Released - Acquitted,3161,65,3226
WEST BENGAL,2001,Under trials Released - Released on appeal,508,31,539
WEST BENGAL,2001,Under trials Released - Released on bail,71409,4371,75780
WEST BENGAL,2001,Under trials Released - Transferred to other States,70,0,70
WEST BENGAL,2001,Under trials Released - Extradited,7,0,7
WEST BENGAL,2001,Under trials Released - Other releases (transferred to Mental/Civil hospital),19,2,21
WEST BENGAL,2001,Total Under trials Released,75174,4469,79643
WEST BENGAL,2001,Detenus Released - Released on completion of detention period,7,0,7
WEST BENGAL,2001,Detenus Released - Released before completion of detention period,0,0,0
WEST BENGAL,2001,Detenus Released - Released on bail,15,0,15
WEST BENGAL,2001,Detenus Released - Other releases (temporary transfer etc.),0,0,0
WEST BENGAL,2001,Total Detenus Released,22,0,22
WEST BENGAL,2002,Convicts Released - Released after completion of conviction,19012,616,19628
WEST BENGAL,2002,Convicts Released - Premature release,40,1,41
WEST BENGAL,2002,Convicts Released - Released on appeal,167,10,177
WEST BENGAL,2002,Convicts Released - Released on bail,1691,141,1832
WEST BENGAL,2002,Convicts Released - Pardons,0,0,0
WEST BENGAL,2002,Convicts Released - Transferred to other States,21,0,21
WEST BENGAL,2002,"Convicts Released - Other Releases (due to illness, transferred to Mental hospital)",44,0,44
WEST BENGAL,2002,Total Convicts Released,20975,768,21743
WEST BENGAL,2002,Under trials Released - Acquitted,1735,37,1772
WEST BENGAL,2002,Under trials Released - Released on appeal,1251,40,1291
WEST BENGAL,2002,Under trials Released - Released on bail,85285,4500,89785
WEST BENGAL,2002,Under trials Released - Transferred to other States,138,4,142
WEST BENGAL,2002,Under trials Released - Extradited,0,0,0
WEST BENGAL,2002,Under trials Released - Other releases (transferred to Mental/Civil hospital),0,0,0
WEST BENGAL,2002,Total Under trials Released,88409,4581,92990
WEST BENGAL,2002,Detenus Released - Released on completion of detention period,0,0,0
WEST BENGAL,2002,Detenus Released - Released before completion of detention period,0,0,0
WEST BENGAL,2002,Detenus Released - Released on bail,0,0,0
WEST BENGAL,2002,Detenus Released - Other releases (temporary transfer etc.),0,0,0
WEST BENGAL,2002,Total Detenus Released,0,0,0
WEST BENGAL,2003,Convicts Released - Released after completion of conviction,14637,401,15038
WEST BENGAL,2003,Convicts Released - Premature release,897,18,915
WEST BENGAL,2003,Convicts Released - Released on appeal,117,21,138
WEST BENGAL,2003,Convicts Released - Released on bail,809,37,846
WEST BENGAL,2003,Convicts Released - Pardons,261,5,266
WEST BENGAL,2003,Convicts Released - Transferred to other States,20,0,20
WEST BENGAL,2003,"Convicts Released - Other Releases (due to illness, transferred to Mental hospital)",87,4,91
WEST BENGAL,2003,Total Convicts Released,16828,486,17314
WEST BENGAL,2003,Under trials Released - Acquitted,1267,61,1328
WEST BENGAL,2003,Under trials Released - Released on appeal,889,5,894
WEST BENGAL,2003,Under trials Released - Released on bail,68265,4243,72508
WEST BENGAL,2003,Under trials Released - Transferred to other States,242,48,290
WEST BENGAL,2003,Under trials Released - Extradited,0,0,0
WEST BENGAL,2003,Under trials Released - Other releases (transferred to Mental/Civil hospital),72,1,73
WEST BENGAL,2003,Total Under trials Released,70735,4358,75093
WEST BENGAL,2003,Detenus Released - Released on completion of detention period,0,0,0
WEST BENGAL,2003,Detenus Released - Released before completion of detention period,0,0,0
WEST BENGAL,2003,Detenus Released - Released on bail,0,0,0
WEST BENGAL,2003,Detenus Released - Other releases (temporary transfer etc.),0,0,0
WEST BENGAL,2003,Total Detenus Released,0,0,0
WEST BENGAL,2004,Convicts Released - Released after completion of conviction,12253,389,12642
WEST BENGAL,2004,Convicts Released - Premature release,61,0,61
WEST BENGAL,2004,Convicts Released - Released on appeal,73,34,107
WEST BENGAL,2004,Convicts Released - Released on bail,1456,61,1517
WEST BENGAL,2004,Convicts Released - Pardons,1,0,1
WEST BENGAL,2004,Convicts Released - Transferred to other States,31,1,32
WEST BENGAL,2004,"Convicts Released - Other Releases (due to illness, transferred to Mental hospital)",76,5,81
WEST BENGAL,2004,Total Convicts Released,13951,490,14441
WEST BENGAL,2004,Under trials Released - Acquitted,1190,43,1233
WEST BENGAL,2004,Under trials Released - Released on appeal,253,5,258
WEST BENGAL,2004,Under trials Released - Released on bail,69735,2908,72643
WEST BENGAL,2004,Under trials Released - Transferred to other States,57,6,63
WEST BENGAL,2004,Under trials Released - Extradited,0,0,0
WEST BENGAL,2004,Under trials Released - Other releases (transferred to Mental/Civil hospital),78,5,83
WEST BENGAL,2004,Total Under trials Released,71313,2967,74280
WEST BENGAL,2004,Detenus Released - Released on completion of detention period,0,0,0
WEST BENGAL,2004,Detenus Released - Released before completion of detention period,0,0,0
WEST BENGAL,2004,Detenus Released - Released on bail,1,0,1
WEST BENGAL,2004,Detenus Released - Other releases (temporary transfer etc.),0,0,0
WEST BENGAL,2004,Total Detenus Released,1,0,1
WEST BENGAL,2005,Convicts Released - Released after completion of conviction,12865,617,13482
WEST BENGAL,2005,Convicts Released - Premature release,13,0,13
WEST BENGAL,2005,Convicts Released - Released on appeal,78,46,124
WEST BENGAL,2005,Convicts Released - Released on bail,1752,61,1813
WEST BENGAL,2005,Convicts Released - Pardons,0,0,0
WEST BENGAL,2005,Convicts Released - Transferred to other States,3,0,3
WEST BENGAL,2005,"Convicts Released - Other Releases (due to illness, transferred to Mental hospital)",26,2,28
WEST BENGAL,2005,Total Convicts Released,14737,726,15463
WEST BENGAL,2005,Under trials Released - Acquitted,1683,42,1725
WEST BENGAL,2005,Under trials Released - Released on appeal,0,0,0
WEST BENGAL,2005,Under trials Released - Released on bail,52834,2738,55572
WEST BENGAL,2005,Under trials Released - Transferred to other States,39,0,39
WEST BENGAL,2005,Under trials Released - Extradited,0,0,0
WEST BENGAL,2005,Under trials Released - Other releases (transferred to Mental/Civil hospital),12,1,13
WEST BENGAL,2005,Total Under trials Released,54568,2781,57349
WEST BENGAL,2005,Detenus Released - Released on completion of detention period,0,0,0
WEST BENGAL,2005,Detenus Released - Released before completion of detention period,0,0,0
WEST BENGAL,2005,Detenus Released - Released on bail,0,0,0
WEST BENGAL,2005,Detenus Released - Other releases (temporary transfer etc.),0,0,0
WEST BENGAL,2005,Total Detenus Released,0,0,0
WEST BENGAL,2006,Convicts Released - Released after completion of conviction,24941,703,25644
WEST BENGAL,2006,Convicts Released - Premature release,23,0,23
WEST BENGAL,2006,Convicts Released - Released on appeal,22,6,28
WEST BENGAL,2006,Convicts Released - Released on bail,4541,228,4769
WEST BENGAL,2006,Convicts Released - Pardons,0,0,0
WEST BENGAL,2006,Convicts Released - Transferred to other States,4,0,4
WEST BENGAL,2006,"Convicts Released - Other Releases (due to illness, transferred to Mental hospital)",0,0,0
WEST BENGAL,2006,Total Convicts Released,29531,937,30468
WEST BENGAL,2006,Under trials Released - Acquitted,2501,175,2676
WEST BENGAL,2006,Under trials Released - Released on appeal,66,0,66
WEST BENGAL,2006,Under trials Released - Released on bail,87308,5781,93089
WEST BENGAL,2006,Under trials Released - Transferred to other States,89,2,91
WEST BENGAL,2006,Under trials Released - Extradited,2,0,2
WEST BENGAL,2006,Under trials Released - Other releases (transferred to Mental/Civil hospital),6,4,10
WEST BENGAL,2006,Total Under trials Released,89972,5962,95934
WEST BENGAL,2006,Detenus Released - Released on completion of detention period,1,0,1
WEST BENGAL,2006,Detenus Released - Released before completion of detention period,0,0,0
WEST BENGAL,2006,Detenus Released - Released on bail,1,0,1
WEST BENGAL,2006,Detenus Released - Other releases (temporary transfer etc.),1,0,1
WEST BENGAL,2006,Total Detenus Released,3,0,3
WEST BENGAL,2007,Convicts Released - Released after completion of conviction,18312,300,18612
WEST BENGAL,2007,Convicts Released - Premature release,57,1,58
WEST BENGAL,2007,Convicts Released - Released on appeal,687,16,703
WEST BENGAL,2007,Convicts Released - Released on bail,490,64,554
WEST BENGAL,2007,Convicts Released - Pardons,0,0,0
WEST BENGAL,2007,Convicts Released - Transferred to other States,1,1,2
WEST BENGAL,2007,"Convicts Released - Other Releases (due to illness, transferred to Mental hospital)",0,2,2
WEST BENGAL,2007,Total Convicts Released,19547,384,19931
WEST BENGAL,2007,Under trials Released - Acquitted,2644,95,2739
WEST BENGAL,2007,Under trials Released - Released on appeal,57,6,63
WEST BENGAL,2007,Under trials Released - Released on bail,75019,3916,78935
WEST BENGAL,2007,Under trials Released - Transferred to other States,109,7,116
WEST BENGAL,2007,Under trials Released - Extradited,2,0,2
WEST BENGAL,2007,Under trials Released - Other releases (transferred to Mental/Civil hospital),0,0,0
WEST BENGAL,2007,Total Under trials Released,77831,4024,81855
WEST BENGAL,2007,Detenus Released - Released on completion of detention period,0,0,0
WEST BENGAL,2007,Detenus Released - Released before completion of detention period,0,0,0
WEST BENGAL,2007,Detenus Released - Released on bail,0,0,0
WEST BENGAL,2007,Detenus Released - Other releases (temporary transfer etc.),0,0,0
WEST BENGAL,2007,Total Detenus Released,0,0,0
WEST BENGAL,2008,Convicts Released - Released after completion of conviction,9763,105,9868
WEST BENGAL,2008,Convicts Released - Premature release,15,0,15
WEST BENGAL,2008,Convicts Released - Released on appeal,49,7,56
WEST BENGAL,2008,Convicts Released - Released on bail,991,42,1033
WEST BENGAL,2008,Convicts Released - Pardons,0,0,0
WEST BENGAL,2008,Convicts Released - Transferred to other States,2,0,2
WEST BENGAL,2008,"Convicts Released - Other Releases (due to illness, transferred to Mental hospital)",0,0,0
WEST BENGAL,2008,Total Convicts Released,10820,154,10974
WEST BENGAL,2008,Under trials Released - Acquitted,1389,85,1474
WEST BENGAL,2008,Under trials Released - Released on appeal,66,0,66
WEST BENGAL,2008,Under trials Released - Released on bail,66491,3788,70279
WEST BENGAL,2008,Under trials Released - Transferred to other States,78,0,78
WEST BENGAL,2008,Under trials Released - Extradited,0,0,0
WEST BENGAL,2008,Under trials Released - Other releases (transferred to Mental/Civil hospital),0,0,0
WEST BENGAL,2008,Total Under trials Released,68024,3873,71897
WEST BENGAL,2008,Detenus Released - Released on completion of detention period,0,0,0
WEST BENGAL,2008,Detenus Released - Released before completion of detention period,0,0,0
WEST BENGAL,2008,Detenus Released - Released on bail,0,0,0
WEST BENGAL,2008,Detenus Released - Other releases (temporary transfer etc.),0,0,0
WEST BENGAL,2008,Total Detenus Released,0,0,0
WEST BENGAL,2009,Convicts Released - Released after completion of conviction,9850,85,9935
WEST BENGAL,2009,Convicts Released - Premature release,15,0,15
WEST BENGAL,2009,Convicts Released - Released on appeal,49,7,56
WEST BENGAL,2009,Convicts Released - Released on bail,916,30,946
WEST BENGAL,2009,Convicts Released - Pardons,0,0,0
WEST BENGAL,2009,Convicts Released - Transferred to other States,0,0,0
WEST BENGAL,2009,"Convicts Released - Other Releases (due to illness, transferred to Mental hospital)",0,0,0
WEST BENGAL,2009,Total Convicts Released,10830,122,10952
WEST BENGAL,2009,Under trials Released - Acquitted,1411,95,1506
WEST BENGAL,2009,Under trials Released - Released on appeal,36,0,36
WEST BENGAL,2009,Under trials Released - Released on bail,67200,3900,71100
WEST BENGAL,2009,Under trials Released - Transferred to other States,70,0,70
WEST BENGAL,2009,Under trials Released - Extradited,0,0,0
WEST BENGAL,2009,Under trials Released - Other releases (transferred to Mental/Civil hospital),0,0,0
WEST BENGAL,2009,Total Under trials Released,68717,3995,72712
WEST BENGAL,2009,Detenus Released - Released on completion of detention period,0,0,0
WEST BENGAL,2009,Detenus Released - Released before completion of detention period,0,0,0
WEST BENGAL,2009,Detenus Released - Released on bail,0,0,0
WEST BENGAL,2009,Detenus Released - Other releases (temporary transfer etc.),0,0,0
WEST BENGAL,2009,Total Detenus Released,0,0,0
WEST BENGAL,2010,Convicts Released - Released after completion of conviction,10110,75,10185
WEST BENGAL,2010,Convicts Released - Premature release,17,0,17
WEST BENGAL,2010,Convicts Released - Released on appeal,29,6,35
WEST BENGAL,2010,Convicts Released - Released on bail,2014,40,2054
WEST BENGAL,2010,Convicts Released - Pardons,0,0,0
WEST BENGAL,2010,Convicts Released - Transferred to other States,0,0,0
WEST BENGAL,2010,"Convicts Released - Other Releases (due to illness, transferred to Mental hospital)",0,0,0
WEST BENGAL,2010,Total Convicts Released,12170,121,12291
WEST BENGAL,2010,Under trials Released - Acquitted,1432,90,1522
WEST BENGAL,2010,Under trials Released - Released on appeal,32,0,32
WEST BENGAL,2010,Under trials Released - Released on bail,68600,3850,72450
WEST BENGAL,2010,Under trials Released - Transferred to other States,64,0,64
WEST BENGAL,2010,Under trials Released - Extradited,0,0,0
WEST BENGAL,2010,Under trials Released - Other releases (transferred to Mental/Civil hospital),0,0,0
WEST BENGAL,2010,Total Under trials Released,70128,3940,74068
WEST BENGAL,2010,Detenus Released - Released on completion of detention period,0,0,0
WEST BENGAL,2010,Detenus Released - Released before completion of detention period,0,0,0
WEST BENGAL,2010,Detenus Released - Released on bail,0,0,0
WEST BENGAL,2010,Detenus Released - Other releases (temporary transfer etc.),0,0,0
WEST BENGAL,2010,Total Detenus Released,0,0,0
WEST BENGAL,2011,Convicts Released - Released after completion of conviction,7550,181,7731
WEST BENGAL,2011,Convicts Released - Premature release,75,0,75
WEST BENGAL,2011,Convicts Released - Released on appeal,50,11,61
WEST BENGAL,2011,Convicts Released - Released on bail,1996,35,2031
WEST BENGAL,2011,Convicts Released - Pardons,0,0,0
WEST BENGAL,2011,Convicts Released - Transferred to other States,101,0,101
WEST BENGAL,2011,"Convicts Released - Other Releases (due to illness, transferred to Mental hospital)",304,47,351
WEST BENGAL,2011,Total Convicts Released,10076,274,10350
WEST BENGAL,2011,Under trials Released - Acquitted,1094,85,1179
WEST BENGAL,2011,Under trials Released - Released on appeal,781,6,787
WEST BENGAL,2011,Under trials Released - Released on bail,78763,5272,84035
WEST BENGAL,2011,Under trials Released - Transferred to other States,139,0,139
WEST BENGAL,2011,Under trials Released - Extradited,0,0,0
WEST BENGAL,2011,Under trials Released - Other releases (transferred to Mental/Civil hospital),219,2,221
WEST BENGAL,2011,Total Under trials Released,80996,5365,86361
WEST BENGAL,2011,Detenus Released - Released on completion of detention period,0,0,0
WEST BENGAL,2011,Detenus Released - Released before completion of detention period,0,0,0
WEST BENGAL,2011,Detenus Released - Released on bail,0,0,0
WEST BENGAL,2011,Detenus Released - Other releases (temporary transfer etc.),0,0,0
WEST BENGAL,2011,Total Detenus Released,0,0,0
WEST BENGAL,2012,Convicts Released - Released after completion of conviction,6559,279,6838
WEST BENGAL,2012,Convicts Released - Premature release,99,2,101
WEST BENGAL,2012,Convicts Released - Released on appeal,15,7,22
WEST BENGAL,2012,Convicts Released - Released on bail,977,75,1052
WEST BENGAL,2012,Convicts Released - Pardons,0,1,1
WEST BENGAL,2012,Convicts Released - Transferred to other States,26,2,28
WEST BENGAL,2012,"Convicts Released - Other Releases (due to illness, transferred to Mental hospital)",236,10,246
WEST BENGAL,2012,Total Convicts Released,7912,376,8288
WEST BENGAL,2012,Under trials Released - Acquitted,1074,94,1168
WEST BENGAL,2012,Under trials Released - Released on appeal,148,26,174
WEST BENGAL,2012,Under trials Released - Released on bail,77616,3952,81568
WEST BENGAL,2012,Under trials Released - Transferred to other States,108,2,110
WEST BENGAL,2012,Under trials Released - Extradited,0,0,0
WEST BENGAL,2012,Under trials Released - Other releases (transferred to Mental/Civil hospital),225,3,228
WEST BENGAL,2012,Total Under trials Released,79171,4077,83248
WEST BENGAL,2012,Detenus Released - Released on completion of detention period,4,0,4
WEST BENGAL,2012,Detenus Released - Released before completion of detention period,0,0,0
WEST BENGAL,2012,Detenus Released - Released on bail,0,0,0
WEST BENGAL,2012,Detenus Released - Other releases (temporary transfer etc.),0,0,0
WEST BENGAL,2012,Total Detenus Released,4,0,4
A & N ISLANDS,2001,Convicts Released - Released after completion of conviction,0,0,0
A & N ISLANDS,2001,Convicts Released - Premature release,0,0,0
A & N ISLANDS,2001,Convicts Released - Released on appeal,6,0,6
A & N ISLANDS,2001,Convicts Released - Released on bail,4,0,4
A & N ISLANDS,2001,Convicts Released - Pardons,0,0,0
A & N ISLANDS,2001,Convicts Released - Transferred to other States,0,0,0
A & N ISLANDS,2001,"Convicts Released - Other Releases (due to illness, transferred to Mental hospital)",2,0,2
A & N ISLANDS,2001,Total Convicts Released,12,0,12
A & N ISLANDS,2001,Under trials Released - Acquitted,0,0,0
A & N ISLANDS,2001,Under trials Released - Released on appeal,0,0,0
A & N ISLANDS,2001,Under trials Released - Released on bail,0,0,0
A & N ISLANDS,2001,Under trials Released - Transferred to other States,0,0,0
A & N ISLANDS,2001,Under trials Released - Extradited,0,0,0
A & N ISLANDS,2001,Under trials Released - Other releases (transferred to Mental/Civil hospital),0,0,0
A & N ISLANDS,2001,Total Under trials Released,0,0,0
A & N ISLANDS,2001,Detenus Released - Released on completion of detention period,0,0,0
A & N ISLANDS,2001,Detenus Released - Released before completion of detention period,0,0,0
A & N ISLANDS,2001,Detenus Released - Released on bail,0,0,0
A & N ISLANDS,2001,Detenus Released - Other releases (temporary transfer etc.),0,0,0
A & N ISLANDS,2001,Total Detenus Released,0,0,0
A & N ISLANDS,2002,Convicts Released - Released after completion of conviction,0,0,0
A & N ISLANDS,2002,Convicts Released - Premature release,0,0,0
A & N ISLANDS,2002,Convicts Released - Released on appeal,4,0,4
A & N ISLANDS,2002,Convicts Released - Released on bail,10,1,11
A & N ISLANDS,2002,Convicts Released - Pardons,0,0,0
A & N ISLANDS,2002,Convicts Released - Transferred to other States,0,0,0
A & N ISLANDS,2002,"Convicts Released - Other Releases (due to illness, transferred to Mental hospital)",4,0,4
A & N ISLANDS,2002,Total Convicts Released,18,1,19
A & N ISLANDS,2002,Under trials Released - Acquitted,0,0,0
A & N ISLANDS,2002,Under trials Released - Released on appeal,0,0,0
A & N ISLANDS,2002,Under trials Released - Released on bail,0,0,0
A & N ISLANDS,2002,Under trials Released - Transferred to other States,0,0,0
A & N ISLANDS,2002,Under trials Released - Extradited,0,0,0
A & N ISLANDS,2002,Under trials Released - Other releases (transferred to Mental/Civil hospital),0,0,0
A & N ISLANDS,2002,Total Under trials Released,0,0,0
A & N ISLANDS,2002,Detenus Released - Released on completion of detention period,0,0,0
A & N ISLANDS,2002,Detenus Released - Released before completion of detention period,0,0,0
A & N ISLANDS,2002,Detenus Released - Released on bail,0,0,0
A & N ISLANDS,2002,Detenus Released - Other releases (temporary transfer etc.),0,0,0
A & N ISLANDS,2002,Total Detenus Released,0,0,0
A & N ISLANDS,2003,Convicts Released - Released after completion of conviction,395,1,396
A & N ISLANDS,2003,Convicts Released - Premature release,0,0,0
A & N ISLANDS,2003,Convicts Released - Released on appeal,1,0,1
A & N ISLANDS,2003,Convicts Released - Released on bail,1,0,1
A & N ISLANDS,2003,Convicts Released - Pardons,0,0,0
A & N ISLANDS,2003,Convicts Released - Transferred to other States,0,0,0
A & N ISLANDS,2003,"Convicts Released - Other Releases (due to illness, transferred to Mental hospital)",44,1,45
A & N ISLANDS,2003,Total Convicts Released,441,2,443
A & N ISLANDS,2003,Under trials Released - Acquitted,4,0,4
A & N ISLANDS,2003,Under trials Released - Released on appeal,0,0,0
A & N ISLANDS,2003,Under trials Released - Released on bail,493,1,494
A & N ISLANDS,2003,Under trials Released - Transferred to other States,0,0,0
A & N ISLANDS,2003,Under trials Released - Extradited,0,0,0
A & N ISLANDS,2003,Under trials Released - Other releases (transferred to Mental/Civil hospital),203,0,203
A & N ISLANDS,2003,Total Under trials Released,700,1,701
A & N ISLANDS,2003,Detenus Released - Released on completion of detention period,0,0,0
A & N ISLANDS,2003,Detenus Released - Released before completion of detention period,0,0,0
A & N ISLANDS,2003,Detenus Released - Released on bail,0,0,0
A & N ISLANDS,2003,Detenus Released - Other releases (temporary transfer etc.),0,0,0
A & N ISLANDS,2003,Total Detenus Released,0,0,0
A & N ISLANDS,2004,Convicts Released - Released after completion of conviction,189,0,189
A & N ISLANDS,2004,Convicts Released - Premature release,3,0,3
A & N ISLANDS,2004,Convicts Released - Released on appeal,1,0,1
A & N ISLANDS,2004,Convicts Released - Released on bail,1,0,1
A & N ISLANDS,2004,Convicts Released - Pardons,0,0,0
A & N ISLANDS,2004,Convicts Released - Transferred to other States,0,0,0
A & N ISLANDS,2004,"Convicts Released - Other Releases (due to illness, transferred to Mental hospital)",32,0,32
A & N ISLANDS,2004,Total Convicts Released,226,0,226
A & N ISLANDS,2004,Under trials Released - Acquitted,15,0,15
A & N ISLANDS,2004,Under trials Released - Released on appeal,0,0,0
A & N ISLANDS,2004,Under trials Released - Released on bail,678,18,696
A & N ISLANDS,2004,Under trials Released - Transferred to other States,0,0,0
A & N ISLANDS,2004,Under trials Released - Extradited,0,0,0
A & N ISLANDS,2004,Under trials Released - Other releases (transferred to Mental/Civil hospital),185,0,185
A & N ISLANDS,2004,Total Under trials Released,878,18,896
A & N ISLANDS,2004,Detenus Released - Released on completion of detention period,0,0,0
A & N ISLANDS,2004,Detenus Released - Released before completion of detention period,0,0,0
A & N ISLANDS,2004,Detenus Released - Released on bail,0,0,0
A & N ISLANDS,2004,Detenus Released - Other releases (temporary transfer etc.),0,0,0
A & N ISLANDS,2004,Total Detenus Released,0,0,0
A & N ISLANDS,2005,Convicts Released - Released after completion of conviction,154,0,154
A & N ISLANDS,2005,Convicts Released - Premature release,5,1,6
A & N ISLANDS,2005,Convicts Released - Released on appeal,2,0,2
A & N ISLANDS,2005,Convicts Released - Released on bail,3,0,3
A & N ISLANDS,2005,Convicts Released - Pardons,0,0,0
A & N ISLANDS,2005,Convicts Released - Transferred to other States,0,0,0
A & N ISLANDS,2005,"Convicts Released - Other Releases (due to illness, transferred to Mental hospital)",46,0,46
A & N ISLANDS,2005,Total Convicts Released,210,1,211
A & N ISLANDS,2005,Under trials Released - Acquitted,2,0,2
A & N ISLANDS,2005,Under trials Released - Released on appeal,0,0,0
A & N ISLANDS,2005,Under trials Released - Released on bail,417,5,422
A & N ISLANDS,2005,Under trials Released - Transferred to other States,0,0,0
A & N ISLANDS,2005,Under trials Released - Extradited,0,0,0
A & N ISLANDS,2005,Under trials Released - Other releases (transferred to Mental/Civil hospital),186,0,186
A & N ISLANDS,2005,Total Under trials Released,605,5,610
A & N ISLANDS,2005,Detenus Released - Released on completion of detention period,0,0,0
A & N ISLANDS,2005,Detenus Released - Released before completion of detention period,0,0,0
A & N ISLANDS,2005,Detenus Released - Released on bail,0,0,0
A & N ISLANDS,2005,Detenus Released - Other releases (temporary transfer etc.),0,0,0
A & N ISLANDS,2005,Total Detenus Released,0,0,0
A & N ISLANDS,2006,Convicts Released - Released after completion of conviction,360,0,360
A & N ISLANDS,2006,Convicts Released - Premature release,4,0,4
A & N ISLANDS,2006,Convicts Released - Released on appeal,0,0,0
A & N ISLANDS,2006,Convicts Released - Released on bail,1,0,1
A & N ISLANDS,2006,Convicts Released - Pardons,0,0,0
A & N ISLANDS,2006,Convicts Released - Transferred to other States,0,0,0
A & N ISLANDS,2006,"Convicts Released - Other Releases (due to illness, transferred to Mental hospital)",0,0,0
A & N ISLANDS,2006,Total Convicts Released,365,0,365
A & N ISLANDS,2006,Under trials Released - Acquitted,0,0,0
A & N ISLANDS,2006,Under trials Released - Released on appeal,0,0,0
A & N ISLANDS,2006,Under trials Released - Released on bail,488,0,488
A & N ISLANDS,2006,Under trials Released - Transferred to other States,0,0,0
A & N ISLANDS,2006,Under trials Released - Extradited,0,0,0
A & N ISLANDS,2006,Under trials Released - Other releases (transferred to Mental/Civil hospital),235,0,235
A & N ISLANDS,2006,Total Under trials Released,723,0,723
A & N ISLANDS,2006,Detenus Released - Released on completion of detention period,0,0,0
A & N ISLANDS,2006,Detenus Released - Released before completion of detention period,0,0,0
A & N ISLANDS,2006,Detenus Released - Released on bail,0,0,0
A & N ISLANDS,2006,Detenus Released - Other releases (temporary transfer etc.),0,0,0
A & N ISLANDS,2006,Total Detenus Released,0,0,0
A & N ISLANDS,2007,Convicts Released - Released after completion of conviction,473,0,473
A & N ISLANDS,2007,Convicts Released - Premature release,1,0,1
A & N ISLANDS,2007,Convicts Released - Released on appeal,0,0,0
A & N ISLANDS,2007,Convicts Released - Released on bail,0,0,0
A & N ISLANDS,2007,Convicts Released - Pardons,0,0,0
A & N ISLANDS,2007,Convicts Released - Transferred to other States,0,0,0
A & N ISLANDS,2007,"Convicts Released - Other Releases (due to illness, transferred to Mental hospital)",0,0,0
A & N ISLANDS,2007,Total Convicts Released,474,0,474
A & N ISLANDS,2007,Under trials Released - Acquitted,0,0,0
A & N ISLANDS,2007,Under trials Released - Released on appeal,0,0,0
A & N ISLANDS,2007,Under trials Released - Released on bail,468,7,475
A & N ISLANDS,2007,Under trials Released - Transferred to other States,0,0,0
A & N ISLANDS,2007,Under trials Released - Extradited,0,0,0
A & N ISLANDS,2007,Under trials Released - Other releases (transferred to Mental/Civil hospital),446,0,446
A & N ISLANDS,2007,Total Under trials Released,914,7,921
A & N ISLANDS,2007,Detenus Released - Released on completion of detention period,0,0,0
A & N ISLANDS,2007,Detenus Released - Released before completion of detention period,0,0,0
A & N ISLANDS,2007,Detenus Released - Released on bail,0,0,0
A & N ISLANDS,2007,Detenus Released - Other releases (temporary transfer etc.),0,0,0
A & N ISLANDS,2007,Total Detenus Released,0,0,0
A & N ISLANDS,2008,Convicts Released - Released after completion of conviction,505,0,505
A & N ISLANDS,2008,Convicts Released - Premature release,1,0,1
A & N ISLANDS,2008,Convicts Released - Released on appeal,0,0,0
A & N ISLANDS,2008,Convicts Released - Released on bail,0,0,0
A & N ISLANDS,2008,Convicts Released - Pardons,0,0,0
A & N ISLANDS,2008,Convicts Released - Transferred to other States,0,0,0
A & N ISLANDS,2008,"Convicts Released - Other Releases (due to illness, transferred to Mental hospital)",0,0,0
A & N ISLANDS,2008,Total Convicts Released,506,0,506
A & N ISLANDS,2008,Under trials Released - Acquitted,0,0,0
A & N ISLANDS,2008,Under trials Released - Released on appeal,0,0,0
A & N ISLANDS,2008,Under trials Released - Released on bail,618,11,629
A & N ISLANDS,2008,Under trials Released - Transferred to other States,0,0,0
A & N ISLANDS,2008,Under trials Released - Extradited,0,0,0
A & N ISLANDS,2008,Under trials Released - Other releases (transferred to Mental/Civil hospital),283,0,283
A & N ISLANDS,2008,Total Under trials Released,901,11,912
A & N ISLANDS,2008,Detenus Released - Released on completion of detention period,0,0,0
A & N ISLANDS,2008,Detenus Released - Released before completion of detention period,0,0,0
A & N ISLANDS,2008,Detenus Released - Released on bail,0,0,0
A & N ISLANDS,2008,Detenus Released - Other releases (temporary transfer etc.),0,0,0
A & N ISLANDS,2008,Total Detenus Released,0,0,0
A & N ISLANDS,2009,Convicts Released - Released after completion of conviction,357,0,357
A & N ISLANDS,2009,Convicts Released - Premature release,3,0,3
A & N ISLANDS,2009,Convicts Released - Released on appeal,0,0,0
A & N ISLANDS,2009,Convicts Released - Released on bail,0,0,0
A & N ISLANDS,2009,Convicts Released - Pardons,0,0,0
A & N ISLANDS,2009,Convicts Released - Transferred to other States,0,0,0
A & N ISLANDS,2009,"Convicts Released - Other Releases (due to illness, transferred to Mental hospital)",0,0,0
A & N ISLANDS,2009,Total Convicts Released,360,0,360
A & N ISLANDS,2009,Under trials Released - Acquitted,7,0,7
A & N ISLANDS,2009,Under trials Released - Released on appeal,1,0,1
A & N ISLANDS,2009,Under trials Released - Released on bail,569,1,570
A & N ISLANDS,2009,Under trials Released - Transferred to other States,0,0,0
A & N ISLANDS,2009,Under trials Released - Extradited,0,0,0
A & N ISLANDS,2009,Under trials Released - Other releases (transferred to Mental/Civil hospital),0,0,0
A & N ISLANDS,2009,Total Under trials Released,577,1,578
A & N ISLANDS,2009,Detenus Released - Released on completion of detention period,0,0,0
A & N ISLANDS,2009,Detenus Released - Released before completion of detention period,0,0,0
A & N ISLANDS,2009,Detenus Released - Released on bail,0,0,0
A & N ISLANDS,2009,Detenus Released - Other releases (temporary transfer etc.),0,0,0
A & N ISLANDS,2009,Total Detenus Released,0,0,0
A & N ISLANDS,2010,Convicts Released - Released after completion of conviction,237,0,237
A & N ISLANDS,2010,Convicts Released - Premature release,0,0,0
A & N ISLANDS,2010,Convicts Released - Released on appeal,0,0,0
A & N ISLANDS,2010,Convicts Released - Released on bail,0,0,0
A & N ISLANDS,2010,Convicts Released - Pardons,0,0,0
A & N ISLANDS,2010,Convicts Released - Transferred to other States,0,0,0
A & N ISLANDS,2010,"Convicts Released - Other Releases (due to illness, transferred to Mental hospital)",0,0,0
A & N ISLANDS,2010,Total Convicts Released,237,0,237
A & N ISLANDS,2010,Under trials Released - Acquitted,3,0,3
A & N ISLANDS,2010,Under trials Released - Released on appeal,0,0,0
A & N ISLANDS,2010,Under trials Released - Released on bail,633,3,636
A & N ISLANDS,2010,Under trials Released - Transferred to other States,0,0,0
A & N ISLANDS,2010,Under trials Released - Extradited,0,0,0
A & N ISLANDS,2010,Under trials Released - Other releases (transferred to Mental/Civil hospital),0,0,0
A & N ISLANDS,2010,Total Under trials Released,636,3,639
A & N ISLANDS,2010,Detenus Released - Released on completion of detention period,0,0,0
A & N ISLANDS,2010,Detenus Released - Released before completion of detention period,0,0,0
A & N ISLANDS,2010,Detenus Released - Released on bail,0,0,0
A & N ISLANDS,2010,Detenus Released - Other releases (temporary transfer etc.),0,0,0
A & N ISLANDS,2010,Total Detenus Released,0,0,0
A & N ISLANDS,2011,Convicts Released - Released after completion of conviction,64,0,64
A & N ISLANDS,2011,Convicts Released - Premature release,0,0,0
A & N ISLANDS,2011,Convicts Released - Released on appeal,0,0,0
A & N ISLANDS,2011,Convicts Released - Released on bail,0,0,0
A & N ISLANDS,2011,Convicts Released - Pardons,0,0,0
A & N ISLANDS,2011,Convicts Released - Transferred to other States,0,0,0
A & N ISLANDS,2011,"Convicts Released - Other Releases (due to illness, transferred to Mental hospital)",0,0,0
A & N ISLANDS,2011,Total Convicts Released,64,0,64
A & N ISLANDS,2011,Under trials Released - Acquitted,1,0,1
A & N ISLANDS,2011,Under trials Released - Released on appeal,0,0,0
A & N ISLANDS,2011,Under trials Released - Released on bail,601,0,601
A & N ISLANDS,2011,Under trials Released - Transferred to other States,0,0,0
A & N ISLANDS,2011,Under trials Released - Extradited,0,0,0
A & N ISLANDS,2011,Under trials Released - Other releases (transferred to Mental/Civil hospital),0,0,0
A & N ISLANDS,2011,Total Under trials Released,602,0,602
A & N ISLANDS,2011,Detenus Released - Released on completion of detention period,0,0,0
A & N ISLANDS,2011,Detenus Released - Released before completion of detention period,0,0,0
A & N ISLANDS,2011,Detenus Released - Released on bail,0,0,0
A & N ISLANDS,2011,Detenus Released - Other releases (temporary transfer etc.),0,0,0
A & N ISLANDS,2011,Total Detenus Released,0,0,0
A & N ISLANDS,2012,Convicts Released - Released after completion of conviction,1052,0,1052
A & N ISLANDS,2012,Convicts Released - Premature release,0,0,0
A & N ISLANDS,2012,Convicts Released - Released on appeal,1,0,1
A & N ISLANDS,2012,Convicts Released - Released on bail,0,0,0
A & N ISLANDS,2012,Convicts Released - Pardons,0,0,0
A & N ISLANDS,2012,Convicts Released - Transferred to other States,0,0,0
A & N ISLANDS,2012,"Convicts Released - Other Releases (due to illness, transferred to Mental hospital)",0,0,0
A & N ISLANDS,2012,Total Convicts Released,1053,0,1053
A & N ISLANDS,2012,Under trials Released - Acquitted,0,0,0
A & N ISLANDS,2012,Under trials Released - Released on appeal,0,0,0
A & N ISLANDS,2012,Under trials Released - Released on bail,150,0,150
A & N ISLANDS,2012,Under trials Released - Transferred to other States,0,0,0
A & N ISLANDS,2012,Under trials Released - Extradited,0,0,0
A & N ISLANDS,2012,Under trials Released - Other releases (transferred to Mental/Civil hospital),562,0,562
A & N ISLANDS,2012,Total Under trials Released,712,0,712
A & N ISLANDS,2012,Detenus Released - Released on completion of detention period,0,0,0
A & N ISLANDS,2012,Detenus Released - Released before completion of detention period,0,0,0
A & N ISLANDS,2012,Detenus Released - Released on bail,0,0,0
A & N ISLANDS,2012,Detenus Released - Other releases (temporary transfer etc.),0,0,0
A & N ISLANDS,2012,Total Detenus Released,0,0,0
CHANDIGARH,2001,Convicts Released - Released after completion of conviction,17,2,19
CHANDIGARH,2001,Convicts Released - Premature release,0,0,0
CHANDIGARH,2001,Convicts Released - Released on appeal,75,8,83
CHANDIGARH,2001,Convicts Released - Released on bail,25,4,29
CHANDIGARH,2001,Convicts Released - Pardons,0,0,0
CHANDIGARH,2001,Convicts Released - Transferred to other States,6,0,6
CHANDIGARH,2001,"Convicts Released - Other Releases (due to illness, transferred to Mental hospital)",0,0,0
CHANDIGARH,2001,Total Convicts Released,123,14,137
CHANDIGARH,2001,Under trials Released - Acquitted,19,3,22
CHANDIGARH,2001,Under trials Released - Released on appeal,0,0,0
CHANDIGARH,2001,Under trials Released - Released on bail,1278,28,1306
CHANDIGARH,2001,Under trials Released - Transferred to other States,32,0,32
CHANDIGARH,2001,Under trials Released - Extradited,120,9,129
CHANDIGARH,2001,Under trials Released - Other releases (transferred to Mental/Civil hospital),0,0,0
CHANDIGARH,2001,Total Under trials Released,1449,40,1489
CHANDIGARH,2001,Detenus Released - Released on completion of detention period,0,0,0
CHANDIGARH,2001,Detenus Released - Released before completion of detention period,0,0,0
CHANDIGARH,2001,Detenus Released - Released on bail,0,0,0
CHANDIGARH,2001,Detenus Released - Other releases (temporary transfer etc.),0,0,0
CHANDIGARH,2001,Total Detenus Released,0,0,0
CHANDIGARH,2002,Convicts Released - Released after completion of conviction,26,4,30
CHANDIGARH,2002,Convicts Released - Premature release,1,0,1
CHANDIGARH,2002,Convicts Released - Released on appeal,0,0,0
CHANDIGARH,2002,Convicts Released - Released on bail,45,6,51
CHANDIGARH,2002,Convicts Released - Pardons,0,0,0
CHANDIGARH,2002,Convicts Released - Transferred to other States,5,0,5
CHANDIGARH,2002,"Convicts Released - Other Releases (due to illness, transferred to Mental hospital)",0,0,0
CHANDIGARH,2002,Total Convicts Released,77,10,87
CHANDIGARH,2002,Under trials Released - Acquitted,35,2,37
CHANDIGARH,2002,Under trials Released - Released on appeal,15,1,16
CHANDIGARH,2002,Under trials Released - Released on bail,1680,35,1715
CHANDIGARH,2002,Under trials Released - Transferred to other States,27,0,27
CHANDIGARH,2002,Under trials Released - Extradited,115,12,127
CHANDIGARH,2002,Under trials Released - Other releases (transferred to Mental/Civil hospital),0,0,0
CHANDIGARH,2002,Total Under trials Released,1872,50,1922
CHANDIGARH,2002,Detenus Released - Released on completion of detention period,0,0,0
CHANDIGARH,2002,Detenus Released - Released before completion of detention period,0,0,0
CHANDIGARH,2002,Detenus Released - Released on bail,0,0,0
CHANDIGARH,2002,Detenus Released - Other releases (temporary transfer etc.),0,0,0
CHANDIGARH,2002,Total Detenus Released,0,0,0
CHANDIGARH,2003,Convicts Released - Released after completion of conviction,34,6,40
CHANDIGARH,2003,Convicts Released - Premature release,1,0,1
CHANDIGARH,2003,Convicts Released - Released on appeal,0,0,0
CHANDIGARH,2003,Convicts Released - Released on bail,58,9,67
CHANDIGARH,2003,Convicts Released - Pardons,0,0,0
CHANDIGARH,2003,Convicts Released - Transferred to other States,2,0,2
CHANDIGARH,2003,"Convicts Released - Other Releases (due to illness, transferred to Mental hospital)",0,0,0
CHANDIGARH,2003,Total Convicts Released,95,15,110
CHANDIGARH,2003,Under trials Released - Acquitted,47,4,51
CHANDIGARH,2003,Under trials Released - Released on appeal,25,4,29
CHANDIGARH,2003,Under trials Released - Released on bail,1725,45,1770
CHANDIGARH,2003,Under trials Released - Transferred to other States,34,2,36
CHANDIGARH,2003,Under trials Released - Extradited,125,6,131
CHANDIGARH,2003,Under trials Released - Other releases (transferred to Mental/Civil hospital),0,0,0
CHANDIGARH,2003,Total Under trials Released,1956,61,2017
CHANDIGARH,2003,Detenus Released - Released on completion of detention period,0,0,0
CHANDIGARH,2003,Detenus Released - Released before completion of detention period,0,0,0
CHANDIGARH,2003,Detenus Released - Released on bail,0,0,0
CHANDIGARH,2003,Detenus Released - Other releases (temporary transfer etc.),0,0,0
CHANDIGARH,2003,Total Detenus Released,0,0,0
CHANDIGARH,2004,Convicts Released - Released after completion of conviction,29,4,33
CHANDIGARH,2004,Convicts Released - Premature release,4,0,4
CHANDIGARH,2004,Convicts Released - Released on appeal,0,0,0
CHANDIGARH,2004,Convicts Released - Released on bail,54,7,61
CHANDIGARH,2004,Convicts Released - Pardons,0,0,0
CHANDIGARH,2004,Convicts Released - Transferred to other States,2,0,2
CHANDIGARH,2004,"Convicts Released - Other Releases (due to illness, transferred to Mental hospital)",0,0,0
CHANDIGARH,2004,Total Convicts Released,89,11,100
CHANDIGARH,2004,Under trials Released - Acquitted,24,2,26
CHANDIGARH,2004,Under trials Released - Released on appeal,56,8,64
CHANDIGARH,2004,Under trials Released - Released on bail,3285,49,3334
CHANDIGARH,2004,Under trials Released - Transferred to other States,16,1,17
CHANDIGARH,2004,Under trials Released - Extradited,112,3,115
CHANDIGARH,2004,Under trials Released - Other releases (transferred to Mental/Civil hospital),0,0,0
CHANDIGARH,2004,Total Under trials Released,3493,63,3556
CHANDIGARH,2004,Detenus Released - Released on completion of detention period,0,0,0
CHANDIGARH,2004,Detenus Released - Released before completion of detention period,0,0,0
CHANDIGARH,2004,Detenus Released - Released on bail,0,0,0
CHANDIGARH,2004,Detenus Released - Other releases (temporary transfer etc.),0,0,0
CHANDIGARH,2004,Total Detenus Released,0,0,0
CHANDIGARH,2005,Convicts Released - Released after completion of conviction,15,4,19
CHANDIGARH,2005,Convicts Released - Premature release,3,0,3
CHANDIGARH,2005,Convicts Released - Released on appeal,0,0,0
CHANDIGARH,2005,Convicts Released - Released on bail,49,6,55
CHANDIGARH,2005,Convicts Released - Pardons,0,0,0
CHANDIGARH,2005,Convicts Released - Transferred to other States,4,0,4
CHANDIGARH,2005,"Convicts Released - Other Releases (due to illness, transferred to Mental hospital)",0,0,0
CHANDIGARH,2005,Total Convicts Released,71,10,81
CHANDIGARH,2005,Under trials Released - Acquitted,26,3,29
CHANDIGARH,2005,Under trials Released - Released on appeal,0,0,0
CHANDIGARH,2005,Under trials Released - Released on bail,2880,40,2920
CHANDIGARH,2005,Under trials Released - Transferred to other States,27,0,27
CHANDIGARH,2005,Under trials Released - Extradited,145,4,149
CHANDIGARH,2005,Under trials Released - Other releases (transferred to Mental/Civil hospital),0,0,0
CHANDIGARH,2005,Total Under trials Released,3078,47,3125
CHANDIGARH,2005,Detenus Released - Released on completion of detention period,0,0,0
CHANDIGARH,2005,Detenus Released - Released before completion of detention period,0,0,0
CHANDIGARH,2005,Detenus Released - Released on bail,0,0,0
CHANDIGARH,2005,Detenus Released - Other releases (temporary transfer etc.),0,0,0
CHANDIGARH,2005,Total Detenus Released,0,0,0
CHANDIGARH,2006,Convicts Released - Released after completion of conviction,25,2,27
CHANDIGARH,2006,Convicts Released - Premature release,1,0,1
CHANDIGARH,2006,Convicts Released - Released on appeal,0,0,0
CHANDIGARH,2006,Convicts Released - Released on bail,62,12,74
CHANDIGARH,2006,Convicts Released - Pardons,0,0,0
CHANDIGARH,2006,Convicts Released - Transferred to other States,3,0,3
CHANDIGARH,2006,"Convicts Released - Other Releases (due to illness, transferred to Mental hospital)",0,0,0
CHANDIGARH,2006,Total Convicts Released,91,14,105
CHANDIGARH,2006,Under trials Released - Acquitted,39,4,43
CHANDIGARH,2006,Under trials Released - Released on appeal,0,0,0
CHANDIGARH,2006,Under trials Released - Released on bail,3120,65,3185
CHANDIGARH,2006,Under trials Released - Transferred to other States,43,0,43
CHANDIGARH,2006,Under trials Released - Extradited,240,9,249
CHANDIGARH,2006,Under trials Released - Other releases (transferred to Mental/Civil hospital),0,0,0
CHANDIGARH,2006,Total Under trials Released,3442,78,3520
CHANDIGARH,2006,Detenus Released - Released on completion of detention period,0,0,0
CHANDIGARH,2006,Detenus Released - Released before completion of detention period,0,0,0
CHANDIGARH,2006,Detenus Released - Released on bail,0,0,0
CHANDIGARH,2006,Detenus Released - Other releases (temporary transfer etc.),0,0,0
CHANDIGARH,2006,Total Detenus Released,0,0,0
CHANDIGARH,2007,Convicts Released - Released after completion of conviction,29,3,32
CHANDIGARH,2007,Convicts Released - Premature release,1,0,1
CHANDIGARH,2007,Convicts Released - Released on appeal,0,0,0
CHANDIGARH,2007,Convicts Released - Released on bail,56,6,62
CHANDIGARH,2007,Convicts Released - Pardons,0,0,0
CHANDIGARH,2007,Convicts Released - Transferred to other States,1,0,1
CHANDIGARH,2007,"Convicts Released - Other Releases (due to illness, transferred to Mental hospital)",0,0,0
CHANDIGARH,2007,Total Convicts Released,87,9,96
CHANDIGARH,2007,Under trials Released - Acquitted,45,2,47
CHANDIGARH,2007,Under trials Released - Released on appeal,22,0,22
CHANDIGARH,2007,Under trials Released - Released on bail,3143,70,3213
CHANDIGARH,2007,Under trials Released - Transferred to other States,32,0,32
CHANDIGARH,2007,Under trials Released - Extradited,342,16,358
CHANDIGARH,2007,Under trials Released - Other releases (transferred to Mental/Civil hospital),1,0,1
CHANDIGARH,2007,Total Under trials Released,3585,88,3673
CHANDIGARH,2007,Detenus Released - Released on completion of detention period,0,0,0
CHANDIGARH,2007,Detenus Released - Released before completion of detention period,0,0,0
CHANDIGARH,2007,Detenus Released - Released on bail,0,0,0
CHANDIGARH,2007,Detenus Released - Other releases (temporary transfer etc.),0,0,0
CHANDIGARH,2007,Total Detenus Released,0,0,0
CHANDIGARH,2008,Convicts Released - Released after completion of conviction,42,4,46
CHANDIGARH,2008,Convicts Released - Premature release,2,0,2
CHANDIGARH,2008,Convicts Released - Released on appeal,0,0,0
CHANDIGARH,2008,Convicts Released - Released on bail,114,20,134
CHANDIGARH,2008,Convicts Released - Pardons,0,0,0
CHANDIGARH,2008,Convicts Released - Transferred to other States,1,0,1
CHANDIGARH,2008,"Convicts Released - Other Releases (due to illness, transferred to Mental hospital)",0,0,0
CHANDIGARH,2008,Total Convicts Released,159,24,183
CHANDIGARH,2008,Under trials Released - Acquitted,25,1,26
CHANDIGARH,2008,Under trials Released - Released on appeal,32,0,32
CHANDIGARH,2008,Under trials Released - Released on bail,3420,93,3513
CHANDIGARH,2008,Under trials Released - Transferred to other States,21,0,21
CHANDIGARH,2008,Under trials Released - Extradited,432,22,454
CHANDIGARH,2008,Under trials Released - Other releases (transferred to Mental/Civil hospital),0,0,0
CHANDIGARH,2008,Total Under trials Released,3930,116,4046
CHANDIGARH,2008,Detenus Released - Released on completion of detention period,0,0,0
CHANDIGARH,2008,Detenus Released - Released before completion of detention period,0,0,0
CHANDIGARH,2008,Detenus Released - Released on bail,0,0,0
CHANDIGARH,2008,Detenus Released - Other releases (temporary transfer etc.),0,0,0
CHANDIGARH,2008,Total Detenus Released,0,0,0
CHANDIGARH,2009,Convicts Released - Released after completion of conviction,54,3,57
CHANDIGARH,2009,Convicts Released - Premature release,4,0,4
CHANDIGARH,2009,Convicts Released - Released on appeal,0,0,0
CHANDIGARH,2009,Convicts Released - Released on bail,130,12,142
CHANDIGARH,2009,Convicts Released - Pardons,0,0,0
CHANDIGARH,2009,Convicts Released - Transferred to other States,1,0,1
CHANDIGARH,2009,"Convicts Released - Other Releases (due to illness, transferred to Mental hospital)",0,0,0
CHANDIGARH,2009,Total Convicts Released,189,15,204
CHANDIGARH,2009,Under trials Released - Acquitted,36,2,38
CHANDIGARH,2009,Under trials Released - Released on appeal,62,2,64
CHANDIGARH,2009,Under trials Released - Released on bail,3640,48,3688
CHANDIGARH,2009,Under trials Released - Transferred to other States,22,0,22
CHANDIGARH,2009,Under trials Released - Extradited,0,0,0
CHANDIGARH,2009,Under trials Released - Other releases (transferred to Mental/Civil hospital),0,0,0
CHANDIGARH,2009,Total Under trials Released,3760,52,3812
CHANDIGARH,2009,Detenus Released - Released on completion of detention period,0,0,0
CHANDIGARH,2009,Detenus Released - Released before completion of detention period,0,0,0
CHANDIGARH,2009,Detenus Released - Released on bail,0,0,0
CHANDIGARH,2009,Detenus Released - Other releases (temporary transfer etc.),0,0,0
CHANDIGARH,2009,Total Detenus Released,0,0,0
CHANDIGARH,2010,Convicts Released - Released after completion of conviction,67,9,76
CHANDIGARH,2010,Convicts Released - Premature release,1,0,1
CHANDIGARH,2010,Convicts Released - Released on appeal,0,0,0
CHANDIGARH,2010,Convicts Released - Released on bail,126,9,135
CHANDIGARH,2010,Convicts Released - Pardons,0,0,0
CHANDIGARH,2010,Convicts Released - Transferred to other States,10,0,10
CHANDIGARH,2010,"Convicts Released - Other Releases (due to illness, transferred to Mental hospital)",0,0,0
CHANDIGARH,2010,Total Convicts Released,204,18,222
CHANDIGARH,2010,Under trials Released - Acquitted,44,1,45
CHANDIGARH,2010,Under trials Released - Released on appeal,38,1,39
CHANDIGARH,2010,Under trials Released - Released on bail,3285,61,3346
CHANDIGARH,2010,Under trials Released - Transferred to other States,34,0,34
CHANDIGARH,2010,Under trials Released - Extradited,0,0,0
CHANDIGARH,2010,Under trials Released - Other releases (transferred to Mental/Civil hospital),0,0,0
CHANDIGARH,2010,Total Under trials Released,3401,63,3464
CHANDIGARH,2010,Detenus Released - Released on completion of detention period,0,0,0
CHANDIGARH,2010,Detenus Released - Released before completion of detention period,0,0,0
CHANDIGARH,2010,Detenus Released - Released on bail,0,0,0
CHANDIGARH,2010,Detenus Released - Other releases (temporary transfer etc.),0,0,0
CHANDIGARH,2010,Total Detenus Released,0,0,0
CHANDIGARH,2011,Convicts Released - Released after completion of conviction,22,5,27
CHANDIGARH,2011,Convicts Released - Premature release,0,0,0
CHANDIGARH,2011,Convicts Released - Released on appeal,0,0,0
CHANDIGARH,2011,Convicts Released - Released on bail,143,6,149
CHANDIGARH,2011,Convicts Released - Pardons,0,0,0
CHANDIGARH,2011,Convicts Released - Transferred to other States,7,0,7
CHANDIGARH,2011,"Convicts Released - Other Releases (due to illness, transferred to Mental hospital)",0,0,0
CHANDIGARH,2011,Total Convicts Released,172,11,183
CHANDIGARH,2011,Under trials Released - Acquitted,39,2,41
CHANDIGARH,2011,Under trials Released - Released on appeal,24,0,24
CHANDIGARH,2011,Under trials Released - Released on bail,3425,54,3479
CHANDIGARH,2011,Under trials Released - Transferred to other States,27,0,27
CHANDIGARH,2011,Under trials Released - Extradited,0,0,0
CHANDIGARH,2011,Under trials Released - Other releases (transferred to Mental/Civil hospital),0,0,0
CHANDIGARH,2011,Total Under trials Released,3515,56,3571
CHANDIGARH,2011,Detenus Released - Released on completion of detention period,0,0,0
CHANDIGARH,2011,Detenus Released - Released before completion of detention period,0,0,0
CHANDIGARH,2011,Detenus Released - Released on bail,0,0,0
CHANDIGARH,2011,Detenus Released - Other releases (temporary transfer etc.),0,0,0
CHANDIGARH,2011,Total Detenus Released,0,0,0
CHANDIGARH,2012,Convicts Released - Released after completion of conviction,42,6,48
CHANDIGARH,2012,Convicts Released - Premature release,3,0,3
CHANDIGARH,2012,Convicts Released - Released on appeal,35,0,35
CHANDIGARH,2012,Convicts Released - Released on bail,159,12,171
CHANDIGARH,2012,Convicts Released - Pardons,0,0,0
CHANDIGARH,2012,Convicts Released - Transferred to other States,4,0,4
CHANDIGARH,2012,"Convicts Released - Other Releases (due to illness, transferred to Mental hospital)",0,0,0
CHANDIGARH,2012,Total Convicts Released,243,18,261
CHANDIGARH,2012,Under trials Released - Acquitted,46,5,51
CHANDIGARH,2012,Under trials Released - Released on appeal,37,4,41
CHANDIGARH,2012,Under trials Released - Released on bail,4220,89,4309
CHANDIGARH,2012,Under trials Released - Transferred to other States,68,2,70
CHANDIGARH,2012,Under trials Released - Extradited,0,0,0
CHANDIGARH,2012,Under trials Released - Other releases (transferred to Mental/Civil hospital),0,0,0
CHANDIGARH,2012,Total Under trials Released,4371,100,4471
CHANDIGARH,2012,Detenus Released - Released on completion of detention period,0,0,0
CHANDIGARH,2012,Detenus Released - Released before completion of detention period,0,0,0
CHANDIGARH,2012,Detenus Released - Released on bail,0,0,0
CHANDIGARH,2012,Detenus Released - Other releases (temporary transfer etc.),0,0,0
CHANDIGARH,2012,Total Detenus Released,0,0,0
D & N HAVELI,2001,Convicts Released - Released after completion of conviction,8,0,8
D & N HAVELI,2001,Convicts Released - Premature release,0,0,0
D & N HAVELI,2001,Convicts Released - Released on appeal,0,0,0
D & N HAVELI,2001,Convicts Released - Released on bail,0,0,0
D & N HAVELI,2001,Convicts Released - Pardons,0,0,0
D & N HAVELI,2001,Convicts Released - Transferred to other States,0,0,0
D & N HAVELI,2001,"Convicts Released - Other Releases (due to illness, transferred to Mental hospital)",0,0,0
D & N HAVELI,2001,Total Convicts Released,8,0,8
D & N HAVELI,2001,Under trials Released - Acquitted,5,0,5
D & N HAVELI,2001,Under trials Released - Released on appeal,0,0,0
D & N HAVELI,2001,Under trials Released - Released on bail,122,2,124
D & N HAVELI,2001,Under trials Released - Transferred to other States,5,0,5
D & N HAVELI,2001,Under trials Released - Extradited,0,0,0
D & N HAVELI,2001,Under trials Released - Other releases (transferred to Mental/Civil hospital),0,0,0
D & N HAVELI,2001,Total Under trials Released,132,2,134
D & N HAVELI,2001,Detenus Released - Released on completion of detention period,0,0,0
D & N HAVELI,2001,Detenus Released - Released before completion of detention period,0,0,0
D & N HAVELI,2001,Detenus Released - Released on bail,0,0,0
D & N HAVELI,2001,Detenus Released - Other releases (temporary transfer etc.),0,0,0
D & N HAVELI,2001,Total Detenus Released,0,0,0
D & N HAVELI,2002,Convicts Released - Released after completion of conviction,10,0,10
D & N HAVELI,2002,Convicts Released - Premature release,0,0,0
D & N HAVELI,2002,Convicts Released - Released on appeal,0,0,0
D & N HAVELI,2002,Convicts Released - Released on bail,0,0,0
D & N HAVELI,2002,Convicts Released - Pardons,0,0,0
D & N HAVELI,2002,Convicts Released - Transferred to other States,0,0,0
D & N HAVELI,2002,"Convicts Released - Other Releases (due to illness, transferred to Mental hospital)",0,0,0
D & N HAVELI,2002,Total Convicts Released,10,0,10
D & N HAVELI,2002,Under trials Released - Acquitted,0,0,0
D & N HAVELI,2002,Under trials Released - Released on appeal,8,0,8
D & N HAVELI,2002,Under trials Released - Released on bail,0,0,0
D & N HAVELI,2002,Under trials Released - Transferred to other States,0,0,0
D & N HAVELI,2002,Under trials Released - Extradited,138,0,138
D & N HAVELI,2002,Under trials Released - Other releases (transferred to Mental/Civil hospital),2,2,4
D & N HAVELI,2002,Total Under trials Released,148,2,150
D & N HAVELI,2002,Detenus Released - Released on completion of detention period,0,0,0
D & N HAVELI,2002,Detenus Released - Released before completion of detention period,0,0,0
D & N HAVELI,2002,Detenus Released - Released on bail,0,0,0
D & N HAVELI,2002,Detenus Released - Other releases (temporary transfer etc.),0,0,0
D & N HAVELI,2002,Total Detenus Released,0,0,0
D & N HAVELI,2003,Convicts Released - Released after completion of conviction,0,0,0
D & N HAVELI,2003,Convicts Released - Premature release,0,0,0
D & N HAVELI,2003,Convicts Released - Released on appeal,0,0,0
D & N HAVELI,2003,Convicts Released - Released on bail,0,0,0
D & N HAVELI,2003,Convicts Released - Pardons,0,0,0
D & N HAVELI,2003,Convicts Released - Transferred to other States,0,0,0
D & N HAVELI,2003,"Convicts Released - Other Releases (due to illness, transferred to Mental hospital)",0,0,0
D & N HAVELI,2003,Total Convicts Released,0,0,0
D & N HAVELI,2003,Under trials Released - Acquitted,10,0,10
D & N HAVELI,2003,Under trials Released - Released on appeal,0,0,0
D & N HAVELI,2003,Under trials Released - Released on bail,144,0,144
D & N HAVELI,2003,Under trials Released - Transferred to other States,1,0,1
D & N HAVELI,2003,Under trials Released - Extradited,0,0,0
D & N HAVELI,2003,Under trials Released - Other releases (transferred to Mental/Civil hospital),0,0,0
D & N HAVELI,2003,Total Under trials Released,155,0,155
D & N HAVELI,2003,Detenus Released - Released on completion of detention period,0,0,0
D & N HAVELI,2003,Detenus Released - Released before completion of detention period,0,0,0
D & N HAVELI,2003,Detenus Released - Released on bail,0,0,0
D & N HAVELI,2003,Detenus Released - Other releases (temporary transfer etc.),0,0,0
D & N HAVELI,2003,Total Detenus Released,0,0,0
D & N HAVELI,2004,Convicts Released - Released after completion of conviction,0,0,0
D & N HAVELI,2004,Convicts Released - Premature release,0,0,0
D & N HAVELI,2004,Convicts Released - Released on appeal,0,0,0
D & N HAVELI,2004,Convicts Released - Released on bail,0,0,0
D & N HAVELI,2004,Convicts Released - Pardons,0,0,0
D & N HAVELI,2004,Convicts Released - Transferred to other States,0,0,0
D & N HAVELI,2004,"Convicts Released - Other Releases (due to illness, transferred to Mental hospital)",0,0,0
D & N HAVELI,2004,Total Convicts Released,0,0,0
D & N HAVELI,2004,Under trials Released - Acquitted,24,0,24
D & N HAVELI,2004,Under trials Released - Released on appeal,0,0,0
D & N HAVELI,2004,Under trials Released - Released on bail,83,0,83
D & N HAVELI,2004,Under trials Released - Transferred to other States,25,0,25
D & N HAVELI,2004,Under trials Released - Extradited,0,0,0
D & N HAVELI,2004,Under trials Released - Other releases (transferred to Mental/Civil hospital),0,0,0
D & N HAVELI,2004,Total Under trials Released,132,0,132
D & N HAVELI,2004,Detenus Released - Released on completion of detention period,0,0,0
D & N HAVELI,2004,Detenus Released - Released before completion of detention period,0,0,0
D & N HAVELI,2004,Detenus Released - Released on bail,0,0,0
D & N HAVELI,2004,Detenus Released - Other releases (temporary transfer etc.),0,0,0
D & N HAVELI,2004,Total Detenus Released,0,0,0
D & N HAVELI,2005,Convicts Released - Released after completion of conviction,0,0,0
D & N HAVELI,2005,Convicts Released - Premature release,0,0,0
D & N HAVELI,2005,Convicts Released - Released on appeal,0,0,0
D & N HAVELI,2005,Convicts Released - Released on bail,0,0,0
D & N HAVELI,2005,Convicts Released - Pardons,0,0,0
D & N HAVELI,2005,Convicts Released - Transferred to other States,0,0,0
D & N HAVELI,2005,"Convicts Released - Other Releases (due to illness, transferred to Mental hospital)",0,0,0
D & N HAVELI,2005,Total Convicts Released,0,0,0
D & N HAVELI,2005,Under trials Released - Acquitted,27,0,27
D & N HAVELI,2005,Under trials Released - Released on appeal,0,0,0
D & N HAVELI,2005,Under trials Released - Released on bail,183,0,183
D & N HAVELI,2005,Under trials Released - Transferred to other States,15,0,15
D & N HAVELI,2005,Under trials Released - Extradited,0,0,0
D & N HAVELI,2005,Under trials Released - Other releases (transferred to Mental/Civil hospital),0,0,0
D & N HAVELI,2005,Total Under trials Released,225,0,225
D & N HAVELI,2005,Detenus Released - Released on completion of detention period,0,0,0
D & N HAVELI,2005,Detenus Released - Released before completion of detention period,0,0,0
D & N HAVELI,2005,Detenus Released - Released on bail,0,0,0
D & N HAVELI,2005,Detenus Released - Other releases (temporary transfer etc.),0,0,0
D & N HAVELI,2005,Total Detenus Released,0,0,0
D & N HAVELI,2006,Convicts Released - Released after completion of conviction,0,0,0
D & N HAVELI,2006,Convicts Released - Premature release,0,0,0
D & N HAVELI,2006,Convicts Released - Released on appeal,0,0,0
D & N HAVELI,2006,Convicts Released - Released on bail,0,0,0
D & N HAVELI,2006,Convicts Released - Pardons,0,0,0
D & N HAVELI,2006,Convicts Released - Transferred to other States,0,0,0
D & N HAVELI,2006,"Convicts Released - Other Releases (due to illness, transferred to Mental hospital)",0,0,0
D & N HAVELI,2006,Total Convicts Released,0,0,0
D & N HAVELI,2006,Under trials Released - Acquitted,11,0,11
D & N HAVELI,2006,Under trials Released - Released on appeal,0,0,0
D & N HAVELI,2006,Under trials Released - Released on bail,129,0,129
D & N HAVELI,2006,Under trials Released - Transferred to other States,0,0,0
D & N HAVELI,2006,Under trials Released - Extradited,0,0,0
D & N HAVELI,2006,Under trials Released - Other releases (transferred to Mental/Civil hospital),0,0,0
D & N HAVELI,2006,Total Under trials Released,140,0,140
D & N HAVELI,2006,Detenus Released - Released on completion of detention period,0,0,0
D & N HAVELI,2006,Detenus Released - Released before completion of detention period,0,0,0
D & N HAVELI,2006,Detenus Released - Released on bail,0,0,0
D & N HAVELI,2006,Detenus Released - Other releases (temporary transfer etc.),0,0,0
D & N HAVELI,2006,Total Detenus Released,0,0,0
D & N HAVELI,2007,Convicts Released - Released after completion of conviction,0,0,0
D & N HAVELI,2007,Convicts Released - Premature release,0,0,0
D & N HAVELI,2007,Convicts Released - Released on appeal,0,0,0
D & N HAVELI,2007,Convicts Released - Released on bail,0,0,0
D & N HAVELI,2007,Convicts Released - Pardons,0,0,0
D & N HAVELI,2007,Convicts Released - Transferred to other States,0,0,0
D & N HAVELI,2007,"Convicts Released - Other Releases (due to illness, transferred to Mental hospital)",0,0,0
D & N HAVELI,2007,Total Convicts Released,0,0,0
D & N HAVELI,2007,Under trials Released - Acquitted,5,0,5
D & N HAVELI,2007,Under trials Released - Released on appeal,0,0,0
D & N HAVELI,2007,Under trials Released - Released on bail,70,0,70
D & N HAVELI,2007,Under trials Released - Transferred to other States,8,0,8
D & N HAVELI,2007,Under trials Released - Extradited,0,0,0
D & N HAVELI,2007,Under trials Released - Other releases (transferred to Mental/Civil hospital),0,0,0
D & N HAVELI,2007,Total Under trials Released,83,0,83
D & N HAVELI,2007,Detenus Released - Released on completion of detention period,0,0,0
D & N HAVELI,2007,Detenus Released - Released before completion of detention period,0,0,0
D & N HAVELI,2007,Detenus Released - Released on bail,0,0,0
D & N HAVELI,2007,Detenus Released - Other releases (temporary transfer etc.),0,0,0
D & N HAVELI,2007,Total Detenus Released,0,0,0
D & N HAVELI,2008,Convicts Released - Released after completion of conviction,2,0,2
D & N HAVELI,2008,Convicts Released - Premature release,0,0,0
D & N HAVELI,2008,Convicts Released - Released on appeal,0,0,0
D & N HAVELI,2008,Convicts Released - Released on bail,0,0,0
D & N HAVELI,2008,Convicts Released - Pardons,0,0,0
D & N HAVELI,2008,Convicts Released - Transferred to other States,9,0,9
D & N HAVELI,2008,"Convicts Released - Other Releases (due to illness, transferred to Mental hospital)",0,0,0
D & N HAVELI,2008,Total Convicts Released,11,0,11
D & N HAVELI,2008,Under trials Released - Acquitted,12,0,12
D & N HAVELI,2008,Under trials Released - Released on appeal,0,0,0
D & N HAVELI,2008,Under trials Released - Released on bail,40,2,42
D & N HAVELI,2008,Under trials Released - Transferred to other States,2,0,2
D & N HAVELI,2008,Under trials Released - Extradited,0,0,0
D & N HAVELI,2008,Under trials Released - Other releases (transferred to Mental/Civil hospital),0,0,0
D & N HAVELI,2008,Total Under trials Released,54,2,56
D & N HAVELI,2008,Detenus Released - Released on completion of detention period,0,0,0
D & N HAVELI,2008,Detenus Released - Released before completion of detention period,0,0,0
D & N HAVELI,2008,Detenus Released - Released on bail,0,0,0
D & N HAVELI,2008,Detenus Released - Other releases (temporary transfer etc.),0,0,0
D & N HAVELI,2008,Total Detenus Released,0,0,0
D & N HAVELI,2009,Convicts Released - Released after completion of conviction,0,0,0
D & N HAVELI,2009,Convicts Released - Premature release,0,0,0
D & N HAVELI,2009,Convicts Released - Released on appeal,0,0,0
D & N HAVELI,2009,Convicts Released - Released on bail,0,0,0
D & N HAVELI,2009,Convicts Released - Pardons,0,0,0
D & N HAVELI,2009,Convicts Released - Transferred to other States,28,0,28
D & N HAVELI,2009,"Convicts Released - Other Releases (due to illness, transferred to Mental hospital)",0,0,0
D & N HAVELI,2009,Total Convicts Released,28,0,28
D & N HAVELI,2009,Under trials Released - Acquitted,15,0,15
D & N HAVELI,2009,Under trials Released - Released on appeal,0,0,0
D & N HAVELI,2009,Under trials Released - Released on bail,134,0,134
D & N HAVELI,2009,Under trials Released - Transferred to other States,0,0,0
D & N HAVELI,2009,Under trials Released - Extradited,0,0,0
D & N HAVELI,2009,Under trials Released - Other releases (transferred to Mental/Civil hospital),0,0,0
D & N HAVELI,2009,Total Under trials Released,149,0,149
D & N HAVELI,2009,Detenus Released - Released on completion of detention period,0,0,0
D & N HAVELI,2009,Detenus Released - Released before completion of detention period,0,0,0
D & N HAVELI,2009,Detenus Released - Released on bail,0,0,0
D & N HAVELI,2009,Detenus Released - Other releases (temporary transfer etc.),0,0,0
D & N HAVELI,2009,Total Detenus Released,0,0,0
D & N HAVELI,2010,Convicts Released - Released after completion of conviction,0,0,0
D & N HAVELI,2010,Convicts Released - Premature release,0,0,0
D & N HAVELI,2010,Convicts Released - Released on appeal,0,0,0
D & N HAVELI,2010,Convicts Released - Released on bail,0,0,0
D & N HAVELI,2010,Convicts Released - Pardons,0,0,0
D & N HAVELI,2010,Convicts Released - Transferred to other States,5,0,5
D & N HAVELI,2010,"Convicts Released - Other Releases (due to illness, transferred to Mental hospital)",0,0,0
D & N HAVELI,2010,Total Convicts Released,5,0,5
D & N HAVELI,2010,Under trials Released - Acquitted,11,2,13
D & N HAVELI,2010,Under trials Released - Released on appeal,0,0,0
D & N HAVELI,2010,Under trials Released - Released on bail,188,2,190
D & N HAVELI,2010,Under trials Released - Transferred to other States,6,0,6
D & N HAVELI,2010,Under trials Released - Extradited,0,0,0
D & N HAVELI,2010,Under trials Released - Other releases (transferred to Mental/Civil hospital),0,0,0
D & N HAVELI,2010,Total Under trials Released,205,4,209
D & N HAVELI,2010,Detenus Released - Released on completion of detention period,0,0,0
D & N HAVELI,2010,Detenus Released - Released before completion of detention period,0,0,0
D & N HAVELI,2010,Detenus Released - Released on bail,0,0,0
D & N HAVELI,2010,Detenus Released - Other releases (temporary transfer etc.),0,0,0
D & N HAVELI,2010,Total Detenus Released,0,0,0
D & N HAVELI,2011,Convicts Released - Released after completion of conviction,4,0,4
D & N HAVELI,2011,Convicts Released - Premature release,0,0,0
D & N HAVELI,2011,Convicts Released - Released on appeal,0,0,0
D & N HAVELI,2011,Convicts Released - Released on bail,0,0,0
D & N HAVELI,2011,Convicts Released - Pardons,0,0,0
D & N HAVELI,2011,Convicts Released - Transferred to other States,11,0,11
D & N HAVELI,2011,"Convicts Released - Other Releases (due to illness, transferred to Mental hospital)",0,0,0
D & N HAVELI,2011,Total Convicts Released,15,0,15
D & N HAVELI,2011,Under trials Released - Acquitted,6,0,6
D & N HAVELI,2011,Under trials Released - Released on appeal,0,0,0
D & N HAVELI,2011,Under trials Released - Released on bail,265,0,265
D & N HAVELI,2011,Under trials Released - Transferred to other States,16,0,16
D & N HAVELI,2011,Under trials Released - Extradited,0,0,0
D & N HAVELI,2011,Under trials Released - Other releases (transferred to Mental/Civil hospital),0,0,0
D & N HAVELI,2011,Total Under trials Released,287,0,287
D & N HAVELI,2011,Detenus Released - Released on completion of detention period,0,0,0
D & N HAVELI,2011,Detenus Released - Released before completion of detention period,0,0,0
D & N HAVELI,2011,Detenus Released - Released on bail,0,0,0
D & N HAVELI,2011,Detenus Released - Other releases (temporary transfer etc.),0,0,0
D & N HAVELI,2011,Total Detenus Released,0,0,0
D & N HAVELI,2012,Convicts Released - Released after completion of conviction,0,0,0
D & N HAVELI,2012,Convicts Released - Premature release,0,0,0
D & N HAVELI,2012,Convicts Released - Released on appeal,0,0,0
D & N HAVELI,2012,Convicts Released - Released on bail,0,0,0
D & N HAVELI,2012,Convicts Released - Pardons,0,0,0
D & N HAVELI,2012,Convicts Released - Transferred to other States,13,0,13
D & N HAVELI,2012,"Convicts Released - Other Releases (due to illness, transferred to Mental hospital)",0,0,0
D & N HAVELI,2012,Total Convicts Released,13,0,13
D & N HAVELI,2012,Under trials Released - Acquitted,12,2,14
D & N HAVELI,2012,Under trials Released - Released on appeal,0,0,0
D & N HAVELI,2012,Under trials Released - Released on bail,301,10,311
D & N HAVELI,2012,Under trials Released - Transferred to other States,0,0,0
D & N HAVELI,2012,Under trials Released - Extradited,0,0,0
D & N HAVELI,2012,Under trials Released - Other releases (transferred to Mental/Civil hospital),0,0,0
D & N HAVELI,2012,Total Under trials Released,313,12,325
D & N HAVELI,2012,Detenus Released - Released on completion of detention period,0,0,0
D & N HAVELI,2012,Detenus Released - Released before completion of detention period,0,0,0
D & N HAVELI,2012,Detenus Released - Released on bail,0,0,0
D & N HAVELI,2012,Detenus Released - Other releases (temporary transfer etc.),0,0,0
D & N HAVELI,2012,Total Detenus Released,0,0,0
DAMAN & DIU,2001,Convicts Released - Released after completion of conviction,0,0,0
DAMAN & DIU,2001,Convicts Released - Premature release,0,0,0
DAMAN & DIU,2001,Convicts Released - Released on appeal,2,0,2
DAMAN & DIU,2001,Convicts Released - Released on bail,3,0,3
DAMAN & DIU,2001,Convicts Released - Pardons,0,0,0
DAMAN & DIU,2001,Convicts Released - Transferred to other States,1,0,1
DAMAN & DIU,2001,"Convicts Released - Other Releases (due to illness, transferred to Mental hospital)",0,0,0
DAMAN & DIU,2001,Total Convicts Released,6,0,6
DAMAN & DIU,2001,Under trials Released - Acquitted,8,0,8
DAMAN & DIU,2001,Under trials Released - Released on appeal,0,0,0
DAMAN & DIU,2001,Under trials Released - Released on bail,11,1,12
DAMAN & DIU,2001,Under trials Released - Transferred to other States,0,0,0
DAMAN & DIU,2001,Under trials Released - Extradited,0,0,0
DAMAN & DIU,2001,Under trials Released - Other releases (transferred to Mental/Civil hospital),1,1,2
DAMAN & DIU,2001,Total Under trials Released,20,2,22
DAMAN & DIU,2001,Detenus Released - Released on completion of detention period,0,0,0
DAMAN & DIU,2001,Detenus Released - Released before completion of detention period,0,0,0
DAMAN & DIU,2001,Detenus Released - Released on bail,0,0,0
DAMAN & DIU,2001,Detenus Released - Other releases (temporary transfer etc.),0,0,0
DAMAN & DIU,2001,Total Detenus Released,0,0,0
DAMAN & DIU,2002,Convicts Released - Released after completion of conviction,1,0,1
DAMAN & DIU,2002,Convicts Released - Premature release,0,0,0
DAMAN & DIU,2002,Convicts Released - Released on appeal,0,0,0
DAMAN & DIU,2002,Convicts Released - Released on bail,0,0,0
DAMAN & DIU,2002,Convicts Released - Pardons,3,0,3
DAMAN & DIU,2002,Convicts Released - Transferred to other States,1,0,1
DAMAN & DIU,2002,"Convicts Released - Other Releases (due to illness, transferred to Mental hospital)",0,0,0
DAMAN & DIU,2002,Total Convicts Released,5,0,5
DAMAN & DIU,2002,Under trials Released - Acquitted,7,0,7
DAMAN & DIU,2002,Under trials Released - Released on appeal,0,0,0
DAMAN & DIU,2002,Under trials Released - Released on bail,8,0,8
DAMAN & DIU,2002,Under trials Released - Transferred to other States,2,0,2
DAMAN & DIU,2002,Under trials Released - Extradited,0,0,0
DAMAN & DIU,2002,Under trials Released - Other releases (transferred to Mental/Civil hospital),0,0,0
DAMAN & DIU,2002,Total Under trials Released,17,0,17
DAMAN & DIU,2002,Detenus Released - Released on completion of detention period,0,0,0
DAMAN & DIU,2002,Detenus Released - Released before completion of detention period,0,0,0
DAMAN & DIU,2002,Detenus Released - Released on bail,0,0,0
DAMAN & DIU,2002,Detenus Released - Other releases (temporary transfer etc.),0,0,0
DAMAN & DIU,2002,Total Detenus Released,0,0,0
DAMAN & DIU,2003,Convicts Released - Released after completion of conviction,0,0,0
DAMAN & DIU,2003,Convicts Released - Premature release,0,0,0
DAMAN & DIU,2003,Convicts Released - Released on appeal,0,0,0
DAMAN & DIU,2003,Convicts Released - Released on bail,0,0,0
DAMAN & DIU,2003,Convicts Released - Pardons,0,0,0
DAMAN & DIU,2003,Convicts Released - Transferred to other States,0,0,0
DAMAN & DIU,2003,"Convicts Released - Other Releases (due to illness, transferred to Mental hospital)",0,0,0
DAMAN & DIU,2003,Total Convicts Released,0,0,0
DAMAN & DIU,2003,Under trials Released - Acquitted,7,0,7
DAMAN & DIU,2003,Under trials Released - Released on appeal,0,0,0
DAMAN & DIU,2003,Under trials Released - Released on bail,44,0,44
DAMAN & DIU,2003,Under trials Released - Transferred to other States,0,0,0
DAMAN & DIU,2003,Under trials Released - Extradited,0,0,0
DAMAN & DIU,2003,Under trials Released - Other releases (transferred to Mental/Civil hospital),0,0,0
DAMAN & DIU,2003,Total Under trials Released,51,0,51
DAMAN & DIU,2003,Detenus Released - Released on completion of detention period,0,0,0
DAMAN & DIU,2003,Detenus Released - Released before completion of detention period,0,0,0
DAMAN & DIU,2003,Detenus Released - Released on bail,0,0,0
DAMAN & DIU,2003,Detenus Released - Other releases (temporary transfer etc.),0,0,0
DAMAN & DIU,2003,Total Detenus Released,0,0,0
DAMAN & DIU,2004,Convicts Released - Released after completion of conviction,0,0,0
DAMAN & DIU,2004,Convicts Released - Premature release,0,0,0
DAMAN & DIU,2004,Convicts Released - Released on appeal,0,0,0
DAMAN & DIU,2004,Convicts Released - Released on bail,0,0,0
DAMAN & DIU,2004,Convicts Released - Pardons,0,0,0
DAMAN & DIU,2004,Convicts Released - Transferred to other States,0,0,0
DAMAN & DIU,2004,"Convicts Released - Other Releases (due to illness, transferred to Mental hospital)",0,0,0
DAMAN & DIU,2004,Total Convicts Released,0,0,0
DAMAN & DIU,2004,Under trials Released - Acquitted,0,0,0
DAMAN & DIU,2004,Under trials Released - Released on appeal,8,0,8
DAMAN & DIU,2004,Under trials Released - Released on bail,37,1,38
DAMAN & DIU,2004,Under trials Released - Transferred to other States,0,0,0
DAMAN & DIU,2004,Under trials Released - Extradited,0,0,0
DAMAN & DIU,2004,Under trials Released - Other releases (transferred to Mental/Civil hospital),0,0,0
DAMAN & DIU,2004,Total Under trials Released,45,1,46
DAMAN & DIU,2004,Detenus Released - Released on completion of detention period,0,0,0
DAMAN & DIU,2004,Detenus Released - Released before completion of detention period,0,0,0
DAMAN & DIU,2004,Detenus Released - Released on bail,0,0,0
DAMAN & DIU,2004,Detenus Released - Other releases (temporary transfer etc.),0,0,0
DAMAN & DIU,2004,Total Detenus Released,0,0,0
DAMAN & DIU,2005,Convicts Released - Released after completion of conviction,0,0,0
DAMAN & DIU,2005,Convicts Released - Premature release,0,0,0
DAMAN & DIU,2005,Convicts Released - Released on appeal,0,0,0
DAMAN & DIU,2005,Convicts Released - Released on bail,0,0,0
DAMAN & DIU,2005,Convicts Released - Pardons,0,0,0
DAMAN & DIU,2005,Convicts Released - Transferred to other States,0,0,0
DAMAN & DIU,2005,"Convicts Released - Other Releases (due to illness, transferred to Mental hospital)",0,0,0
DAMAN & DIU,2005,Total Convicts Released,0,0,0
DAMAN & DIU,2005,Under trials Released - Acquitted,9,0,9
DAMAN & DIU,2005,Under trials Released - Released on appeal,0,0,0
DAMAN & DIU,2005,Under trials Released - Released on bail,45,0,45
DAMAN & DIU,2005,Under trials Released - Transferred to other States,8,0,8
DAMAN & DIU,2005,Under trials Released - Extradited,0,0,0
DAMAN & DIU,2005,Under trials Released - Other releases (transferred to Mental/Civil hospital),0,0,0
DAMAN & DIU,2005,Total Under trials Released,62,0,62
DAMAN & DIU,2005,Detenus Released - Released on completion of detention period,0,0,0
DAMAN & DIU,2005,Detenus Released - Released before completion of detention period,0,0,0
DAMAN & DIU,2005,Detenus Released - Released on bail,0,0,0
DAMAN & DIU,2005,Detenus Released - Other releases (temporary transfer etc.),0,0,0
DAMAN & DIU,2005,Total Detenus Released,0,0,0
DAMAN & DIU,2006,Convicts Released - Released after completion of conviction,0,0,0
DAMAN & DIU,2006,Convicts Released - Premature release,0,0,0
DAMAN & DIU,2006,Convicts Released - Released on appeal,0,0,0
DAMAN & DIU,2006,Convicts Released - Released on bail,0,0,0
DAMAN & DIU,2006,Convicts Released - Pardons,0,0,0
DAMAN & DIU,2006,Convicts Released - Transferred to other States,0,0,0
DAMAN & DIU,2006,"Convicts Released - Other Releases (due to illness, transferred to Mental hospital)",0,0,0
DAMAN & DIU,2006,Total Convicts Released,0,0,0
DAMAN & DIU,2006,Under trials Released - Acquitted,8,0,8
DAMAN & DIU,2006,Under trials Released - Released on appeal,0,0,0
DAMAN & DIU,2006,Under trials Released - Released on bail,14,0,14
DAMAN & DIU,2006,Under trials Released - Transferred to other States,4,0,4
DAMAN & DIU,2006,Under trials Released - Extradited,0,0,0
DAMAN & DIU,2006,Under trials Released - Other releases (transferred to Mental/Civil hospital),0,0,0
DAMAN & DIU,2006,Total Under trials Released,26,0,26
DAMAN & DIU,2006,Detenus Released - Released on completion of detention period,0,0,0
DAMAN & DIU,2006,Detenus Released - Released before completion of detention period,0,0,0
DAMAN & DIU,2006,Detenus Released - Released on bail,0,0,0
DAMAN & DIU,2006,Detenus Released - Other releases (temporary transfer etc.),0,0,0
DAMAN & DIU,2006,Total Detenus Released,0,0,0
DAMAN & DIU,2007,Convicts Released - Released after completion of conviction,0,0,0
DAMAN & DIU,2007,Convicts Released - Premature release,0,0,0
DAMAN & DIU,2007,Convicts Released - Released on appeal,0,0,0
DAMAN & DIU,2007,Convicts Released - Released on bail,0,0,0
DAMAN & DIU,2007,Convicts Released - Pardons,0,0,0
DAMAN & DIU,2007,Convicts Released - Transferred to other States,0,0,0
DAMAN & DIU,2007,"Convicts Released - Other Releases (due to illness, transferred to Mental hospital)",0,0,0
DAMAN & DIU,2007,Total Convicts Released,0,0,0
DAMAN & DIU,2007,Under trials Released - Acquitted,5,0,5
DAMAN & DIU,2007,Under trials Released - Released on appeal,0,0,0
DAMAN & DIU,2007,Under trials Released - Released on bail,17,0,17
DAMAN & DIU,2007,Under trials Released - Transferred to other States,3,0,3
DAMAN & DIU,2007,Under trials Released - Extradited,0,0,0
DAMAN & DIU,2007,Under trials Released - Other releases (transferred to Mental/Civil hospital),0,0,0
DAMAN & DIU,2007,Total Under trials Released,25,0,25
DAMAN & DIU,2007,Detenus Released - Released on completion of detention period,0,0,0
DAMAN & DIU,2007,Detenus Released - Released before completion of detention period,0,0,0
DAMAN & DIU,2007,Detenus Released - Released on bail,0,0,0
DAMAN & DIU,2007,Detenus Released - Other releases (temporary transfer etc.),0,0,0
DAMAN & DIU,2007,Total Detenus Released,0,0,0
DAMAN & DIU,2008,Convicts Released - Released after completion of conviction,0,0,0
DAMAN & DIU,2008,Convicts Released - Premature release,0,0,0
DAMAN & DIU,2008,Convicts Released - Released on appeal,0,0,0
DAMAN & DIU,2008,Convicts Released - Released on bail,4,0,4
DAMAN & DIU,2008,Convicts Released - Pardons,0,0,0
DAMAN & DIU,2008,Convicts Released - Transferred to other States,0,0,0
DAMAN & DIU,2008,"Convicts Released - Other Releases (due to illness, transferred to Mental hospital)",0,0,0
DAMAN & DIU,2008,Total Convicts Released,4,0,4
DAMAN & DIU,2008,Under trials Released - Acquitted,8,0,8
DAMAN & DIU,2008,Under trials Released - Released on appeal,0,0,0
DAMAN & DIU,2008,Under trials Released - Released on bail,21,0,21
DAMAN & DIU,2008,Under trials Released - Transferred to other States,4,0,4
DAMAN & DIU,2008,Under trials Released - Extradited,0,0,0
DAMAN & DIU,2008,Under trials Released - Other releases (transferred to Mental/Civil hospital),0,0,0
DAMAN & DIU,2008,Total Under trials Released,33,0,33
DAMAN & DIU,2008,Detenus Released - Released on completion of detention period,0,0,0
DAMAN & DIU,2008,Detenus Released - Released before completion of detention period,0,0,0
DAMAN & DIU,2008,Detenus Released - Released on bail,0,0,0
DAMAN & DIU,2008,Detenus Released - Other releases (temporary transfer etc.),0,0,0
DAMAN & DIU,2008,Total Detenus Released,0,0,0
DAMAN & DIU,2009,Convicts Released - Released after completion of conviction,0,1,1
DAMAN & DIU,2009,Convicts Released - Premature release,0,0,0
DAMAN & DIU,2009,Convicts Released - Released on appeal,0,0,0
DAMAN & DIU,2009,Convicts Released - Released on bail,0,0,0
DAMAN & DIU,2009,Convicts Released - Pardons,0,0,0
DAMAN & DIU,2009,Convicts Released - Transferred to other States,0,0,0
DAMAN & DIU,2009,"Convicts Released - Other Releases (due to illness, transferred to Mental hospital)",0,0,0
DAMAN & DIU,2009,Total Convicts Released,0,1,1
DAMAN & DIU,2009,Under trials Released - Acquitted,7,0,7
DAMAN & DIU,2009,Under trials Released - Released on appeal,3,0,3
DAMAN & DIU,2009,Under trials Released - Released on bail,5,0,5
DAMAN & DIU,2009,Under trials Released - Transferred to other States,0,0,0
DAMAN & DIU,2009,Under trials Released - Extradited,0,0,0
DAMAN & DIU,2009,Under trials Released - Other releases (transferred to Mental/Civil hospital),0,0,0
DAMAN & DIU,2009,Total Under trials Released,15,0,15
DAMAN & DIU,2009,Detenus Released - Released on completion of detention period,0,0,0
DAMAN & DIU,2009,Detenus Released - Released before completion of detention period,0,0,0
DAMAN & DIU,2009,Detenus Released - Released on bail,0,0,0
DAMAN & DIU,2009,Detenus Released - Other releases (temporary transfer etc.),0,0,0
DAMAN & DIU,2009,Total Detenus Released,0,0,0
DAMAN & DIU,2010,Convicts Released - Released after completion of conviction,0,0,0
DAMAN & DIU,2010,Convicts Released - Premature release,0,0,0
DAMAN & DIU,2010,Convicts Released - Released on appeal,2,0,2
DAMAN & DIU,2010,Convicts Released - Released on bail,0,0,0
DAMAN & DIU,2010,Convicts Released - Pardons,0,0,0
DAMAN & DIU,2010,Convicts Released - Transferred to other States,0,0,0
DAMAN & DIU,2010,"Convicts Released - Other Releases (due to illness, transferred to Mental hospital)",0,0,0
DAMAN & DIU,2010,Total Convicts Released,2,0,2
DAMAN & DIU,2010,Under trials Released - Acquitted,6,0,6
DAMAN & DIU,2010,Under trials Released - Released on appeal,0,0,0
DAMAN & DIU,2010,Under trials Released - Released on bail,13,0,13
DAMAN & DIU,2010,Under trials Released - Transferred to other States,0,0,0
DAMAN & DIU,2010,Under trials Released - Extradited,0,0,0
DAMAN & DIU,2010,Under trials Released - Other releases (transferred to Mental/Civil hospital),0,0,0
DAMAN & DIU,2010,Total Under trials Released,19,0,19
DAMAN & DIU,2010,Detenus Released - Released on completion of detention period,0,0,0
DAMAN & DIU,2010,Detenus Released - Released before completion of detention period,0,0,0
DAMAN & DIU,2010,Detenus Released - Released on bail,0,0,0
DAMAN & DIU,2010,Detenus Released - Other releases (temporary transfer etc.),0,0,0
DAMAN & DIU,2010,Total Detenus Released,0,0,0
DAMAN & DIU,2011,Convicts Released - Released after completion of conviction,0,0,0
DAMAN & DIU,2011,Convicts Released - Premature release,0,0,0
DAMAN & DIU,2011,Convicts Released - Released on appeal,0,0,0
DAMAN & DIU,2011,Convicts Released - Released on bail,2,0,2
DAMAN & DIU,2011,Convicts Released - Pardons,0,0,0
DAMAN & DIU,2011,Convicts Released - Transferred to other States,0,0,0
DAMAN & DIU,2011,"Convicts Released - Other Releases (due to illness, transferred to Mental hospital)",0,0,0
DAMAN & DIU,2011,Total Convicts Released,2,0,2
DAMAN & DIU,2011,Under trials Released - Acquitted,0,0,0
DAMAN & DIU,2011,Under trials Released - Released on appeal,0,0,0
DAMAN & DIU,2011,Under trials Released - Released on bail,6,0,6
DAMAN & DIU,2011,Under trials Released - Transferred to other States,2,0,2
DAMAN & DIU,2011,Under trials Released - Extradited,0,0,0
DAMAN & DIU,2011,Under trials Released - Other releases (transferred to Mental/Civil hospital),0,0,0
DAMAN & DIU,2011,Total Under trials Released,8,0,8
DAMAN & DIU,2011,Detenus Released - Released on completion of detention period,0,0,0
DAMAN & DIU,2011,Detenus Released - Released before completion of detention period,0,0,0
DAMAN & DIU,2011,Detenus Released - Released on bail,0,0,0
DAMAN & DIU,2011,Detenus Released - Other releases (temporary transfer etc.),0,0,0
DAMAN & DIU,2011,Total Detenus Released,0,0,0
DAMAN & DIU,2012,Convicts Released - Released after completion of conviction,0,0,0
DAMAN & DIU,2012,Convicts Released - Premature release,0,0,0
DAMAN & DIU,2012,Convicts Released - Released on appeal,0,0,0
DAMAN & DIU,2012,Convicts Released - Released on bail,0,0,0
DAMAN & DIU,2012,Convicts Released - Pardons,0,0,0
DAMAN & DIU,2012,Convicts Released - Transferred to other States,0,0,0
DAMAN & DIU,2012,"Convicts Released - Other Releases (due to illness, transferred to Mental hospital)",0,0,0
DAMAN & DIU,2012,Total Convicts Released,0,0,0
DAMAN & DIU,2012,Under trials Released - Acquitted,2,0,2
DAMAN & DIU,2012,Under trials Released - Released on appeal,0,0,0
DAMAN & DIU,2012,Under trials Released - Released on bail,3,0,3
DAMAN & DIU,2012,Under trials Released - Transferred to other States,0,0,0
DAMAN & DIU,2012,Under trials Released - Extradited,0,0,0
DAMAN & DIU,2012,Under trials Released - Other releases (transferred to Mental/Civil hospital),0,0,0
DAMAN & DIU,2012,Total Under trials Released,5,0,5
DAMAN & DIU,2012,Detenus Released - Released on completion of detention period,0,0,0
DAMAN & DIU,2012,Detenus Released - Released before completion of detention period,0,0,0
DAMAN & DIU,2012,Detenus Released - Released on bail,0,0,0
DAMAN & DIU,2012,Detenus Released - Other releases (temporary transfer etc.),0,0,0
DAMAN & DIU,2012,Total Detenus Released,0,0,0
DELHI,2001,Convicts Released - Released after completion of conviction,7215,13,7228
DELHI,2001,Convicts Released - Premature release,3,0,3
DELHI,2001,Convicts Released - Released on appeal,125,0,125
DELHI,2001,Convicts Released - Released on bail,959,229,1188
DELHI,2001,Convicts Released - Pardons,9,0,9
DELHI,2001,Convicts Released - Transferred to other States,190,0,190
DELHI,2001,"Convicts Released - Other Releases (due to illness, transferred to Mental hospital)",869,22,891
DELHI,2001,Total Convicts Released,9370,264,9634
DELHI,2001,Under trials Released - Acquitted,1914,194,2108
DELHI,2001,Under trials Released - Released on appeal,365,0,365
DELHI,2001,Under trials Released - Released on bail,42011,1976,43987
DELHI,2001,Under trials Released - Transferred to other States,1897,0,1897
DELHI,2001,Under trials Released - Extradited,0,0,0
DELHI,2001,Under trials Released - Other releases (transferred to Mental/Civil hospital),2835,0,2835
DELHI,2001,Total Under trials Released,49022,2170,51192
DELHI,2001,Detenus Released - Released on completion of detention period,53,0,53
DELHI,2001,Detenus Released - Released before completion of detention period,3,0,3
DELHI,2001,Detenus Released - Released on bail,0,0,0
DELHI,2001,Detenus Released - Other releases (temporary transfer etc.),12,0,12
DELHI,2001,Total Detenus Released,68,0,68
DELHI,2002,Convicts Released - Released after completion of conviction,7071,42,7113
DELHI,2002,Convicts Released - Premature release,4,0,4
DELHI,2002,Convicts Released - Released on appeal,48,0,48
DELHI,2002,Convicts Released - Released on bail,1043,139,1182
DELHI,2002,Convicts Released - Pardons,6,0,6
DELHI,2002,Convicts Released - Transferred to other States,508,0,508
DELHI,2002,"Convicts Released - Other Releases (due to illness, transferred to Mental hospital)",348,0,348
DELHI,2002,Total Convicts Released,9028,181,9209
DELHI,2002,Under trials Released - Acquitted,2170,501,2671
DELHI,2002,Under trials Released - Released on appeal,33,0,33
DELHI,2002,Under trials Released - Released on bail,44336,1972,46308
DELHI,2002,Under trials Released - Transferred to other States,3758,2,3760
DELHI,2002,Under trials Released - Extradited,68,0,68
DELHI,2002,Under trials Released - Other releases (transferred to Mental/Civil hospital),4696,2,4698
DELHI,2002,Total Under trials Released,55061,2477,57538
DELHI,2002,Detenus Released - Released on completion of detention period,33,2,35
DELHI,2002,Detenus Released - Released before completion of detention period,32,1,33
DELHI,2002,Detenus Released - Released on bail,1,0,1
DELHI,2002,Detenus Released - Other releases (temporary transfer etc.),26,0,26
DELHI,2002,Total Detenus Released,92,3,95
DELHI,2003,Convicts Released - Released after completion of conviction,8338,49,8387
DELHI,2003,Convicts Released - Premature release,1,0,1
DELHI,2003,Convicts Released - Released on appeal,18,17,35
DELHI,2003,Convicts Released - Released on bail,705,62,767
DELHI,2003,Convicts Released - Pardons,0,0,0
DELHI,2003,Convicts Released - Transferred to other States,1004,2,1006
DELHI,2003,"Convicts Released - Other Releases (due to illness, transferred to Mental hospital)",200,0,200
DELHI,2003,Total Convicts Released,10266,130,10396
DELHI,2003,Under trials Released - Acquitted,5294,294,5588
DELHI,2003,Under trials Released - Released on appeal,2,0,2
DELHI,2003,Under trials Released - Released on bail,50794,1998,52792
DELHI,2003,Under trials Released - Transferred to other States,2269,7,2276
DELHI,2003,Under trials Released - Extradited,22,0,22
DELHI,2003,Under trials Released - Other releases (transferred to Mental/Civil hospital),3797,2,3799
DELHI,2003,Total Under trials Released,62178,2301,64479
DELHI,2003,Detenus Released - Released on completion of detention period,23,1,24
DELHI,2003,Detenus Released - Released before completion of detention period,13,0,13
DELHI,2003,Detenus Released - Released on bail,11,0,11
DELHI,2003,Detenus Released - Other releases (temporary transfer etc.),20,1,21
DELHI,2003,Total Detenus Released,67,2,69
DELHI,2004,Convicts Released - Released after completion of conviction,7772,83,7855
DELHI,2004,Convicts Released - Premature release,29,1,30
DELHI,2004,Convicts Released - Released on appeal,82,5,87
DELHI,2004,Convicts Released - Released on bail,692,84,776
DELHI,2004,Convicts Released - Pardons,8,0,8
DELHI,2004,Convicts Released - Transferred to other States,96,2,98
DELHI,2004,"Convicts Released - Other Releases (due to illness, transferred to Mental hospital)",737,0,737
DELHI,2004,Total Convicts Released,9416,175,9591
DELHI,2004,Under trials Released - Acquitted,3066,417,3483
DELHI,2004,Under trials Released - Released on appeal,0,0,0
DELHI,2004,Under trials Released - Released on bail,61676,2228,63904
DELHI,2004,Under trials Released - Transferred to other States,1115,3,1118
DELHI,2004,Under trials Released - Extradited,1,0,1
DELHI,2004,Under trials Released - Other releases (transferred to Mental/Civil hospital),3621,0,3621
DELHI,2004,Total Under trials Released,69479,2648,72127
DELHI,2004,Detenus Released - Released on completion of detention period,21,1,22
DELHI,2004,Detenus Released - Released before completion of detention period,8,0,8
DELHI,2004,Detenus Released - Released on bail,5,0,5
DELHI,2004,Detenus Released - Other releases (temporary transfer etc.),22,0,22
DELHI,2004,Total Detenus Released,56,1,57
DELHI,2005,Convicts Released - Released after completion of conviction,8425,85,8510
DELHI,2005,Convicts Released - Premature release,131,1,132
DELHI,2005,Convicts Released - Released on appeal,121,0,121
DELHI,2005,Convicts Released - Released on bail,1558,104,1662
DELHI,2005,Convicts Released - Pardons,7,0,7
DELHI,2005,Convicts Released - Transferred to other States,98,0,98
DELHI,2005,"Convicts Released - Other Releases (due to illness, transferred to Mental hospital)",1106,0,1106
DELHI,2005,Total Convicts Released,11446,190,11636
DELHI,2005,Under trials Released - Acquitted,2424,196,2620
DELHI,2005,Under trials Released - Released on appeal,0,0,0
DELHI,2005,Under trials Released - Released on bail,67855,2449,70304
DELHI,2005,Under trials Released - Transferred to other States,1014,4,1018
DELHI,2005,Under trials Released - Extradited,1,0,1
DELHI,2005,Under trials Released - Other releases (transferred to Mental/Civil hospital),14374,0,14374
DELHI,2005,Total Under trials Released,85668,2649,88317
DELHI,2005,Detenus Released - Released on completion of detention period,5,0,5
DELHI,2005,Detenus Released - Released before completion of detention period,4,0,4
DELHI,2005,Detenus Released - Released on bail,1,0,1
DELHI,2005,Detenus Released - Other releases (temporary transfer etc.),38,0,38
DELHI,2005,Total Detenus Released,48,0,48
DELHI,2006,Convicts Released - Released after completion of conviction,7863,72,7935
DELHI,2006,Convicts Released - Premature release,50,0,50
DELHI,2006,Convicts Released - Released on appeal,106,0,106
DELHI,2006,Convicts Released - Released on bail,1074,94,1168
DELHI,2006,Convicts Released - Pardons,8,0,8
DELHI,2006,Convicts Released - Transferred to other States,51,0,51
DELHI,2006,"Convicts Released - Other Releases (due to illness, transferred to Mental hospital)",1361,6,1367
DELHI,2006,Total Convicts Released,10513,172,10685
DELHI,2006,Under trials Released - Acquitted,2579,132,2711
DELHI,2006,Under trials Released - Released on appeal,470,0,470
DELHI,2006,Under trials Released - Released on bail,70279,2675,72954
DELHI,2006,Under trials Released - Transferred to other States,417,2,419
DELHI,2006,Under trials Released - Extradited,13,0,13
DELHI,2006,Under trials Released - Other releases (transferred to Mental/Civil hospital),8803,0,8803
DELHI,2006,Total Under trials Released,82561,2809,85370
DELHI,2006,Detenus Released - Released on completion of detention period,5,0,5
DELHI,2006,Detenus Released - Released before completion of detention period,1,0,1
DELHI,2006,Detenus Released - Released on bail,8,0,8
DELHI,2006,Detenus Released - Other releases (temporary transfer etc.),48,0,48
DELHI,2006,Total Detenus Released,62,0,62
DELHI,2007,Convicts Released - Released after completion of conviction,9516,74,9590
DELHI,2007,Convicts Released - Premature release,100,1,101
DELHI,2007,Convicts Released - Released on appeal,187,0,187
DELHI,2007,Convicts Released - Released on bail,908,66,974
DELHI,2007,Convicts Released - Pardons,21,0,21
DELHI,2007,Convicts Released - Transferred to other States,11,1,12
DELHI,2007,"Convicts Released - Other Releases (due to illness, transferred to Mental hospital)",820,10,830
DELHI,2007,Total Convicts Released,11563,152,11715
DELHI,2007,Under trials Released - Acquitted,2256,95,2351
DELHI,2007,Under trials Released - Released on appeal,32,6,38
DELHI,2007,Under trials Released - Released on bail,58515,2110,60625
DELHI,2007,Under trials Released - Transferred to other States,380,8,388
DELHI,2007,Under trials Released - Extradited,5,0,5
DELHI,2007,Under trials Released - Other releases (transferred to Mental/Civil hospital),4419,4,4423
DELHI,2007,Total Under trials Released,65607,2223,67830
DELHI,2007,Detenus Released - Released on completion of detention period,5,1,6
DELHI,2007,Detenus Released - Released before completion of detention period,2,0,2
DELHI,2007,Detenus Released - Released on bail,0,0,0
DELHI,2007,Detenus Released - Other releases (temporary transfer etc.),24,0,24
DELHI,2007,Total Detenus Released,31,1,32
DELHI,2008,Convicts Released - Released after completion of conviction,5212,72,5284
DELHI,2008,Convicts Released - Premature release,35,0,35
DELHI,2008,Convicts Released - Released on appeal,189,1,190
DELHI,2008,Convicts Released - Released on bail,784,39,823
DELHI,2008,Convicts Released - Pardons,15,0,15
DELHI,2008,Convicts Released - Transferred to other States,0,1,1
DELHI,2008,"Convicts Released - Other Releases (due to illness, transferred to Mental hospital)",699,7,706
DELHI,2008,Total Convicts Released,6934,120,7054
DELHI,2008,Under trials Released - Acquitted,1645,69,1714
DELHI,2008,Under trials Released - Released on appeal,0,0,0
DELHI,2008,Under trials Released - Released on bail,31901,1447,33348
DELHI,2008,Under trials Released - Transferred to other States,368,4,372
DELHI,2008,Under trials Released - Extradited,0,0,0
DELHI,2008,Under trials Released - Other releases (transferred to Mental/Civil hospital),5819,3,5822
DELHI,2008,Total Under trials Released,39733,1523,41256
DELHI,2008,Detenus Released - Released on completion of detention period,4,0,4
DELHI,2008,Detenus Released - Released before completion of detention period,1,0,1
DELHI,2008,Detenus Released - Released on bail,1,0,1
DELHI,2008,Detenus Released - Other releases (temporary transfer etc.),64,0,64
DELHI,2008,Total Detenus Released,70,0,70
DELHI,2009,Convicts Released - Released after completion of conviction,4649,89,4738
DELHI,2009,Convicts Released - Premature release,45,0,45
DELHI,2009,Convicts Released - Released on appeal,132,3,135
DELHI,2009,Convicts Released - Released on bail,617,48,665
DELHI,2009,Convicts Released - Pardons,35,0,35
DELHI,2009,Convicts Released - Transferred to other States,12,1,13
DELHI,2009,"Convicts Released - Other Releases (due to illness, transferred to Mental hospital)",814,12,826
DELHI,2009,Total Convicts Released,6304,153,6457
DELHI,2009,Under trials Released - Acquitted,1586,90,1676
DELHI,2009,Under trials Released - Released on appeal,0,1,1
DELHI,2009,Under trials Released - Released on bail,28411,1160,29571
DELHI,2009,Under trials Released - Transferred to other States,337,2,339
DELHI,2009,Under trials Released - Extradited,0,0,0
DELHI,2009,Under trials Released - Other releases (transferred to Mental/Civil hospital),6236,5,6241
DELHI,2009,Total Under trials Released,36570,1258,37828
DELHI,2009,Detenus Released - Released on completion of detention period,4,0,4
DELHI,2009,Detenus Released - Released before completion of detention period,0,0,0
DELHI,2009,Detenus Released - Released on bail,1,0,1
DELHI,2009,Detenus Released - Other releases (temporary transfer etc.),20,0,20
DELHI,2009,Total Detenus Released,25,0,25
DELHI,2010,Convicts Released - Released after completion of conviction,4515,149,4664
DELHI,2010,Convicts Released - Premature release,67,2,69
DELHI,2010,Convicts Released - Released on appeal,167,6,173
DELHI,2010,Convicts Released - Released on bail,814,19,833
DELHI,2010,Convicts Released - Pardons,18,0,18
DELHI,2010,Convicts Released - Transferred to other States,13,3,16
DELHI,2010,"Convicts Released - Other Releases (due to illness, transferred to Mental hospital)",2188,23,2211
DELHI,2010,Total Convicts Released,7782,202,7984
DELHI,2010,Under trials Released - Acquitted,1461,67,1528
DELHI,2010,Under trials Released - Released on appeal,0,0,0
DELHI,2010,Under trials Released - Released on bail,27231,1110,28341
DELHI,2010,Under trials Released - Transferred to other States,620,11,631
DELHI,2010,Under trials Released - Extradited,0,0,0
DELHI,2010,Under trials Released - Other releases (transferred to Mental/Civil hospital),6742,45,6787
DELHI,2010,Total Under trials Released,36054,1233,37287
DELHI,2010,Detenus Released - Released on completion of detention period,18,0,18
DELHI,2010,Detenus Released - Released before completion of detention period,0,0,0
DELHI,2010,Detenus Released - Released on bail,2,0,2
DELHI,2010,Detenus Released - Other releases (temporary transfer etc.),87,0,87
DELHI,2010,Total Detenus Released,107,0,107
DELHI,2011,Convicts Released - Released after completion of conviction,4484,158,4642
DELHI,2011,Convicts Released - Premature release,297,0,297
DELHI,2011,Convicts Released - Released on appeal,49,6,55
DELHI,2011,Convicts Released - Released on bail,1344,37,1381
DELHI,2011,Convicts Released - Pardons,1,0,1
DELHI,2011,Convicts Released - Transferred to other States,81,1,82
DELHI,2011,"Convicts Released - Other Releases (due to illness, transferred to Mental hospital)",1399,54,1453
DELHI,2011,Total Convicts Released,7655,256,7911
DELHI,2011,Under trials Released - Acquitted,2065,42,2107
DELHI,2011,Under trials Released - Released on appeal,13,0,13
DELHI,2011,Under trials Released - Released on bail,34937,1743,36680
DELHI,2011,Under trials Released - Transferred to other States,432,16,448
DELHI,2011,Under trials Released - Extradited,0,1,1
DELHI,2011,Under trials Released - Other releases (transferred to Mental/Civil hospital),6214,6,6220
DELHI,2011,Total Under trials Released,43661,1808,45469
DELHI,2011,Detenus Released - Released on completion of detention period,2,0,2
DELHI,2011,Detenus Released - Released before completion of detention period,0,0,0
DELHI,2011,Detenus Released - Released on bail,1,0,1
DELHI,2011,Detenus Released - Other releases (temporary transfer etc.),13,0,13
DELHI,2011,Total Detenus Released,16,0,16
DELHI,2012,Convicts Released - Released after completion of conviction,4558,141,4699
DELHI,2012,Convicts Released - Premature release,521,1,522
DELHI,2012,Convicts Released - Released on appeal,5,4,9
DELHI,2012,Convicts Released - Released on bail,1304,41,1345
DELHI,2012,Convicts Released - Pardons,0,0,0
DELHI,2012,Convicts Released - Transferred to other States,118,2,120
DELHI,2012,"Convicts Released - Other Releases (due to illness, transferred to Mental hospital)",1292,47,1339
DELHI,2012,Total Convicts Released,7798,236,8034
DELHI,2012,Under trials Released - Acquitted,2232,43,2275
DELHI,2012,Under trials Released - Released on appeal,0,0,0
DELHI,2012,Under trials Released - Released on bail,32995,1783,34778
DELHI,2012,Under trials Released - Transferred to other States,546,10,556
DELHI,2012,Under trials Released - Extradited,0,0,0
DELHI,2012,Under trials Released - Other releases (transferred to Mental/Civil hospital),5584,43,5627
DELHI,2012,Total Under trials Released,41357,1879,43236
DELHI,2012,Detenus Released - Released on completion of detention period,1,0,1
DELHI,2012,Detenus Released - Released before completion of detention period,1,0,1
DELHI,2012,Detenus Released - Released on bail,2,0,2
DELHI,2012,Detenus Released - Other releases (temporary transfer etc.),12,1,13
DELHI,2012,Total Detenus Released,16,1,17
LAKSHADWEEP,2001,Convicts Released - Released after completion of conviction,0,0,0
LAKSHADWEEP,2001,Convicts Released - Premature release,0,0,0
LAKSHADWEEP,2001,Convicts Released - Released on appeal,0,0,0
LAKSHADWEEP,2001,Convicts Released - Released on bail,0,0,0
LAKSHADWEEP,2001,Convicts Released - Pardons,0,0,0
LAKSHADWEEP,2001,Convicts Released - Transferred to other States,0,0,0
LAKSHADWEEP,2001,"Convicts Released - Other Releases (due to illness, transferred to Mental hospital)",0,0,0
LAKSHADWEEP,2001,Total Convicts Released,0,0,0
LAKSHADWEEP,2001,Under trials Released - Acquitted,0,0,0
LAKSHADWEEP,2001,Under trials Released - Released on appeal,0,0,0
LAKSHADWEEP,2001,Under trials Released - Released on bail,0,0,0
LAKSHADWEEP,2001,Under trials Released - Transferred to other States,0,0,0
LAKSHADWEEP,2001,Under trials Released - Extradited,0,0,0
LAKSHADWEEP,2001,Under trials Released - Other releases (transferred to Mental/Civil hospital),0,0,0
LAKSHADWEEP,2001,Total Under trials Released,0,0,0
LAKSHADWEEP,2001,Detenus Released - Released on completion of detention period,0,0,0
LAKSHADWEEP,2001,Detenus Released - Released before completion of detention period,0,0,0
LAKSHADWEEP,2001,Detenus Released - Released on bail,0,0,0
LAKSHADWEEP,2001,Detenus Released - Other releases (temporary transfer etc.),0,0,0
LAKSHADWEEP,2001,Total Detenus Released,0,0,0
LAKSHADWEEP,2002,Convicts Released - Released after completion of conviction,2,0,2
LAKSHADWEEP,2002,Convicts Released - Premature release,0,0,0
LAKSHADWEEP,2002,Convicts Released - Released on appeal,0,0,0
LAKSHADWEEP,2002,Convicts Released - Released on bail,0,0,0
LAKSHADWEEP,2002,Convicts Released - Pardons,0,0,0
LAKSHADWEEP,2002,Convicts Released - Transferred to other States,1,0,1
LAKSHADWEEP,2002,"Convicts Released - Other Releases (due to illness, transferred to Mental hospital)",0,0,0
LAKSHADWEEP,2002,Total Convicts Released,3,0,3
LAKSHADWEEP,2002,Under trials Released - Acquitted,13,0,13
LAKSHADWEEP,2002,Under trials Released - Released on appeal,0,0,0
LAKSHADWEEP,2002,Under trials Released - Released on bail,0,0,0
LAKSHADWEEP,2002,Under trials Released - Transferred to other States,0,0,0
LAKSHADWEEP,2002,Under trials Released - Extradited,0,0,0
LAKSHADWEEP,2002,Under trials Released - Other releases (transferred to Mental/Civil hospital),0,0,0
LAKSHADWEEP,2002,Total Under trials Released,13,0,13
LAKSHADWEEP,2002,Detenus Released - Released on completion of detention period,0,0,0
LAKSHADWEEP,2002,Detenus Released - Released before completion of detention period,0,0,0
LAKSHADWEEP,2002,Detenus Released - Released on bail,0,0,0
LAKSHADWEEP,2002,Detenus Released - Other releases (temporary transfer etc.),0,0,0
LAKSHADWEEP,2002,Total Detenus Released,0,0,0
LAKSHADWEEP,2003,Convicts Released - Released after completion of conviction,0,0,0
LAKSHADWEEP,2003,Convicts Released - Premature release,0,0,0
LAKSHADWEEP,2003,Convicts Released - Released on appeal,0,0,0
LAKSHADWEEP,2003,Convicts Released - Released on bail,0,0,0
LAKSHADWEEP,2003,Convicts Released - Pardons,0,0,0
LAKSHADWEEP,2003,Convicts Released - Transferred to other States,0,0,0
LAKSHADWEEP,2003,"Convicts Released - Other Releases (due to illness, transferred to Mental hospital)",0,0,0
LAKSHADWEEP,2003,Total Convicts Released,0,0,0
LAKSHADWEEP,2003,Under trials Released - Acquitted,0,0,0
LAKSHADWEEP,2003,Under trials Released - Released on appeal,4,0,4
LAKSHADWEEP,2003,Under trials Released - Released on bail,0,0,0
LAKSHADWEEP,2003,Under trials Released - Transferred to other States,0,0,0
LAKSHADWEEP,2003,Under trials Released - Extradited,0,0,0
LAKSHADWEEP,2003,Under trials Released - Other releases (transferred to Mental/Civil hospital),0,0,0
LAKSHADWEEP,2003,Total Under trials Released,4,0,4
LAKSHADWEEP,2003,Detenus Released - Released on completion of detention period,0,0,0
LAKSHADWEEP,2003,Detenus Released - Released before completion of detention period,0,0,0
LAKSHADWEEP,2003,Detenus Released - Released on bail,0,0,0
LAKSHADWEEP,2003,Detenus Released - Other releases (temporary transfer etc.),0,0,0
LAKSHADWEEP,2003,Total Detenus Released,0,0,0
LAKSHADWEEP,2004,Convicts Released - Released after completion of conviction,0,0,0
LAKSHADWEEP,2004,Convicts Released - Premature release,0,0,0
LAKSHADWEEP,2004,Convicts Released - Released on appeal,0,0,0
LAKSHADWEEP,2004,Convicts Released - Released on bail,0,0,0
LAKSHADWEEP,2004,Convicts Released - Pardons,0,0,0
LAKSHADWEEP,2004,Convicts Released - Transferred to other States,0,0,0
LAKSHADWEEP,2004,"Convicts Released - Other Releases (due to illness, transferred to Mental hospital)",0,0,0
LAKSHADWEEP,2004,Total Convicts Released,0,0,0
LAKSHADWEEP,2004,Under trials Released - Acquitted,0,0,0
LAKSHADWEEP,2004,Under trials Released - Released on appeal,0,0,0
LAKSHADWEEP,2004,Under trials Released - Released on bail,0,0,0
LAKSHADWEEP,2004,Under trials Released - Transferred to other States,0,0,0
LAKSHADWEEP,2004,Under trials Released - Extradited,0,0,0
LAKSHADWEEP,2004,Under trials Released - Other releases (transferred to Mental/Civil hospital),0,0,0
LAKSHADWEEP,2004,Total Under trials Released,0,0,0
LAKSHADWEEP,2004,Detenus Released - Released on completion of detention period,0,0,0
LAKSHADWEEP,2004,Detenus Released - Released before completion of detention period,0,0,0
LAKSHADWEEP,2004,Detenus Released - Released on bail,0,0,0
LAKSHADWEEP,2004,Detenus Released - Other releases (temporary transfer etc.),0,0,0
LAKSHADWEEP,2004,Total Detenus Released,0,0,0
LAKSHADWEEP,2005,Convicts Released - Released after completion of conviction,0,0,0
LAKSHADWEEP,2005,Convicts Released - Premature release,0,0,0
LAKSHADWEEP,2005,Convicts Released - Released on appeal,0,0,0
LAKSHADWEEP,2005,Convicts Released - Released on bail,0,0,0
LAKSHADWEEP,2005,Convicts Released - Pardons,0,0,0
LAKSHADWEEP,2005,Convicts Released - Transferred to other States,0,0,0
LAKSHADWEEP,2005,"Convicts Released - Other Releases (due to illness, transferred to Mental hospital)",0,0,0
LAKSHADWEEP,2005,Total Convicts Released,0,0,0
LAKSHADWEEP,2005,Under trials Released - Acquitted,0,0,0
LAKSHADWEEP,2005,Under trials Released - Released on appeal,0,0,0
LAKSHADWEEP,2005,Under trials Released - Released on bail,0,0,0
LAKSHADWEEP,2005,Under trials Released - Transferred to other States,0,0,0
LAKSHADWEEP,2005,Under trials Released - Extradited,0,0,0
LAKSHADWEEP,2005,Under trials Released - Other releases (transferred to Mental/Civil hospital),0,0,0
LAKSHADWEEP,2005,Total Under trials Released,0,0,0
LAKSHADWEEP,2005,Detenus Released - Released on completion of detention period,0,0,0
LAKSHADWEEP,2005,Detenus Released - Released before completion of detention period,0,0,0
LAKSHADWEEP,2005,Detenus Released - Released on bail,0,0,0
LAKSHADWEEP,2005,Detenus Released - Other releases (temporary transfer etc.),0,0,0
LAKSHADWEEP,2005,Total Detenus Released,0,0,0
LAKSHADWEEP,2006,Convicts Released - Released after completion of conviction,0,0,0
LAKSHADWEEP,2006,Convicts Released - Premature release,0,0,0
LAKSHADWEEP,2006,Convicts Released - Released on appeal,0,0,0
LAKSHADWEEP,2006,Convicts Released - Released on bail,0,0,0
LAKSHADWEEP,2006,Convicts Released - Pardons,0,0,0
LAKSHADWEEP,2006,Convicts Released - Transferred to other States,0,0,0
LAKSHADWEEP,2006,"Convicts Released - Other Releases (due to illness, transferred to Mental hospital)",0,0,0
LAKSHADWEEP,2006,Total Convicts Released,0,0,0
LAKSHADWEEP,2006,Under trials Released - Acquitted,0,0,0
LAKSHADWEEP,2006,Under trials Released - Released on appeal,0,0,0
LAKSHADWEEP,2006,Under trials Released - Released on bail,0,0,0
LAKSHADWEEP,2006,Under trials Released - Transferred to other States,0,0,0
LAKSHADWEEP,2006,Under trials Released - Extradited,0,0,0
LAKSHADWEEP,2006,Under trials Released - Other releases (transferred to Mental/Civil hospital),0,0,0
LAKSHADWEEP,2006,Total Under trials Released,0,0,0
LAKSHADWEEP,2006,Detenus Released - Released on completion of detention period,0,0,0
LAKSHADWEEP,2006,Detenus Released - Released before completion of detention period,0,0,0
LAKSHADWEEP,2006,Detenus Released - Released on bail,0,0,0
LAKSHADWEEP,2006,Detenus Released - Other releases (temporary transfer etc.),0,0,0
LAKSHADWEEP,2006,Total Detenus Released,0,0,0
LAKSHADWEEP,2007,Convicts Released - Released after completion of conviction,0,0,0
LAKSHADWEEP,2007,Convicts Released - Premature release,0,0,0
LAKSHADWEEP,2007,Convicts Released - Released on appeal,0,0,0
LAKSHADWEEP,2007,Convicts Released - Released on bail,2,0,2
LAKSHADWEEP,2007,Convicts Released - Pardons,0,0,0
LAKSHADWEEP,2007,Convicts Released - Transferred to other States,1,0,1
LAKSHADWEEP,2007,"Convicts Released - Other Releases (due to illness, transferred to Mental hospital)",0,0,0
LAKSHADWEEP,2007,Total Convicts Released,3,0,3
LAKSHADWEEP,2007,Under trials Released - Acquitted,0,0,0
LAKSHADWEEP,2007,Under trials Released - Released on appeal,1,0,1
LAKSHADWEEP,2007,Under trials Released - Released on bail,18,0,18
LAKSHADWEEP,2007,Under trials Released - Transferred to other States,0,0,0
LAKSHADWEEP,2007,Under trials Released - Extradited,0,0,0
LAKSHADWEEP,2007,Under trials Released - Other releases (transferred to Mental/Civil hospital),0,0,0
LAKSHADWEEP,2007,Total Under trials Released,19,0,19
LAKSHADWEEP,2007,Detenus Released - Released on completion of detention period,0,0,0
LAKSHADWEEP,2007,Detenus Released - Released before completion of detention period,0,0,0
LAKSHADWEEP,2007,Detenus Released - Released on bail,0,0,0
LAKSHADWEEP,2007,Detenus Released - Other releases (temporary transfer etc.),0,0,0
LAKSHADWEEP,2007,Total Detenus Released,0,0,0
LAKSHADWEEP,2008,Convicts Released - Released after completion of conviction,0,0,0
LAKSHADWEEP,2008,Convicts Released - Premature release,0,0,0
LAKSHADWEEP,2008,Convicts Released - Released on appeal,0,0,0
LAKSHADWEEP,2008,Convicts Released - Released on bail,0,0,0
LAKSHADWEEP,2008,Convicts Released - Pardons,0,0,0
LAKSHADWEEP,2008,Convicts Released - Transferred to other States,0,0,0
LAKSHADWEEP,2008,"Convicts Released - Other Releases (due to illness, transferred to Mental hospital)",0,0,0
LAKSHADWEEP,2008,Total Convicts Released,0,0,0
LAKSHADWEEP,2008,Under trials Released - Acquitted,0,0,0
LAKSHADWEEP,2008,Under trials Released - Released on appeal,0,0,0
LAKSHADWEEP,2008,Under trials Released - Released on bail,17,0,17
LAKSHADWEEP,2008,Under trials Released - Transferred to other States,1,0,1
LAKSHADWEEP,2008,Under trials Released - Extradited,0,0,0
LAKSHADWEEP,2008,Under trials Released - Other releases (transferred to Mental/Civil hospital),0,0,0
LAKSHADWEEP,2008,Total Under trials Released,18,0,18
LAKSHADWEEP,2008,Detenus Released - Released on completion of detention period,0,0,0
LAKSHADWEEP,2008,Detenus Released - Released before completion of detention period,0,0,0
LAKSHADWEEP,2008,Detenus Released - Released on bail,0,0,0
LAKSHADWEEP,2008,Detenus Released - Other releases (temporary transfer etc.),0,0,0
LAKSHADWEEP,2008,Total Detenus Released,0,0,0
LAKSHADWEEP,2009,Convicts Released - Released after completion of conviction,0,0,0
LAKSHADWEEP,2009,Convicts Released - Premature release,0,0,0
LAKSHADWEEP,2009,Convicts Released - Released on appeal,0,0,0
LAKSHADWEEP,2009,Convicts Released - Released on bail,0,0,0
LAKSHADWEEP,2009,Convicts Released - Pardons,0,0,0
LAKSHADWEEP,2009,Convicts Released - Transferred to other States,1,0,1
LAKSHADWEEP,2009,"Convicts Released - Other Releases (due to illness, transferred to Mental hospital)",0,0,0
LAKSHADWEEP,2009,Total Convicts Released,1,0,1
LAKSHADWEEP,2009,Under trials Released - Acquitted,0,0,0
LAKSHADWEEP,2009,Under trials Released - Released on appeal,0,0,0
LAKSHADWEEP,2009,Under trials Released - Released on bail,43,0,43
LAKSHADWEEP,2009,Under trials Released - Transferred to other States,0,0,0
LAKSHADWEEP,2009,Under trials Released - Extradited,0,0,0
LAKSHADWEEP,2009,Under trials Released - Other releases (transferred to Mental/Civil hospital),0,0,0
LAKSHADWEEP,2009,Total Under trials Released,43,0,43
LAKSHADWEEP,2009,Detenus Released - Released on completion of detention period,0,0,0
LAKSHADWEEP,2009,Detenus Released - Released before completion of detention period,0,0,0
LAKSHADWEEP,2009,Detenus Released - Released on bail,0,0,0
LAKSHADWEEP,2009,Detenus Released - Other releases (temporary transfer etc.),0,0,0
LAKSHADWEEP,2009,Total Detenus Released,0,0,0
LAKSHADWEEP,2010,Convicts Released - Released after completion of conviction,0,0,0
LAKSHADWEEP,2010,Convicts Released - Premature release,0,0,0
LAKSHADWEEP,2010,Convicts Released - Released on appeal,0,0,0
LAKSHADWEEP,2010,Convicts Released - Released on bail,0,0,0
LAKSHADWEEP,2010,Convicts Released - Pardons,0,0,0
LAKSHADWEEP,2010,Convicts Released - Transferred to other States,0,0,0
LAKSHADWEEP,2010,"Convicts Released - Other Releases (due to illness, transferred to Mental hospital)",0,0,0
LAKSHADWEEP,2010,Total Convicts Released,0,0,0
LAKSHADWEEP,2010,Under trials Released - Acquitted,0,0,0
LAKSHADWEEP,2010,Under trials Released - Released on appeal,0,0,0
LAKSHADWEEP,2010,Under trials Released - Released on bail,8,0,8
LAKSHADWEEP,2010,Under trials Released - Transferred to other States,0,0,0
LAKSHADWEEP,2010,Under trials Released - Extradited,0,0,0
LAKSHADWEEP,2010,Under trials Released - Other releases (transferred to Mental/Civil hospital),0,0,0
LAKSHADWEEP,2010,Total Under trials Released,8,0,8
LAKSHADWEEP,2010,Detenus Released - Released on completion of detention period,0,0,0
LAKSHADWEEP,2010,Detenus Released - Released before completion of detention period,0,0,0
LAKSHADWEEP,2010,Detenus Released - Released on bail,0,0,0
LAKSHADWEEP,2010,Detenus Released - Other releases (temporary transfer etc.),0,0,0
LAKSHADWEEP,2010,Total Detenus Released,0,0,0
LAKSHADWEEP,2011,Convicts Released - Released after completion of conviction,0,0,0
LAKSHADWEEP,2011,Convicts Released - Premature release,0,0,0
LAKSHADWEEP,2011,Convicts Released - Released on appeal,0,0,0
LAKSHADWEEP,2011,Convicts Released - Released on bail,0,0,0
LAKSHADWEEP,2011,Convicts Released - Pardons,0,0,0
LAKSHADWEEP,2011,Convicts Released - Transferred to other States,0,0,0
LAKSHADWEEP,2011,"Convicts Released - Other Releases (due to illness, transferred to Mental hospital)",0,0,0
LAKSHADWEEP,2011,Total Convicts Released,0,0,0
LAKSHADWEEP,2011,Under trials Released - Acquitted,0,0,0
LAKSHADWEEP,2011,Under trials Released - Released on appeal,0,0,0
LAKSHADWEEP,2011,Under trials Released - Released on bail,7,1,8
LAKSHADWEEP,2011,Under trials Released - Transferred to other States,3,0,3
LAKSHADWEEP,2011,Under trials Released - Extradited,0,0,0
LAKSHADWEEP,2011,Under trials Released - Other releases (transferred to Mental/Civil hospital),0,0,0
LAKSHADWEEP,2011,Total Under trials Released,10,1,11
LAKSHADWEEP,2011,Detenus Released - Released on completion of detention period,0,0,0
LAKSHADWEEP,2011,Detenus Released - Released before completion of detention period,32,0,32
LAKSHADWEEP,2011,Detenus Released - Released on bail,0,0,0
LAKSHADWEEP,2011,Detenus Released - Other releases (temporary transfer etc.),0,0,0
LAKSHADWEEP,2011,Total Detenus Released,32,0,32
LAKSHADWEEP,2012,Convicts Released - Released after completion of conviction,0,0,0
LAKSHADWEEP,2012,Convicts Released - Premature release,0,0,0
LAKSHADWEEP,2012,Convicts Released - Released on appeal,0,0,0
LAKSHADWEEP,2012,Convicts Released - Released on bail,0,0,0
LAKSHADWEEP,2012,Convicts Released - Pardons,0,0,0
LAKSHADWEEP,2012,Convicts Released - Transferred to other States,0,0,0
LAKSHADWEEP,2012,"Convicts Released - Other Releases (due to illness, transferred to Mental hospital)",0,0,0
LAKSHADWEEP,2012,Total Convicts Released,0,0,0
LAKSHADWEEP,2012,Under trials Released - Acquitted,0,0,0
LAKSHADWEEP,2012,Under trials Released - Released on appeal,0,0,0
LAKSHADWEEP,2012,Under trials Released - Released on bail,21,0,21
LAKSHADWEEP,2012,Under trials Released - Transferred to other States,0,0,0
LAKSHADWEEP,2012,Under trials Released - Extradited,0,0,0
LAKSHADWEEP,2012,Under trials Released - Other releases (transferred to Mental/Civil hospital),0,0,0
LAKSHADWEEP,2012,Total Under trials Released,21,0,21
LAKSHADWEEP,2012,Detenus Released - Released on completion of detention period,0,0,0
LAKSHADWEEP,2012,Detenus Released - Released before completion of detention period,24,0,24
LAKSHADWEEP,2012,Detenus Released - Released on bail,0,0,0
LAKSHADWEEP,2012,Detenus Released - Other releases (temporary transfer etc.),0,0,0
LAKSHADWEEP,2012,Total Detenus Released,24,0,24
PONDICHERRY,2001,Convicts Released - Released after completion of conviction,401,48,449
PONDICHERRY,2001,Convicts Released - Premature release,2,0,2
PONDICHERRY,2001,Convicts Released - Released on appeal,0,0,0
PONDICHERRY,2001,Convicts Released - Released on bail,28,0,28
PONDICHERRY,2001,Convicts Released - Pardons,0,0,0
PONDICHERRY,2001,Convicts Released - Transferred to other States,1,0,1
PONDICHERRY,2001,"Convicts Released - Other Releases (due to illness, transferred to Mental hospital)",0,0,0
PONDICHERRY,2001,Total Convicts Released,432,48,480
PONDICHERRY,2001,Under trials Released - Acquitted,15,0,15
PONDICHERRY,2001,Under trials Released - Released on appeal,0,0,0
PONDICHERRY,2001,Under trials Released - Released on bail,2763,41,2804
PONDICHERRY,2001,Under trials Released - Transferred to other States,0,0,0
PONDICHERRY,2001,Under trials Released - Extradited,0,0,0
PONDICHERRY,2001,Under trials Released - Other releases (transferred to Mental/Civil hospital),0,0,0
PONDICHERRY,2001,Total Under trials Released,2778,41,2819
PONDICHERRY,2001,Detenus Released - Released on completion of detention period,0,0,0
PONDICHERRY,2001,Detenus Released - Released before completion of detention period,0,0,0
PONDICHERRY,2001,Detenus Released - Released on bail,0,0,0
PONDICHERRY,2001,Detenus Released - Other releases (temporary transfer etc.),0,0,0
PONDICHERRY,2001,Total Detenus Released,0,0,0
PONDICHERRY,2002,Convicts Released - Released after completion of conviction,412,15,427
PONDICHERRY,2002,Convicts Released - Premature release,0,0,0
PONDICHERRY,2002,Convicts Released - Released on appeal,4,0,4
PONDICHERRY,2002,Convicts Released - Released on bail,10,0,10
PONDICHERRY,2002,Convicts Released - Pardons,0,0,0
PONDICHERRY,2002,Convicts Released - Transferred to other States,0,0,0
PONDICHERRY,2002,"Convicts Released - Other Releases (due to illness, transferred to Mental hospital)",0,0,0
PONDICHERRY,2002,Total Convicts Released,426,15,441
PONDICHERRY,2002,Under trials Released - Acquitted,19,0,19
PONDICHERRY,2002,Under trials Released - Released on appeal,0,0,0
PONDICHERRY,2002,Under trials Released - Released on bail,2448,169,2617
PONDICHERRY,2002,Under trials Released - Transferred to other States,0,0,0
PONDICHERRY,2002,Under trials Released - Extradited,0,0,0
PONDICHERRY,2002,Under trials Released - Other releases (transferred to Mental/Civil hospital),0,0,0
PONDICHERRY,2002,Total Under trials Released,2467,169,2636
PONDICHERRY,2002,Detenus Released - Released on completion of detention period,0,0,0
PONDICHERRY,2002,Detenus Released - Released before completion of detention period,0,0,0
PONDICHERRY,2002,Detenus Released - Released on bail,0,0,0
PONDICHERRY,2002,Detenus Released - Other releases (temporary transfer etc.),0,0,0
PONDICHERRY,2002,Total Detenus Released,0,0,0
PONDICHERRY,2003,Convicts Released - Released after completion of conviction,412,15,427
PONDICHERRY,2003,Convicts Released - Premature release,0,0,0
PONDICHERRY,2003,Convicts Released - Released on appeal,4,0,4
PONDICHERRY,2003,Convicts Released - Released on bail,10,0,10
PONDICHERRY,2003,Convicts Released - Pardons,0,0,0
PONDICHERRY,2003,Convicts Released - Transferred to other States,0,0,0
PONDICHERRY,2003,"Convicts Released - Other Releases (due to illness, transferred to Mental hospital)",0,0,0
PONDICHERRY,2003,Total Convicts Released,426,15,441
PONDICHERRY,2003,Under trials Released - Acquitted,19,0,19
PONDICHERRY,2003,Under trials Released - Released on appeal,0,0,0
PONDICHERRY,2003,Under trials Released - Released on bail,2448,169,2617
PONDICHERRY,2003,Under trials Released - Transferred to other States,0,0,0
PONDICHERRY,2003,Under trials Released - Extradited,0,0,0
PONDICHERRY,2003,Under trials Released - Other releases (transferred to Mental/Civil hospital),0,0,0
PONDICHERRY,2003,Total Under trials Released,2467,169,2636
PONDICHERRY,2003,Detenus Released - Released on completion of detention period,0,0,0
PONDICHERRY,2003,Detenus Released - Released before completion of detention period,0,0,0
PONDICHERRY,2003,Detenus Released - Released on bail,0,0,0
PONDICHERRY,2003,Detenus Released - Other releases (temporary transfer etc.),0,0,0
PONDICHERRY,2003,Total Detenus Released,0,0,0
PONDICHERRY,2004,Convicts Released - Released after completion of conviction,460,18,478
PONDICHERRY,2004,Convicts Released - Premature release,0,0,0
PONDICHERRY,2004,Convicts Released - Released on appeal,6,0,6
PONDICHERRY,2004,Convicts Released - Released on bail,17,0,17
PONDICHERRY,2004,Convicts Released - Pardons,0,0,0
PONDICHERRY,2004,Convicts Released - Transferred to other States,0,0,0
PONDICHERRY,2004,"Convicts Released - Other Releases (due to illness, transferred to Mental hospital)",0,0,0
PONDICHERRY,2004,Total Convicts Released,483,18,501
PONDICHERRY,2004,Under trials Released - Acquitted,25,0,25
PONDICHERRY,2004,Under trials Released - Released on appeal,0,0,0
PONDICHERRY,2004,Under trials Released - Released on bail,2291,148,2439
PONDICHERRY,2004,Under trials Released - Transferred to other States,0,0,0
PONDICHERRY,2004,Under trials Released - Extradited,0,0,0
PONDICHERRY,2004,Under trials Released - Other releases (transferred to Mental/Civil hospital),0,0,0
PONDICHERRY,2004,Total Under trials Released,2316,148,2464
PONDICHERRY,2004,Detenus Released - Released on completion of detention period,0,0,0
PONDICHERRY,2004,Detenus Released - Released before completion of detention period,0,0,0
PONDICHERRY,2004,Detenus Released - Released on bail,0,0,0
PONDICHERRY,2004,Detenus Released - Other releases (temporary transfer etc.),0,0,0
PONDICHERRY,2004,Total Detenus Released,0,0,0
PONDICHERRY,2005,Convicts Released - Released after completion of conviction,522,23,545
PONDICHERRY,2005,Convicts Released - Premature release,1,0,1
PONDICHERRY,2005,Convicts Released - Released on appeal,12,0,12
PONDICHERRY,2005,Convicts Released - Released on bail,11,0,11
PONDICHERRY,2005,Convicts Released - Pardons,0,0,0
PONDICHERRY,2005,Convicts Released - Transferred to other States,0,0,0
PONDICHERRY,2005,"Convicts Released - Other Releases (due to illness, transferred to Mental hospital)",0,0,0
PONDICHERRY,2005,Total Convicts Released,546,23,569
PONDICHERRY,2005,Under trials Released - Acquitted,32,0,32
PONDICHERRY,2005,Under trials Released - Released on appeal,0,0,0
PONDICHERRY,2005,Under trials Released - Released on bail,1922,124,2046
PONDICHERRY,2005,Under trials Released - Transferred to other States,0,0,0
PONDICHERRY,2005,Under trials Released - Extradited,0,0,0
PONDICHERRY,2005,Under trials Released - Other releases (transferred to Mental/Civil hospital),0,0,0
PONDICHERRY,2005,Total Under trials Released,1954,124,2078
PONDICHERRY,2005,Detenus Released - Released on completion of detention period,0,0,0
PONDICHERRY,2005,Detenus Released - Released before completion of detention period,0,0,0
PONDICHERRY,2005,Detenus Released - Released on bail,0,0,0
PONDICHERRY,2005,Detenus Released - Other releases (temporary transfer etc.),0,0,0
PONDICHERRY,2005,Total Detenus Released,0,0,0
PONDICHERRY,2006,Convicts Released - Released after completion of conviction,471,3,474
PONDICHERRY,2006,Convicts Released - Premature release,0,0,0
PONDICHERRY,2006,Convicts Released - Released on appeal,0,0,0
PONDICHERRY,2006,Convicts Released - Released on bail,22,0,22
PONDICHERRY,2006,Convicts Released - Pardons,0,0,0
PONDICHERRY,2006,Convicts Released - Transferred to other States,0,0,0
PONDICHERRY,2006,"Convicts Released - Other Releases (due to illness, transferred to Mental hospital)",0,0,0
PONDICHERRY,2006,Total Convicts Released,493,3,496
PONDICHERRY,2006,Under trials Released - Acquitted,169,0,169
PONDICHERRY,2006,Under trials Released - Released on appeal,0,0,0
PONDICHERRY,2006,Under trials Released - Released on bail,1848,77,1925
PONDICHERRY,2006,Under trials Released - Transferred to other States,0,0,0
PONDICHERRY,2006,Under trials Released - Extradited,0,0,0
PONDICHERRY,2006,Under trials Released - Other releases (transferred to Mental/Civil hospital),0,0,0
PONDICHERRY,2006,Total Under trials Released,2017,77,2094
PONDICHERRY,2006,Detenus Released - Released on completion of detention period,0,0,0
PONDICHERRY,2006,Detenus Released - Released before completion of detention period,0,0,0
PONDICHERRY,2006,Detenus Released - Released on bail,0,0,0
PONDICHERRY,2006,Detenus Released - Other releases (temporary transfer etc.),0,0,0
PONDICHERRY,2006,Total Detenus Released,0,0,0
PONDICHERRY,2007,Convicts Released - Released after completion of conviction,296,4,300
PONDICHERRY,2007,Convicts Released - Premature release,0,0,0
PONDICHERRY,2007,Convicts Released - Released on appeal,42,0,42
PONDICHERRY,2007,Convicts Released - Released on bail,0,0,0
PONDICHERRY,2007,Convicts Released - Pardons,0,0,0
PONDICHERRY,2007,Convicts Released - Transferred to other States,0,0,0
PONDICHERRY,2007,"Convicts Released - Other Releases (due to illness, transferred to Mental hospital)",1,0,1
PONDICHERRY,2007,Total Convicts Released,339,4,343
PONDICHERRY,2007,Under trials Released - Acquitted,182,2,184
PONDICHERRY,2007,Under trials Released - Released on appeal,1833,26,1859
PONDICHERRY,2007,Under trials Released - Released on bail,0,0,0
PONDICHERRY,2007,Under trials Released - Transferred to other States,0,0,0
PONDICHERRY,2007,Under trials Released - Extradited,0,0,0
PONDICHERRY,2007,Under trials Released - Other releases (transferred to Mental/Civil hospital),0,1,1
PONDICHERRY,2007,Total Under trials Released,2015,29,2044
PONDICHERRY,2007,Detenus Released - Released on completion of detention period,0,0,0
PONDICHERRY,2007,Detenus Released - Released before completion of detention period,0,0,0
PONDICHERRY,2007,Detenus Released - Released on bail,0,0,0
PONDICHERRY,2007,Detenus Released - Other releases (temporary transfer etc.),0,0,0
PONDICHERRY,2007,Total Detenus Released,0,0,0
PONDICHERRY,2008,Convicts Released - Released after completion of conviction,313,1,314
PONDICHERRY,2008,Convicts Released - Premature release,1,0,1
PONDICHERRY,2008,Convicts Released - Released on appeal,0,0,0
PONDICHERRY,2008,Convicts Released - Released on bail,0,0,0
PONDICHERRY,2008,Convicts Released - Pardons,0,0,0
PONDICHERRY,2008,Convicts Released - Transferred to other States,0,0,0
PONDICHERRY,2008,"Convicts Released - Other Releases (due to illness, transferred to Mental hospital)",0,0,0
PONDICHERRY,2008,Total Convicts Released,314,1,315
PONDICHERRY,2008,Under trials Released - Acquitted,17,0,17
PONDICHERRY,2008,Under trials Released - Released on appeal,0,0,0
PONDICHERRY,2008,Under trials Released - Released on bail,1930,0,1930
PONDICHERRY,2008,Under trials Released - Transferred to other States,0,0,0
PONDICHERRY,2008,Under trials Released - Extradited,0,0,0
PONDICHERRY,2008,Under trials Released - Other releases (transferred to Mental/Civil hospital),0,0,0
PONDICHERRY,2008,Total Under trials Released,1947,0,1947
PONDICHERRY,2008,Detenus Released - Released on completion of detention period,0,0,0
PONDICHERRY,2008,Detenus Released - Released before completion of detention period,0,0,0
PONDICHERRY,2008,Detenus Released - Released on bail,0,0,0
PONDICHERRY,2008,Detenus Released - Other releases (temporary transfer etc.),0,0,0
PONDICHERRY,2008,Total Detenus Released,0,0,0
PONDICHERRY,2009,Convicts Released - Released after completion of conviction,201,0,201
PONDICHERRY,2009,Convicts Released - Premature release,1,0,1
PONDICHERRY,2009,Convicts Released - Released on appeal,0,0,0
PONDICHERRY,2009,Convicts Released - Released on bail,7,0,7
PONDICHERRY,2009,Convicts Released - Pardons,0,0,0
PONDICHERRY,2009,Convicts Released - Transferred to other States,8,1,9
PONDICHERRY,2009,"Convicts Released - Other Releases (due to illness, transferred to Mental hospital)",0,0,0
PONDICHERRY,2009,Total Convicts Released,217,1,218
PONDICHERRY,2009,Under trials Released - Acquitted,32,0,32
PONDICHERRY,2009,Under trials Released - Released on appeal,0,0,0
PONDICHERRY,2009,Under trials Released - Released on bail,2129,24,2153
PONDICHERRY,2009,Under trials Released - Transferred to other States,0,0,0
PONDICHERRY,2009,Under trials Released - Extradited,0,0,0
PONDICHERRY,2009,Under trials Released - Other releases (transferred to Mental/Civil hospital),0,0,0
PONDICHERRY,2009,Total Under trials Released,2161,24,2185
PONDICHERRY,2009,Detenus Released - Released on completion of detention period,0,0,0
PONDICHERRY,2009,Detenus Released - Released before completion of detention period,0,0,0
PONDICHERRY,2009,Detenus Released - Released on bail,0,0,0
PONDICHERRY,2009,Detenus Released - Other releases (temporary transfer etc.),0,0,0
PONDICHERRY,2009,Total Detenus Released,0,0,0
PONDICHERRY,2010,Convicts Released - Released after completion of conviction,371,1,372
PONDICHERRY,2010,Convicts Released - Premature release,0,0,0
PONDICHERRY,2010,Convicts Released - Released on appeal,5,0,5
PONDICHERRY,2010,Convicts Released - Released on bail,29,0,29
PONDICHERRY,2010,Convicts Released - Pardons,0,0,0
PONDICHERRY,2010,Convicts Released - Transferred to other States,14,0,14
PONDICHERRY,2010,"Convicts Released - Other Releases (due to illness, transferred to Mental hospital)",0,0,0
PONDICHERRY,2010,Total Convicts Released,419,1,420
PONDICHERRY,2010,Under trials Released - Acquitted,38,2,40
PONDICHERRY,2010,Under trials Released - Released on appeal,0,0,0
PONDICHERRY,2010,Under trials Released - Released on bail,1699,37,1736
PONDICHERRY,2010,Under trials Released - Transferred to other States,15,0,15
PONDICHERRY,2010,Under trials Released - Extradited,0,0,0
PONDICHERRY,2010,Under trials Released - Other releases (transferred to Mental/Civil hospital),0,0,0
PONDICHERRY,2010,Total Under trials Released,1752,39,1791
PONDICHERRY,2010,Detenus Released - Released on completion of detention period,0,0,0
PONDICHERRY,2010,Detenus Released - Released before completion of detention period,3,0,3
PONDICHERRY,2010,Detenus Released - Released on bail,0,0,0
PONDICHERRY,2010,Detenus Released - Other releases (temporary transfer etc.),0,0,0
PONDICHERRY,2010,Total Detenus Released,3,0,3
PONDICHERRY,2011,Convicts Released - Released after completion of conviction,232,0,232
PONDICHERRY,2011,Convicts Released - Premature release,3,0,3
PONDICHERRY,2011,Convicts Released - Released on appeal,12,0,12
PONDICHERRY,2011,Convicts Released - Released on bail,7,0,7
PONDICHERRY,2011,Convicts Released - Pardons,0,0,0
PONDICHERRY,2011,Convicts Released - Transferred to other States,8,0,8
PONDICHERRY,2011,"Convicts Released - Other Releases (due to illness, transferred to Mental hospital)",0,0,0
PONDICHERRY,2011,Total Convicts Released,262,0,262
PONDICHERRY,2011,Under trials Released - Acquitted,31,4,35
PONDICHERRY,2011,Under trials Released - Released on appeal,0,0,0
PONDICHERRY,2011,Under trials Released - Released on bail,1751,70,1821
PONDICHERRY,2011,Under trials Released - Transferred to other States,29,1,30
PONDICHERRY,2011,Under trials Released - Extradited,0,0,0
PONDICHERRY,2011,Under trials Released - Other releases (transferred to Mental/Civil hospital),0,0,0
PONDICHERRY,2011,Total Under trials Released,1811,75,1886
PONDICHERRY,2011,Detenus Released - Released on completion of detention period,0,0,0
PONDICHERRY,2011,Detenus Released - Released before completion of detention period,3,0,3
PONDICHERRY,2011,Detenus Released - Released on bail,0,0,0
PONDICHERRY,2011,Detenus Released - Other releases (temporary transfer etc.),0,0,0
PONDICHERRY,2011,Total Detenus Released,3,0,3
PONDICHERRY,2012,Convicts Released - Released after completion of conviction,250,1,251
PONDICHERRY,2012,Convicts Released - Premature release,6,0,6
PONDICHERRY,2012,Convicts Released - Released on appeal,6,0,6
PONDICHERRY,2012,Convicts Released - Released on bail,10,0,10
PONDICHERRY,2012,Convicts Released - Pardons,0,0,0
PONDICHERRY,2012,Convicts Released - Transferred to other States,0,0,0
PONDICHERRY,2012,"Convicts Released - Other Releases (due to illness, transferred to Mental hospital)",0,0,0
PONDICHERRY,2012,Total Convicts Released,272,1,273
PONDICHERRY,2012,Under trials Released - Acquitted,5,0,5
PONDICHERRY,2012,Under trials Released - Released on appeal,0,0,0
PONDICHERRY,2012,Under trials Released - Released on bail,2249,33,2282
PONDICHERRY,2012,Under trials Released - Transferred to other States,2,0,2
PONDICHERRY,2012,Under trials Released - Extradited,0,0,0
PONDICHERRY,2012,Under trials Released - Other releases (transferred to Mental/Civil hospital),0,0,0
PONDICHERRY,2012,Total Under trials Released,2256,33,2289
PONDICHERRY,2012,Detenus Released - Released on completion of detention period,0,0,0
PONDICHERRY,2012,Detenus Released - Released before completion of detention period,0,0,0
PONDICHERRY,2012,Detenus Released - Released on bail,0,0,0
PONDICHERRY,2012,Detenus Released - Other releases (temporary transfer etc.),0,0,0
PONDICHERRY,2012,Total Detenus Released,0,0,0
Andhra Pradesh,2013,Released after completion of conviction,7595,140,7735
Andhra Pradesh,2013,Premature release,377,13,390
Andhra Pradesh,2013,Released on appeal,364,15,379
Andhra Pradesh,2013,Released on bail,3394,179,3573
Andhra Pradesh,2013,Pardons,0,0,0
Andhra Pradesh,2013,Transferred to other States,62,0,62
Andhra Pradesh,2013,"Other Releases (due to illness,transferred to Mental hospital)",4,0,4
Arunachal Pradesh,2013,Released after completion of conviction,12,2,14
Arunachal Pradesh,2013,Premature release,0,0,0
Arunachal Pradesh,2013,Released on appeal,0,0,0
Arunachal Pradesh,2013,Released on bail,0,0,0
Arunachal Pradesh,2013,Pardons,0,0,0
Arunachal Pradesh,2013,Transferred to other States,0,0,0
Arunachal Pradesh,2013,"Other Releases (due to illness,transferred to Mental hospital)",0,0,0
Assam,2013,Released after completion of conviction,1661,27,1688
Assam,2013,Premature release,0,0,0
Assam,2013,Released on appeal,251,12,263
Assam,2013,Released on bail,200,9,209
Assam,2013,Pardons,0,0,0
Assam,2013,Transferred to other States,0,0,0
Assam,2013,"Other Releases (due to illness,transferred to Mental hospital)",7,0,7
Bihar,2013,Released after completion of conviction,2631,28,2659
Bihar,2013,Premature release,1408,5,1413
Bihar,2013,Released on appeal,2067,55,2122
Bihar,2013,Released on bail,2629,85,2714
Bihar,2013,Pardons,0,0,0
Bihar,2013,Transferred to other States,190,7,197
Bihar,2013,"Other Releases (due to illness,transferred to Mental hospital)",120,6,126
Chhattisgarh,2013,Released after completion of conviction,1670,36,1706
Chhattisgarh,2013,Premature release,18,0,18
Chhattisgarh,2013,Released on appeal,365,15,380
Chhattisgarh,2013,Released on bail,1131,91,1222
Chhattisgarh,2013,Pardons,0,0,0
Chhattisgarh,2013,Transferred to other States,1,0,1
Chhattisgarh,2013,"Other Releases (due to illness,transferred to Mental hospital)",1,0,1
Goa,2013,Released after completion of conviction,83,1,84
Goa,2013,Premature release,11,0,11
Goa,2013,Released on appeal,1,1,2
Goa,2013,Released on bail,22,1,23
Goa,2013,Pardons,0,0,0
Goa,2013,Transferred to other States,4,1,5
Goa,2013,"Other Releases (due to illness,transferred to Mental hospital)",0,0,0
Gujarat,2013,Released after completion of conviction,5997,61,6058
Gujarat,2013,Premature release,127,0,127
Gujarat,2013,Released on appeal,207,6,213
Gujarat,2013,Released on bail,448,25,473
Gujarat,2013,Pardons,106,3,109
Gujarat,2013,Transferred to other States,148,0,148
Gujarat,2013,"Other Releases (due to illness,transferred to Mental hospital)",531,4,535
Haryana,2013,Released after completion of conviction,1427,13,1440
Haryana,2013,Premature release,84,8,92
Haryana,2013,Released on appeal,434,55,489
Haryana,2013,Released on bail,1923,79,2002
Haryana,2013,Pardons,17,1,18
Haryana,2013,Transferred to other States,126,13,139
Haryana,2013,"Other Releases (due to illness,transferred to Mental hospital)",26,2,28
Himachal Pradesh,2013,Released after completion of conviction,320,11,331
Himachal Pradesh,2013,Premature release,6,0,6
Himachal Pradesh,2013,Released on appeal,66,5,71
Himachal Pradesh,2013,Released on bail,95,7,102
Himachal Pradesh,2013,Pardons,0,0,0
Himachal Pradesh,2013,Transferred to other States,10,1,11
Himachal Pradesh,2013,"Other Releases (due to illness,transferred to Mental hospital)",81,5,86
Jammu and Kashmir,2013,Released after completion of conviction,134,5,139
Jammu and Kashmir,2013,Premature release,8,0,8
Jammu and Kashmir,2013,Released on appeal,11,1,12
Jammu and Kashmir,2013,Released on bail,179,0,179
Jammu and Kashmir,2013,Pardons,0,0,0
Jammu and Kashmir,2013,Transferred to other States,21,1,22
Jammu and Kashmir,2013,"Other Releases (due to illness,transferred to Mental hospital)",66,0,66
Jharkhand,2013,Released after completion of conviction,915,43,958
Jharkhand,2013,Premature release,9,0,9
Jharkhand,2013,Released on appeal,249,13,262
Jharkhand,2013,Released on bail,1631,106,1737
Jharkhand,2013,Pardons,0,0,0
Jharkhand,2013,Transferred to other States,114,2,116
Jharkhand,2013,"Other Releases (due to illness,transferred to Mental hospital)",37,0,37
Karnataka,2013,Released after completion of conviction,29804,284,30088
Karnataka,2013,Premature release,0,0,0
Karnataka,2013,Released on appeal,157,0,157
Karnataka,2013,Released on bail,841,47,888
Karnataka,2013,Pardons,0,0,0
Karnataka,2013,Transferred to other States,6,0,6
Karnataka,2013,"Other Releases (due to illness,transferred to Mental hospital)",11,0,11
Kerala,2013,Released after completion of conviction,5254,162,5416
Kerala,2013,Premature release,26,2,28
Kerala,2013,Released on appeal,972,2,974
Kerala,2013,Released on bail,375,2,377
Kerala,2013,Pardons,0,0,0
Kerala,2013,Transferred to other States,0,0,0
Kerala,2013,"Other Releases (due to illness,transferred to Mental hospital)",6,0,6
Madhya Pradesh,2013,Released after completion of conviction,3846,89,3935
Madhya Pradesh,2013,Premature release,332,4,336
Madhya Pradesh,2013,Released on appeal,910,22,932
Madhya Pradesh,2013,Released on bail,8798,386,9184
Madhya Pradesh,2013,Pardons,1,0,1
Madhya Pradesh,2013,Transferred to other States,33,0,33
Madhya Pradesh,2013,"Other Releases (due to illness,transferred to Mental hospital)",761,24,785
Maharashtra,2013,Released after completion of conviction,8647,329,8976
Maharashtra,2013,Premature release,687,14,701
Maharashtra,2013,Released on appeal,591,41,632
Maharashtra,2013,Released on bail,1440,82,1522
Maharashtra,2013,Pardons,43,4,47
Maharashtra,2013,Transferred to other States,8,0,8
Maharashtra,2013,"Other Releases (due to illness,transferred to Mental hospital)",3509,267,3776
Manipur,2013,Released after completion of conviction,35,2,37
Manipur,2013,Premature release,0,0,0
Manipur,2013,Released on appeal,0,0,0
Manipur,2013,Released on bail,0,0,0
Manipur,2013,Pardons,0,0,0
Manipur,2013,Transferred to other States,0,0,0
Manipur,2013,"Other Releases (due to illness,transferred to Mental hospital)",0,0,0
Meghalaya,2013,Released after completion of conviction,54,4,58
Meghalaya,2013,Premature release,0,0,0
Meghalaya,2013,Released on appeal,0,0,0
Meghalaya,2013,Released on bail,0,0,0
Meghalaya,2013,Pardons,0,0,0
Meghalaya,2013,Transferred to other States,0,0,0
Meghalaya,2013,"Other Releases (due to illness,transferred to Mental hospital)",0,0,0
Mizoram,2013,Released after completion of conviction,2168,246,2414
Mizoram,2013,Premature release,0,0,0
Mizoram,2013,Released on appeal,18,5,23
Mizoram,2013,Released on bail,12,0,12
Mizoram,2013,Pardons,0,0,0
Mizoram,2013,Transferred to other States,0,0,0
Mizoram,2013,"Other Releases (due to illness,transferred to Mental hospital)",0,0,0
Nagaland,2013,Released after completion of conviction,131,0,131
Nagaland,2013,Premature release,0,0,0
Nagaland,2013,Released on appeal,0,0,0
Nagaland,2013,Released on bail,6,0,6
Nagaland,2013,Pardons,0,0,0
Nagaland,2013,Transferred to other States,1,1,2
Nagaland,2013,"Other Releases (due to illness,transferred to Mental hospital)",10,0,10
Odisha,2013,Released after completion of conviction,860,25,885
Odisha,2013,Premature release,86,0,86
Odisha,2013,Released on appeal,198,13,211
Odisha,2013,Released on bail,874,35,909
Odisha,2013,Pardons,0,0,0
Odisha,2013,Transferred to other States,106,0,106
Odisha,2013,"Other Releases (due to illness,transferred to Mental hospital)",60,1,61
Punjab,2013,Released after completion of conviction,2634,153,2787
Punjab,2013,Premature release,151,6,157
Punjab,2013,Released on appeal,251,20,271
Punjab,2013,Released on bail,2609,230,2839
Punjab,2013,Pardons,0,0,0
Punjab,2013,Transferred to other States,414,13,427
Punjab,2013,"Other Releases (due to illness,transferred to Mental hospital)",109,0,109
Rajasthan,2013,Released after completion of conviction,2358,15,2373
Rajasthan,2013,Premature release,40,0,40
Rajasthan,2013,Released on appeal,577,7,584
Rajasthan,2013,Released on bail,3630,120,3750
Rajasthan,2013,Pardons,41,5,46
Rajasthan,2013,Transferred to other States,22,7,29
Rajasthan,2013,"Other Releases (due to illness,transferred to Mental hospital)",370,10,380
Sikkim,2013,Released after completion of conviction,94,5,99
Sikkim,2013,Premature release,3,0,3
Sikkim,2013,Released on appeal,0,0,0
Sikkim,2013,Released on bail,5,0,5
Sikkim,2013,Pardons,0,0,0
Sikkim,2013,Transferred to other States,2,0,2
Sikkim,2013,"Other Releases (due to illness,transferred to Mental hospital)",0,0,0
Tamil Nadu,2013,Released after completion of conviction,2475,79,2554
Tamil Nadu,2013,Premature release,4,1,5
Tamil Nadu,2013,Released on appeal,647,10,657
Tamil Nadu,2013,Released on bail,959,114,1073
Tamil Nadu,2013,Pardons,0,0,0
Tamil Nadu,2013,Transferred to other States,3,3,6
Tamil Nadu,2013,"Other Releases (due to illness,transferred to Mental hospital)",411,0,411
Tripura,2013,Released after completion of conviction,1450,15,1465
Tripura,2013,Premature release,1,0,1
Tripura,2013,Released on appeal,32,2,34
Tripura,2013,Released on bail,28,2,30
Tripura,2013,Pardons,0,0,0
Tripura,2013,Transferred to other States,1,0,1
Tripura,2013,"Other Releases (due to illness,transferred to Mental hospital)",1,0,1
Uttar Pradesh,2013,Released after completion of conviction,17618,71,17689
Uttar Pradesh,2013,Premature release,361,0,361
Uttar Pradesh,2013,Released on appeal,723,37,760
Uttar Pradesh,2013,Released on bail,10404,453,10857
Uttar Pradesh,2013,Pardons,199,14,213
Uttar Pradesh,2013,Transferred to other States,275,7,282
Uttar Pradesh,2013,"Other Releases (due to illness,transferred to Mental hospital)",194,16,210
Uttarakhand,2013,Released after completion of conviction,1479,12,1491
Uttarakhand,2013,Premature release,7,0,7
Uttarakhand,2013,Released on appeal,31,4,35
Uttarakhand,2013,Released on bail,305,21,326
Uttarakhand,2013,Pardons,0,0,0
Uttarakhand,2013,Transferred to other States,63,0,63
Uttarakhand,2013,"Other Releases (due to illness,transferred to Mental hospital)",0,0,0
West Bengal,2013,Released after completion of conviction,7110,351,7461
West Bengal,2013,Premature release,48,1,49
West Bengal,2013,Released on appeal,60,8,68
West Bengal,2013,Released on bail,1684,106,1790
West Bengal,2013,Pardons,0,0,0
West Bengal,2013,Transferred to other States,56,2,58
West Bengal,2013,"Other Releases (due to illness,transferred to Mental hospital)",684,29,713
Andaman and Nicobar Islands,2013,Released after completion of conviction,87,0,87
Andaman and Nicobar Islands,2013,Premature release,1,0,1
Andaman and Nicobar Islands,2013,Released on appeal,0,0,0
Andaman and Nicobar Islands,2013,Released on bail,0,0,0
Andaman and Nicobar Islands,2013,Pardons,0,0,0
Andaman and Nicobar Islands,2013,Transferred to other States,0,0,0
Andaman and Nicobar Islands,2013,"Other Releases (due to illness,transferred to Mental hospital)",0,0,0
Chandigarh,2013,Released after completion of conviction,48,4,52
Chandigarh,2013,Premature release,2,0,2
Chandigarh,2013,Released on appeal,42,0,42
Chandigarh,2013,Released on bail,218,0,218
Chandigarh,2013,Pardons,0,0,0
Chandigarh,2013,Transferred to other States,6,0,6
Chandigarh,2013,"Other Releases (due to illness,transferred to Mental hospital)",0,0,0
Dadra and Nagar Haveli,2013,Released after completion of conviction,0,0,0
Dadra and Nagar Haveli,2013,Premature release,0,0,0
Dadra and Nagar Haveli,2013,Released on appeal,0,0,0
Dadra and Nagar Haveli,2013,Released on bail,0,0,0
Dadra and Nagar Haveli,2013,Pardons,0,0,0
Dadra and Nagar Haveli,2013,Transferred to other States,0,0,0
Dadra and Nagar Haveli,2013,"Other Releases (due to illness,transferred to Mental hospital)",0,0,0
Daman and Diu,2013,Released after completion of conviction,3,0,3
Daman and Diu,2013,Premature release,0,0,0
Daman and Diu,2013,Released on appeal,0,0,0
Daman and Diu,2013,Released on bail,0,0,0
Daman and Diu,2013,Pardons,0,0,0
Daman and Diu,2013,Transferred to other States,2,0,2
Daman and Diu,2013,"Other Releases (due to illness,transferred to Mental hospital)",0,0,0
Delhi,2013,Released after completion of conviction,4006,85,4091
Delhi,2013,Premature release,290,1,291
Delhi,2013,Released on appeal,79,9,88
Delhi,2013,Released on bail,1034,64,1098
Delhi,2013,Pardons,5,0,5
Delhi,2013,Transferred to other States,19,1,20
Delhi,2013,"Other Releases (due to illness,transferred to Mental hospital)",1196,57,1253
Lakshadweep,2013,Released after completion of conviction,0,0,0
Lakshadweep,2013,Premature release,0,0,0
Lakshadweep,2013,Released on appeal,0,0,0
Lakshadweep,2013,Released on bail,0,0,0
Lakshadweep,2013,Pardons,0,0,0
Lakshadweep,2013,Transferred to other States,0,0,0
Lakshadweep,2013,"Other Releases (due to illness,transferred to Mental hospital)",0,0,0
Puducherry,2013,Released after completion of conviction,172,5,177
Puducherry,2013,Premature release,4,0,4
Puducherry,2013,Released on appeal,0,0,0
Puducherry,2013,Released on bail,3,0,3
Puducherry,2013,Pardons,0,0,0
Puducherry,2013,Transferred to other States,0,0,0
Puducherry,2013,"Other Releases (due to illness,transferred to Mental hospital)",0,0,0
