STATE/UT,YEAR,PERIOD OF DETENTION,Male,Female,Total
ANDHRA PRADESH,2001,Upto 3 months,5545,361,5906
ANDHRA PRADESH,2001,3-6 months,1630,78,1708
ANDHRA PRADESH,2001,6-12 months,823,20,843
ANDHRA PRADESH,2001,1-2 Years,289,21,310
ANDHRA PRADESH,2001,2-3 Years,52,2,54
ANDHRA PRADESH,2001,3-5 Years,21,0,21
ANDHRA PRADESH,2001,Above 5 Years,0,0,0
ANDHRA PRADESH,2001,Total,8360,482,8842
ANDHRA PRADESH,2002,Upto 3 months,5099,445,5544
ANDHRA PRADESH,2002,3-6 months,1607,55,1662
ANDHRA PRADESH,2002,6-12 months,892,35,927
ANDHRA PRADESH,2002,1-2 Years,269,14,283
ANDHRA PRADESH,2002,2-3 Years,101,7,108
ANDHRA PRADESH,2002,3-5 Years,15,1,16
ANDHRA PRADESH,2002,Above 5 Years,9,0,9
ANDHRA PRADESH,2002,Total,7992,557,8549
ANDHRA PRADESH,2003,Upto 3 months,5505,388,5893
ANDHRA PRADESH,2003,3-6 months,1890,99,1989
ANDHRA PRADESH,2003,6-12 months,722,39,761
ANDHRA PRADESH,2003,1-2 Years,226,14,240
ANDHRA PRADESH,2003,2-3 Years,32,1,33
ANDHRA PRADESH,2003,3-5 Years,2,0,2
ANDHRA PRADESH,2003,Above 5 Years,1,0,1
ANDHRA PRADESH,2003,Total,8378,541,8919
ANDHRA PRADESH,2004,Upto 3 months,5915,452,6367
ANDHRA PRADESH,2004,3-6 months,1912,94,2006
ANDHRA PRADESH,2004,6-12 months,472,21,493
ANDHRA PRADESH,2004,1-2 Years,162,10,172
ANDHRA PRADESH,2004,2-3 Years,29,1,30
ANDHRA PRADESH,2004,3-5 Years,9,1,10
ANDHRA PRADESH,2004,Above 5 Years,0,0,0
ANDHRA PRADESH,2004,Total,8499,579,9078
ANDHRA PRADESH,2005,Upto 3 months,5716,562,6278
ANDHRA PRADESH,2005,3-6 months,2361,84,2445
ANDHRA PRADESH,2005,6-12 months,633,29,662
ANDHRA PRADESH,2005,1-2 Years,167,6,173
ANDHRA PRADESH,2005,2-3 Years,29,3,32
ANDHRA PRADESH,2005,3-5 Years,0,2,2
ANDHRA PRADESH,2005,Above 5 Years,0,0,0
ANDHRA PRADESH,2005,Total,8906,686,9592
ANDHRA PRADESH,2006,Upto 3 months,6705,519,7224
ANDHRA PRADESH,2006,3-6 months,1929,105,2034
ANDHRA PRADESH,2006,6-12 months,590,11,601
ANDHRA PRADESH,2006,1-2 Years,174,2,176
ANDHRA PRADESH,2006,2-3 Years,39,0,39
ANDHRA PRADESH,2006,3-5 Years,7,0,7
ANDHRA PRADESH,2006,Above 5 Years,1,0,1
ANDHRA PRADESH,2006,Total,9445,637,10082
ANDHRA PRADESH,2007,Upto 3 months,6082,462,6544
ANDHRA PRADESH,2007,3-6 months,1868,133,2001
ANDHRA PRADESH,2007,6-12 months,654,35,689
ANDHRA PRADESH,2007,1-2 Years,157,5,162
ANDHRA PRADESH,2007,2-3 Years,35,0,35
ANDHRA PRADESH,2007,3-5 Years,14,0,14
ANDHRA PRADESH,2007,Above 5 Years,0,0,0
ANDHRA PRADESH,2007,Total,8810,635,9445
ANDHRA PRADESH,2008,Upto 3 months,5632,487,6119
ANDHRA PRADESH,2008,3-6 months,1558,117,1675
ANDHRA PRADESH,2008,6-12 months,603,28,631
ANDHRA PRADESH,2008,1-2 Years,178,17,195
ANDHRA PRADESH,2008,2-3 Years,36,2,38
ANDHRA PRADESH,2008,3-5 Years,11,0,11
ANDHRA PRADESH,2008,Above 5 Years,0,0,0
ANDHRA PRADESH,2008,Total,8018,651,8669
ANDHRA PRADESH,2009,Upto 3 months,5391,483,5874
ANDHRA PRADESH,2009,3-6 months,1494,64,1558
ANDHRA PRADESH,2009,6-12 months,541,20,561
ANDHRA PRADESH,2009,1-2 Years,168,7,175
ANDHRA PRADESH,2009,2-3 Years,24,3,27
ANDHRA PRADESH,2009,3-5 Years,22,0,22
ANDHRA PRADESH,2009,Above 5 Years,0,0,0
ANDHRA PRADESH,2009,Total,7640,577,8217
ANDHRA PRADESH,2010,Upto 3 months,4645,458,5103
ANDHRA PRADESH,2010,3-6 months,1844,67,1911
ANDHRA PRADESH,2010,6-12 months,506,12,518
ANDHRA PRADESH,2010,1-2 Years,87,8,95
ANDHRA PRADESH,2010,2-3 Years,12,0,12
ANDHRA PRADESH,2010,3-5 Years,5,1,6
ANDHRA PRADESH,2010,Above 5 Years,4,0,4
ANDHRA PRADESH,2010,Total,7103,546,7649
ANDHRA PRADESH,2011,Upto 3 months,7357,559,7916
ANDHRA PRADESH,2011,3-6 months,405,10,415
ANDHRA PRADESH,2011,6-12 months,159,6,165
ANDHRA PRADESH,2011,1-2 Years,31,4,35
ANDHRA PRADESH,2011,2-3 Years,7,1,8
ANDHRA PRADESH,2011,3-5 Years,3,0,3
ANDHRA PRADESH,2011,Above 5 Years,2,0,2
ANDHRA PRADESH,2011,Total,7964,580,8544
ANDHRA PRADESH,2012,Upto 3 months,7307,594,7901
ANDHRA PRADESH,2012,3-6 months,405,32,437
ANDHRA PRADESH,2012,6-12 months,159,6,165
ANDHRA PRADESH,2012,1-2 Years,31,4,35
ANDHRA PRADESH,2012,2-3 Years,7,1,8
ANDHRA PRADESH,2012,3-5 Years,3,0,3
ANDHRA PRADESH,2012,Above 5 Years,2,0,2
ANDHRA PRADESH,2012,Total,7914,637,8551
ARUNACHAL PRADESH,2009,Upto 3 months,26,2,28
ARUNACHAL PRADESH,2009,3-6 months,13,1,14
ARUNACHAL PRADESH,2009,6-12 months,13,0,13
ARUNACHAL PRADESH,2009,1-2 Years,4,1,5
ARUNACHAL PRADESH,2009,2-3 Years,0,0,0
ARUNACHAL PRADESH,2009,3-5 Years,0,0,0
ARUNACHAL PRADESH,2009,Above 5 Years,0,0,0
ARUNACHAL PRADESH,2009,Total,56,4,60
ARUNACHAL PRADESH,2010,Upto 3 months,20,2,22
ARUNACHAL PRADESH,2010,3-6 months,9,0,9
ARUNACHAL PRADESH,2010,6-12 months,13,0,13
ARUNACHAL PRADESH,2010,1-2 Years,4,2,6
ARUNACHAL PRADESH,2010,2-3 Years,2,0,2
ARUNACHAL PRADESH,2010,3-5 Years,0,0,0
ARUNACHAL PRADESH,2010,Above 5 Years,0,0,0
ARUNACHAL PRADESH,2010,Total,48,4,52
ARUNACHAL PRADESH,2011,Upto 3 months,16,0,16
ARUNACHAL PRADESH,2011,3-6 months,12,0,12
ARUNACHAL PRADESH,2011,6-12 months,4,2,6
ARUNACHAL PRADESH,2011,1-2 Years,8,1,9
ARUNACHAL PRADESH,2011,2-3 Years,3,2,5
ARUNACHAL PRADESH,2011,3-5 Years,1,0,1
ARUNACHAL PRADESH,2011,Above 5 Years,0,0,0
ARUNACHAL PRADESH,2011,Total,44,5,49
ARUNACHAL PRADESH,2012,Upto 3 months,30,0,30
ARUNACHAL PRADESH,2012,3-6 months,13,0,13
ARUNACHAL PRADESH,2012,6-12 months,12,1,13
ARUNACHAL PRADESH,2012,1-2 Years,5,1,6
ARUNACHAL PRADESH,2012,2-3 Years,2,1,3
ARUNACHAL PRADESH,2012,3-5 Years,1,1,2
ARUNACHAL PRADESH,2012,Above 5 Years,0,0,0
ARUNACHAL PRADESH,2012,Total,63,4,67
ASSAM,2001,Upto 3 months,2606,93,2699
ASSAM,2001,3-6 months,620,16,636
ASSAM,2001,6-12 months,406,6,412
ASSAM,2001,1-2 Years,217,9,226
ASSAM,2001,2-3 Years,52,2,54
ASSAM,2001,3-5 Years,32,1,33
ASSAM,2001,Above 5 Years,5,0,5
ASSAM,2001,Total,3938,127,4065
ASSAM,2002,Upto 3 months,2706,64,2770
ASSAM,2002,3-6 months,641,16,657
ASSAM,2002,6-12 months,397,16,413
ASSAM,2002,1-2 Years,314,16,330
ASSAM,2002,2-3 Years,91,1,92
ASSAM,2002,3-5 Years,48,0,48
ASSAM,2002,Above 5 Years,9,0,9
ASSAM,2002,Total,4206,113,4319
ASSAM,2003,Upto 3 months,3048,102,3150
ASSAM,2003,3-6 months,543,16,559
ASSAM,2003,6-12 months,358,13,371
ASSAM,2003,1-2 Years,255,5,260
ASSAM,2003,2-3 Years,123,0,123
ASSAM,2003,3-5 Years,51,1,52
ASSAM,2003,Above 5 Years,8,0,8
ASSAM,2003,Total,4386,137,4523
ASSAM,2004,Upto 3 months,2749,70,2819
ASSAM,2004,3-6 months,532,29,561
ASSAM,2004,6-12 months,525,21,546
ASSAM,2004,1-2 Years,206,13,219
ASSAM,2004,2-3 Years,86,1,87
ASSAM,2004,3-5 Years,64,0,64
ASSAM,2004,Above 5 Years,2,0,2
ASSAM,2004,Total,4164,134,4298
ASSAM,2005,Upto 3 months,3165,76,3241
ASSAM,2005,3-6 months,600,19,619
ASSAM,2005,6-12 months,540,12,552
ASSAM,2005,1-2 Years,424,16,440
ASSAM,2005,2-3 Years,82,10,92
ASSAM,2005,3-5 Years,37,0,37
ASSAM,2005,Above 5 Years,19,0,19
ASSAM,2005,Total,4867,133,5000
ASSAM,2006,Upto 3 months,3097,99,3196
ASSAM,2006,3-6 months,782,33,815
ASSAM,2006,6-12 months,442,11,453
ASSAM,2006,1-2 Years,283,12,295
ASSAM,2006,2-3 Years,119,1,120
ASSAM,2006,3-5 Years,50,3,53
ASSAM,2006,Above 5 Years,28,0,28
ASSAM,2006,Total,4801,159,4960
ASSAM,2007,Upto 3 months,2932,72,3004
ASSAM,2007,3-6 months,852,32,884
ASSAM,2007,6-12 months,594,20,614
ASSAM,2007,1-2 Years,323,14,337
ASSAM,2007,2-3 Years,138,6,144
ASSAM,2007,3-5 Years,71,2,73
ASSAM,2007,Above 5 Years,34,0,34
ASSAM,2007,Total,4944,146,5090
ASSAM,2008,Upto 3 months,3122,115,3237
ASSAM,2008,3-6 months,647,35,682
ASSAM,2008,6-12 months,539,25,564
ASSAM,2008,1-2 Years,377,16,393
ASSAM,2008,2-3 Years,214,15,229
ASSAM,2008,3-5 Years,85,9,94
ASSAM,2008,Above 5 Years,39,0,39
ASSAM,2008,Total,5023,215,5238
ASSAM,2009,Upto 3 months,2960,110,3070
ASSAM,2009,3-6 months,692,32,724
ASSAM,2009,6-12 months,469,25,494
ASSAM,2009,1-2 Years,328,18,346
ASSAM,2009,2-3 Years,85,12,97
ASSAM,2009,3-5 Years,56,8,64
ASSAM,2009,Above 5 Years,29,0,29
ASSAM,2009,Total,4619,205,4824
ASSAM,2010,Upto 3 months,2995,93,3088
ASSAM,2010,3-6 months,681,24,705
ASSAM,2010,6-12 months,336,31,367
ASSAM,2010,1-2 Years,240,20,260
ASSAM,2010,2-3 Years,138,7,145
ASSAM,2010,3-5 Years,63,0,63
ASSAM,2010,Above 5 Years,27,0,27
ASSAM,2010,Total,4480,175,4655
ASSAM,2011,Upto 3 months,3174,112,3286
ASSAM,2011,3-6 months,731,30,761
ASSAM,2011,6-12 months,386,33,419
ASSAM,2011,1-2 Years,260,24,284
ASSAM,2011,2-3 Years,158,8,166
ASSAM,2011,3-5 Years,93,0,93
ASSAM,2011,Above 5 Years,57,0,57
ASSAM,2011,Total,4859,207,5066
ASSAM,2012,Upto 3 months,3245,113,3358
ASSAM,2012,3-6 months,741,21,762
ASSAM,2012,6-12 months,392,22,414
ASSAM,2012,1-2 Years,250,20,270
ASSAM,2012,2-3 Years,156,7,163
ASSAM,2012,3-5 Years,92,0,92
ASSAM,2012,Above 5 Years,39,0,39
ASSAM,2012,Total,4915,183,5098
BIHAR,2001,Upto 3 months,9084,228,9312
BIHAR,2001,3-6 months,4805,147,4952
BIHAR,2001,6-12 months,7745,210,7955
BIHAR,2001,1-2 Years,4546,125,4671
BIHAR,2001,2-3 Years,2338,53,2391
BIHAR,2001,3-5 Years,1017,19,1036
BIHAR,2001,Above 5 Years,465,11,476
BIHAR,2001,Total,30000,793,30793
BIHAR,2002,Upto 3 months,9802,327,10129
BIHAR,2002,3-6 months,6826,233,7059
BIHAR,2002,6-12 months,6775,183,6958
BIHAR,2002,1-2 Years,4142,115,4257
BIHAR,2002,2-3 Years,2326,47,2373
BIHAR,2002,3-5 Years,1040,36,1076
BIHAR,2002,Above 5 Years,248,1,249
BIHAR,2002,Total,31159,942,32101
BIHAR,2003,Upto 3 months,9633,331,9964
BIHAR,2003,3-6 months,7497,255,7752
BIHAR,2003,6-12 months,6379,175,6554
BIHAR,2003,1-2 Years,3935,108,4043
BIHAR,2003,2-3 Years,2121,46,2167
BIHAR,2003,3-5 Years,1120,23,1143
BIHAR,2003,Above 5 Years,504,7,511
BIHAR,2003,Total,31189,945,32134
BIHAR,2004,Upto 3 months,6322,268,6590
BIHAR,2004,3-6 months,5352,175,5527
BIHAR,2004,6-12 months,5500,149,5649
BIHAR,2004,1-2 Years,5634,72,5706
BIHAR,2004,2-3 Years,2187,45,2232
BIHAR,2004,3-5 Years,1024,19,1043
BIHAR,2004,Above 5 Years,613,15,628
BIHAR,2004,Total,26632,743,27375
BIHAR,2005,Upto 3 months,8000,300,8300
BIHAR,2005,3-6 months,9500,304,9804
BIHAR,2005,6-12 months,10510,312,10822
BIHAR,2005,1-2 Years,5545,158,5703
BIHAR,2005,2-3 Years,3019,87,3106
BIHAR,2005,3-5 Years,1700,20,1720
BIHAR,2005,Above 5 Years,547,17,564
BIHAR,2005,Total,38821,1198,40019
BIHAR,2006,Upto 3 months,10342,362,10704
BIHAR,2006,3-6 months,9301,356,9657
BIHAR,2006,6-12 months,7795,281,8076
BIHAR,2006,1-2 Years,4593,165,4758
BIHAR,2006,2-3 Years,2492,73,2565
BIHAR,2006,3-5 Years,1232,27,1259
BIHAR,2006,Above 5 Years,351,5,356
BIHAR,2006,Total,36106,1269,37375
BIHAR,2007,Upto 3 months,8311,316,8627
BIHAR,2007,3-6 months,6233,263,6496
BIHAR,2007,6-12 months,9126,315,9441
BIHAR,2007,1-2 Years,4649,181,4830
BIHAR,2007,2-3 Years,2485,51,2536
BIHAR,2007,3-5 Years,1147,26,1173
BIHAR,2007,Above 5 Years,209,4,213
BIHAR,2007,Total,32160,1156,33316
BIHAR,2008,Upto 3 months,6231,267,6498
BIHAR,2008,3-6 months,7662,290,7952
BIHAR,2008,6-12 months,8626,318,8944
BIHAR,2008,1-2 Years,4370,137,4507
BIHAR,2008,2-3 Years,2278,54,2332
BIHAR,2008,3-5 Years,883,21,904
BIHAR,2008,Above 5 Years,499,11,510
BIHAR,2008,Total,30549,1098,31647
BIHAR,2009,Upto 3 months,5521,224,5745
BIHAR,2009,3-6 months,6913,238,7151
BIHAR,2009,6-12 months,7520,269,7789
BIHAR,2009,1-2 Years,4016,122,4138
BIHAR,2009,2-3 Years,2098,46,2144
BIHAR,2009,3-5 Years,736,13,749
BIHAR,2009,Above 5 Years,442,5,447
BIHAR,2009,Total,27246,917,28163
BIHAR,2010,Upto 3 months,4872,189,5061
BIHAR,2010,3-6 months,6084,223,6307
BIHAR,2010,6-12 months,6163,178,6341
BIHAR,2010,1-2 Years,3570,109,3679
BIHAR,2010,2-3 Years,1879,50,1929
BIHAR,2010,3-5 Years,680,17,697
BIHAR,2010,Above 5 Years,341,7,348
BIHAR,2010,Total,23589,773,24362
BIHAR,2011,Upto 3 months,7021,273,7294
BIHAR,2011,3-6 months,5276,182,5458
BIHAR,2011,6-12 months,4880,208,5088
BIHAR,2011,1-2 Years,2894,81,2975
BIHAR,2011,2-3 Years,1489,31,1520
BIHAR,2011,3-5 Years,816,14,830
BIHAR,2011,Above 5 Years,246,6,252
BIHAR,2011,Total,22622,795,23417
BIHAR,2012,Upto 3 months,7131,301,7432
BIHAR,2012,3-6 months,5758,217,5975
BIHAR,2012,6-12 months,5210,166,5376
BIHAR,2012,1-2 Years,2876,84,2960
BIHAR,2012,2-3 Years,1532,39,1571
BIHAR,2012,3-5 Years,812,14,826
BIHAR,2012,Above 5 Years,244,5,249
BIHAR,2012,Total,23563,826,24389
CHHATTISGARH,2012,Upto 3 months,2657,101,2758
CHHATTISGARH,2012,3-6 months,1611,96,1707
CHHATTISGARH,2012,6-12 months,1735,121,1856
CHHATTISGARH,2012,1-2 Years,1490,78,1568
CHHATTISGARH,2012,2-3 Years,601,45,646
CHHATTISGARH,2012,3-5 Years,226,9,235
CHHATTISGARH,2012,Above 5 Years,24,5,29
CHHATTISGARH,2012,Total,8344,455,8799
CHHATTISGARH,2001,Upto 3 months,1821,59,1880
CHHATTISGARH,2001,3-6 months,1308,61,1369
CHHATTISGARH,2001,6-12 months,1077,46,1123
CHHATTISGARH,2001,1-2 Years,440,34,474
CHHATTISGARH,2001,2-3 Years,51,4,55
CHHATTISGARH,2001,3-5 Years,16,0,16
CHHATTISGARH,2001,Above 5 Years,4,0,4
CHHATTISGARH,2001,Total,4717,204,4921
CHHATTISGARH,2002,Upto 3 months,1877,83,1960
CHHATTISGARH,2002,3-6 months,1070,62,1132
CHHATTISGARH,2002,6-12 months,1143,55,1198
CHHATTISGARH,2002,1-2 Years,548,20,568
CHHATTISGARH,2002,2-3 Years,77,4,81
CHHATTISGARH,2002,3-5 Years,15,1,16
CHHATTISGARH,2002,Above 5 Years,6,0,6
CHHATTISGARH,2002,Total,4736,225,4961
CHHATTISGARH,2003,Upto 3 months,1729,74,1803
CHHATTISGARH,2003,3-6 months,1174,56,1230
CHHATTISGARH,2003,6-12 months,657,17,674
CHHATTISGARH,2003,1-2 Years,327,8,335
CHHATTISGARH,2003,2-3 Years,60,5,65
CHHATTISGARH,2003,3-5 Years,19,0,19
CHHATTISGARH,2003,Above 5 Years,2,0,2
CHHATTISGARH,2003,Total,3968,160,4128
CHHATTISGARH,2004,Upto 3 months,1573,79,1652
CHHATTISGARH,2004,3-6 months,982,54,1036
CHHATTISGARH,2004,6-12 months,974,41,1015
CHHATTISGARH,2004,1-2 Years,412,14,426
CHHATTISGARH,2004,2-3 Years,95,3,98
CHHATTISGARH,2004,3-5 Years,79,3,82
CHHATTISGARH,2004,Above 5 Years,28,0,28
CHHATTISGARH,2004,Total,4143,194,4337
CHHATTISGARH,2005,Upto 3 months,2411,101,2512
CHHATTISGARH,2005,3-6 months,1497,67,1564
CHHATTISGARH,2005,6-12 months,903,38,941
CHHATTISGARH,2005,1-2 Years,406,24,430
CHHATTISGARH,2005,2-3 Years,50,2,52
CHHATTISGARH,2005,3-5 Years,8,0,8
CHHATTISGARH,2005,Above 5 Years,2,0,2
CHHATTISGARH,2005,Total,5277,232,5509
CHHATTISGARH,2006,Upto 3 months,2234,123,2357
CHHATTISGARH,2006,3-6 months,1536,79,1615
CHHATTISGARH,2006,6-12 months,1220,47,1267
CHHATTISGARH,2006,1-2 Years,681,31,712
CHHATTISGARH,2006,2-3 Years,87,3,90
CHHATTISGARH,2006,3-5 Years,23,1,24
CHHATTISGARH,2006,Above 5 Years,8,0,8
CHHATTISGARH,2006,Total,5789,284,6073
CHHATTISGARH,2007,Upto 3 months,2071,65,2136
CHHATTISGARH,2007,3-6 months,1663,66,1729
CHHATTISGARH,2007,6-12 months,1134,59,1193
CHHATTISGARH,2007,1-2 Years,595,51,646
CHHATTISGARH,2007,2-3 Years,155,10,165
CHHATTISGARH,2007,3-5 Years,24,2,26
CHHATTISGARH,2007,Above 5 Years,4,0,4
CHHATTISGARH,2007,Total,5646,253,5899
CHHATTISGARH,2008,Upto 3 months,2261,115,2376
CHHATTISGARH,2008,3-6 months,1622,58,1680
CHHATTISGARH,2008,6-12 months,1450,70,1520
CHHATTISGARH,2008,1-2 Years,595,27,622
CHHATTISGARH,2008,2-3 Years,183,31,214
CHHATTISGARH,2008,3-5 Years,39,1,40
CHHATTISGARH,2008,Above 5 Years,5,0,5
CHHATTISGARH,2008,Total,6155,302,6457
CHHATTISGARH,2009,Upto 3 months,2269,81,2350
CHHATTISGARH,2009,3-6 months,2069,133,2202
CHHATTISGARH,2009,6-12 months,1742,95,1837
CHHATTISGARH,2009,1-2 Years,640,40,680
CHHATTISGARH,2009,2-3 Years,137,6,143
CHHATTISGARH,2009,3-5 Years,52,4,56
CHHATTISGARH,2009,Above 5 Years,1,0,1
CHHATTISGARH,2009,Total,6910,359,7269
CHHATTISGARH,2010,Upto 3 months,2222,110,2332
CHHATTISGARH,2010,3-6 months,1533,99,1632
CHHATTISGARH,2010,6-12 months,1679,61,1740
CHHATTISGARH,2010,1-2 Years,1454,82,1536
CHHATTISGARH,2010,2-3 Years,348,19,367
CHHATTISGARH,2010,3-5 Years,84,4,88
CHHATTISGARH,2010,Above 5 Years,4,0,4
CHHATTISGARH,2010,Total,7324,375,7699
CHHATTISGARH,2011,Upto 3 months,2542,118,2660
CHHATTISGARH,2011,3-6 months,1538,83,1621
CHHATTISGARH,2011,6-12 months,1825,78,1903
CHHATTISGARH,2011,1-2 Years,1314,59,1373
CHHATTISGARH,2011,2-3 Years,439,36,475
CHHATTISGARH,2011,3-5 Years,219,13,232
CHHATTISGARH,2011,Above 5 Years,6,5,11
CHHATTISGARH,2011,Total,7883,392,8275
GOA,2001,Upto 3 months,92,3,95
GOA,2001,3-6 months,87,1,88
GOA,2001,6-12 months,58,0,58
GOA,2001,1-2 Years,33,3,36
GOA,2001,2-3 Years,17,0,17
GOA,2001,3-5 Years,0,0,0
GOA,2001,Above 5 Years,0,0,0
GOA,2001,Total,287,7,294
GOA,2002,Upto 3 months,45,0,45
GOA,2002,3-6 months,34,2,36
GOA,2002,6-12 months,28,3,31
GOA,2002,1-2 Years,41,0,41
GOA,2002,2-3 Years,42,0,42
GOA,2002,3-5 Years,8,0,8
GOA,2002,Above 5 Years,0,0,0
GOA,2002,Total,198,5,203
GOA,2003,Upto 3 months,191,3,194
GOA,2003,3-6 months,73,3,76
GOA,2003,6-12 months,61,2,63
GOA,2003,1-2 Years,39,1,40
GOA,2003,2-3 Years,10,0,10
GOA,2003,3-5 Years,5,0,5
GOA,2003,Above 5 Years,0,0,0
GOA,2003,Total,379,9,388
GOA,2004,Upto 3 months,74,0,74
GOA,2004,3-6 months,60,0,60
GOA,2004,6-12 months,75,6,81
GOA,2004,1-2 Years,32,3,35
GOA,2004,2-3 Years,20,0,20
GOA,2004,3-5 Years,7,0,7
GOA,2004,Above 5 Years,0,0,0
GOA,2004,Total,268,9,277
GOA,2005,Upto 3 months,94,2,96
GOA,2005,3-6 months,47,13,60
GOA,2005,6-12 months,43,1,44
GOA,2005,1-2 Years,31,1,32
GOA,2005,2-3 Years,14,0,14
GOA,2005,3-5 Years,0,0,0
GOA,2005,Above 5 Years,0,0,0
GOA,2005,Total,229,17,246
GOA,2006,Upto 3 months,33,4,37
GOA,2006,3-6 months,35,10,45
GOA,2006,6-12 months,92,2,94
GOA,2006,1-2 Years,51,1,52
GOA,2006,2-3 Years,6,1,7
GOA,2006,3-5 Years,1,0,1
GOA,2006,Above 5 Years,0,0,0
GOA,2006,Total,218,18,236
GOA,2007,Upto 3 months,56,6,62
GOA,2007,3-6 months,56,8,64
GOA,2007,6-12 months,40,3,43
GOA,2007,1-2 Years,35,1,36
GOA,2007,2-3 Years,14,0,14
GOA,2007,3-5 Years,0,0,0
GOA,2007,Above 5 Years,0,0,0
GOA,2007,Total,201,18,219
GOA,2008,Upto 3 months,79,4,83
GOA,2008,3-6 months,67,8,75
GOA,2008,6-12 months,46,2,48
GOA,2008,1-2 Years,45,2,47
GOA,2008,2-3 Years,0,0,0
GOA,2008,3-5 Years,0,0,0
GOA,2008,Above 5 Years,0,0,0
GOA,2008,Total,237,16,253
GOA,2009,Upto 3 months,76,1,77
GOA,2009,3-6 months,44,1,45
GOA,2009,6-12 months,63,18,81
GOA,2009,1-2 Years,26,2,28
GOA,2009,2-3 Years,7,2,9
GOA,2009,3-5 Years,4,0,4
GOA,2009,Above 5 Years,0,0,0
GOA,2009,Total,220,24,244
GOA,2010,Upto 3 months,88,2,90
GOA,2010,3-6 months,72,2,74
GOA,2010,6-12 months,55,18,73
GOA,2010,1-2 Years,23,2,25
GOA,2010,2-3 Years,10,2,12
GOA,2010,3-5 Years,4,0,4
GOA,2010,Above 5 Years,0,1,1
GOA,2010,Total,252,27,279
GOA,2011,Upto 3 months,48,2,50
GOA,2011,3-6 months,55,4,59
GOA,2011,6-12 months,76,11,87
GOA,2011,1-2 Years,74,7,81
GOA,2011,2-3 Years,41,3,44
GOA,2011,3-5 Years,18,1,19
GOA,2011,Above 5 Years,5,0,5
GOA,2011,Total,317,28,345
GOA,2012,Upto 3 months,38,2,40
GOA,2012,3-6 months,61,5,66
GOA,2012,6-12 months,84,8,92
GOA,2012,1-2 Years,74,6,80
GOA,2012,2-3 Years,33,2,35
GOA,2012,3-5 Years,18,1,19
GOA,2012,Above 5 Years,4,0,4
GOA,2012,Total,312,24,336
GUJARAT,2001,Upto 3 months,1532,44,1576
GUJARAT,2001,3-6 months,1249,46,1295
GUJARAT,2001,6-12 months,1091,27,1118
GUJARAT,2001,1-2 Years,840,17,857
GUJARAT,2001,2-3 Years,453,5,458
GUJARAT,2001,3-5 Years,199,0,199
GUJARAT,2001,Above 5 Years,54,0,54
GUJARAT,2001,Total,5418,139,5557
GUJARAT,2002,Upto 3 months,1677,80,1757
GUJARAT,2002,3-6 months,1508,41,1549
GUJARAT,2002,6-12 months,1284,42,1326
GUJARAT,2002,1-2 Years,1047,17,1064
GUJARAT,2002,2-3 Years,566,3,569
GUJARAT,2002,3-5 Years,69,4,73
GUJARAT,2002,Above 5 Years,31,0,31
GUJARAT,2002,Total,6182,187,6369
GUJARAT,2003,Upto 3 months,2102,98,2200
GUJARAT,2003,3-6 months,1407,58,1465
GUJARAT,2003,6-12 months,1146,49,1195
GUJARAT,2003,1-2 Years,950,18,968
GUJARAT,2003,2-3 Years,405,7,412
GUJARAT,2003,3-5 Years,137,3,140
GUJARAT,2003,Above 5 Years,40,1,41
GUJARAT,2003,Total,6187,234,6421
GUJARAT,2004,Upto 3 months,2236,129,2365
GUJARAT,2004,3-6 months,1380,89,1469
GUJARAT,2004,6-12 months,1417,40,1457
GUJARAT,2004,1-2 Years,1104,27,1131
GUJARAT,2004,2-3 Years,503,6,509
GUJARAT,2004,3-5 Years,194,5,199
GUJARAT,2004,Above 5 Years,71,1,72
GUJARAT,2004,Total,6905,297,7202
GUJARAT,2005,Upto 3 months,2106,120,2226
GUJARAT,2005,3-6 months,1252,62,1314
GUJARAT,2005,6-12 months,1335,37,1372
GUJARAT,2005,1-2 Years,930,19,949
GUJARAT,2005,2-3 Years,320,3,323
GUJARAT,2005,3-5 Years,204,4,208
GUJARAT,2005,Above 5 Years,58,1,59
GUJARAT,2005,Total,6205,246,6451
GUJARAT,2006,Upto 3 months,2328,157,2485
GUJARAT,2006,3-6 months,1285,63,1348
GUJARAT,2006,6-12 months,1177,41,1218
GUJARAT,2006,1-2 Years,764,16,780
GUJARAT,2006,2-3 Years,323,9,332
GUJARAT,2006,3-5 Years,168,2,170
GUJARAT,2006,Above 5 Years,53,1,54
GUJARAT,2006,Total,6098,289,6387
GUJARAT,2007,Upto 3 months,1936,126,2062
GUJARAT,2007,3-6 months,1213,61,1274
GUJARAT,2007,6-12 months,1127,71,1198
GUJARAT,2007,1-2 Years,710,31,741
GUJARAT,2007,2-3 Years,246,8,254
GUJARAT,2007,3-5 Years,228,0,228
GUJARAT,2007,Above 5 Years,129,0,129
GUJARAT,2007,Total,5589,297,5886
GUJARAT,2008,Upto 3 months,2332,108,2440
GUJARAT,2008,3-6 months,1513,91,1604
GUJARAT,2008,6-12 months,1461,50,1511
GUJARAT,2008,1-2 Years,914,23,937
GUJARAT,2008,2-3 Years,293,13,306
GUJARAT,2008,3-5 Years,118,5,123
GUJARAT,2008,Above 5 Years,49,1,50
GUJARAT,2008,Total,6680,291,6971
GUJARAT,2009,Upto 3 months,2244,122,2366
GUJARAT,2009,3-6 months,1744,77,1821
GUJARAT,2009,6-12 months,1329,65,1394
GUJARAT,2009,1-2 Years,945,55,1000
GUJARAT,2009,2-3 Years,312,16,328
GUJARAT,2009,3-5 Years,157,5,162
GUJARAT,2009,Above 5 Years,134,1,135
GUJARAT,2009,Total,6865,341,7206
GUJARAT,2010,Upto 3 months,2082,136,2218
GUJARAT,2010,3-6 months,1463,62,1525
GUJARAT,2010,6-12 months,1254,66,1320
GUJARAT,2010,1-2 Years,985,53,1038
GUJARAT,2010,2-3 Years,443,25,468
GUJARAT,2010,3-5 Years,208,8,216
GUJARAT,2010,Above 5 Years,124,1,125
GUJARAT,2010,Total,6559,351,6910
GUJARAT,2011,Upto 3 months,1367,77,1444
GUJARAT,2011,3-6 months,1924,98,2022
GUJARAT,2011,6-12 months,1085,61,1146
GUJARAT,2011,1-2 Years,1084,60,1144
GUJARAT,2011,2-3 Years,508,15,523
GUJARAT,2011,3-5 Years,358,15,373
GUJARAT,2011,Above 5 Years,42,2,44
GUJARAT,2011,Total,6368,328,6696
GUJARAT,2012,Upto 3 months,1130,69,1199
GUJARAT,2012,3-6 months,1596,72,1668
GUJARAT,2012,6-12 months,1353,80,1433
GUJARAT,2012,1-2 Years,1220,53,1273
GUJARAT,2012,2-3 Years,642,34,676
GUJARAT,2012,3-5 Years,291,17,308
GUJARAT,2012,Above 5 Years,54,2,56
GUJARAT,2012,Total,6286,327,6613
HARYANA,2001,Upto 3 months,3094,119,3213
HARYANA,2001,3-6 months,2069,96,2165
HARYANA,2001,6-12 months,1393,52,1445
HARYANA,2001,1-2 Years,907,39,946
HARYANA,2001,2-3 Years,342,13,355
HARYANA,2001,3-5 Years,81,4,85
HARYANA,2001,Above 5 Years,3,0,3
HARYANA,2001,Total,7889,323,8212
HARYANA,2002,Upto 3 months,2475,101,2576
HARYANA,2002,3-6 months,1668,75,1743
HARYANA,2002,6-12 months,1734,89,1823
HARYANA,2002,1-2 Years,1167,36,1203
HARYANA,2002,2-3 Years,276,15,291
HARYANA,2002,3-5 Years,76,5,81
HARYANA,2002,Above 5 Years,0,0,0
HARYANA,2002,Total,7396,321,7717
HARYANA,2003,Upto 3 months,2159,100,2259
HARYANA,2003,3-6 months,1863,99,1962
HARYANA,2003,6-12 months,1600,74,1674
HARYANA,2003,1-2 Years,1010,47,1057
HARYANA,2003,2-3 Years,457,16,473
HARYANA,2003,3-5 Years,70,1,71
HARYANA,2003,Above 5 Years,8,0,8
HARYANA,2003,Total,7167,337,7504
HARYANA,2004,Upto 3 months,2453,97,2550
HARYANA,2004,3-6 months,1533,49,1582
HARYANA,2004,6-12 months,1776,108,1884
HARYANA,2004,1-2 Years,844,40,884
HARYANA,2004,2-3 Years,320,11,331
HARYANA,2004,3-5 Years,145,1,146
HARYANA,2004,Above 5 Years,19,0,19
HARYANA,2004,Total,7090,306,7396
HARYANA,2005,Upto 3 months,2137,85,2222
HARYANA,2005,3-6 months,1643,77,1720
HARYANA,2005,6-12 months,1853,73,1926
HARYANA,2005,1-2 Years,1183,58,1241
HARYANA,2005,2-3 Years,292,20,312
HARYANA,2005,3-5 Years,154,13,167
HARYANA,2005,Above 5 Years,129,0,129
HARYANA,2005,Total,7391,326,7717
HARYANA,2006,Upto 3 months,2597,133,2730
HARYANA,2006,3-6 months,1788,87,1875
HARYANA,2006,6-12 months,1672,61,1733
HARYANA,2006,1-2 Years,867,33,900
HARYANA,2006,2-3 Years,284,15,299
HARYANA,2006,3-5 Years,145,4,149
HARYANA,2006,Above 5 Years,0,0,0
HARYANA,2006,Total,7353,333,7686
HARYANA,2007,Upto 3 months,2395,99,2494
HARYANA,2007,3-6 months,1760,80,1840
HARYANA,2007,6-12 months,1908,88,1996
HARYANA,2007,1-2 Years,1093,66,1159
HARYANA,2007,2-3 Years,441,21,462
HARYANA,2007,3-5 Years,155,6,161
HARYANA,2007,Above 5 Years,5,0,5
HARYANA,2007,Total,7757,360,8117
HARYANA,2008,Upto 3 months,2350,136,2486
HARYANA,2008,3-6 months,2512,131,2643
HARYANA,2008,6-12 months,2025,85,2110
HARYANA,2008,1-2 Years,1076,41,1117
HARYANA,2008,2-3 Years,243,9,252
HARYANA,2008,3-5 Years,51,0,51
HARYANA,2008,Above 5 Years,3,0,3
HARYANA,2008,Total,8260,402,8662
HARYANA,2009,Upto 3 months,2465,103,2568
HARYANA,2009,3-6 months,1827,112,1939
HARYANA,2009,6-12 months,1909,99,2008
HARYANA,2009,1-2 Years,1109,38,1147
HARYANA,2009,2-3 Years,311,2,313
HARYANA,2009,3-5 Years,64,0,64
HARYANA,2009,Above 5 Years,2,0,2
HARYANA,2009,Total,7687,354,8041
HARYANA,2010,Upto 3 months,2865,120,2985
HARYANA,2010,3-6 months,1874,96,1970
HARYANA,2010,6-12 months,1583,74,1657
HARYANA,2010,1-2 Years,1000,55,1055
HARYANA,2010,2-3 Years,273,5,278
HARYANA,2010,3-5 Years,57,0,57
HARYANA,2010,Above 5 Years,6,0,6
HARYANA,2010,Total,7658,350,8008
HARYANA,2011,Upto 3 months,2923,108,3031
HARYANA,2011,3-6 months,2148,101,2249
HARYANA,2011,6-12 months,1642,87,1729
HARYANA,2011,1-2 Years,1047,68,1115
HARYANA,2011,2-3 Years,279,21,300
HARYANA,2011,3-5 Years,73,0,73
HARYANA,2011,Above 5 Years,6,0,6
HARYANA,2011,Total,8118,385,8503
HARYANA,2012,Upto 3 months,2809,164,2973
HARYANA,2012,3-6 months,2529,98,2627
HARYANA,2012,6-12 months,2428,97,2525
HARYANA,2012,1-2 Years,1400,87,1487
HARYANA,2012,2-3 Years,500,10,510
HARYANA,2012,3-5 Years,112,4,116
HARYANA,2012,Above 5 Years,13,0,13
HARYANA,2012,Total,9791,460,10251
HIMACHAL PRADESH,2001,Upto 3 months,266,10,276
HIMACHAL PRADESH,2001,3-6 months,141,3,144
HIMACHAL PRADESH,2001,6-12 months,90,2,92
HIMACHAL PRADESH,2001,1-2 Years,0,0,0
HIMACHAL PRADESH,2001,2-3 Years,0,0,0
HIMACHAL PRADESH,2001,3-5 Years,0,0,0
HIMACHAL PRADESH,2001,Above 5 Years,0,0,0
HIMACHAL PRADESH,2001,Total,497,15,512
HIMACHAL PRADESH,2002,Upto 3 months,162,4,166
HIMACHAL PRADESH,2002,3-6 months,105,8,113
HIMACHAL PRADESH,2002,6-12 months,137,8,145
HIMACHAL PRADESH,2002,1-2 Years,44,0,44
HIMACHAL PRADESH,2002,2-3 Years,10,0,10
HIMACHAL PRADESH,2002,3-5 Years,0,0,0
HIMACHAL PRADESH,2002,Above 5 Years,0,0,0
HIMACHAL PRADESH,2002,Total,458,20,478
HIMACHAL PRADESH,2003,Upto 3 months,202,8,210
HIMACHAL PRADESH,2003,3-6 months,108,2,110
HIMACHAL PRADESH,2003,6-12 months,125,7,132
HIMACHAL PRADESH,2003,1-2 Years,46,2,48
HIMACHAL PRADESH,2003,2-3 Years,2,0,2
HIMACHAL PRADESH,2003,3-5 Years,0,0,0
HIMACHAL PRADESH,2003,Above 5 Years,0,0,0
HIMACHAL PRADESH,2003,Total,483,19,502
HIMACHAL PRADESH,2004,Upto 3 months,153,6,159
HIMACHAL PRADESH,2004,3-6 months,82,3,85
HIMACHAL PRADESH,2004,6-12 months,159,7,166
HIMACHAL PRADESH,2004,1-2 Years,64,3,67
HIMACHAL PRADESH,2004,2-3 Years,10,0,10
HIMACHAL PRADESH,2004,3-5 Years,0,0,0
HIMACHAL PRADESH,2004,Above 5 Years,0,0,0
HIMACHAL PRADESH,2004,Total,468,19,487
HIMACHAL PRADESH,2005,Upto 3 months,145,6,151
HIMACHAL PRADESH,2005,3-6 months,110,4,114
HIMACHAL PRADESH,2005,6-12 months,170,4,174
HIMACHAL PRADESH,2005,1-2 Years,84,1,85
HIMACHAL PRADESH,2005,2-3 Years,11,1,12
HIMACHAL PRADESH,2005,3-5 Years,0,0,0
HIMACHAL PRADESH,2005,Above 5 Years,0,0,0
HIMACHAL PRADESH,2005,Total,520,16,536
HIMACHAL PRADESH,2006,Upto 3 months,173,4,177
HIMACHAL PRADESH,2006,3-6 months,136,6,142
HIMACHAL PRADESH,2006,6-12 months,162,9,171
HIMACHAL PRADESH,2006,1-2 Years,67,2,69
HIMACHAL PRADESH,2006,2-3 Years,13,0,13
HIMACHAL PRADESH,2006,3-5 Years,0,0,0
HIMACHAL PRADESH,2006,Above 5 Years,0,0,0
HIMACHAL PRADESH,2006,Total,551,21,572
HIMACHAL PRADESH,2007,Upto 3 months,208,12,220
HIMACHAL PRADESH,2007,3-6 months,94,6,100
HIMACHAL PRADESH,2007,6-12 months,148,4,152
HIMACHAL PRADESH,2007,1-2 Years,60,2,62
HIMACHAL PRADESH,2007,2-3 Years,21,0,21
HIMACHAL PRADESH,2007,3-5 Years,5,0,5
HIMACHAL PRADESH,2007,Above 5 Years,0,0,0
HIMACHAL PRADESH,2007,Total,536,24,560
HIMACHAL PRADESH,2008,Upto 3 months,226,13,239
HIMACHAL PRADESH,2008,3-6 months,118,5,123
HIMACHAL PRADESH,2008,6-12 months,107,3,110
HIMACHAL PRADESH,2008,1-2 Years,63,4,67
HIMACHAL PRADESH,2008,2-3 Years,24,1,25
HIMACHAL PRADESH,2008,3-5 Years,14,0,14
HIMACHAL PRADESH,2008,Above 5 Years,0,0,0
HIMACHAL PRADESH,2008,Total,552,26,578
HIMACHAL PRADESH,2009,Upto 3 months,245,6,251
HIMACHAL PRADESH,2009,3-6 months,155,5,160
HIMACHAL PRADESH,2009,6-12 months,160,4,164
HIMACHAL PRADESH,2009,1-2 Years,104,1,105
HIMACHAL PRADESH,2009,2-3 Years,21,1,22
HIMACHAL PRADESH,2009,3-5 Years,5,0,5
HIMACHAL PRADESH,2009,Above 5 Years,5,0,5
HIMACHAL PRADESH,2009,Total,695,17,712
HIMACHAL PRADESH,2010,Upto 3 months,183,6,189
HIMACHAL PRADESH,2010,3-6 months,105,9,114
HIMACHAL PRADESH,2010,6-12 months,149,7,156
HIMACHAL PRADESH,2010,1-2 Years,132,1,133
HIMACHAL PRADESH,2010,2-3 Years,21,0,21
HIMACHAL PRADESH,2010,3-5 Years,6,0,6
HIMACHAL PRADESH,2010,Above 5 Years,4,0,4
HIMACHAL PRADESH,2010,Total,600,23,623
HIMACHAL PRADESH,2011,Upto 3 months,211,20,231
HIMACHAL PRADESH,2011,3-6 months,134,4,138
HIMACHAL PRADESH,2011,6-12 months,165,5,170
HIMACHAL PRADESH,2011,1-2 Years,87,4,91
HIMACHAL PRADESH,2011,2-3 Years,30,0,30
HIMACHAL PRADESH,2011,3-5 Years,5,0,5
HIMACHAL PRADESH,2011,Above 5 Years,0,0,0
HIMACHAL PRADESH,2011,Total,632,33,665
HIMACHAL PRADESH,2012,Upto 3 months,254,15,269
HIMACHAL PRADESH,2012,3-6 months,166,10,176
HIMACHAL PRADESH,2012,6-12 months,181,8,189
HIMACHAL PRADESH,2012,1-2 Years,121,4,125
HIMACHAL PRADESH,2012,2-3 Years,5,0,5
HIMACHAL PRADESH,2012,3-5 Years,0,0,0
HIMACHAL PRADESH,2012,Above 5 Years,0,0,0
HIMACHAL PRADESH,2012,Total,727,37,764
JAMMU & KASHMIR,2001,Upto 3 months,226,0,226
JAMMU & KASHMIR,2001,3-6 months,187,3,190
JAMMU & KASHMIR,2001,6-12 months,178,8,186
JAMMU & KASHMIR,2001,1-2 Years,163,16,179
JAMMU & KASHMIR,2001,2-3 Years,174,2,176
JAMMU & KASHMIR,2001,3-5 Years,116,3,119
JAMMU & KASHMIR,2001,Above 5 Years,28,1,29
JAMMU & KASHMIR,2001,Total,1072,33,1105
JAMMU & KASHMIR,2002,Upto 3 months,310,7,317
JAMMU & KASHMIR,2002,3-6 months,157,11,168
JAMMU & KASHMIR,2002,6-12 months,181,13,194
JAMMU & KASHMIR,2002,1-2 Years,259,6,265
JAMMU & KASHMIR,2002,2-3 Years,134,6,140
JAMMU & KASHMIR,2002,3-5 Years,95,2,97
JAMMU & KASHMIR,2002,Above 5 Years,47,1,48
JAMMU & KASHMIR,2002,Total,1183,46,1229
JAMMU & KASHMIR,2003,Upto 3 months,80,0,80
JAMMU & KASHMIR,2003,3-6 months,41,0,41
JAMMU & KASHMIR,2003,6-12 months,67,3,70
JAMMU & KASHMIR,2003,1-2 Years,55,5,60
JAMMU & KASHMIR,2003,2-3 Years,428,6,434
JAMMU & KASHMIR,2003,3-5 Years,300,8,308
JAMMU & KASHMIR,2003,Above 5 Years,295,42,337
JAMMU & KASHMIR,2003,Total,1266,64,1330
JAMMU & KASHMIR,2004,Upto 3 months,295,7,302
JAMMU & KASHMIR,2004,3-6 months,227,8,235
JAMMU & KASHMIR,2004,6-12 months,207,7,214
JAMMU & KASHMIR,2004,1-2 Years,268,10,278
JAMMU & KASHMIR,2004,2-3 Years,165,18,183
JAMMU & KASHMIR,2004,3-5 Years,130,2,132
JAMMU & KASHMIR,2004,Above 5 Years,42,1,43
JAMMU & KASHMIR,2004,Total,1334,53,1387
JAMMU & KASHMIR,2005,Upto 3 months,374,20,394
JAMMU & KASHMIR,2005,3-6 months,270,6,276
JAMMU & KASHMIR,2005,6-12 months,229,4,233
JAMMU & KASHMIR,2005,1-2 Years,277,9,286
JAMMU & KASHMIR,2005,2-3 Years,154,9,163
JAMMU & KASHMIR,2005,3-5 Years,128,7,135
JAMMU & KASHMIR,2005,Above 5 Years,50,2,52
JAMMU & KASHMIR,2005,Total,1482,57,1539
JAMMU & KASHMIR,2006,Upto 3 months,628,22,650
JAMMU & KASHMIR,2006,3-6 months,415,16,431
JAMMU & KASHMIR,2006,6-12 months,298,11,309
JAMMU & KASHMIR,2006,1-2 Years,149,0,149
JAMMU & KASHMIR,2006,2-3 Years,60,0,60
JAMMU & KASHMIR,2006,3-5 Years,35,0,35
JAMMU & KASHMIR,2006,Above 5 Years,0,0,0
JAMMU & KASHMIR,2006,Total,1585,49,1634
JAMMU & KASHMIR,2007,Upto 3 months,413,30,443
JAMMU & KASHMIR,2007,3-6 months,256,3,259
JAMMU & KASHMIR,2007,6-12 months,220,12,232
JAMMU & KASHMIR,2007,1-2 Years,325,12,337
JAMMU & KASHMIR,2007,2-3 Years,187,13,200
JAMMU & KASHMIR,2007,3-5 Years,156,1,157
JAMMU & KASHMIR,2007,Above 5 Years,103,1,104
JAMMU & KASHMIR,2007,Total,1660,72,1732
JAMMU & KASHMIR,2008,Upto 3 months,321,20,341
JAMMU & KASHMIR,2008,3-6 months,176,4,180
JAMMU & KASHMIR,2008,6-12 months,251,10,261
JAMMU & KASHMIR,2008,1-2 Years,387,16,403
JAMMU & KASHMIR,2008,2-3 Years,182,17,199
JAMMU & KASHMIR,2008,3-5 Years,220,6,226
JAMMU & KASHMIR,2008,Above 5 Years,94,2,96
JAMMU & KASHMIR,2008,Total,1631,75,1706
JAMMU & KASHMIR,2009,Upto 3 months,445,24,469
JAMMU & KASHMIR,2009,3-6 months,252,10,262
JAMMU & KASHMIR,2009,6-12 months,238,12,250
JAMMU & KASHMIR,2009,1-2 Years,360,16,376
JAMMU & KASHMIR,2009,2-3 Years,237,17,254
JAMMU & KASHMIR,2009,3-5 Years,139,4,143
JAMMU & KASHMIR,2009,Above 5 Years,65,2,67
JAMMU & KASHMIR,2009,Total,1736,85,1821
JAMMU & KASHMIR,2010,Upto 3 months,449,17,466
JAMMU & KASHMIR,2010,3-6 months,236,19,255
JAMMU & KASHMIR,2010,6-12 months,420,9,429
JAMMU & KASHMIR,2010,1-2 Years,342,16,358
JAMMU & KASHMIR,2010,2-3 Years,152,9,161
JAMMU & KASHMIR,2010,3-5 Years,140,11,151
JAMMU & KASHMIR,2010,Above 5 Years,84,3,87
JAMMU & KASHMIR,2010,Total,1823,84,1907
JAMMU & KASHMIR,2011,Upto 3 months,463,18,481
JAMMU & KASHMIR,2011,3-6 months,293,11,304
JAMMU & KASHMIR,2011,6-12 months,284,4,288
JAMMU & KASHMIR,2011,1-2 Years,417,13,430
JAMMU & KASHMIR,2011,2-3 Years,275,14,289
JAMMU & KASHMIR,2011,3-5 Years,223,22,245
JAMMU & KASHMIR,2011,Above 5 Years,70,6,76
JAMMU & KASHMIR,2011,Total,2025,88,2113
JAMMU & KASHMIR,2012,Upto 3 months,493,14,507
JAMMU & KASHMIR,2012,3-6 months,279,23,302
JAMMU & KASHMIR,2012,6-12 months,257,10,267
JAMMU & KASHMIR,2012,1-2 Years,409,14,423
JAMMU & KASHMIR,2012,2-3 Years,210,7,217
JAMMU & KASHMIR,2012,3-5 Years,211,8,219
JAMMU & KASHMIR,2012,Above 5 Years,68,4,72
JAMMU & KASHMIR,2012,Total,1927,80,2007
JHARKHAND,2001,Upto 3 months,3357,85,3442
JHARKHAND,2001,3-6 months,3150,96,3246
JHARKHAND,2001,6-12 months,2847,84,2931
JHARKHAND,2001,1-2 Years,2215,83,2298
JHARKHAND,2001,2-3 Years,1234,19,1253
JHARKHAND,2001,3-5 Years,711,19,730
JHARKHAND,2001,Above 5 Years,172,6,178
JHARKHAND,2001,Total,13686,392,14078
JHARKHAND,2002,Upto 3 months,2412,182,2594
JHARKHAND,2002,3-6 months,1848,80,1928
JHARKHAND,2002,6-12 months,1199,31,1230
JHARKHAND,2002,1-2 Years,3028,80,3108
JHARKHAND,2002,2-3 Years,2386,18,2404
JHARKHAND,2002,3-5 Years,648,11,659
JHARKHAND,2002,Above 5 Years,168,3,171
JHARKHAND,2002,Total,11689,405,12094
JHARKHAND,2003,Upto 3 months,3178,93,3271
JHARKHAND,2003,3-6 months,2801,111,2912
JHARKHAND,2003,6-12 months,2601,91,2692
JHARKHAND,2003,1-2 Years,1632,73,1705
JHARKHAND,2003,2-3 Years,956,34,990
JHARKHAND,2003,3-5 Years,462,10,472
JHARKHAND,2003,Above 5 Years,90,2,92
JHARKHAND,2003,Total,11720,414,12134
JHARKHAND,2004,Upto 3 months,4041,146,4187
JHARKHAND,2004,3-6 months,2342,127,2469
JHARKHAND,2004,6-12 months,2814,109,2923
JHARKHAND,2004,1-2 Years,1609,74,1683
JHARKHAND,2004,2-3 Years,791,26,817
JHARKHAND,2004,3-5 Years,309,11,320
JHARKHAND,2004,Above 5 Years,48,0,48
JHARKHAND,2004,Total,11954,493,12447
JHARKHAND,2005,Upto 3 months,4648,188,4836
JHARKHAND,2005,3-6 months,3335,166,3501
JHARKHAND,2005,6-12 months,2491,93,2584
JHARKHAND,2005,1-2 Years,1672,67,1739
JHARKHAND,2005,2-3 Years,802,25,827
JHARKHAND,2005,3-5 Years,402,7,409
JHARKHAND,2005,Above 5 Years,43,0,43
JHARKHAND,2005,Total,13393,546,13939
JHARKHAND,2006,Upto 3 months,4026,178,4204
JHARKHAND,2006,3-6 months,2958,111,3069
JHARKHAND,2006,6-12 months,2522,108,2630
JHARKHAND,2006,1-2 Years,1946,82,2028
JHARKHAND,2006,2-3 Years,912,42,954
JHARKHAND,2006,3-5 Years,405,12,417
JHARKHAND,2006,Above 5 Years,37,0,37
JHARKHAND,2006,Total,12806,533,13339
JHARKHAND,2007,Upto 3 months,3653,135,3788
JHARKHAND,2007,3-6 months,2535,130,2665
JHARKHAND,2007,6-12 months,2163,122,2285
JHARKHAND,2007,1-2 Years,2028,54,2082
JHARKHAND,2007,2-3 Years,831,26,857
JHARKHAND,2007,3-5 Years,339,6,345
JHARKHAND,2007,Above 5 Years,41,0,41
JHARKHAND,2007,Total,11590,473,12063
JHARKHAND,2008,Upto 3 months,4178,131,4309
JHARKHAND,2008,3-6 months,2730,128,2858
JHARKHAND,2008,6-12 months,2539,112,2651
JHARKHAND,2008,1-2 Years,1515,74,1589
JHARKHAND,2008,2-3 Years,802,32,834
JHARKHAND,2008,3-5 Years,335,5,340
JHARKHAND,2008,Above 5 Years,29,0,29
JHARKHAND,2008,Total,12128,482,12610
JHARKHAND,2009,Upto 3 months,3891,136,4027
JHARKHAND,2009,3-6 months,2664,120,2784
JHARKHAND,2009,6-12 months,2155,128,2283
JHARKHAND,2009,1-2 Years,1444,62,1506
JHARKHAND,2009,2-3 Years,758,29,787
JHARKHAND,2009,3-5 Years,258,7,265
JHARKHAND,2009,Above 5 Years,28,2,30
JHARKHAND,2009,Total,11198,484,11682
JHARKHAND,2010,Upto 3 months,3778,152,3930
JHARKHAND,2010,3-6 months,2780,108,2888
JHARKHAND,2010,6-12 months,2414,125,2539
JHARKHAND,2010,1-2 Years,1874,90,1964
JHARKHAND,2010,2-3 Years,1010,46,1056
JHARKHAND,2010,3-5 Years,334,17,351
JHARKHAND,2010,Above 5 Years,36,1,37
JHARKHAND,2010,Total,12226,539,12765
JHARKHAND,2011,Upto 3 months,3728,177,3905
JHARKHAND,2011,3-6 months,2636,135,2771
JHARKHAND,2011,6-12 months,2336,133,2469
JHARKHAND,2011,1-2 Years,1619,87,1706
JHARKHAND,2011,2-3 Years,852,31,883
JHARKHAND,2011,3-5 Years,270,10,280
JHARKHAND,2011,Above 5 Years,54,5,59
JHARKHAND,2011,Total,11495,578,12073
JHARKHAND,2012,Upto 3 months,3944,169,4113
JHARKHAND,2012,3-6 months,3486,144,3630
JHARKHAND,2012,6-12 months,2016,108,2124
JHARKHAND,2012,1-2 Years,1584,104,1688
JHARKHAND,2012,2-3 Years,887,47,934
JHARKHAND,2012,3-5 Years,445,24,469
JHARKHAND,2012,Above 5 Years,73,4,77
JHARKHAND,2012,Total,12435,600,13035
KARNATAKA,2001,Upto 3 months,3759,86,3845
KARNATAKA,2001,3-6 months,1974,72,2046
KARNATAKA,2001,6-12 months,887,33,920
KARNATAKA,2001,1-2 Years,396,5,401
KARNATAKA,2001,2-3 Years,293,3,296
KARNATAKA,2001,3-5 Years,119,0,119
KARNATAKA,2001,Above 5 Years,89,0,89
KARNATAKA,2001,Total,7517,199,7716
KARNATAKA,2002,Upto 3 months,2646,77,2723
KARNATAKA,2002,3-6 months,1426,83,1509
KARNATAKA,2002,6-12 months,1629,61,1690
KARNATAKA,2002,1-2 Years,1144,27,1171
KARNATAKA,2002,2-3 Years,554,12,566
KARNATAKA,2002,3-5 Years,278,3,281
KARNATAKA,2002,Above 5 Years,32,0,32
KARNATAKA,2002,Total,7709,263,7972
KARNATAKA,2003,Upto 3 months,2818,88,2906
KARNATAKA,2003,3-6 months,1479,79,1558
KARNATAKA,2003,6-12 months,1840,68,1908
KARNATAKA,2003,1-2 Years,983,11,994
KARNATAKA,2003,2-3 Years,326,15,341
KARNATAKA,2003,3-5 Years,221,0,221
KARNATAKA,2003,Above 5 Years,47,0,47
KARNATAKA,2003,Total,7714,261,7975
KARNATAKA,2004,Upto 3 months,2523,113,2636
KARNATAKA,2004,3-6 months,1638,82,1720
KARNATAKA,2004,6-12 months,1901,62,1963
KARNATAKA,2004,1-2 Years,965,31,996
KARNATAKA,2004,2-3 Years,367,14,381
KARNATAKA,2004,3-5 Years,219,3,222
KARNATAKA,2004,Above 5 Years,42,2,44
KARNATAKA,2004,Total,7655,307,7962
KARNATAKA,2005,Upto 3 months,2811,92,2903
KARNATAKA,2005,3-6 months,1503,76,1579
KARNATAKA,2005,6-12 months,1802,93,1895
KARNATAKA,2005,1-2 Years,971,22,993
KARNATAKA,2005,2-3 Years,321,13,334
KARNATAKA,2005,3-5 Years,219,0,219
KARNATAKA,2005,Above 5 Years,56,0,56
KARNATAKA,2005,Total,7683,296,7979
KARNATAKA,2006,Upto 3 months,3606,114,3720
KARNATAKA,2006,3-6 months,1497,86,1583
KARNATAKA,2006,6-12 months,1693,82,1775
KARNATAKA,2006,1-2 Years,1092,17,1109
KARNATAKA,2006,2-3 Years,283,8,291
KARNATAKA,2006,3-5 Years,123,1,124
KARNATAKA,2006,Above 5 Years,44,3,47
KARNATAKA,2006,Total,8338,311,8649
KARNATAKA,2007,Upto 3 months,3822,153,3975
KARNATAKA,2007,3-6 months,1526,88,1614
KARNATAKA,2007,6-12 months,1725,81,1806
KARNATAKA,2007,1-2 Years,1127,18,1145
KARNATAKA,2007,2-3 Years,303,9,312
KARNATAKA,2007,3-5 Years,137,1,138
KARNATAKA,2007,Above 5 Years,54,2,56
KARNATAKA,2007,Total,8694,352,9046
KARNATAKA,2008,Upto 3 months,4004,151,4155
KARNATAKA,2008,3-6 months,1597,92,1689
KARNATAKA,2008,6-12 months,1769,81,1850
KARNATAKA,2008,1-2 Years,1173,18,1191
KARNATAKA,2008,2-3 Years,302,9,311
KARNATAKA,2008,3-5 Years,141,1,142
KARNATAKA,2008,Above 5 Years,68,2,70
KARNATAKA,2008,Total,9054,354,9408
KARNATAKA,2009,Upto 3 months,3285,161,3446
KARNATAKA,2009,3-6 months,2117,87,2204
KARNATAKA,2009,6-12 months,1740,43,1783
KARNATAKA,2009,1-2 Years,1057,41,1098
KARNATAKA,2009,2-3 Years,396,18,414
KARNATAKA,2009,3-5 Years,277,6,283
KARNATAKA,2009,Above 5 Years,88,5,93
KARNATAKA,2009,Total,8960,361,9321
KARNATAKA,2010,Upto 3 months,3244,154,3398
KARNATAKA,2010,3-6 months,2113,82,2195
KARNATAKA,2010,6-12 months,1469,27,1496
KARNATAKA,2010,1-2 Years,1037,22,1059
KARNATAKA,2010,2-3 Years,414,11,425
KARNATAKA,2010,3-5 Years,168,4,172
KARNATAKA,2010,Above 5 Years,31,0,31
KARNATAKA,2010,Total,8476,300,8776
KARNATAKA,2011,Upto 3 months,3118,172,3290
KARNATAKA,2011,3-6 months,2069,82,2151
KARNATAKA,2011,6-12 months,1214,29,1243
KARNATAKA,2011,1-2 Years,898,27,925
KARNATAKA,2011,2-3 Years,362,13,375
KARNATAKA,2011,3-5 Years,268,3,271
KARNATAKA,2011,Above 5 Years,31,0,31
KARNATAKA,2011,Total,7960,326,8286
KARNATAKA,2012,Upto 3 months,3124,162,3286
KARNATAKA,2012,3-6 months,2052,89,2141
KARNATAKA,2012,6-12 months,1773,72,1845
KARNATAKA,2012,1-2 Years,1041,20,1061
KARNATAKA,2012,2-3 Years,382,10,392
KARNATAKA,2012,3-5 Years,150,14,164
KARNATAKA,2012,Above 5 Years,50,1,51
KARNATAKA,2012,Total,8572,368,8940
KERALA,2001,Upto 3 months,2218,68,2286
KERALA,2001,3-6 months,909,38,947
KERALA,2001,6-12 months,185,4,189
KERALA,2001,1-2 Years,96,1,97
KERALA,2001,2-3 Years,7,0,7
KERALA,2001,3-5 Years,1,0,1
KERALA,2001,Above 5 Years,0,0,0
KERALA,2001,Total,3416,111,3527
KERALA,2002,Upto 3 months,2312,70,2382
KERALA,2002,3-6 months,890,40,930
KERALA,2002,6-12 months,99,15,114
KERALA,2002,1-2 Years,16,12,28
KERALA,2002,2-3 Years,4,0,4
KERALA,2002,3-5 Years,0,0,0
KERALA,2002,Above 5 Years,0,0,0
KERALA,2002,Total,3321,137,3458
KERALA,2003,Upto 3 months,2810,73,2883
KERALA,2003,3-6 months,1092,36,1128
KERALA,2003,6-12 months,174,17,191
KERALA,2003,1-2 Years,36,10,46
KERALA,2003,2-3 Years,10,0,10
KERALA,2003,3-5 Years,0,0,0
KERALA,2003,Above 5 Years,0,0,0
KERALA,2003,Total,4122,136,4258
KERALA,2004,Upto 3 months,2870,82,2952
KERALA,2004,3-6 months,1140,42,1182
KERALA,2004,6-12 months,184,19,203
KERALA,2004,1-2 Years,40,11,51
KERALA,2004,2-3 Years,12,0,12
KERALA,2004,3-5 Years,0,0,0
KERALA,2004,Above 5 Years,0,0,0
KERALA,2004,Total,4246,154,4400
KERALA,2005,Upto 3 months,2580,49,2629
KERALA,2005,3-6 months,1123,56,1179
KERALA,2005,6-12 months,160,12,172
KERALA,2005,1-2 Years,43,6,49
KERALA,2005,2-3 Years,3,0,3
KERALA,2005,3-5 Years,7,0,7
KERALA,2005,Above 5 Years,2,1,3
KERALA,2005,Total,3918,124,4042
KERALA,2006,Upto 3 months,2132,86,2218
KERALA,2006,3-6 months,710,33,743
KERALA,2006,6-12 months,318,5,323
KERALA,2006,1-2 Years,185,1,186
KERALA,2006,2-3 Years,146,0,146
KERALA,2006,3-5 Years,2,0,2
KERALA,2006,Above 5 Years,1,0,1
KERALA,2006,Total,3494,125,3619
KERALA,2007,Upto 3 months,2245,98,2343
KERALA,2007,3-6 months,864,15,879
KERALA,2007,6-12 months,302,11,313
KERALA,2007,1-2 Years,76,1,77
KERALA,2007,2-3 Years,36,0,36
KERALA,2007,3-5 Years,139,0,139
KERALA,2007,Above 5 Years,0,0,0
KERALA,2007,Total,3662,125,3787
KERALA,2008,Upto 3 months,2292,97,2389
KERALA,2008,3-6 months,990,18,1008
KERALA,2008,6-12 months,371,6,377
KERALA,2008,1-2 Years,97,4,101
KERALA,2008,2-3 Years,7,1,8
KERALA,2008,3-5 Years,1,1,2
KERALA,2008,Above 5 Years,48,1,49
KERALA,2008,Total,3806,128,3934
KERALA,2009,Upto 3 months,2610,111,2721
KERALA,2009,3-6 months,875,22,897
KERALA,2009,6-12 months,363,18,381
KERALA,2009,1-2 Years,61,2,63
KERALA,2009,2-3 Years,9,0,9
KERALA,2009,3-5 Years,5,0,5
KERALA,2009,Above 5 Years,2,0,2
KERALA,2009,Total,3925,153,4078
KERALA,2010,Upto 3 months,2457,113,2570
KERALA,2010,3-6 months,641,19,660
KERALA,2010,6-12 months,393,13,406
KERALA,2010,1-2 Years,165,5,170
KERALA,2010,2-3 Years,56,6,62
KERALA,2010,3-5 Years,23,6,29
KERALA,2010,Above 5 Years,2,0,2
KERALA,2010,Total,3737,162,3899
KERALA,2011,Upto 3 months,2516,87,2603
KERALA,2011,3-6 months,672,15,687
KERALA,2011,6-12 months,321,6,327
KERALA,2011,1-2 Years,106,5,111
KERALA,2011,2-3 Years,31,1,32
KERALA,2011,3-5 Years,14,1,15
KERALA,2011,Above 5 Years,0,0,0
KERALA,2011,Total,3660,115,3775
KERALA,2012,Upto 3 months,2649,95,2744
KERALA,2012,3-6 months,873,21,894
KERALA,2012,6-12 months,297,16,313
KERALA,2012,1-2 Years,143,9,152
KERALA,2012,2-3 Years,39,2,41
KERALA,2012,3-5 Years,19,2,21
KERALA,2012,Above 5 Years,0,0,0
KERALA,2012,Total,4020,145,4165
MADHYA PRADESH,2001,Upto 3 months,8023,189,8212
MADHYA PRADESH,2001,3-6 months,3829,138,3967
MADHYA PRADESH,2001,6-12 months,2692,89,2781
MADHYA PRADESH,2001,1-2 Years,1355,26,1381
MADHYA PRADESH,2001,2-3 Years,347,11,358
MADHYA PRADESH,2001,3-5 Years,108,2,110
MADHYA PRADESH,2001,Above 5 Years,28,0,28
MADHYA PRADESH,2001,Total,16382,455,16837
MADHYA PRADESH,2002,Upto 3 months,6495,236,6731
MADHYA PRADESH,2002,3-6 months,4909,124,5033
MADHYA PRADESH,2002,6-12 months,2070,54,2124
MADHYA PRADESH,2002,1-2 Years,1333,28,1361
MADHYA PRADESH,2002,2-3 Years,225,11,236
MADHYA PRADESH,2002,3-5 Years,115,6,121
MADHYA PRADESH,2002,Above 5 Years,29,0,29
MADHYA PRADESH,2002,Total,15176,459,15635
MADHYA PRADESH,2003,Upto 3 months,6491,198,6689
MADHYA PRADESH,2003,3-6 months,3657,150,3807
MADHYA PRADESH,2003,6-12 months,2067,54,2121
MADHYA PRADESH,2003,1-2 Years,1019,44,1063
MADHYA PRADESH,2003,2-3 Years,213,9,222
MADHYA PRADESH,2003,3-5 Years,70,0,70
MADHYA PRADESH,2003,Above 5 Years,21,0,21
MADHYA PRADESH,2003,Total,13538,455,13993
MADHYA PRADESH,2004,Upto 3 months,7308,243,7551
MADHYA PRADESH,2004,3-6 months,3147,78,3225
MADHYA PRADESH,2004,6-12 months,3347,90,3437
MADHYA PRADESH,2004,1-2 Years,1198,39,1237
MADHYA PRADESH,2004,2-3 Years,188,6,194
MADHYA PRADESH,2004,3-5 Years,79,2,81
MADHYA PRADESH,2004,Above 5 Years,49,3,52
MADHYA PRADESH,2004,Total,15316,461,15777
MADHYA PRADESH,2005,Upto 3 months,8227,247,8474
MADHYA PRADESH,2005,3-6 months,3771,101,3872
MADHYA PRADESH,2005,6-12 months,2510,92,2602
MADHYA PRADESH,2005,1-2 Years,1404,64,1468
MADHYA PRADESH,2005,2-3 Years,361,12,373
MADHYA PRADESH,2005,3-5 Years,180,4,184
MADHYA PRADESH,2005,Above 5 Years,18,0,18
MADHYA PRADESH,2005,Total,16471,520,16991
MADHYA PRADESH,2006,Upto 3 months,7556,213,7769
MADHYA PRADESH,2006,3-6 months,3960,94,4054
MADHYA PRADESH,2006,6-12 months,2752,66,2818
MADHYA PRADESH,2006,1-2 Years,1443,36,1479
MADHYA PRADESH,2006,2-3 Years,384,13,397
MADHYA PRADESH,2006,3-5 Years,145,5,150
MADHYA PRADESH,2006,Above 5 Years,19,0,19
MADHYA PRADESH,2006,Total,16259,427,16686
MADHYA PRADESH,2007,Upto 3 months,7625,204,7829
MADHYA PRADESH,2007,3-6 months,4043,126,4169
MADHYA PRADESH,2007,6-12 months,2110,77,2187
MADHYA PRADESH,2007,1-2 Years,1430,56,1486
MADHYA PRADESH,2007,2-3 Years,418,18,436
MADHYA PRADESH,2007,3-5 Years,166,0,166
MADHYA PRADESH,2007,Above 5 Years,27,0,27
MADHYA PRADESH,2007,Total,15819,481,16300
MADHYA PRADESH,2008,Upto 3 months,8389,285,8674
MADHYA PRADESH,2008,3-6 months,4411,133,4544
MADHYA PRADESH,2008,6-12 months,2859,110,2969
MADHYA PRADESH,2008,1-2 Years,1524,40,1564
MADHYA PRADESH,2008,2-3 Years,500,15,515
MADHYA PRADESH,2008,3-5 Years,202,3,205
MADHYA PRADESH,2008,Above 5 Years,17,0,17
MADHYA PRADESH,2008,Total,17902,586,18488
MADHYA PRADESH,2009,Upto 3 months,8011,219,8230
MADHYA PRADESH,2009,3-6 months,3890,143,4033
MADHYA PRADESH,2009,6-12 months,2561,101,2662
MADHYA PRADESH,2009,1-2 Years,1593,61,1654
MADHYA PRADESH,2009,2-3 Years,509,7,516
MADHYA PRADESH,2009,3-5 Years,186,0,186
MADHYA PRADESH,2009,Above 5 Years,30,0,30
MADHYA PRADESH,2009,Total,16780,531,17311
MADHYA PRADESH,2010,Upto 3 months,7322,253,7575
MADHYA PRADESH,2010,3-6 months,3879,148,4027
MADHYA PRADESH,2010,6-12 months,2623,100,2723
MADHYA PRADESH,2010,1-2 Years,1345,46,1391
MADHYA PRADESH,2010,2-3 Years,507,21,528
MADHYA PRADESH,2010,3-5 Years,247,6,253
MADHYA PRADESH,2010,Above 5 Years,25,0,25
MADHYA PRADESH,2010,Total,15948,574,16522
MADHYA PRADESH,2011,Upto 3 months,8022,290,8312
MADHYA PRADESH,2011,3-6 months,3248,142,3390
MADHYA PRADESH,2011,6-12 months,2836,138,2974
MADHYA PRADESH,2011,1-2 Years,1446,44,1490
MADHYA PRADESH,2011,2-3 Years,377,12,389
MADHYA PRADESH,2011,3-5 Years,127,4,131
MADHYA PRADESH,2011,Above 5 Years,15,0,15
MADHYA PRADESH,2011,Total,16071,630,16701
MADHYA PRADESH,2012,Upto 3 months,7144,297,7441
MADHYA PRADESH,2012,3-6 months,4019,177,4196
MADHYA PRADESH,2012,6-12 months,3237,116,3353
MADHYA PRADESH,2012,1-2 Years,1752,67,1819
MADHYA PRADESH,2012,2-3 Years,558,23,581
MADHYA PRADESH,2012,3-5 Years,200,4,204
MADHYA PRADESH,2012,Above 5 Years,23,2,25
MADHYA PRADESH,2012,Total,16933,686,17619
MAHARASHTRA,2001,Upto 3 months,5609,291,5900
MAHARASHTRA,2001,3-6 months,3523,119,3642
MAHARASHTRA,2001,6-12 months,2272,90,2362
MAHARASHTRA,2001,1-2 Years,2876,72,2948
MAHARASHTRA,2001,2-3 Years,443,5,448
MAHARASHTRA,2001,3-5 Years,127,4,131
MAHARASHTRA,2001,Above 5 Years,13,2,15
MAHARASHTRA,2001,Total,14863,583,15446
MAHARASHTRA,2002,Upto 3 months,5647,368,6015
MAHARASHTRA,2002,3-6 months,2837,112,2949
MAHARASHTRA,2002,6-12 months,2284,82,2366
MAHARASHTRA,2002,1-2 Years,2706,80,2786
MAHARASHTRA,2002,2-3 Years,233,2,235
MAHARASHTRA,2002,3-5 Years,100,1,101
MAHARASHTRA,2002,Above 5 Years,62,3,65
MAHARASHTRA,2002,Total,13869,648,14517
MAHARASHTRA,2003,Upto 3 months,5564,530,6094
MAHARASHTRA,2003,3-6 months,2735,85,2820
MAHARASHTRA,2003,6-12 months,3286,59,3345
MAHARASHTRA,2003,1-2 Years,2745,49,2794
MAHARASHTRA,2003,2-3 Years,285,2,287
MAHARASHTRA,2003,3-5 Years,113,1,114
MAHARASHTRA,2003,Above 5 Years,48,2,50
MAHARASHTRA,2003,Total,14776,728,15504
MAHARASHTRA,2004,Upto 3 months,6323,377,6700
MAHARASHTRA,2004,3-6 months,2615,210,2825
MAHARASHTRA,2004,6-12 months,2934,134,3068
MAHARASHTRA,2004,1-2 Years,2532,44,2576
MAHARASHTRA,2004,2-3 Years,438,6,444
MAHARASHTRA,2004,3-5 Years,121,1,122
MAHARASHTRA,2004,Above 5 Years,49,0,49
MAHARASHTRA,2004,Total,15012,772,15784
MAHARASHTRA,2005,Upto 3 months,6391,530,6921
MAHARASHTRA,2005,3-6 months,2893,123,3016
MAHARASHTRA,2005,6-12 months,2445,76,2521
MAHARASHTRA,2005,1-2 Years,2621,94,2715
MAHARASHTRA,2005,2-3 Years,490,12,502
MAHARASHTRA,2005,3-5 Years,179,26,205
MAHARASHTRA,2005,Above 5 Years,65,1,66
MAHARASHTRA,2005,Total,15084,862,15946
MAHARASHTRA,2006,Upto 3 months,6863,378,7241
MAHARASHTRA,2006,3-6 months,2776,288,3064
MAHARASHTRA,2006,6-12 months,2460,111,2571
MAHARASHTRA,2006,1-2 Years,2773,84,2857
MAHARASHTRA,2006,2-3 Years,296,21,317
MAHARASHTRA,2006,3-5 Years,203,29,232
MAHARASHTRA,2006,Above 5 Years,83,0,83
MAHARASHTRA,2006,Total,15454,911,16365
MAHARASHTRA,2007,Upto 3 months,6977,522,7499
MAHARASHTRA,2007,3-6 months,2852,108,2960
MAHARASHTRA,2007,6-12 months,2177,89,2266
MAHARASHTRA,2007,1-2 Years,2764,80,2844
MAHARASHTRA,2007,2-3 Years,736,25,761
MAHARASHTRA,2007,3-5 Years,147,17,164
MAHARASHTRA,2007,Above 5 Years,43,0,43
MAHARASHTRA,2007,Total,15696,841,16537
MAHARASHTRA,2008,Upto 3 months,6319,519,6838
MAHARASHTRA,2008,3-6 months,3051,183,3234
MAHARASHTRA,2008,6-12 months,2351,107,2458
MAHARASHTRA,2008,1-2 Years,2781,89,2870
MAHARASHTRA,2008,2-3 Years,997,27,1024
MAHARASHTRA,2008,3-5 Years,100,11,111
MAHARASHTRA,2008,Above 5 Years,19,0,19
MAHARASHTRA,2008,Total,15618,936,16554
MAHARASHTRA,2009,Upto 3 months,6088,506,6594
MAHARASHTRA,2009,3-6 months,2870,186,3056
MAHARASHTRA,2009,6-12 months,2387,104,2491
MAHARASHTRA,2009,1-2 Years,2721,113,2834
MAHARASHTRA,2009,2-3 Years,816,30,846
MAHARASHTRA,2009,3-5 Years,295,14,309
MAHARASHTRA,2009,Above 5 Years,50,0,50
MAHARASHTRA,2009,Total,15227,953,16180
MAHARASHTRA,2010,Upto 3 months,6471,432,6903
MAHARASHTRA,2010,3-6 months,2743,143,2886
MAHARASHTRA,2010,6-12 months,2265,139,2404
MAHARASHTRA,2010,1-2 Years,2561,79,2640
MAHARASHTRA,2010,2-3 Years,813,31,844
MAHARASHTRA,2010,3-5 Years,314,21,335
MAHARASHTRA,2010,Above 5 Years,52,1,53
MAHARASHTRA,2010,Total,15219,846,16065
MAHARASHTRA,2011,Upto 3 months,6130,415,6545
MAHARASHTRA,2011,3-6 months,2532,161,2693
MAHARASHTRA,2011,6-12 months,2203,129,2332
MAHARASHTRA,2011,1-2 Years,3168,157,3325
MAHARASHTRA,2011,2-3 Years,826,36,862
MAHARASHTRA,2011,3-5 Years,255,17,272
MAHARASHTRA,2011,Above 5 Years,35,0,35
MAHARASHTRA,2011,Total,15149,915,16064
MAHARASHTRA,2012,Upto 3 months,6131,401,6532
MAHARASHTRA,2012,3-6 months,3337,182,3519
MAHARASHTRA,2012,6-12 months,2279,162,2441
MAHARASHTRA,2012,1-2 Years,2388,103,2491
MAHARASHTRA,2012,2-3 Years,783,20,803
MAHARASHTRA,2012,3-5 Years,566,13,579
MAHARASHTRA,2012,Above 5 Years,61,0,61
MAHARASHTRA,2012,Total,15545,881,16426
MANIPUR,2001,Upto 3 months,151,6,157
MANIPUR,2001,3-6 months,101,5,106
MANIPUR,2001,6-12 months,54,1,55
MANIPUR,2001,1-2 Years,21,1,22
MANIPUR,2001,2-3 Years,1,0,1
MANIPUR,2001,3-5 Years,3,0,3
MANIPUR,2001,Above 5 Years,0,0,0
MANIPUR,2001,Total,331,13,344
MANIPUR,2002,Upto 3 months,129,10,139
MANIPUR,2002,3-6 months,75,5,80
MANIPUR,2002,6-12 months,65,3,68
MANIPUR,2002,1-2 Years,49,1,50
MANIPUR,2002,2-3 Years,14,1,15
MANIPUR,2002,3-5 Years,7,1,8
MANIPUR,2002,Above 5 Years,0,0,0
MANIPUR,2002,Total,339,21,360
MANIPUR,2003,Upto 3 months,110,2,112
MANIPUR,2003,3-6 months,109,5,114
MANIPUR,2003,6-12 months,63,5,68
MANIPUR,2003,1-2 Years,31,3,34
MANIPUR,2003,2-3 Years,18,1,19
MANIPUR,2003,3-5 Years,11,1,12
MANIPUR,2003,Above 5 Years,1,1,2
MANIPUR,2003,Total,343,18,361
MANIPUR,2004,Upto 3 months,124,8,132
MANIPUR,2004,3-6 months,106,6,112
MANIPUR,2004,6-12 months,43,1,44
MANIPUR,2004,1-2 Years,37,3,40
MANIPUR,2004,2-3 Years,14,1,15
MANIPUR,2004,3-5 Years,14,2,16
MANIPUR,2004,Above 5 Years,0,0,0
MANIPUR,2004,Total,338,21,359
MANIPUR,2005,Upto 3 months,182,16,198
MANIPUR,2005,3-6 months,53,1,54
MANIPUR,2005,6-12 months,61,0,61
MANIPUR,2005,1-2 Years,58,0,58
MANIPUR,2005,2-3 Years,9,1,10
MANIPUR,2005,3-5 Years,9,1,10
MANIPUR,2005,Above 5 Years,4,0,4
MANIPUR,2005,Total,376,19,395
MANIPUR,2006,Upto 3 months,128,10,138
MANIPUR,2006,3-6 months,84,1,85
MANIPUR,2006,6-12 months,54,1,55
MANIPUR,2006,1-2 Years,12,1,13
MANIPUR,2006,2-3 Years,19,0,19
MANIPUR,2006,3-5 Years,7,2,9
MANIPUR,2006,Above 5 Years,4,0,4
MANIPUR,2006,Total,308,15,323
MANIPUR,2007,Upto 3 months,82,1,83
MANIPUR,2007,3-6 months,67,1,68
MANIPUR,2007,6-12 months,43,1,44
MANIPUR,2007,1-2 Years,28,1,29
MANIPUR,2007,2-3 Years,10,0,10
MANIPUR,2007,3-5 Years,9,1,10
MANIPUR,2007,Above 5 Years,7,1,8
MANIPUR,2007,Total,246,6,252
MANIPUR,2008,Upto 3 months,118,7,125
MANIPUR,2008,3-6 months,70,3,73
MANIPUR,2008,6-12 months,21,4,25
MANIPUR,2008,1-2 Years,18,0,18
MANIPUR,2008,2-3 Years,5,1,6
MANIPUR,2008,3-5 Years,11,0,11
MANIPUR,2008,Above 5 Years,9,2,11
MANIPUR,2008,Total,252,17,269
MANIPUR,2009,Upto 3 months,137,15,152
MANIPUR,2009,3-6 months,73,13,86
MANIPUR,2009,6-12 months,60,2,62
MANIPUR,2009,1-2 Years,31,0,31
MANIPUR,2009,2-3 Years,6,0,6
MANIPUR,2009,3-5 Years,4,0,4
MANIPUR,2009,Above 5 Years,12,2,14
MANIPUR,2009,Total,323,32,355
MANIPUR,2010,Upto 3 months,143,2,145
MANIPUR,2010,3-6 months,76,3,79
MANIPUR,2010,6-12 months,62,2,64
MANIPUR,2010,1-2 Years,56,2,58
MANIPUR,2010,2-3 Years,13,0,13
MANIPUR,2010,3-5 Years,5,0,5
MANIPUR,2010,Above 5 Years,8,1,9
MANIPUR,2010,Total,363,10,373
MANIPUR,2011,Upto 3 months,173,16,189
MANIPUR,2011,3-6 months,105,5,110
MANIPUR,2011,6-12 months,73,4,77
MANIPUR,2011,1-2 Years,43,0,43
MANIPUR,2011,2-3 Years,14,0,14
MANIPUR,2011,3-5 Years,12,0,12
MANIPUR,2011,Above 5 Years,8,1,9
MANIPUR,2011,Total,428,26,454
MANIPUR,2012,Upto 3 months,205,11,216
MANIPUR,2012,3-6 months,142,6,148
MANIPUR,2012,6-12 months,83,3,86
MANIPUR,2012,1-2 Years,43,1,44
MANIPUR,2012,2-3 Years,14,0,14
MANIPUR,2012,3-5 Years,8,0,8
MANIPUR,2012,Above 5 Years,11,0,11
MANIPUR,2012,Total,506,21,527
MEGHALAYA,2001,Upto 3 months,174,2,176
MEGHALAYA,2001,3-6 months,141,1,142
MEGHALAYA,2001,6-12 months,87,2,89
MEGHALAYA,2001,1-2 Years,44,2,46
MEGHALAYA,2001,2-3 Years,27,0,27
MEGHALAYA,2001,3-5 Years,18,0,18
MEGHALAYA,2001,Above 5 Years,6,1,7
MEGHALAYA,2001,Total,497,8,505
MEGHALAYA,2002,Upto 3 months,146,2,148
MEGHALAYA,2002,3-6 months,117,1,118
MEGHALAYA,2002,6-12 months,107,3,110
MEGHALAYA,2002,1-2 Years,67,4,71
MEGHALAYA,2002,2-3 Years,30,0,30
MEGHALAYA,2002,3-5 Years,17,1,18
MEGHALAYA,2002,Above 5 Years,11,0,11
MEGHALAYA,2002,Total,495,11,506
MEGHALAYA,2003,Upto 3 months,104,2,106
MEGHALAYA,2003,3-6 months,164,2,166
MEGHALAYA,2003,6-12 months,78,0,78
MEGHALAYA,2003,1-2 Years,61,3,64
MEGHALAYA,2003,2-3 Years,53,1,54
MEGHALAYA,2003,3-5 Years,35,0,35
MEGHALAYA,2003,Above 5 Years,5,0,5
MEGHALAYA,2003,Total,500,8,508
MEGHALAYA,2004,Upto 3 months,160,0,160
MEGHALAYA,2004,3-6 months,43,0,43
MEGHALAYA,2004,6-12 months,62,9,71
MEGHALAYA,2004,1-2 Years,65,0,65
MEGHALAYA,2004,2-3 Years,44,0,44
MEGHALAYA,2004,3-5 Years,29,0,29
MEGHALAYA,2004,Above 5 Years,17,1,18
MEGHALAYA,2004,Total,420,10,430
MEGHALAYA,2005,Upto 3 months,208,0,208
MEGHALAYA,2005,3-6 months,75,0,75
MEGHALAYA,2005,6-12 months,71,4,75
MEGHALAYA,2005,1-2 Years,58,4,62
MEGHALAYA,2005,2-3 Years,28,0,28
MEGHALAYA,2005,3-5 Years,24,0,24
MEGHALAYA,2005,Above 5 Years,14,1,15
MEGHALAYA,2005,Total,478,9,487
MEGHALAYA,2006,Upto 3 months,171,1,172
MEGHALAYA,2006,3-6 months,69,2,71
MEGHALAYA,2006,6-12 months,85,3,88
MEGHALAYA,2006,1-2 Years,97,1,98
MEGHALAYA,2006,2-3 Years,52,0,52
MEGHALAYA,2006,3-5 Years,39,0,39
MEGHALAYA,2006,Above 5 Years,19,0,19
MEGHALAYA,2006,Total,532,7,539
MEGHALAYA,2007,Upto 3 months,207,0,207
MEGHALAYA,2007,3-6 months,89,1,90
MEGHALAYA,2007,6-12 months,82,3,85
MEGHALAYA,2007,1-2 Years,69,0,69
MEGHALAYA,2007,2-3 Years,43,0,43
MEGHALAYA,2007,3-5 Years,41,0,41
MEGHALAYA,2007,Above 5 Years,22,0,22
MEGHALAYA,2007,Total,553,4,557
MEGHALAYA,2008,Upto 3 months,189,0,189
MEGHALAYA,2008,3-6 months,91,1,92
MEGHALAYA,2008,6-12 months,74,2,76
MEGHALAYA,2008,1-2 Years,54,1,55
MEGHALAYA,2008,2-3 Years,38,0,38
MEGHALAYA,2008,3-5 Years,27,0,27
MEGHALAYA,2008,Above 5 Years,3,0,3
MEGHALAYA,2008,Total,476,4,480
MEGHALAYA,2009,Upto 3 months,118,3,121
MEGHALAYA,2009,3-6 months,105,0,105
MEGHALAYA,2009,6-12 months,135,2,137
MEGHALAYA,2009,1-2 Years,0,0,0
MEGHALAYA,2009,2-3 Years,114,2,116
MEGHALAYA,2009,3-5 Years,22,0,22
MEGHALAYA,2009,Above 5 Years,19,0,19
MEGHALAYA,2009,Total,513,7,520
MEGHALAYA,2010,Upto 3 months,146,2,148
MEGHALAYA,2010,3-6 months,89,1,90
MEGHALAYA,2010,6-12 months,93,2,95
MEGHALAYA,2010,1-2 Years,89,1,90
MEGHALAYA,2010,2-3 Years,52,0,52
MEGHALAYA,2010,3-5 Years,29,0,29
MEGHALAYA,2010,Above 5 Years,9,0,9
MEGHALAYA,2010,Total,507,6,513
MEGHALAYA,2011,Upto 3 months,136,6,142
MEGHALAYA,2011,3-6 months,126,3,129
MEGHALAYA,2011,6-12 months,105,1,106
MEGHALAYA,2011,1-2 Years,55,1,56
MEGHALAYA,2011,2-3 Years,20,1,21
MEGHALAYA,2011,3-5 Years,15,0,15
MEGHALAYA,2011,Above 5 Years,9,0,9
MEGHALAYA,2011,Total,466,12,478
MEGHALAYA,2012,Upto 3 months,242,6,248
MEGHALAYA,2012,3-6 months,108,3,111
MEGHALAYA,2012,6-12 months,106,0,106
MEGHALAYA,2012,1-2 Years,48,1,49
MEGHALAYA,2012,2-3 Years,46,2,48
MEGHALAYA,2012,3-5 Years,28,0,28
MEGHALAYA,2012,Above 5 Years,15,0,15
MEGHALAYA,2012,Total,593,12,605
MIZORAM,2001,Upto 3 months,440,36,476
MIZORAM,2001,3-6 months,154,20,174
MIZORAM,2001,6-12 months,29,14,43
MIZORAM,2001,1-2 Years,5,2,7
MIZORAM,2001,2-3 Years,3,0,3
MIZORAM,2001,3-5 Years,1,0,1
MIZORAM,2001,Above 5 Years,0,0,0
MIZORAM,2001,Total,632,72,704
MIZORAM,2002,Upto 3 months,77,13,90
MIZORAM,2002,3-6 months,250,39,289
MIZORAM,2002,6-12 months,81,3,84
MIZORAM,2002,1-2 Years,34,4,38
MIZORAM,2002,2-3 Years,27,5,32
MIZORAM,2002,3-5 Years,20,1,21
MIZORAM,2002,Above 5 Years,27,0,27
MIZORAM,2002,Total,516,65,581
MIZORAM,2003,Upto 3 months,412,54,466
MIZORAM,2003,3-6 months,79,11,90
MIZORAM,2003,6-12 months,42,3,45
MIZORAM,2003,1-2 Years,24,0,24
MIZORAM,2003,2-3 Years,10,0,10
MIZORAM,2003,3-5 Years,0,0,0
MIZORAM,2003,Above 5 Years,0,0,0
MIZORAM,2003,Total,567,68,635
MIZORAM,2004,Upto 3 months,314,37,351
MIZORAM,2004,3-6 months,127,24,151
MIZORAM,2004,6-12 months,188,25,213
MIZORAM,2004,1-2 Years,20,0,20
MIZORAM,2004,2-3 Years,7,0,7
MIZORAM,2004,3-5 Years,0,0,0
MIZORAM,2004,Above 5 Years,0,0,0
MIZORAM,2004,Total,656,86,742
MIZORAM,2005,Upto 3 months,345,28,373
MIZORAM,2005,3-6 months,58,18,76
MIZORAM,2005,6-12 months,32,13,45
MIZORAM,2005,1-2 Years,27,0,27
MIZORAM,2005,2-3 Years,21,0,21
MIZORAM,2005,3-5 Years,0,0,0
MIZORAM,2005,Above 5 Years,0,0,0
MIZORAM,2005,Total,483,59,542
MIZORAM,2006,Upto 3 months,324,43,367
MIZORAM,2006,3-6 months,60,10,70
MIZORAM,2006,6-12 months,44,7,51
MIZORAM,2006,1-2 Years,15,2,17
MIZORAM,2006,2-3 Years,7,1,8
MIZORAM,2006,3-5 Years,3,0,3
MIZORAM,2006,Above 5 Years,0,0,0
MIZORAM,2006,Total,453,63,516
MIZORAM,2007,Upto 3 months,310,65,375
MIZORAM,2007,3-6 months,120,5,125
MIZORAM,2007,6-12 months,66,3,69
MIZORAM,2007,1-2 Years,45,0,45
MIZORAM,2007,2-3 Years,14,0,14
MIZORAM,2007,3-5 Years,6,0,6
MIZORAM,2007,Above 5 Years,1,0,1
MIZORAM,2007,Total,562,73,635
MIZORAM,2008,Upto 3 months,259,43,302
MIZORAM,2008,3-6 months,70,4,74
MIZORAM,2008,6-12 months,35,0,35
MIZORAM,2008,1-2 Years,24,0,24
MIZORAM,2008,2-3 Years,14,0,14
MIZORAM,2008,3-5 Years,12,0,12
MIZORAM,2008,Above 5 Years,0,0,0
MIZORAM,2008,Total,414,47,461
MIZORAM,2009,Upto 3 months,255,40,295
MIZORAM,2009,3-6 months,51,3,54
MIZORAM,2009,6-12 months,25,2,27
MIZORAM,2009,1-2 Years,26,0,26
MIZORAM,2009,2-3 Years,5,0,5
MIZORAM,2009,3-5 Years,5,0,5
MIZORAM,2009,Above 5 Years,0,0,0
MIZORAM,2009,Total,367,45,412
MIZORAM,2010,Upto 3 months,300,55,355
MIZORAM,2010,3-6 months,87,0,87
MIZORAM,2010,6-12 months,54,0,54
MIZORAM,2010,1-2 Years,25,5,30
MIZORAM,2010,2-3 Years,10,0,10
MIZORAM,2010,3-5 Years,5,0,5
MIZORAM,2010,Above 5 Years,0,0,0
MIZORAM,2010,Total,481,60,541
MIZORAM,2011,Upto 3 months,343,38,381
MIZORAM,2011,3-6 months,61,10,71
MIZORAM,2011,6-12 months,25,4,29
MIZORAM,2011,1-2 Years,8,0,8
MIZORAM,2011,2-3 Years,6,0,6
MIZORAM,2011,3-5 Years,4,0,4
MIZORAM,2011,Above 5 Years,0,0,0
MIZORAM,2011,Total,447,52,499
MIZORAM,2012,Upto 3 months,381,47,428
MIZORAM,2012,3-6 months,52,2,54
MIZORAM,2012,6-12 months,22,4,26
MIZORAM,2012,1-2 Years,15,0,15
MIZORAM,2012,2-3 Years,5,0,5
MIZORAM,2012,3-5 Years,0,0,0
MIZORAM,2012,Above 5 Years,0,0,0
MIZORAM,2012,Total,475,53,528
NAGALAND,2001,Upto 3 months,88,2,90
NAGALAND,2001,3-6 months,107,5,112
NAGALAND,2001,6-12 months,117,9,126
NAGALAND,2001,1-2 Years,105,2,107
NAGALAND,2001,2-3 Years,74,0,74
NAGALAND,2001,3-5 Years,30,0,30
NAGALAND,2001,Above 5 Years,6,0,6
NAGALAND,2001,Total,527,18,545
NAGALAND,2002,Upto 3 months,104,3,107
NAGALAND,2002,3-6 months,140,5,145
NAGALAND,2002,6-12 months,117,2,119
NAGALAND,2002,1-2 Years,102,1,103
NAGALAND,2002,2-3 Years,53,0,53
NAGALAND,2002,3-5 Years,11,0,11
NAGALAND,2002,Above 5 Years,6,0,6
NAGALAND,2002,Total,533,11,544
NAGALAND,2003,Upto 3 months,62,2,64
NAGALAND,2003,3-6 months,117,7,124
NAGALAND,2003,6-12 months,101,3,104
NAGALAND,2003,1-2 Years,70,1,71
NAGALAND,2003,2-3 Years,32,0,32
NAGALAND,2003,3-5 Years,9,0,9
NAGALAND,2003,Above 5 Years,3,0,3
NAGALAND,2003,Total,394,13,407
NAGALAND,2004,Upto 3 months,73,4,77
NAGALAND,2004,3-6 months,140,7,147
NAGALAND,2004,6-12 months,87,3,90
NAGALAND,2004,1-2 Years,41,2,43
NAGALAND,2004,2-3 Years,23,0,23
NAGALAND,2004,3-5 Years,7,0,7
NAGALAND,2004,Above 5 Years,3,0,3
NAGALAND,2004,Total,374,16,390
NAGALAND,2005,Upto 3 months,187,4,191
NAGALAND,2005,3-6 months,154,7,161
NAGALAND,2005,6-12 months,98,5,103
NAGALAND,2005,1-2 Years,23,0,23
NAGALAND,2005,2-3 Years,4,0,4
NAGALAND,2005,3-5 Years,2,0,2
NAGALAND,2005,Above 5 Years,0,0,0
NAGALAND,2005,Total,468,16,484
NAGALAND,2006,Upto 3 months,72,1,73
NAGALAND,2006,3-6 months,174,7,181
NAGALAND,2006,6-12 months,108,4,112
NAGALAND,2006,1-2 Years,97,2,99
NAGALAND,2006,2-3 Years,37,3,40
NAGALAND,2006,3-5 Years,10,2,12
NAGALAND,2006,Above 5 Years,0,0,0
NAGALAND,2006,Total,498,19,517
NAGALAND,2007,Upto 3 months,172,3,175
NAGALAND,2007,3-6 months,109,5,114
NAGALAND,2007,6-12 months,71,3,74
NAGALAND,2007,1-2 Years,20,1,21
NAGALAND,2007,2-3 Years,1,0,1
NAGALAND,2007,3-5 Years,7,0,7
NAGALAND,2007,Above 5 Years,2,0,2
NAGALAND,2007,Total,382,12,394
NAGALAND,2008,Upto 3 months,197,6,203
NAGALAND,2008,3-6 months,78,3,81
NAGALAND,2008,6-12 months,69,1,70
NAGALAND,2008,1-2 Years,37,0,37
NAGALAND,2008,2-3 Years,2,0,2
NAGALAND,2008,3-5 Years,2,0,2
NAGALAND,2008,Above 5 Years,1,0,1
NAGALAND,2008,Total,386,10,396
NAGALAND,2009,Upto 3 months,163,9,172
NAGALAND,2009,3-6 months,132,1,133
NAGALAND,2009,6-12 months,69,3,72
NAGALAND,2009,1-2 Years,31,0,31
NAGALAND,2009,2-3 Years,11,2,13
NAGALAND,2009,3-5 Years,6,0,6
NAGALAND,2009,Above 5 Years,0,0,0
NAGALAND,2009,Total,412,15,427
NAGALAND,2010,Upto 3 months,130,6,136
NAGALAND,2010,3-6 months,100,3,103
NAGALAND,2010,6-12 months,50,2,52
NAGALAND,2010,1-2 Years,20,2,22
NAGALAND,2010,2-3 Years,8,1,9
NAGALAND,2010,3-5 Years,3,0,3
NAGALAND,2010,Above 5 Years,0,0,0
NAGALAND,2010,Total,311,14,325
NAGALAND,2011,Upto 3 months,78,3,81
NAGALAND,2011,3-6 months,82,2,84
NAGALAND,2011,6-12 months,61,1,62
NAGALAND,2011,1-2 Years,52,1,53
NAGALAND,2011,2-3 Years,12,1,13
NAGALAND,2011,3-5 Years,6,0,6
NAGALAND,2011,Above 5 Years,0,0,0
NAGALAND,2011,Total,291,8,299
NAGALAND,2012,Upto 3 months,94,4,98
NAGALAND,2012,3-6 months,61,3,64
NAGALAND,2012,6-12 months,46,1,47
NAGALAND,2012,1-2 Years,20,1,21
NAGALAND,2012,2-3 Years,15,0,15
NAGALAND,2012,3-5 Years,6,1,7
NAGALAND,2012,Above 5 Years,1,0,1
NAGALAND,2012,Total,243,10,253
ORISSA,2001,Upto 3 months,2857,107,2964
ORISSA,2001,3-6 months,2175,66,2241
ORISSA,2001,6-12 months,1388,26,1414
ORISSA,2001,1-2 Years,1270,28,1298
ORISSA,2001,2-3 Years,511,13,524
ORISSA,2001,3-5 Years,295,9,304
ORISSA,2001,Above 5 Years,23,0,23
ORISSA,2001,Total,8519,249,8768
ORISSA,2002,Upto 3 months,3816,149,3965
ORISSA,2002,3-6 months,2185,54,2239
ORISSA,2002,6-12 months,1436,47,1483
ORISSA,2002,1-2 Years,1044,29,1073
ORISSA,2002,2-3 Years,517,13,530
ORISSA,2002,3-5 Years,295,0,295
ORISSA,2002,Above 5 Years,31,0,31
ORISSA,2002,Total,9324,292,9616
ORISSA,2003,Upto 3 months,4293,133,4426
ORISSA,2003,3-6 months,2421,51,2472
ORISSA,2003,6-12 months,1896,60,1956
ORISSA,2003,1-2 Years,520,32,552
ORISSA,2003,2-3 Years,189,14,203
ORISSA,2003,3-5 Years,23,0,23
ORISSA,2003,Above 5 Years,8,0,8
ORISSA,2003,Total,9350,290,9640
ORISSA,2004,Upto 3 months,2750,199,2949
ORISSA,2004,3-6 months,1724,39,1763
ORISSA,2004,6-12 months,1102,22,1124
ORISSA,2004,1-2 Years,2958,19,2977
ORISSA,2004,2-3 Years,391,12,403
ORISSA,2004,3-5 Years,189,4,193
ORISSA,2004,Above 5 Years,35,0,35
ORISSA,2004,Total,9149,295,9444
ORISSA,2005,Upto 3 months,4412,138,4550
ORISSA,2005,3-6 months,1760,119,1879
ORISSA,2005,6-12 months,1547,40,1587
ORISSA,2005,1-2 Years,1073,31,1104
ORISSA,2005,2-3 Years,349,6,355
ORISSA,2005,3-5 Years,193,8,201
ORISSA,2005,Above 5 Years,44,0,44
ORISSA,2005,Total,9378,342,9720
ORISSA,2006,Upto 3 months,4399,163,4562
ORISSA,2006,3-6 months,2135,118,2253
ORISSA,2006,6-12 months,1501,62,1563
ORISSA,2006,1-2 Years,1234,19,1253
ORISSA,2006,2-3 Years,361,19,380
ORISSA,2006,3-5 Years,198,5,203
ORISSA,2006,Above 5 Years,33,0,33
ORISSA,2006,Total,9861,386,10247
ORISSA,2007,Upto 3 months,5092,212,5304
ORISSA,2007,3-6 months,2029,176,2205
ORISSA,2007,6-12 months,1694,88,1782
ORISSA,2007,1-2 Years,1020,29,1049
ORISSA,2007,2-3 Years,419,8,427
ORISSA,2007,3-5 Years,201,4,205
ORISSA,2007,Above 5 Years,48,0,48
ORISSA,2007,Total,10503,517,11020
ORISSA,2008,Upto 3 months,4033,185,4218
ORISSA,2008,3-6 months,2348,110,2458
ORISSA,2008,6-12 months,1641,63,1704
ORISSA,2008,1-2 Years,1025,31,1056
ORISSA,2008,2-3 Years,331,10,341
ORISSA,2008,3-5 Years,242,2,244
ORISSA,2008,Above 5 Years,40,0,40
ORISSA,2008,Total,9660,401,10061
ORISSA,2009,Upto 3 months,3992,152,4144
ORISSA,2009,3-6 months,2176,102,2278
ORISSA,2009,6-12 months,1513,88,1601
ORISSA,2009,1-2 Years,819,35,854
ORISSA,2009,2-3 Years,321,12,333
ORISSA,2009,3-5 Years,251,2,253
ORISSA,2009,Above 5 Years,48,0,48
ORISSA,2009,Total,9120,391,9511
ORISSA,2010,Upto 3 months,3521,218,3739
ORISSA,2010,3-6 months,2132,94,2226
ORISSA,2010,6-12 months,1195,28,1223
ORISSA,2010,1-2 Years,984,24,1008
ORISSA,2010,2-3 Years,24,5,29
ORISSA,2010,3-5 Years,193,7,200
ORISSA,2010,Above 5 Years,53,0,53
ORISSA,2010,Total,8102,376,8478
ORISSA,2011,Upto 3 months,3313,201,3514
ORISSA,2011,3-6 months,2713,50,2763
ORISSA,2011,6-12 months,1298,47,1345
ORISSA,2011,1-2 Years,909,25,934
ORISSA,2011,2-3 Years,284,3,287
ORISSA,2011,3-5 Years,163,5,168
ORISSA,2011,Above 5 Years,41,0,41
ORISSA,2011,Total,8721,331,9052
ORISSA,2012,Upto 3 months,3821,210,4031
ORISSA,2012,3-6 months,2223,64,2287
ORISSA,2012,6-12 months,1244,40,1284
ORISSA,2012,1-2 Years,1021,40,1061
ORISSA,2012,2-3 Years,333,12,345
ORISSA,2012,3-5 Years,182,3,185
ORISSA,2012,Above 5 Years,42,2,44
ORISSA,2012,Total,8866,371,9237
PUNJAB,2001,Upto 3 months,3068,179,3247
PUNJAB,2001,3-6 months,2240,118,2358
PUNJAB,2001,6-12 months,646,95,741
PUNJAB,2001,1-2 Years,829,48,877
PUNJAB,2001,2-3 Years,511,6,517
PUNJAB,2001,3-5 Years,433,7,440
PUNJAB,2001,Above 5 Years,28,0,28
PUNJAB,2001,Total,7755,453,8208
PUNJAB,2002,Upto 3 months,4021,220,4241
PUNJAB,2002,3-6 months,1540,120,1660
PUNJAB,2002,6-12 months,1120,70,1190
PUNJAB,2002,1-2 Years,640,31,671
PUNJAB,2002,2-3 Years,321,30,351
PUNJAB,2002,3-5 Years,0,0,0
PUNJAB,2002,Above 5 Years,0,0,0
PUNJAB,2002,Total,7642,471,8113
PUNJAB,2003,Upto 3 months,3913,203,4116
PUNJAB,2003,3-6 months,1465,130,1595
PUNJAB,2003,6-12 months,1148,90,1238
PUNJAB,2003,1-2 Years,748,75,823
PUNJAB,2003,2-3 Years,617,31,648
PUNJAB,2003,3-5 Years,353,9,362
PUNJAB,2003,Above 5 Years,0,0,0
PUNJAB,2003,Total,8244,538,8782
PUNJAB,2004,Upto 3 months,4125,181,4306
PUNJAB,2004,3-6 months,1502,115,1617
PUNJAB,2004,6-12 months,1460,88,1548
PUNJAB,2004,1-2 Years,895,82,977
PUNJAB,2004,2-3 Years,728,25,753
PUNJAB,2004,3-5 Years,460,6,466
PUNJAB,2004,Above 5 Years,330,4,334
PUNJAB,2004,Total,9500,501,10001
PUNJAB,2005,Upto 3 months,4036,175,4211
PUNJAB,2005,3-6 months,1625,156,1781
PUNJAB,2005,6-12 months,1220,98,1318
PUNJAB,2005,1-2 Years,648,63,711
PUNJAB,2005,2-3 Years,632,40,672
PUNJAB,2005,3-5 Years,523,4,527
PUNJAB,2005,Above 5 Years,345,7,352
PUNJAB,2005,Total,9029,543,9572
PUNJAB,2006,Upto 3 months,4119,173,4292
PUNJAB,2006,3-6 months,1678,155,1833
PUNJAB,2006,6-12 months,1233,97,1330
PUNJAB,2006,1-2 Years,657,55,712
PUNJAB,2006,2-3 Years,638,33,671
PUNJAB,2006,3-5 Years,535,1,536
PUNJAB,2006,Above 5 Years,372,5,377
PUNJAB,2006,Total,9232,519,9751
PUNJAB,2007,Upto 3 months,4295,187,4482
PUNJAB,2007,3-6 months,1852,170,2022
PUNJAB,2007,6-12 months,1408,111,1519
PUNJAB,2007,1-2 Years,832,70,902
PUNJAB,2007,2-3 Years,813,47,860
PUNJAB,2007,3-5 Years,614,16,630
PUNJAB,2007,Above 5 Years,546,20,566
PUNJAB,2007,Total,10360,621,10981
PUNJAB,2008,Upto 3 months,3760,156,3916
PUNJAB,2008,3-6 months,1893,160,2053
PUNJAB,2008,6-12 months,1449,102,1551
PUNJAB,2008,1-2 Years,873,68,941
PUNJAB,2008,2-3 Years,854,43,897
PUNJAB,2008,3-5 Years,655,13,668
PUNJAB,2008,Above 5 Years,587,16,603
PUNJAB,2008,Total,10071,558,10629
PUNJAB,2009,Upto 3 months,3879,176,4055
PUNJAB,2009,3-6 months,1996,181,2177
PUNJAB,2009,6-12 months,1548,114,1662
PUNJAB,2009,1-2 Years,977,71,1048
PUNJAB,2009,2-3 Years,952,46,998
PUNJAB,2009,3-5 Years,749,22,771
PUNJAB,2009,Above 5 Years,661,19,680
PUNJAB,2009,Total,10762,629,11391
PUNJAB,2010,Upto 3 months,4256,239,4495
PUNJAB,2010,3-6 months,2226,199,2425
PUNJAB,2010,6-12 months,1540,118,1658
PUNJAB,2010,1-2 Years,1278,65,1343
PUNJAB,2010,2-3 Years,903,29,932
PUNJAB,2010,3-5 Years,130,12,142
PUNJAB,2010,Above 5 Years,0,0,0
PUNJAB,2010,Total,10333,662,10995
PUNJAB,2011,Upto 3 months,4131,219,4350
PUNJAB,2011,3-6 months,2131,185,2316
PUNJAB,2011,6-12 months,1420,104,1524
PUNJAB,2011,1-2 Years,1168,51,1219
PUNJAB,2011,2-3 Years,793,18,811
PUNJAB,2011,3-5 Years,69,6,75
PUNJAB,2011,Above 5 Years,0,0,0
PUNJAB,2011,Total,9712,583,10295
PUNJAB,2012,Upto 3 months,3676,240,3916
PUNJAB,2012,3-6 months,3921,234,4155
PUNJAB,2012,6-12 months,2983,171,3154
PUNJAB,2012,1-2 Years,1791,119,1910
PUNJAB,2012,2-3 Years,1219,56,1275
PUNJAB,2012,3-5 Years,614,32,646
PUNJAB,2012,Above 5 Years,304,13,317
PUNJAB,2012,Total,14508,865,15373
RAJASTHAN,2001,Upto 3 months,3563,129,3692
RAJASTHAN,2001,3-6 months,1558,36,1594
RAJASTHAN,2001,6-12 months,1552,46,1598
RAJASTHAN,2001,1-2 Years,1205,45,1250
RAJASTHAN,2001,2-3 Years,471,11,482
RAJASTHAN,2001,3-5 Years,106,1,107
RAJASTHAN,2001,Above 5 Years,14,0,14
RAJASTHAN,2001,Total,8469,268,8737
RAJASTHAN,2002,Upto 3 months,2816,91,2907
RAJASTHAN,2002,3-6 months,1453,45,1498
RAJASTHAN,2002,6-12 months,1362,38,1400
RAJASTHAN,2002,1-2 Years,998,24,1022
RAJASTHAN,2002,2-3 Years,349,6,355
RAJASTHAN,2002,3-5 Years,112,3,115
RAJASTHAN,2002,Above 5 Years,25,0,25
RAJASTHAN,2002,Total,7115,207,7322
RAJASTHAN,2003,Upto 3 months,2543,96,2639
RAJASTHAN,2003,3-6 months,1399,43,1442
RAJASTHAN,2003,6-12 months,1330,45,1375
RAJASTHAN,2003,1-2 Years,726,28,754
RAJASTHAN,2003,2-3 Years,298,4,302
RAJASTHAN,2003,3-5 Years,62,2,64
RAJASTHAN,2003,Above 5 Years,8,0,8
RAJASTHAN,2003,Total,6366,218,6584
RAJASTHAN,2004,Upto 3 months,2696,109,2805
RAJASTHAN,2004,3-6 months,1757,83,1840
RAJASTHAN,2004,6-12 months,1485,40,1525
RAJASTHAN,2004,1-2 Years,736,18,754
RAJASTHAN,2004,2-3 Years,275,3,278
RAJASTHAN,2004,3-5 Years,69,0,69
RAJASTHAN,2004,Above 5 Years,10,2,12
RAJASTHAN,2004,Total,7028,255,7283
RAJASTHAN,2005,Upto 3 months,3070,109,3179
RAJASTHAN,2005,3-6 months,1464,58,1522
RAJASTHAN,2005,6-12 months,1364,49,1413
RAJASTHAN,2005,1-2 Years,777,15,792
RAJASTHAN,2005,2-3 Years,361,9,370
RAJASTHAN,2005,3-5 Years,71,6,77
RAJASTHAN,2005,Above 5 Years,9,1,10
RAJASTHAN,2005,Total,7116,247,7363
RAJASTHAN,2006,Upto 3 months,3683,136,3819
RAJASTHAN,2006,3-6 months,1591,69,1660
RAJASTHAN,2006,6-12 months,1370,37,1407
RAJASTHAN,2006,1-2 Years,1000,24,1024
RAJASTHAN,2006,2-3 Years,291,13,304
RAJASTHAN,2006,3-5 Years,59,5,64
RAJASTHAN,2006,Above 5 Years,10,0,10
RAJASTHAN,2006,Total,8004,284,8288
RAJASTHAN,2007,Upto 3 months,3332,143,3475
RAJASTHAN,2007,3-6 months,1674,99,1773
RAJASTHAN,2007,6-12 months,1738,62,1800
RAJASTHAN,2007,1-2 Years,1106,29,1135
RAJASTHAN,2007,2-3 Years,449,5,454
RAJASTHAN,2007,3-5 Years,110,4,114
RAJASTHAN,2007,Above 5 Years,14,0,14
RAJASTHAN,2007,Total,8423,342,8765
RAJASTHAN,2008,Upto 3 months,3331,110,3441
RAJASTHAN,2008,3-6 months,1934,75,2009
RAJASTHAN,2008,6-12 months,1735,74,1809
RAJASTHAN,2008,1-2 Years,1221,52,1273
RAJASTHAN,2008,2-3 Years,406,17,423
RAJASTHAN,2008,3-5 Years,139,1,140
RAJASTHAN,2008,Above 5 Years,24,1,25
RAJASTHAN,2008,Total,8790,330,9120
RAJASTHAN,2009,Upto 3 months,3963,107,4070
RAJASTHAN,2009,3-6 months,2311,88,2399
RAJASTHAN,2009,6-12 months,2311,104,2415
RAJASTHAN,2009,1-2 Years,1470,79,1549
RAJASTHAN,2009,2-3 Years,583,29,612
RAJASTHAN,2009,3-5 Years,216,0,216
RAJASTHAN,2009,Above 5 Years,48,4,52
RAJASTHAN,2009,Total,10902,411,11313
RAJASTHAN,2010,Upto 3 months,3731,131,3862
RAJASTHAN,2010,3-6 months,2201,82,2283
RAJASTHAN,2010,6-12 months,2124,89,2213
RAJASTHAN,2010,1-2 Years,1523,66,1589
RAJASTHAN,2010,2-3 Years,668,10,678
RAJASTHAN,2010,3-5 Years,247,3,250
RAJASTHAN,2010,Above 5 Years,49,4,53
RAJASTHAN,2010,Total,10543,385,10928
RAJASTHAN,2011,Upto 3 months,3886,148,4034
RAJASTHAN,2011,3-6 months,2230,81,2311
RAJASTHAN,2011,6-12 months,2281,81,2362
RAJASTHAN,2011,1-2 Years,1825,68,1893
RAJASTHAN,2011,2-3 Years,816,25,841
RAJASTHAN,2011,3-5 Years,404,12,416
RAJASTHAN,2011,Above 5 Years,38,4,42
RAJASTHAN,2011,Total,11480,419,11899
RAJASTHAN,2012,Upto 3 months,4246,154,4400
RAJASTHAN,2012,3-6 months,2651,79,2730
RAJASTHAN,2012,6-12 months,2391,96,2487
RAJASTHAN,2012,1-2 Years,1901,61,1962
RAJASTHAN,2012,2-3 Years,987,34,1021
RAJASTHAN,2012,3-5 Years,435,18,453
RAJASTHAN,2012,Above 5 Years,104,13,117
RAJASTHAN,2012,Total,12715,455,13170
SIKKIM,2001,Upto 3 months,3,0,3
SIKKIM,2001,3-6 months,8,0,8
SIKKIM,2001,6-12 months,6,0,6
SIKKIM,2001,1-2 Years,52,0,52
SIKKIM,2001,2-3 Years,35,0,35
SIKKIM,2001,3-5 Years,5,0,5
SIKKIM,2001,Above 5 Years,0,0,0
SIKKIM,2001,Total,109,0,109
SIKKIM,2002,Upto 3 months,18,0,18
SIKKIM,2002,3-6 months,21,1,22
SIKKIM,2002,6-12 months,32,0,32
SIKKIM,2002,1-2 Years,12,1,13
SIKKIM,2002,2-3 Years,6,0,6
SIKKIM,2002,3-5 Years,0,0,0
SIKKIM,2002,Above 5 Years,0,0,0
SIKKIM,2002,Total,89,2,91
SIKKIM,2003,Upto 3 months,17,0,17
SIKKIM,2003,3-6 months,21,0,21
SIKKIM,2003,6-12 months,33,2,35
SIKKIM,2003,1-2 Years,12,0,12
SIKKIM,2003,2-3 Years,4,0,4
SIKKIM,2003,3-5 Years,0,0,0
SIKKIM,2003,Above 5 Years,0,0,0
SIKKIM,2003,Total,87,2,89
SIKKIM,2004,Upto 3 months,49,0,49
SIKKIM,2004,3-6 months,14,0,14
SIKKIM,2004,6-12 months,18,0,18
SIKKIM,2004,1-2 Years,16,0,16
SIKKIM,2004,2-3 Years,2,0,2
SIKKIM,2004,3-5 Years,0,0,0
SIKKIM,2004,Above 5 Years,0,0,0
SIKKIM,2004,Total,99,0,99
SIKKIM,2005,Upto 3 months,54,1,55
SIKKIM,2005,3-6 months,20,4,24
SIKKIM,2005,6-12 months,22,0,22
SIKKIM,2005,1-2 Years,19,0,19
SIKKIM,2005,2-3 Years,2,0,2
SIKKIM,2005,3-5 Years,0,0,0
SIKKIM,2005,Above 5 Years,0,0,0
SIKKIM,2005,Total,117,5,122
SIKKIM,2006,Upto 3 months,39,0,39
SIKKIM,2006,3-6 months,29,0,29
SIKKIM,2006,6-12 months,26,0,26
SIKKIM,2006,1-2 Years,27,0,27
SIKKIM,2006,2-3 Years,7,2,9
SIKKIM,2006,3-5 Years,4,0,4
SIKKIM,2006,Above 5 Years,0,0,0
SIKKIM,2006,Total,132,2,134
SIKKIM,2007,Upto 3 months,25,1,26
SIKKIM,2007,3-6 months,39,1,40
SIKKIM,2007,6-12 months,22,0,22
SIKKIM,2007,1-2 Years,29,0,29
SIKKIM,2007,2-3 Years,14,0,14
SIKKIM,2007,3-5 Years,12,1,13
SIKKIM,2007,Above 5 Years,0,0,0
SIKKIM,2007,Total,141,3,144
SIKKIM,2008,Upto 3 months,50,3,53
SIKKIM,2008,3-6 months,48,1,49
SIKKIM,2008,6-12 months,38,2,40
SIKKIM,2008,1-2 Years,13,1,14
SIKKIM,2008,2-3 Years,21,0,21
SIKKIM,2008,3-5 Years,9,1,10
SIKKIM,2008,Above 5 Years,5,0,5
SIKKIM,2008,Total,184,8,192
SIKKIM,2009,Upto 3 months,34,4,38
SIKKIM,2009,3-6 months,27,0,27
SIKKIM,2009,6-12 months,16,0,16
SIKKIM,2009,1-2 Years,18,1,19
SIKKIM,2009,2-3 Years,7,0,7
SIKKIM,2009,3-5 Years,12,0,12
SIKKIM,2009,Above 5 Years,4,1,5
SIKKIM,2009,Total,118,6,124
SIKKIM,2010,Upto 3 months,46,0,46
SIKKIM,2010,3-6 months,19,4,23
SIKKIM,2010,6-12 months,22,1,23
SIKKIM,2010,1-2 Years,19,0,19
SIKKIM,2010,2-3 Years,9,0,9
SIKKIM,2010,3-5 Years,6,0,6
SIKKIM,2010,Above 5 Years,5,0,5
SIKKIM,2010,Total,126,5,131
SIKKIM,2011,Upto 3 months,46,1,47
SIKKIM,2011,3-6 months,26,0,26
SIKKIM,2011,6-12 months,26,0,26
SIKKIM,2011,1-2 Years,10,0,10
SIKKIM,2011,2-3 Years,8,0,8
SIKKIM,2011,3-5 Years,3,0,3
SIKKIM,2011,Above 5 Years,0,0,0
SIKKIM,2011,Total,119,1,120
SIKKIM,2012,Upto 3 months,49,0,49
SIKKIM,2012,3-6 months,45,3,48
SIKKIM,2012,6-12 months,22,2,24
SIKKIM,2012,1-2 Years,17,0,17
SIKKIM,2012,2-3 Years,8,0,8
SIKKIM,2012,3-5 Years,2,0,2
SIKKIM,2012,Above 5 Years,0,0,0
SIKKIM,2012,Total,143,5,148
TAMILNADU,2001,Upto 3 months,973,99,1072
TAMILNADU,2001,3-6 months,581,24,605
TAMILNADU,2001,6-12 months,361,8,369
TAMILNADU,2001,1-2 Years,162,8,170
TAMILNADU,2001,2-3 Years,69,1,70
TAMILNADU,2001,3-5 Years,48,0,48
TAMILNADU,2001,Above 5 Years,30,1,31
TAMILNADU,2001,Total,2224,141,2365
TAMILNADU,2002,Upto 3 months,1086,37,1123
TAMILNADU,2002,3-6 months,632,10,642
TAMILNADU,2002,6-12 months,472,5,477
TAMILNADU,2002,1-2 Years,206,6,212
TAMILNADU,2002,2-3 Years,62,0,62
TAMILNADU,2002,3-5 Years,26,0,26
TAMILNADU,2002,Above 5 Years,24,1,25
TAMILNADU,2002,Total,2508,59,2567
TAMILNADU,2003,Upto 3 months,1333,24,1357
TAMILNADU,2003,3-6 months,832,12,844
TAMILNADU,2003,6-12 months,492,8,500
TAMILNADU,2003,1-2 Years,216,8,224
TAMILNADU,2003,2-3 Years,72,0,72
TAMILNADU,2003,3-5 Years,36,0,36
TAMILNADU,2003,Above 5 Years,34,2,36
TAMILNADU,2003,Total,3015,54,3069
TAMILNADU,2004,Upto 3 months,1216,33,1249
TAMILNADU,2004,3-6 months,437,8,445
TAMILNADU,2004,6-12 months,618,10,628
TAMILNADU,2004,1-2 Years,218,3,221
TAMILNADU,2004,2-3 Years,140,2,142
TAMILNADU,2004,3-5 Years,230,3,233
TAMILNADU,2004,Above 5 Years,0,0,0
TAMILNADU,2004,Total,2859,59,2918
TAMILNADU,2005,Upto 3 months,1108,11,1119
TAMILNADU,2005,3-6 months,762,27,789
TAMILNADU,2005,6-12 months,638,16,654
TAMILNADU,2005,1-2 Years,316,6,322
TAMILNADU,2005,2-3 Years,82,0,82
TAMILNADU,2005,3-5 Years,42,0,42
TAMILNADU,2005,Above 5 Years,0,0,0
TAMILNADU,2005,Total,2948,60,3008
TAMILNADU,2006,Upto 3 months,1089,12,1101
TAMILNADU,2006,3-6 months,717,19,736
TAMILNADU,2006,6-12 months,604,14,618
TAMILNADU,2006,1-2 Years,307,5,312
TAMILNADU,2006,2-3 Years,87,0,87
TAMILNADU,2006,3-5 Years,31,0,31
TAMILNADU,2006,Above 5 Years,0,0,0
TAMILNADU,2006,Total,2835,50,2885
TAMILNADU,2007,Upto 3 months,5380,927,6307
TAMILNADU,2007,3-6 months,2492,51,2543
TAMILNADU,2007,6-12 months,307,8,315
TAMILNADU,2007,1-2 Years,147,4,151
TAMILNADU,2007,2-3 Years,102,3,105
TAMILNADU,2007,3-5 Years,89,1,90
TAMILNADU,2007,Above 5 Years,31,0,31
TAMILNADU,2007,Total,8548,994,9542
TAMILNADU,2008,Upto 3 months,4055,239,4294
TAMILNADU,2008,3-6 months,2618,449,3067
TAMILNADU,2008,6-12 months,1602,161,1763
TAMILNADU,2008,1-2 Years,430,9,439
TAMILNADU,2008,2-3 Years,142,6,148
TAMILNADU,2008,3-5 Years,25,1,26
TAMILNADU,2008,Above 5 Years,9,0,9
TAMILNADU,2008,Total,8881,865,9746
TAMILNADU,2009,Upto 3 months,3940,394,4334
TAMILNADU,2009,3-6 months,1877,117,1994
TAMILNADU,2009,6-12 months,1172,29,1201
TAMILNADU,2009,1-2 Years,306,22,328
TAMILNADU,2009,2-3 Years,160,6,166
TAMILNADU,2009,3-5 Years,75,3,78
TAMILNADU,2009,Above 5 Years,54,4,58
TAMILNADU,2009,Total,7584,575,8159
TAMILNADU,2010,Upto 3 months,3349,396,3745
TAMILNADU,2010,3-6 months,1817,98,1915
TAMILNADU,2010,6-12 months,1481,35,1516
TAMILNADU,2010,1-2 Years,295,2,297
TAMILNADU,2010,2-3 Years,94,4,98
TAMILNADU,2010,3-5 Years,60,8,68
TAMILNADU,2010,Above 5 Years,58,0,58
TAMILNADU,2010,Total,7154,543,7697
TAMILNADU,2011,Upto 3 months,2829,428,3257
TAMILNADU,2011,3-6 months,1794,87,1881
TAMILNADU,2011,6-12 months,1454,36,1490
TAMILNADU,2011,1-2 Years,545,13,558
TAMILNADU,2011,2-3 Years,262,8,270
TAMILNADU,2011,3-5 Years,141,2,143
TAMILNADU,2011,Above 5 Years,83,0,83
TAMILNADU,2011,Total,7108,574,7682
TAMILNADU,2012,Upto 3 months,3102,320,3422
TAMILNADU,2012,3-6 months,2363,167,2530
TAMILNADU,2012,6-12 months,1074,54,1128
TAMILNADU,2012,1-2 Years,419,13,432
TAMILNADU,2012,2-3 Years,215,0,215
TAMILNADU,2012,3-5 Years,127,1,128
TAMILNADU,2012,Above 5 Years,136,3,139
TAMILNADU,2012,Total,7436,558,7994
TRIPURA,2001,Upto 3 months,323,11,334
TRIPURA,2001,3-6 months,152,0,152
TRIPURA,2001,6-12 months,126,0,126
TRIPURA,2001,1-2 Years,41,1,42
TRIPURA,2001,2-3 Years,19,0,19
TRIPURA,2001,3-5 Years,0,0,0
TRIPURA,2001,Above 5 Years,3,0,3
TRIPURA,2001,Total,664,12,676
TRIPURA,2002,Upto 3 months,260,4,264
TRIPURA,2002,3-6 months,115,2,117
TRIPURA,2002,6-12 months,129,2,131
TRIPURA,2002,1-2 Years,29,0,29
TRIPURA,2002,2-3 Years,9,0,9
TRIPURA,2002,3-5 Years,1,0,1
TRIPURA,2002,Above 5 Years,0,0,0
TRIPURA,2002,Total,543,8,551
TRIPURA,2003,Upto 3 months,405,6,411
TRIPURA,2003,3-6 months,221,3,224
TRIPURA,2003,6-12 months,195,2,197
TRIPURA,2003,1-2 Years,50,0,50
TRIPURA,2003,2-3 Years,11,0,11
TRIPURA,2003,3-5 Years,3,0,3
TRIPURA,2003,Above 5 Years,2,0,2
TRIPURA,2003,Total,887,11,898
TRIPURA,2004,Upto 3 months,353,4,357
TRIPURA,2004,3-6 months,124,3,127
TRIPURA,2004,6-12 months,100,2,102
TRIPURA,2004,1-2 Years,76,1,77
TRIPURA,2004,2-3 Years,39,0,39
TRIPURA,2004,3-5 Years,6,0,6
TRIPURA,2004,Above 5 Years,0,0,0
TRIPURA,2004,Total,698,10,708
TRIPURA,2005,Upto 3 months,329,15,344
TRIPURA,2005,3-6 months,143,5,148
TRIPURA,2005,6-12 months,86,1,87
TRIPURA,2005,1-2 Years,39,0,39
TRIPURA,2005,2-3 Years,32,0,32
TRIPURA,2005,3-5 Years,5,0,5
TRIPURA,2005,Above 5 Years,1,0,1
TRIPURA,2005,Total,635,21,656
TRIPURA,2006,Upto 3 months,273,9,282
TRIPURA,2006,3-6 months,86,4,90
TRIPURA,2006,6-12 months,83,0,83
TRIPURA,2006,1-2 Years,62,2,64
TRIPURA,2006,2-3 Years,33,0,33
TRIPURA,2006,3-5 Years,24,0,24
TRIPURA,2006,Above 5 Years,5,0,5
TRIPURA,2006,Total,566,15,581
TRIPURA,2007,Upto 3 months,309,12,321
TRIPURA,2007,3-6 months,72,2,74
TRIPURA,2007,6-12 months,56,0,56
TRIPURA,2007,1-2 Years,38,0,38
TRIPURA,2007,2-3 Years,12,0,12
TRIPURA,2007,3-5 Years,1,0,1
TRIPURA,2007,Above 5 Years,1,0,1
TRIPURA,2007,Total,489,14,503
TRIPURA,2008,Upto 3 months,252,5,257
TRIPURA,2008,3-6 months,74,3,77
TRIPURA,2008,6-12 months,60,0,60
TRIPURA,2008,1-2 Years,32,0,32
TRIPURA,2008,2-3 Years,17,0,17
TRIPURA,2008,3-5 Years,5,0,5
TRIPURA,2008,Above 5 Years,3,0,3
TRIPURA,2008,Total,443,8,451
TRIPURA,2009,Upto 3 months,248,14,262
TRIPURA,2009,3-6 months,35,2,37
TRIPURA,2009,6-12 months,10,0,10
TRIPURA,2009,1-2 Years,5,0,5
TRIPURA,2009,2-3 Years,16,0,16
TRIPURA,2009,3-5 Years,3,0,3
TRIPURA,2009,Above 5 Years,2,0,2
TRIPURA,2009,Total,319,16,335
TRIPURA,2010,Upto 3 months,200,1,201
TRIPURA,2010,3-6 months,77,6,83
TRIPURA,2010,6-12 months,34,3,37
TRIPURA,2010,1-2 Years,17,0,17
TRIPURA,2010,2-3 Years,8,0,8
TRIPURA,2010,3-5 Years,1,0,1
TRIPURA,2010,Above 5 Years,1,0,1
TRIPURA,2010,Total,338,10,348
TRIPURA,2011,Upto 3 months,223,14,237
TRIPURA,2011,3-6 months,55,4,59
TRIPURA,2011,6-12 months,17,0,17
TRIPURA,2011,1-2 Years,8,2,10
TRIPURA,2011,2-3 Years,1,0,1
TRIPURA,2011,3-5 Years,5,0,5
TRIPURA,2011,Above 5 Years,1,0,1
TRIPURA,2011,Total,310,20,330
TRIPURA,2012,Upto 3 months,245,13,258
TRIPURA,2012,3-6 months,43,0,43
TRIPURA,2012,6-12 months,27,0,27
TRIPURA,2012,1-2 Years,16,1,17
TRIPURA,2012,2-3 Years,3,0,3
TRIPURA,2012,3-5 Years,3,0,3
TRIPURA,2012,Above 5 Years,1,0,1
TRIPURA,2012,Total,338,14,352
UTTAR PRADESH,2001,Upto 3 months,17006,422,17428
UTTAR PRADESH,2001,3-6 months,10539,313,10852
UTTAR PRADESH,2001,6-12 months,9505,260,9765
UTTAR PRADESH,2001,1-2 Years,4688,104,4792
UTTAR PRADESH,2001,2-3 Years,2935,63,2998
UTTAR PRADESH,2001,3-5 Years,866,9,875
UTTAR PRADESH,2001,Above 5 Years,159,6,165
UTTAR PRADESH,2001,Total,45698,1177,46875
UTTAR PRADESH,2002,Upto 3 months,17507,499,18006
UTTAR PRADESH,2002,3-6 months,9480,269,9749
UTTAR PRADESH,2002,6-12 months,8730,195,8925
UTTAR PRADESH,2002,1-2 Years,4428,77,4505
UTTAR PRADESH,2002,2-3 Years,2309,47,2356
UTTAR PRADESH,2002,3-5 Years,1257,12,1269
UTTAR PRADESH,2002,Above 5 Years,140,1,141
UTTAR PRADESH,2002,Total,43851,1100,44951
UTTAR PRADESH,2003,Upto 3 months,17873,306,18179
UTTAR PRADESH,2003,3-6 months,8302,193,8495
UTTAR PRADESH,2003,6-12 months,6473,162,6635
UTTAR PRADESH,2003,1-2 Years,4407,230,4637
UTTAR PRADESH,2003,2-3 Years,2494,23,2517
UTTAR PRADESH,2003,3-5 Years,1041,8,1049
UTTAR PRADESH,2003,Above 5 Years,194,4,198
UTTAR PRADESH,2003,Total,40784,926,41710
UTTAR PRADESH,2004,Upto 3 months,16590,419,17009
UTTAR PRADESH,2004,3-6 months,7896,202,8098
UTTAR PRADESH,2004,6-12 months,7202,139,7341
UTTAR PRADESH,2004,1-2 Years,4440,89,4529
UTTAR PRADESH,2004,2-3 Years,2567,21,2588
UTTAR PRADESH,2004,3-5 Years,1437,10,1447
UTTAR PRADESH,2004,Above 5 Years,211,1,212
UTTAR PRADESH,2004,Total,40343,881,41224
UTTAR PRADESH,2005,Upto 3 months,16632,430,17062
UTTAR PRADESH,2005,3-6 months,8497,271,8768
UTTAR PRADESH,2005,6-12 months,7975,223,8198
UTTAR PRADESH,2005,1-2 Years,4807,89,4896
UTTAR PRADESH,2005,2-3 Years,2690,29,2719
UTTAR PRADESH,2005,3-5 Years,1174,6,1180
UTTAR PRADESH,2005,Above 5 Years,254,1,255
UTTAR PRADESH,2005,Total,42029,1049,43078
UTTAR PRADESH,2006,Upto 3 months,19480,642,20122
UTTAR PRADESH,2006,3-6 months,10349,437,10786
UTTAR PRADESH,2006,6-12 months,8647,239,8886
UTTAR PRADESH,2006,1-2 Years,5465,109,5574
UTTAR PRADESH,2006,2-3 Years,3074,27,3101
UTTAR PRADESH,2006,3-5 Years,1360,13,1373
UTTAR PRADESH,2006,Above 5 Years,319,2,321
UTTAR PRADESH,2006,Total,48694,1469,50163
UTTAR PRADESH,2007,Upto 3 months,18836,637,19473
UTTAR PRADESH,2007,3-6 months,11309,454,11763
UTTAR PRADESH,2007,6-12 months,8866,317,9183
UTTAR PRADESH,2007,1-2 Years,6812,200,7012
UTTAR PRADESH,2007,2-3 Years,4118,66,4184
UTTAR PRADESH,2007,3-5 Years,2041,19,2060
UTTAR PRADESH,2007,Above 5 Years,314,3,317
UTTAR PRADESH,2007,Total,52296,1696,53992
UTTAR PRADESH,2008,Upto 3 months,19655,850,20505
UTTAR PRADESH,2008,3-6 months,11027,488,11515
UTTAR PRADESH,2008,6-12 months,10357,314,10671
UTTAR PRADESH,2008,1-2 Years,7723,256,7979
UTTAR PRADESH,2008,2-3 Years,5087,76,5163
UTTAR PRADESH,2008,3-5 Years,2313,25,2338
UTTAR PRADESH,2008,Above 5 Years,316,11,327
UTTAR PRADESH,2008,Total,56478,2020,58498
UTTAR PRADESH,2009,Upto 3 months,19099,720,19819
UTTAR PRADESH,2009,3-6 months,12165,511,12676
UTTAR PRADESH,2009,6-12 months,10661,409,11070
UTTAR PRADESH,2009,1-2 Years,8114,266,8380
UTTAR PRADESH,2009,2-3 Years,4585,103,4688
UTTAR PRADESH,2009,3-5 Years,1999,27,2026
UTTAR PRADESH,2009,Above 5 Years,394,5,399
UTTAR PRADESH,2009,Total,57017,2041,59058
UTTAR PRADESH,2010,Upto 3 months,17233,525,17758
UTTAR PRADESH,2010,3-6 months,11281,498,11779
UTTAR PRADESH,2010,6-12 months,10145,396,10541
UTTAR PRADESH,2010,1-2 Years,7668,236,7904
UTTAR PRADESH,2010,2-3 Years,4382,113,4495
UTTAR PRADESH,2010,3-5 Years,2943,57,3000
UTTAR PRADESH,2010,Above 5 Years,388,7,395
UTTAR PRADESH,2010,Total,54040,1832,55872
UTTAR PRADESH,2011,Upto 3 months,16834,615,17449
UTTAR PRADESH,2011,3-6 months,10882,559,11441
UTTAR PRADESH,2011,6-12 months,9746,486,10232
UTTAR PRADESH,2011,1-2 Years,7269,325,7594
UTTAR PRADESH,2011,2-3 Years,3983,144,4127
UTTAR PRADESH,2011,3-5 Years,2793,86,2879
UTTAR PRADESH,2011,Above 5 Years,321,19,340
UTTAR PRADESH,2011,Total,51828,2234,54062
UTTAR PRADESH,2012,Upto 3 months,16783,642,17425
UTTAR PRADESH,2012,3-6 months,10826,574,11400
UTTAR PRADESH,2012,6-12 months,9702,501,10203
UTTAR PRADESH,2012,1-2 Years,7221,345,7566
UTTAR PRADESH,2012,2-3 Years,3925,144,4069
UTTAR PRADESH,2012,3-5 Years,2743,91,2834
UTTAR PRADESH,2012,Above 5 Years,302,22,324
UTTAR PRADESH,2012,Total,51502,2319,53821
UTTARANCHAL,2001,Upto 3 months,600,20,620
UTTARANCHAL,2001,3-6 months,296,12,308
UTTARANCHAL,2001,6-12 months,318,22,340
UTTARANCHAL,2001,1-2 Years,297,9,306
UTTARANCHAL,2001,2-3 Years,169,0,169
UTTARANCHAL,2001,3-5 Years,38,0,38
UTTARANCHAL,2001,Above 5 Years,0,0,0
UTTARANCHAL,2001,Total,1718,63,1781
UTTARANCHAL,2002,Upto 3 months,945,30,975
UTTARANCHAL,2002,3-6 months,402,10,412
UTTARANCHAL,2002,6-12 months,200,6,206
UTTARANCHAL,2002,1-2 Years,90,4,94
UTTARANCHAL,2002,2-3 Years,10,0,10
UTTARANCHAL,2002,3-5 Years,5,0,5
UTTARANCHAL,2002,Above 5 Years,0,0,0
UTTARANCHAL,2002,Total,1652,50,1702
UTTARANCHAL,2003,Upto 3 months,749,22,771
UTTARANCHAL,2003,3-6 months,433,12,445
UTTARANCHAL,2003,6-12 months,257,8,265
UTTARANCHAL,2003,1-2 Years,127,3,130
UTTARANCHAL,2003,2-3 Years,66,2,68
UTTARANCHAL,2003,3-5 Years,38,0,38
UTTARANCHAL,2003,Above 5 Years,2,0,2
UTTARANCHAL,2003,Total,1672,47,1719
UTTARANCHAL,2004,Upto 3 months,164,18,182
UTTARANCHAL,2004,3-6 months,212,18,230
UTTARANCHAL,2004,6-12 months,316,12,328
UTTARANCHAL,2004,1-2 Years,378,17,395
UTTARANCHAL,2004,2-3 Years,327,12,339
UTTARANCHAL,2004,3-5 Years,114,6,120
UTTARANCHAL,2004,Above 5 Years,16,0,16
UTTARANCHAL,2004,Total,1527,83,1610
UTTARANCHAL,2005,Upto 3 months,503,13,516
UTTARANCHAL,2005,3-6 months,445,8,453
UTTARANCHAL,2005,6-12 months,315,5,320
UTTARANCHAL,2005,1-2 Years,141,7,148
UTTARANCHAL,2005,2-3 Years,109,1,110
UTTARANCHAL,2005,3-5 Years,26,0,26
UTTARANCHAL,2005,Above 5 Years,5,0,5
UTTARANCHAL,2005,Total,1544,34,1578
UTTARANCHAL,2006,Upto 3 months,636,20,656
UTTARANCHAL,2006,3-6 months,396,15,411
UTTARANCHAL,2006,6-12 months,275,10,285
UTTARANCHAL,2006,1-2 Years,195,3,198
UTTARANCHAL,2006,2-3 Years,120,3,123
UTTARANCHAL,2006,3-5 Years,63,1,64
UTTARANCHAL,2006,Above 5 Years,0,0,0
UTTARANCHAL,2006,Total,1685,52,1737
UTTARANCHAL,2007,Upto 3 months,484,3,487
UTTARANCHAL,2007,3-6 months,416,28,444
UTTARANCHAL,2007,6-12 months,349,14,363
UTTARANCHAL,2007,1-2 Years,206,8,214
UTTARANCHAL,2007,2-3 Years,111,1,112
UTTARANCHAL,2007,3-5 Years,38,0,38
UTTARANCHAL,2007,Above 5 Years,3,0,3
UTTARANCHAL,2007,Total,1607,54,1661
UTTARANCHAL,2008,Upto 3 months,423,31,454
UTTARANCHAL,2008,3-6 months,560,21,581
UTTARANCHAL,2008,6-12 months,450,17,467
UTTARANCHAL,2008,1-2 Years,380,12,392
UTTARANCHAL,2008,2-3 Years,65,4,69
UTTARANCHAL,2008,3-5 Years,40,0,40
UTTARANCHAL,2008,Above 5 Years,9,0,9
UTTARANCHAL,2008,Total,1927,85,2012
UTTARANCHAL,2009,Upto 3 months,791,32,823
UTTARANCHAL,2009,3-6 months,674,20,694
UTTARANCHAL,2009,6-12 months,293,15,308
UTTARANCHAL,2009,1-2 Years,221,4,225
UTTARANCHAL,2009,2-3 Years,105,4,109
UTTARANCHAL,2009,3-5 Years,58,1,59
UTTARANCHAL,2009,Above 5 Years,6,0,6
UTTARANCHAL,2009,Total,2148,76,2224
UTTARANCHAL,2010,Upto 3 months,770,27,797
UTTARANCHAL,2010,3-6 months,469,12,481
UTTARANCHAL,2010,6-12 months,375,12,387
UTTARANCHAL,2010,1-2 Years,199,5,204
UTTARANCHAL,2010,2-3 Years,156,1,157
UTTARANCHAL,2010,3-5 Years,56,1,57
UTTARANCHAL,2010,Above 5 Years,4,0,4
UTTARANCHAL,2010,Total,2029,58,2087
UTTARANCHAL,2011,Upto 3 months,389,20,409
UTTARANCHAL,2011,3-6 months,312,18,330
UTTARANCHAL,2011,6-12 months,479,18,497
UTTARANCHAL,2011,1-2 Years,210,8,218
UTTARANCHAL,2011,2-3 Years,175,2,177
UTTARANCHAL,2011,3-5 Years,70,2,72
UTTARANCHAL,2011,Above 5 Years,5,0,5
UTTARANCHAL,2011,Total,1640,68,1708
UTTARANCHAL,2012,Upto 3 months,430,30,460
UTTARANCHAL,2012,3-6 months,324,20,344
UTTARANCHAL,2012,6-12 months,531,19,550
UTTARANCHAL,2012,1-2 Years,223,9,232
UTTARANCHAL,2012,2-3 Years,197,3,200
UTTARANCHAL,2012,3-5 Years,74,0,74
UTTARANCHAL,2012,Above 5 Years,2,0,2
UTTARANCHAL,2012,Total,1781,81,1862
WEST BENGAL,2001,Upto 3 months,6182,317,6499
WEST BENGAL,2001,3-6 months,1459,55,1514
WEST BENGAL,2001,6-12 months,840,32,872
WEST BENGAL,2001,1-2 Years,513,10,523
WEST BENGAL,2001,2-3 Years,158,7,165
WEST BENGAL,2001,3-5 Years,103,7,110
WEST BENGAL,2001,Above 5 Years,38,1,39
WEST BENGAL,2001,Total,9293,429,9722
WEST BENGAL,2002,Upto 3 months,10243,543,10786
WEST BENGAL,2002,3-6 months,3031,82,3113
WEST BENGAL,2002,6-12 months,1177,59,1236
WEST BENGAL,2002,1-2 Years,534,26,560
WEST BENGAL,2002,2-3 Years,180,5,185
WEST BENGAL,2002,3-5 Years,118,6,124
WEST BENGAL,2002,Above 5 Years,31,1,32
WEST BENGAL,2002,Total,15314,722,16036
WEST BENGAL,2003,Upto 3 months,7130,454,7584
WEST BENGAL,2003,3-6 months,2583,92,2675
WEST BENGAL,2003,6-12 months,1508,35,1543
WEST BENGAL,2003,1-2 Years,632,27,659
WEST BENGAL,2003,2-3 Years,226,12,238
WEST BENGAL,2003,3-5 Years,53,3,56
WEST BENGAL,2003,Above 5 Years,2,0,2
WEST BENGAL,2003,Total,12134,623,12757
WEST BENGAL,2004,Upto 3 months,7112,469,7581
WEST BENGAL,2004,3-6 months,2012,101,2113
WEST BENGAL,2004,6-12 months,1299,79,1378
WEST BENGAL,2004,1-2 Years,834,22,856
WEST BENGAL,2004,2-3 Years,468,12,480
WEST BENGAL,2004,3-5 Years,278,0,278
WEST BENGAL,2004,Above 5 Years,99,5,104
WEST BENGAL,2004,Total,12102,688,12790
WEST BENGAL,2005,Upto 3 months,7386,661,8047
WEST BENGAL,2005,3-6 months,1984,190,2174
WEST BENGAL,2005,6-12 months,1808,96,1904
WEST BENGAL,2005,1-2 Years,961,52,1013
WEST BENGAL,2005,2-3 Years,464,9,473
WEST BENGAL,2005,3-5 Years,297,1,298
WEST BENGAL,2005,Above 5 Years,105,3,108
WEST BENGAL,2005,Total,13005,1012,14017
WEST BENGAL,2006,Upto 3 months,7098,467,7565
WEST BENGAL,2006,3-6 months,2115,180,2295
WEST BENGAL,2006,6-12 months,2003,76,2079
WEST BENGAL,2006,1-2 Years,964,56,1020
WEST BENGAL,2006,2-3 Years,563,14,577
WEST BENGAL,2006,3-5 Years,462,7,469
WEST BENGAL,2006,Above 5 Years,84,3,87
WEST BENGAL,2006,Total,13289,803,14092
WEST BENGAL,2007,Upto 3 months,6467,483,6950
WEST BENGAL,2007,3-6 months,2316,152,2468
WEST BENGAL,2007,6-12 months,2268,93,2361
WEST BENGAL,2007,1-2 Years,900,121,1021
WEST BENGAL,2007,2-3 Years,601,128,729
WEST BENGAL,2007,3-5 Years,332,22,354
WEST BENGAL,2007,Above 5 Years,75,3,78
WEST BENGAL,2007,Total,12959,1002,13961
WEST BENGAL,2008,Upto 3 months,6222,538,6760
WEST BENGAL,2008,3-6 months,2719,226,2945
WEST BENGAL,2008,6-12 months,2132,138,2270
WEST BENGAL,2008,1-2 Years,1018,60,1078
WEST BENGAL,2008,2-3 Years,461,56,517
WEST BENGAL,2008,3-5 Years,415,28,443
WEST BENGAL,2008,Above 5 Years,92,6,98
WEST BENGAL,2008,Total,13059,1052,14111
WEST BENGAL,2009,Upto 3 months,5128,371,5499
WEST BENGAL,2009,3-6 months,1865,87,1952
WEST BENGAL,2009,6-12 months,1739,83,1822
WEST BENGAL,2009,1-2 Years,962,70,1032
WEST BENGAL,2009,2-3 Years,625,49,674
WEST BENGAL,2009,3-5 Years,361,22,383
WEST BENGAL,2009,Above 5 Years,94,9,103
WEST BENGAL,2009,Total,10774,691,11465
WEST BENGAL,2010,Upto 3 months,5600,394,5994
WEST BENGAL,2010,3-6 months,2291,120,2411
WEST BENGAL,2010,6-12 months,1768,92,1860
WEST BENGAL,2010,1-2 Years,878,62,940
WEST BENGAL,2010,2-3 Years,570,39,609
WEST BENGAL,2010,3-5 Years,284,19,303
WEST BENGAL,2010,Above 5 Years,234,10,244
WEST BENGAL,2010,Total,11625,736,12361
WEST BENGAL,2011,Upto 3 months,6990,486,7476
WEST BENGAL,2011,3-6 months,1919,125,2044
WEST BENGAL,2011,6-12 months,1544,56,1600
WEST BENGAL,2011,1-2 Years,1050,52,1102
WEST BENGAL,2011,2-3 Years,618,26,644
WEST BENGAL,2011,3-5 Years,481,16,497
WEST BENGAL,2011,Above 5 Years,202,2,204
WEST BENGAL,2011,Total,12804,763,13567
WEST BENGAL,2012,Upto 3 months,6342,488,6830
WEST BENGAL,2012,3-6 months,2301,120,2421
WEST BENGAL,2012,6-12 months,1781,118,1899
WEST BENGAL,2012,1-2 Years,1282,72,1354
WEST BENGAL,2012,2-3 Years,657,28,685
WEST BENGAL,2012,3-5 Years,556,35,591
WEST BENGAL,2012,Above 5 Years,187,10,197
WEST BENGAL,2012,Total,13106,871,13977
A & N ISLANDS,2001,Upto 3 months,58,1,59
A & N ISLANDS,2001,3-6 months,92,0,92
A & N ISLANDS,2001,6-12 months,11,0,11
A & N ISLANDS,2001,1-2 Years,3,0,3
A & N ISLANDS,2001,2-3 Years,1,0,1
A & N ISLANDS,2001,3-5 Years,0,0,0
A & N ISLANDS,2001,Above 5 Years,0,0,0
A & N ISLANDS,2001,Total,165,1,166
A & N ISLANDS,2002,Upto 3 months,111,4,115
A & N ISLANDS,2002,3-6 months,59,0,59
A & N ISLANDS,2002,6-12 months,11,0,11
A & N ISLANDS,2002,1-2 Years,6,0,6
A & N ISLANDS,2002,2-3 Years,2,0,2
A & N ISLANDS,2002,3-5 Years,1,0,1
A & N ISLANDS,2002,Above 5 Years,0,0,0
A & N ISLANDS,2002,Total,190,4,194
A & N ISLANDS,2003,Upto 3 months,165,1,166
A & N ISLANDS,2003,3-6 months,18,0,18
A & N ISLANDS,2003,6-12 months,12,0,12
A & N ISLANDS,2003,1-2 Years,7,0,7
A & N ISLANDS,2003,2-3 Years,1,0,1
A & N ISLANDS,2003,3-5 Years,0,0,0
A & N ISLANDS,2003,Above 5 Years,0,0,0
A & N ISLANDS,2003,Total,203,1,204
A & N ISLANDS,2004,Upto 3 months,119,0,119
A & N ISLANDS,2004,3-6 months,13,0,13
A & N ISLANDS,2004,6-12 months,13,1,14
A & N ISLANDS,2004,1-2 Years,16,0,16
A & N ISLANDS,2004,2-3 Years,3,0,3
A & N ISLANDS,2004,3-5 Years,0,0,0
A & N ISLANDS,2004,Above 5 Years,0,0,0
A & N ISLANDS,2004,Total,164,1,165
A & N ISLANDS,2005,Upto 3 months,117,2,119
A & N ISLANDS,2005,3-6 months,7,0,7
A & N ISLANDS,2005,6-12 months,7,0,7
A & N ISLANDS,2005,1-2 Years,11,1,12
A & N ISLANDS,2005,2-3 Years,10,0,10
A & N ISLANDS,2005,3-5 Years,3,0,3
A & N ISLANDS,2005,Above 5 Years,0,0,0
A & N ISLANDS,2005,Total,155,3,158
A & N ISLANDS,2006,Upto 3 months,142,0,142
A & N ISLANDS,2006,3-6 months,79,0,79
A & N ISLANDS,2006,6-12 months,18,0,18
A & N ISLANDS,2006,1-2 Years,7,1,8
A & N ISLANDS,2006,2-3 Years,10,0,10
A & N ISLANDS,2006,3-5 Years,8,0,8
A & N ISLANDS,2006,Above 5 Years,0,0,0
A & N ISLANDS,2006,Total,264,1,265
A & N ISLANDS,2007,Upto 3 months,151,1,152
A & N ISLANDS,2007,3-6 months,119,0,119
A & N ISLANDS,2007,6-12 months,28,0,28
A & N ISLANDS,2007,1-2 Years,10,0,10
A & N ISLANDS,2007,2-3 Years,8,0,8
A & N ISLANDS,2007,3-5 Years,6,0,6
A & N ISLANDS,2007,Above 5 Years,2,0,2
A & N ISLANDS,2007,Total,324,1,325
A & N ISLANDS,2008,Upto 3 months,83,0,83
A & N ISLANDS,2008,3-6 months,29,0,29
A & N ISLANDS,2008,6-12 months,21,0,21
A & N ISLANDS,2008,1-2 Years,8,0,8
A & N ISLANDS,2008,2-3 Years,6,0,6
A & N ISLANDS,2008,3-5 Years,5,0,5
A & N ISLANDS,2008,Above 5 Years,1,0,1
A & N ISLANDS,2008,Total,153,0,153
A & N ISLANDS,2009,Upto 3 months,123,0,123
A & N ISLANDS,2009,3-6 months,25,0,25
A & N ISLANDS,2009,6-12 months,19,0,19
A & N ISLANDS,2009,1-2 Years,5,0,5
A & N ISLANDS,2009,2-3 Years,4,0,4
A & N ISLANDS,2009,3-5 Years,3,0,3
A & N ISLANDS,2009,Above 5 Years,1,0,1
A & N ISLANDS,2009,Total,180,0,180
A & N ISLANDS,2010,Upto 3 months,53,0,53
A & N ISLANDS,2010,3-6 months,401,2,403
A & N ISLANDS,2010,6-12 months,66,0,66
A & N ISLANDS,2010,1-2 Years,28,0,28
A & N ISLANDS,2010,2-3 Years,5,0,5
A & N ISLANDS,2010,3-5 Years,4,0,4
A & N ISLANDS,2010,Above 5 Years,0,0,0
A & N ISLANDS,2010,Total,557,2,559
A & N ISLANDS,2011,Upto 3 months,75,0,75
A & N ISLANDS,2011,3-6 months,210,0,210
A & N ISLANDS,2011,6-12 months,155,0,155
A & N ISLANDS,2011,1-2 Years,235,2,237
A & N ISLANDS,2011,2-3 Years,15,5,20
A & N ISLANDS,2011,3-5 Years,4,0,4
A & N ISLANDS,2011,Above 5 Years,3,0,3
A & N ISLANDS,2011,Total,697,7,704
A & N ISLANDS,2012,Upto 3 months,3,2,5
A & N ISLANDS,2012,3-6 months,33,0,33
A & N ISLANDS,2012,6-12 months,4,0,4
A & N ISLANDS,2012,1-2 Years,215,5,220
A & N ISLANDS,2012,2-3 Years,95,2,97
A & N ISLANDS,2012,3-5 Years,7,0,7
A & N ISLANDS,2012,Above 5 Years,0,0,0
A & N ISLANDS,2012,Total,357,9,366
CHANDIGARH,2001,Upto 3 months,135,6,141
CHANDIGARH,2001,3-6 months,70,3,73
CHANDIGARH,2001,6-12 months,40,4,44
CHANDIGARH,2001,1-2 Years,35,5,40
CHANDIGARH,2001,2-3 Years,15,0,15
CHANDIGARH,2001,3-5 Years,3,0,3
CHANDIGARH,2001,Above 5 Years,8,0,8
CHANDIGARH,2001,Total,306,18,324
CHANDIGARH,2002,Upto 3 months,112,7,119
CHANDIGARH,2002,3-6 months,50,2,52
CHANDIGARH,2002,6-12 months,42,2,44
CHANDIGARH,2002,1-2 Years,29,1,30
CHANDIGARH,2002,2-3 Years,69,2,71
CHANDIGARH,2002,3-5 Years,16,2,18
CHANDIGARH,2002,Above 5 Years,11,0,11
CHANDIGARH,2002,Total,329,16,345
CHANDIGARH,2003,Upto 3 months,110,6,116
CHANDIGARH,2003,3-6 months,80,2,82
CHANDIGARH,2003,6-12 months,60,4,64
CHANDIGARH,2003,1-2 Years,46,3,49
CHANDIGARH,2003,2-3 Years,32,2,34
CHANDIGARH,2003,3-5 Years,26,1,27
CHANDIGARH,2003,Above 5 Years,9,0,9
CHANDIGARH,2003,Total,363,18,381
CHANDIGARH,2004,Upto 3 months,176,8,184
CHANDIGARH,2004,3-6 months,52,4,56
CHANDIGARH,2004,6-12 months,65,5,70
CHANDIGARH,2004,1-2 Years,49,2,51
CHANDIGARH,2004,2-3 Years,35,3,38
CHANDIGARH,2004,3-5 Years,22,2,24
CHANDIGARH,2004,Above 5 Years,6,0,6
CHANDIGARH,2004,Total,405,24,429
CHANDIGARH,2005,Upto 3 months,152,8,160
CHANDIGARH,2005,3-6 months,85,3,88
CHANDIGARH,2005,6-12 months,48,4,52
CHANDIGARH,2005,1-2 Years,26,3,29
CHANDIGARH,2005,2-3 Years,21,2,23
CHANDIGARH,2005,3-5 Years,9,0,9
CHANDIGARH,2005,Above 5 Years,10,0,10
CHANDIGARH,2005,Total,351,20,371
CHANDIGARH,2006,Upto 3 months,164,11,175
CHANDIGARH,2006,3-6 months,52,4,56
CHANDIGARH,2006,6-12 months,35,1,36
CHANDIGARH,2006,1-2 Years,22,2,24
CHANDIGARH,2006,2-3 Years,16,1,17
CHANDIGARH,2006,3-5 Years,12,0,12
CHANDIGARH,2006,Above 5 Years,11,0,11
CHANDIGARH,2006,Total,312,19,331
CHANDIGARH,2007,Upto 3 months,118,6,124
CHANDIGARH,2007,3-6 months,86,2,88
CHANDIGARH,2007,6-12 months,56,2,58
CHANDIGARH,2007,1-2 Years,42,2,44
CHANDIGARH,2007,2-3 Years,26,1,27
CHANDIGARH,2007,3-5 Years,11,0,11
CHANDIGARH,2007,Above 5 Years,3,0,3
CHANDIGARH,2007,Total,342,13,355
CHANDIGARH,2008,Upto 3 months,142,5,147
CHANDIGARH,2008,3-6 months,82,3,85
CHANDIGARH,2008,6-12 months,47,2,49
CHANDIGARH,2008,1-2 Years,33,0,33
CHANDIGARH,2008,2-3 Years,13,2,15
CHANDIGARH,2008,3-5 Years,8,0,8
CHANDIGARH,2008,Above 5 Years,1,0,1
CHANDIGARH,2008,Total,326,12,338
CHANDIGARH,2009,Upto 3 months,158,10,168
CHANDIGARH,2009,3-6 months,96,4,100
CHANDIGARH,2009,6-12 months,54,3,57
CHANDIGARH,2009,1-2 Years,42,1,43
CHANDIGARH,2009,2-3 Years,22,2,24
CHANDIGARH,2009,3-5 Years,6,0,6
CHANDIGARH,2009,Above 5 Years,1,0,1
CHANDIGARH,2009,Total,379,20,399
CHANDIGARH,2010,Upto 3 months,170,12,182
CHANDIGARH,2010,3-6 months,85,3,88
CHANDIGARH,2010,6-12 months,66,1,67
CHANDIGARH,2010,1-2 Years,51,2,53
CHANDIGARH,2010,2-3 Years,18,1,19
CHANDIGARH,2010,3-5 Years,7,0,7
CHANDIGARH,2010,Above 5 Years,3,0,3
CHANDIGARH,2010,Total,400,19,419
CHANDIGARH,2011,Upto 3 months,179,9,188
CHANDIGARH,2011,3-6 months,68,2,70
CHANDIGARH,2011,6-12 months,49,1,50
CHANDIGARH,2011,1-2 Years,42,3,45
CHANDIGARH,2011,2-3 Years,28,1,29
CHANDIGARH,2011,3-5 Years,2,0,2
CHANDIGARH,2011,Above 5 Years,0,0,0
CHANDIGARH,2011,Total,368,16,384
CHANDIGARH,2012,Upto 3 months,207,13,220
CHANDIGARH,2012,3-6 months,112,6,118
CHANDIGARH,2012,6-12 months,73,3,76
CHANDIGARH,2012,1-2 Years,38,3,41
CHANDIGARH,2012,2-3 Years,14,1,15
CHANDIGARH,2012,3-5 Years,1,0,1
CHANDIGARH,2012,Above 5 Years,2,0,2
CHANDIGARH,2012,Total,447,26,473
D & N HAVELI,2001,Upto 3 months,131,4,135
D & N HAVELI,2001,3-6 months,20,0,20
D & N HAVELI,2001,6-12 months,2,1,3
D & N HAVELI,2001,1-2 Years,0,0,0
D & N HAVELI,2001,2-3 Years,0,0,0
D & N HAVELI,2001,3-5 Years,0,0,0
D & N HAVELI,2001,Above 5 Years,0,0,0
D & N HAVELI,2001,Total,153,5,158
D & N HAVELI,2002,Upto 3 months,131,1,132
D & N HAVELI,2002,3-6 months,20,0,20
D & N HAVELI,2002,6-12 months,3,0,3
D & N HAVELI,2002,1-2 Years,0,0,0
D & N HAVELI,2002,2-3 Years,0,0,0
D & N HAVELI,2002,3-5 Years,0,0,0
D & N HAVELI,2002,Above 5 Years,0,0,0
D & N HAVELI,2002,Total,154,1,155
D & N HAVELI,2003,Upto 3 months,150,0,150
D & N HAVELI,2003,3-6 months,20,0,20
D & N HAVELI,2003,6-12 months,2,0,2
D & N HAVELI,2003,1-2 Years,0,0,0
D & N HAVELI,2003,2-3 Years,0,0,0
D & N HAVELI,2003,3-5 Years,0,0,0
D & N HAVELI,2003,Above 5 Years,0,0,0
D & N HAVELI,2003,Total,172,0,172
D & N HAVELI,2004,Upto 3 months,8,0,8
D & N HAVELI,2004,3-6 months,3,0,3
D & N HAVELI,2004,6-12 months,12,0,12
D & N HAVELI,2004,1-2 Years,10,0,10
D & N HAVELI,2004,2-3 Years,0,0,0
D & N HAVELI,2004,3-5 Years,0,0,0
D & N HAVELI,2004,Above 5 Years,0,0,0
D & N HAVELI,2004,Total,33,0,33
D & N HAVELI,2005,Upto 3 months,5,0,5
D & N HAVELI,2005,3-6 months,5,0,5
D & N HAVELI,2005,6-12 months,10,0,10
D & N HAVELI,2005,1-2 Years,7,0,7
D & N HAVELI,2005,2-3 Years,1,0,1
D & N HAVELI,2005,3-5 Years,1,0,1
D & N HAVELI,2005,Above 5 Years,0,0,0
D & N HAVELI,2005,Total,29,0,29
D & N HAVELI,2006,Upto 3 months,13,0,13
D & N HAVELI,2006,3-6 months,7,0,7
D & N HAVELI,2006,6-12 months,10,0,10
D & N HAVELI,2006,1-2 Years,2,0,2
D & N HAVELI,2006,2-3 Years,1,0,1
D & N HAVELI,2006,3-5 Years,0,0,0
D & N HAVELI,2006,Above 5 Years,0,0,0
D & N HAVELI,2006,Total,33,0,33
D & N HAVELI,2007,Upto 3 months,13,0,13
D & N HAVELI,2007,3-6 months,2,0,2
D & N HAVELI,2007,6-12 months,2,0,2
D & N HAVELI,2007,1-2 Years,11,0,11
D & N HAVELI,2007,2-3 Years,0,0,0
D & N HAVELI,2007,3-5 Years,0,0,0
D & N HAVELI,2007,Above 5 Years,0,0,0
D & N HAVELI,2007,Total,28,0,28
D & N HAVELI,2008,Upto 3 months,24,0,24
D & N HAVELI,2008,3-6 months,7,0,7
D & N HAVELI,2008,6-12 months,1,3,4
D & N HAVELI,2008,1-2 Years,0,0,0
D & N HAVELI,2008,2-3 Years,0,0,0
D & N HAVELI,2008,3-5 Years,0,0,0
D & N HAVELI,2008,Above 5 Years,0,0,0
D & N HAVELI,2008,Total,32,3,35
D & N HAVELI,2009,Upto 3 months,23,0,23
D & N HAVELI,2009,3-6 months,11,0,11
D & N HAVELI,2009,6-12 months,18,2,20
D & N HAVELI,2009,1-2 Years,0,0,0
D & N HAVELI,2009,2-3 Years,0,0,0
D & N HAVELI,2009,3-5 Years,0,0,0
D & N HAVELI,2009,Above 5 Years,0,0,0
D & N HAVELI,2009,Total,52,2,54
D & N HAVELI,2010,Upto 3 months,4,0,4
D & N HAVELI,2010,3-6 months,23,0,23
D & N HAVELI,2010,6-12 months,11,0,11
D & N HAVELI,2010,1-2 Years,4,0,4
D & N HAVELI,2010,2-3 Years,0,0,0
D & N HAVELI,2010,3-5 Years,0,0,0
D & N HAVELI,2010,Above 5 Years,0,0,0
D & N HAVELI,2010,Total,42,0,42
D & N HAVELI,2011,Upto 3 months,12,1,13
D & N HAVELI,2011,3-6 months,3,1,4
D & N HAVELI,2011,6-12 months,4,0,4
D & N HAVELI,2011,1-2 Years,4,0,4
D & N HAVELI,2011,2-3 Years,0,0,0
D & N HAVELI,2011,3-5 Years,0,0,0
D & N HAVELI,2011,Above 5 Years,0,0,0
D & N HAVELI,2011,Total,23,2,25
D & N HAVELI,2012,Upto 3 months,15,0,15
D & N HAVELI,2012,3-6 months,7,0,7
D & N HAVELI,2012,6-12 months,6,0,6
D & N HAVELI,2012,1-2 Years,7,2,9
D & N HAVELI,2012,2-3 Years,0,0,0
D & N HAVELI,2012,3-5 Years,0,0,0
D & N HAVELI,2012,Above 5 Years,0,0,0
D & N HAVELI,2012,Total,35,2,37
DAMAN & DIU,2001,Upto 3 months,5,0,5
DAMAN & DIU,2001,3-6 months,12,0,12
DAMAN & DIU,2001,6-12 months,0,0,0
DAMAN & DIU,2001,1-2 Years,0,1,1
DAMAN & DIU,2001,2-3 Years,0,0,0
DAMAN & DIU,2001,3-5 Years,0,0,0
DAMAN & DIU,2001,Above 5 Years,0,0,0
DAMAN & DIU,2001,Total,17,1,18
DAMAN & DIU,2002,Upto 3 months,8,0,8
DAMAN & DIU,2002,3-6 months,4,0,4
DAMAN & DIU,2002,6-12 months,2,0,2
DAMAN & DIU,2002,1-2 Years,6,0,6
DAMAN & DIU,2002,2-3 Years,0,0,0
DAMAN & DIU,2002,3-5 Years,0,0,0
DAMAN & DIU,2002,Above 5 Years,0,0,0
DAMAN & DIU,2002,Total,20,0,20
DAMAN & DIU,2003,Upto 3 months,8,0,8
DAMAN & DIU,2003,3-6 months,7,0,7
DAMAN & DIU,2003,6-12 months,5,0,5
DAMAN & DIU,2003,1-2 Years,0,0,0
DAMAN & DIU,2003,2-3 Years,0,0,0
DAMAN & DIU,2003,3-5 Years,0,0,0
DAMAN & DIU,2003,Above 5 Years,0,0,0
DAMAN & DIU,2003,Total,20,0,20
DAMAN & DIU,2004,Upto 3 months,7,0,7
DAMAN & DIU,2004,3-6 months,5,1,6
DAMAN & DIU,2004,6-12 months,6,0,6
DAMAN & DIU,2004,1-2 Years,0,0,0
DAMAN & DIU,2004,2-3 Years,0,0,0
DAMAN & DIU,2004,3-5 Years,0,0,0
DAMAN & DIU,2004,Above 5 Years,0,0,0
DAMAN & DIU,2004,Total,18,1,19
DAMAN & DIU,2005,Upto 3 months,7,0,7
DAMAN & DIU,2005,3-6 months,8,0,8
DAMAN & DIU,2005,6-12 months,2,0,2
DAMAN & DIU,2005,1-2 Years,0,1,1
DAMAN & DIU,2005,2-3 Years,6,0,6
DAMAN & DIU,2005,3-5 Years,0,0,0
DAMAN & DIU,2005,Above 5 Years,0,0,0
DAMAN & DIU,2005,Total,23,1,24
DAMAN & DIU,2006,Upto 3 months,18,1,19
DAMAN & DIU,2006,3-6 months,14,0,14
DAMAN & DIU,2006,6-12 months,6,0,6
DAMAN & DIU,2006,1-2 Years,3,0,3
DAMAN & DIU,2006,2-3 Years,0,0,0
DAMAN & DIU,2006,3-5 Years,0,0,0
DAMAN & DIU,2006,Above 5 Years,0,0,0
DAMAN & DIU,2006,Total,41,1,42
DAMAN & DIU,2007,Upto 3 months,8,3,11
DAMAN & DIU,2007,3-6 months,33,1,34
DAMAN & DIU,2007,6-12 months,7,0,7
DAMAN & DIU,2007,1-2 Years,4,0,4
DAMAN & DIU,2007,2-3 Years,0,0,0
DAMAN & DIU,2007,3-5 Years,0,0,0
DAMAN & DIU,2007,Above 5 Years,0,0,0
DAMAN & DIU,2007,Total,52,4,56
DAMAN & DIU,2008,Upto 3 months,0,0,0
DAMAN & DIU,2008,3-6 months,3,0,3
DAMAN & DIU,2008,6-12 months,4,0,4
DAMAN & DIU,2008,1-2 Years,12,0,12
DAMAN & DIU,2008,2-3 Years,7,1,8
DAMAN & DIU,2008,3-5 Years,0,0,0
DAMAN & DIU,2008,Above 5 Years,0,0,0
DAMAN & DIU,2008,Total,26,1,27
DAMAN & DIU,2009,Upto 3 months,0,0,0
DAMAN & DIU,2009,3-6 months,7,0,7
DAMAN & DIU,2009,6-12 months,9,0,9
DAMAN & DIU,2009,1-2 Years,5,0,5
DAMAN & DIU,2009,2-3 Years,3,0,3
DAMAN & DIU,2009,3-5 Years,0,0,0
DAMAN & DIU,2009,Above 5 Years,0,0,0
DAMAN & DIU,2009,Total,24,0,24
DAMAN & DIU,2010,Upto 3 months,9,0,9
DAMAN & DIU,2010,3-6 months,4,0,4
DAMAN & DIU,2010,6-12 months,1,0,1
DAMAN & DIU,2010,1-2 Years,1,0,1
DAMAN & DIU,2010,2-3 Years,1,0,1
DAMAN & DIU,2010,3-5 Years,0,0,0
DAMAN & DIU,2010,Above 5 Years,0,0,0
DAMAN & DIU,2010,Total,16,0,16
DAMAN & DIU,2011,Upto 3 months,2,0,2
DAMAN & DIU,2011,3-6 months,9,0,9
DAMAN & DIU,2011,6-12 months,6,0,6
DAMAN & DIU,2011,1-2 Years,0,0,0
DAMAN & DIU,2011,2-3 Years,0,0,0
DAMAN & DIU,2011,3-5 Years,0,0,0
DAMAN & DIU,2011,Above 5 Years,0,0,0
DAMAN & DIU,2011,Total,17,0,17
DAMAN & DIU,2012,Upto 3 months,0,0,0
DAMAN & DIU,2012,3-6 months,8,1,9
DAMAN & DIU,2012,6-12 months,2,0,2
DAMAN & DIU,2012,1-2 Years,0,0,0
DAMAN & DIU,2012,2-3 Years,0,0,0
DAMAN & DIU,2012,3-5 Years,0,0,0
DAMAN & DIU,2012,Above 5 Years,0,0,0
DAMAN & DIU,2012,Total,10,1,11
DELHI,2001,Upto 3 months,3347,66,3413
DELHI,2001,3-6 months,1419,94,1513
DELHI,2001,6-12 months,1439,127,1566
DELHI,2001,1-2 Years,1232,44,1276
DELHI,2001,2-3 Years,546,29,575
DELHI,2001,3-5 Years,326,24,350
DELHI,2001,Above 5 Years,57,2,59
DELHI,2001,Total,8366,386,8752
DELHI,2002,Upto 3 months,3650,51,3701
DELHI,2002,3-6 months,1911,96,2007
DELHI,2002,6-12 months,1462,121,1583
DELHI,2002,1-2 Years,1285,41,1326
DELHI,2002,2-3 Years,634,46,680
DELHI,2002,3-5 Years,267,24,291
DELHI,2002,Above 5 Years,66,2,68
DELHI,2002,Total,9275,381,9656
DELHI,2003,Upto 3 months,3452,98,3550
DELHI,2003,3-6 months,1885,77,1962
DELHI,2003,6-12 months,1734,133,1867
DELHI,2003,1-2 Years,1219,43,1262
DELHI,2003,2-3 Years,599,47,646
DELHI,2003,3-5 Years,456,35,491
DELHI,2003,Above 5 Years,86,2,88
DELHI,2003,Total,9431,435,9866
DELHI,2004,Upto 3 months,3314,129,3443
DELHI,2004,3-6 months,1542,77,1619
DELHI,2004,6-12 months,1938,68,2006
DELHI,2004,1-2 Years,1441,73,1514
DELHI,2004,2-3 Years,736,34,770
DELHI,2004,3-5 Years,378,13,391
DELHI,2004,Above 5 Years,339,5,344
DELHI,2004,Total,9688,399,10087
DELHI,2005,Upto 3 months,6110,116,6226
DELHI,2005,3-6 months,1188,73,1261
DELHI,2005,6-12 months,1160,62,1222
DELHI,2005,1-2 Years,404,51,455
DELHI,2005,2-3 Years,250,43,293
DELHI,2005,3-5 Years,243,22,265
DELHI,2005,Above 5 Years,66,3,69
DELHI,2005,Total,9421,370,9791
DELHI,2006,Upto 3 months,5324,172,5496
DELHI,2006,3-6 months,1838,47,1885
DELHI,2006,6-12 months,1917,51,1968
DELHI,2006,1-2 Years,922,59,981
DELHI,2006,2-3 Years,244,37,281
DELHI,2006,3-5 Years,240,15,255
DELHI,2006,Above 5 Years,66,2,68
DELHI,2006,Total,10551,383,10934
DELHI,2007,Upto 3 months,4286,181,4467
DELHI,2007,3-6 months,1486,39,1525
DELHI,2007,6-12 months,1164,56,1220
DELHI,2007,1-2 Years,980,76,1056
DELHI,2007,2-3 Years,458,36,494
DELHI,2007,3-5 Years,386,27,413
DELHI,2007,Above 5 Years,132,7,139
DELHI,2007,Total,8892,422,9314
DELHI,2008,Upto 3 months,4262,160,4422
DELHI,2008,3-6 months,1117,27,1144
DELHI,2008,6-12 months,1140,59,1199
DELHI,2008,1-2 Years,1283,75,1358
DELHI,2008,2-3 Years,736,37,773
DELHI,2008,3-5 Years,500,49,549
DELHI,2008,Above 5 Years,100,7,107
DELHI,2008,Total,9138,414,9552
DELHI,2009,Upto 3 months,2746,146,2892
DELHI,2009,3-6 months,1340,23,1363
DELHI,2009,6-12 months,1445,41,1486
DELHI,2009,1-2 Years,1537,58,1595
DELHI,2009,2-3 Years,712,33,745
DELHI,2009,3-5 Years,656,51,707
DELHI,2009,Above 5 Years,131,12,143
DELHI,2009,Total,8567,364,8931
DELHI,2010,Upto 3 months,3181,123,3304
DELHI,2010,3-6 months,1174,45,1219
DELHI,2010,6-12 months,1413,65,1478
DELHI,2010,1-2 Years,985,35,1020
DELHI,2010,2-3 Years,447,64,511
DELHI,2010,3-5 Years,425,59,484
DELHI,2010,Above 5 Years,61,10,71
DELHI,2010,Total,7686,401,8087
DELHI,2011,Upto 3 months,3583,97,3680
DELHI,2011,3-6 months,1415,81,1496
DELHI,2011,6-12 months,1420,86,1506
DELHI,2011,1-2 Years,1103,77,1180
DELHI,2011,2-3 Years,401,21,422
DELHI,2011,3-5 Years,435,36,471
DELHI,2011,Above 5 Years,144,12,156
DELHI,2011,Total,8501,410,8911
DELHI,2012,Upto 3 months,3415,96,3511
DELHI,2012,3-6 months,1542,83,1625
DELHI,2012,6-12 months,1343,78,1421
DELHI,2012,1-2 Years,1090,86,1176
DELHI,2012,2-3 Years,466,26,492
DELHI,2012,3-5 Years,452,30,482
DELHI,2012,Above 5 Years,164,16,180
DELHI,2012,Total,8472,415,8887
LAKSHADWEEP,2001,Upto 3 months,0,0,0
LAKSHADWEEP,2001,3-6 months,1,0,1
LAKSHADWEEP,2001,6-12 months,0,0,0
LAKSHADWEEP,2001,1-2 Years,0,0,0
LAKSHADWEEP,2001,2-3 Years,0,0,0
LAKSHADWEEP,2001,3-5 Years,0,0,0
LAKSHADWEEP,2001,Above 5 Years,0,0,0
LAKSHADWEEP,2001,Total,1,0,1
LAKSHADWEEP,2002,Upto 3 months,14,0,14
LAKSHADWEEP,2002,3-6 months,0,0,0
LAKSHADWEEP,2002,6-12 months,0,0,0
LAKSHADWEEP,2002,1-2 Years,0,0,0
LAKSHADWEEP,2002,2-3 Years,0,0,0
LAKSHADWEEP,2002,3-5 Years,0,0,0
LAKSHADWEEP,2002,Above 5 Years,0,0,0
LAKSHADWEEP,2002,Total,14,0,14
LAKSHADWEEP,2003,Upto 3 months,4,0,4
LAKSHADWEEP,2003,3-6 months,0,0,0
LAKSHADWEEP,2003,6-12 months,0,0,0
LAKSHADWEEP,2003,1-2 Years,0,0,0
LAKSHADWEEP,2003,2-3 Years,0,0,0
LAKSHADWEEP,2003,3-5 Years,0,0,0
LAKSHADWEEP,2003,Above 5 Years,0,0,0
LAKSHADWEEP,2003,Total,4,0,4
LAKSHADWEEP,2004,Upto 3 months,0,0,0
LAKSHADWEEP,2004,3-6 months,0,0,0
LAKSHADWEEP,2004,6-12 months,0,0,0
LAKSHADWEEP,2004,1-2 Years,0,0,0
LAKSHADWEEP,2004,2-3 Years,0,0,0
LAKSHADWEEP,2004,3-5 Years,0,0,0
LAKSHADWEEP,2004,Above 5 Years,0,0,0
LAKSHADWEEP,2004,Total,0,0,0
LAKSHADWEEP,2005,Upto 3 months,6,0,6
LAKSHADWEEP,2005,3-6 months,0,0,0
LAKSHADWEEP,2005,6-12 months,0,0,0
LAKSHADWEEP,2005,1-2 Years,0,0,0
LAKSHADWEEP,2005,2-3 Years,0,0,0
LAKSHADWEEP,2005,3-5 Years,0,0,0
LAKSHADWEEP,2005,Above 5 Years,0,0,0
LAKSHADWEEP,2005,Total,6,0,6
LAKSHADWEEP,2006,Upto 3 months,0,0,0
LAKSHADWEEP,2006,3-6 months,0,0,0
LAKSHADWEEP,2006,6-12 months,0,0,0
LAKSHADWEEP,2006,1-2 Years,0,0,0
LAKSHADWEEP,2006,2-3 Years,0,0,0
LAKSHADWEEP,2006,3-5 Years,0,0,0
LAKSHADWEEP,2006,Above 5 Years,0,0,0
LAKSHADWEEP,2006,Total,0,0,0
LAKSHADWEEP,2007,Upto 3 months,10,0,10
LAKSHADWEEP,2007,3-6 months,0,0,0
LAKSHADWEEP,2007,6-12 months,1,0,1
LAKSHADWEEP,2007,1-2 Years,0,0,0
LAKSHADWEEP,2007,2-3 Years,0,0,0
LAKSHADWEEP,2007,3-5 Years,0,0,0
LAKSHADWEEP,2007,Above 5 Years,0,0,0
LAKSHADWEEP,2007,Total,11,0,11
LAKSHADWEEP,2008,Upto 3 months,17,0,17
LAKSHADWEEP,2008,3-6 months,1,0,1
LAKSHADWEEP,2008,6-12 months,1,0,1
LAKSHADWEEP,2008,1-2 Years,0,0,0
LAKSHADWEEP,2008,2-3 Years,0,0,0
LAKSHADWEEP,2008,3-5 Years,0,0,0
LAKSHADWEEP,2008,Above 5 Years,0,0,0
LAKSHADWEEP,2008,Total,19,0,19
LAKSHADWEEP,2009,Upto 3 months,42,0,42
LAKSHADWEEP,2009,3-6 months,0,0,0
LAKSHADWEEP,2009,6-12 months,0,0,0
LAKSHADWEEP,2009,1-2 Years,1,0,1
LAKSHADWEEP,2009,2-3 Years,0,0,0
LAKSHADWEEP,2009,3-5 Years,0,0,0
LAKSHADWEEP,2009,Above 5 Years,0,0,0
LAKSHADWEEP,2009,Total,43,0,43
LAKSHADWEEP,2010,Upto 3 months,5,0,5
LAKSHADWEEP,2010,3-6 months,19,0,19
LAKSHADWEEP,2010,6-12 months,3,0,3
LAKSHADWEEP,2010,1-2 Years,0,0,0
LAKSHADWEEP,2010,2-3 Years,0,0,0
LAKSHADWEEP,2010,3-5 Years,0,0,0
LAKSHADWEEP,2010,Above 5 Years,0,0,0
LAKSHADWEEP,2010,Total,27,0,27
LAKSHADWEEP,2011,Upto 3 months,7,1,8
LAKSHADWEEP,2011,3-6 months,0,0,0
LAKSHADWEEP,2011,6-12 months,19,0,19
LAKSHADWEEP,2011,1-2 Years,3,0,3
LAKSHADWEEP,2011,2-3 Years,0,0,0
LAKSHADWEEP,2011,3-5 Years,0,0,0
LAKSHADWEEP,2011,Above 5 Years,0,0,0
LAKSHADWEEP,2011,Total,29,1,30
LAKSHADWEEP,2012,Upto 3 months,0,0,0
LAKSHADWEEP,2012,3-6 months,0,0,0
LAKSHADWEEP,2012,6-12 months,0,0,0
LAKSHADWEEP,2012,1-2 Years,0,0,0
LAKSHADWEEP,2012,2-3 Years,0,0,0
LAKSHADWEEP,2012,3-5 Years,0,0,0
LAKSHADWEEP,2012,Above 5 Years,0,0,0
LAKSHADWEEP,2012,Total,0,0,0
PONDICHERRY,2001,Upto 3 months,116,5,121
PONDICHERRY,2001,3-6 months,22,0,22
PONDICHERRY,2001,6-12 months,9,0,9
PONDICHERRY,2001,1-2 Years,2,0,2
PONDICHERRY,2001,2-3 Years,0,0,0
PONDICHERRY,2001,3-5 Years,0,0,0
PONDICHERRY,2001,Above 5 Years,0,0,0
PONDICHERRY,2001,Total,149,5,154
PONDICHERRY,2002,Upto 3 months,85,12,97
PONDICHERRY,2002,3-6 months,12,0,12
PONDICHERRY,2002,6-12 months,2,0,2
PONDICHERRY,2002,1-2 Years,1,0,1
PONDICHERRY,2002,2-3 Years,0,0,0
PONDICHERRY,2002,3-5 Years,0,0,0
PONDICHERRY,2002,Above 5 Years,0,0,0
PONDICHERRY,2002,Total,100,12,112
PONDICHERRY,2003,Upto 3 months,113,4,117
PONDICHERRY,2003,3-6 months,17,0,17
PONDICHERRY,2003,6-12 months,4,0,4
PONDICHERRY,2003,1-2 Years,1,0,1
PONDICHERRY,2003,2-3 Years,0,0,0
PONDICHERRY,2003,3-5 Years,0,0,0
PONDICHERRY,2003,Above 5 Years,0,0,0
PONDICHERRY,2003,Total,135,4,139
PONDICHERRY,2004,Upto 3 months,134,1,135
PONDICHERRY,2004,3-6 months,24,0,24
PONDICHERRY,2004,6-12 months,32,0,32
PONDICHERRY,2004,1-2 Years,1,0,1
PONDICHERRY,2004,2-3 Years,0,0,0
PONDICHERRY,2004,3-5 Years,0,0,0
PONDICHERRY,2004,Above 5 Years,0,0,0
PONDICHERRY,2004,Total,191,1,192
PONDICHERRY,2005,Upto 3 months,143,1,144
PONDICHERRY,2005,3-6 months,8,0,8
PONDICHERRY,2005,6-12 months,0,0,0
PONDICHERRY,2005,1-2 Years,4,0,4
PONDICHERRY,2005,2-3 Years,13,0,13
PONDICHERRY,2005,3-5 Years,0,0,0
PONDICHERRY,2005,Above 5 Years,0,0,0
PONDICHERRY,2005,Total,168,1,169
PONDICHERRY,2006,Upto 3 months,123,1,124
PONDICHERRY,2006,3-6 months,52,0,52
PONDICHERRY,2006,6-12 months,11,0,11
PONDICHERRY,2006,1-2 Years,3,0,3
PONDICHERRY,2006,2-3 Years,0,0,0
PONDICHERRY,2006,3-5 Years,13,0,13
PONDICHERRY,2006,Above 5 Years,0,0,0
PONDICHERRY,2006,Total,202,1,203
PONDICHERRY,2007,Upto 3 months,155,1,156
PONDICHERRY,2007,3-6 months,45,0,45
PONDICHERRY,2007,6-12 months,12,1,13
PONDICHERRY,2007,1-2 Years,4,0,4
PONDICHERRY,2007,2-3 Years,3,0,3
PONDICHERRY,2007,3-5 Years,13,0,13
PONDICHERRY,2007,Above 5 Years,0,0,0
PONDICHERRY,2007,Total,232,2,234
PONDICHERRY,2008,Upto 3 months,159,3,162
PONDICHERRY,2008,3-6 months,18,0,18
PONDICHERRY,2008,6-12 months,11,0,11
PONDICHERRY,2008,1-2 Years,5,2,7
PONDICHERRY,2008,2-3 Years,2,0,2
PONDICHERRY,2008,3-5 Years,3,0,3
PONDICHERRY,2008,Above 5 Years,0,0,0
PONDICHERRY,2008,Total,198,5,203
PONDICHERRY,2009,Upto 3 months,88,0,88
PONDICHERRY,2009,3-6 months,34,1,35
PONDICHERRY,2009,6-12 months,20,0,20
PONDICHERRY,2009,1-2 Years,4,0,4
PONDICHERRY,2009,2-3 Years,2,0,2
PONDICHERRY,2009,3-5 Years,1,0,1
PONDICHERRY,2009,Above 5 Years,0,0,0
PONDICHERRY,2009,Total,149,1,150
PONDICHERRY,2010,Upto 3 months,96,3,99
PONDICHERRY,2010,3-6 months,18,0,18
PONDICHERRY,2010,6-12 months,4,0,4
PONDICHERRY,2010,1-2 Years,4,0,4
PONDICHERRY,2010,2-3 Years,2,1,3
PONDICHERRY,2010,3-5 Years,0,0,0
PONDICHERRY,2010,Above 5 Years,0,0,0
PONDICHERRY,2010,Total,124,4,128
PONDICHERRY,2011,Upto 3 months,67,2,69
PONDICHERRY,2011,3-6 months,41,0,41
PONDICHERRY,2011,6-12 months,2,0,2
PONDICHERRY,2011,1-2 Years,0,0,0
PONDICHERRY,2011,2-3 Years,0,0,0
PONDICHERRY,2011,3-5 Years,0,0,0
PONDICHERRY,2011,Above 5 Years,0,0,0
PONDICHERRY,2011,Total,110,2,112
PONDICHERRY,2012,Upto 3 months,91,1,92
PONDICHERRY,2012,3-6 months,66,0,66
PONDICHERRY,2012,6-12 months,18,0,18
PONDICHERRY,2012,1-2 Years,0,0,0
PONDICHERRY,2012,2-3 Years,0,0,0
PONDICHERRY,2012,3-5 Years,0,0,0
PONDICHERRY,2012,Above 5 Years,0,0,0
PONDICHERRY,2012,Total,175,1,176
ANDHRA PRADESH,2013,Upto 3 months,8125,529,8654
ANDHRA PRADESH,2013,3-6 months,645,63,708
ANDHRA PRADESH,2013,6-12 months,237,8,245
ANDHRA PRADESH,2013,1-2 Years,65,6,71
ANDHRA PRADESH,2013,2-3 Years,12,2,14
ANDHRA PRADESH,2013,3-5 Years,5,1,6
ANDHRA PRADESH,2013,Above 5 Years,3,0,3
ANDHRA PRADESH,2013,Total,9092,609,9701
ARUNACHAL PRADESH,2013,Upto 3 months,32,0,32
ARUNACHAL PRADESH,2013,3-6 months,15,0,15
ARUNACHAL PRADESH,2013,6-12 months,17,0,17
ARUNACHAL PRADESH,2013,1-2 Years,15,0,15
ARUNACHAL PRADESH,2013,2-3 Years,0,0,0
ARUNACHAL PRADESH,2013,3-5 Years,1,1,2
ARUNACHAL PRADESH,2013,Above 5 Years,0,0,0
ARUNACHAL PRADESH,2013,Total,80,1,81
ASSAM,2013,Upto 3 months,3145,130,3275
ASSAM,2013,3-6 months,765,40,805
ASSAM,2013,6-12 months,515,14,529
ASSAM,2013,1-2 Years,318,13,331
ASSAM,2013,2-3 Years,104,3,107
ASSAM,2013,3-5 Years,91,4,95
ASSAM,2013,Above 5 Years,20,1,21
ASSAM,2013,Total,4958,205,5163
BIHAR,2013,Upto 3 months,7624,357,7981
BIHAR,2013,3-6 months,6024,230,6254
BIHAR,2013,6-12 months,5272,187,5459
BIHAR,2013,1-2 Years,3213,97,3310
BIHAR,2013,2-3 Years,1854,44,1898
BIHAR,2013,3-5 Years,1208,35,1243
BIHAR,2013,Above 5 Years,441,23,464
BIHAR,2013,Total,25636,973,26609
CHHATISGARH,2013,Upto 3 months,2826,175,3001
CHHATISGARH,2013,3-6 months,1793,101,1894
CHHATISGARH,2013,6-12 months,1940,107,2047
CHHATISGARH,2013,1-2 Years,1358,85,1443
CHHATISGARH,2013,2-3 Years,439,27,466
CHHATISGARH,2013,3-5 Years,315,12,327
CHHATISGARH,2013,Above 5 Years,54,9,63
CHHATISGARH,2013,Total,8725,516,9241
GOA,2013,Upto 3 months,70,4,74
GOA,2013,3-6 months,65,2,67
GOA,2013,6-12 months,80,2,82
GOA,2013,1-2 Years,60,1,61
GOA,2013,2-3 Years,36,4,40
GOA,2013,3-5 Years,36,4,40
GOA,2013,Above 5 Years,28,4,32
GOA,2013,Total,375,21,396
GUJARAT,2013,Upto 3 months,1843,115,1958
GUJARAT,2013,3-6 months,1669,82,1751
GUJARAT,2013,6-12 months,1355,51,1406
GUJARAT,2013,1-2 Years,1353,74,1427
GUJARAT,2013,2-3 Years,595,29,624
GUJARAT,2013,3-5 Years,336,17,353
GUJARAT,2013,Above 5 Years,74,11,85
GUJARAT,2013,Total,7225,379,7604
HARYANA,2013,Upto 3 months,3617,172,3789
HARYANA,2013,3-6 months,2401,115,2516
HARYANA,2013,6-12 months,2278,91,2369
HARYANA,2013,1-2 Years,1353,89,1442
HARYANA,2013,2-3 Years,405,5,410
HARYANA,2013,3-5 Years,82,3,85
HARYANA,2013,Above 5 Years,12,0,12
HARYANA,2013,Total,10148,475,10623
HIMACHAL PRADESH,2013,Upto 3 months,304,21,325
HIMACHAL PRADESH,2013,3-6 months,230,11,241
HIMACHAL PRADESH,2013,6-12 months,212,15,227
HIMACHAL PRADESH,2013,1-2 Years,172,9,181
HIMACHAL PRADESH,2013,2-3 Years,20,2,22
HIMACHAL PRADESH,2013,3-5 Years,2,0,2
HIMACHAL PRADESH,2013,Above 5 Years,0,0,0
HIMACHAL PRADESH,2013,Total,940,58,998
JAMMU & KASHMIR,2013,Upto 3 months,318,12,330
JAMMU & KASHMIR,2013,3-6 months,272,8,280
JAMMU & KASHMIR,2013,6-12 months,281,13,294
JAMMU & KASHMIR,2013,1-2 Years,355,16,371
JAMMU & KASHMIR,2013,2-3 Years,262,12,274
JAMMU & KASHMIR,2013,3-5 Years,233,8,241
JAMMU & KASHMIR,2013,Above 5 Years,103,7,110
JAMMU & KASHMIR,2013,Total,1824,76,1900
JHARKHAND,2013,Upto 3 months,4411,203,4614
JHARKHAND,2013,3-6 months,3003,138,3141
JHARKHAND,2013,6-12 months,2493,168,2661
JHARKHAND,2013,1-2 Years,1835,95,1930
JHARKHAND,2013,2-3 Years,968,55,1023
JHARKHAND,2013,3-5 Years,535,29,564
JHARKHAND,2013,Above 5 Years,111,4,115
JHARKHAND,2013,Total,13356,692,14048
KARNATAKA,2013,Upto 3 months,3513,191,3704
KARNATAKA,2013,3-6 months,2189,72,2261
KARNATAKA,2013,6-12 months,1618,74,1692
KARNATAKA,2013,1-2 Years,1213,20,1233
KARNATAKA,2013,2-3 Years,373,9,382
KARNATAKA,2013,3-5 Years,179,7,186
KARNATAKA,2013,Above 5 Years,47,1,48
KARNATAKA,2013,Total,9132,374,9506
KERALA,2013,Upto 3 months,2900,105,3005
KERALA,2013,3-6 months,1105,20,1125
KERALA,2013,6-12 months,320,10,330
KERALA,2013,1-2 Years,125,5,130
KERALA,2013,2-3 Years,31,0,31
KERALA,2013,3-5 Years,0,0,0
KERALA,2013,Above 5 Years,0,0,0
KERALA,2013,Total,4481,140,4621
MADHYA PRADESH,2013,Upto 3 months,7023,235,7258
MADHYA PRADESH,2013,3-6 months,3533,153,3686
MADHYA PRADESH,2013,6-12 months,3118,105,3223
MADHYA PRADESH,2013,1-2 Years,2351,50,2401
MADHYA PRADESH,2013,2-3 Years,720,17,737
MADHYA PRADESH,2013,3-5 Years,213,6,219
MADHYA PRADESH,2013,Above 5 Years,43,1,44
MADHYA PRADESH,2013,Total,17001,567,17568
MAHARASHTRA,2013,Upto 3 months,6911,550,7461
MAHARASHTRA,2013,3-6 months,3677,254,3931
MAHARASHTRA,2013,6-12 months,3283,161,3444
MAHARASHTRA,2013,1-2 Years,2500,98,2598
MAHARASHTRA,2013,2-3 Years,1143,46,1189
MAHARASHTRA,2013,3-5 Years,555,11,566
MAHARASHTRA,2013,Above 5 Years,141,1,142
MAHARASHTRA,2013,Total,18210,1121,19331
MANIPUR,2013,Upto 3 months,221,21,242
MANIPUR,2013,3-6 months,111,4,115
MANIPUR,2013,6-12 months,86,3,89
MANIPUR,2013,1-2 Years,57,1,58
MANIPUR,2013,2-3 Years,15,1,16
MANIPUR,2013,3-5 Years,8,0,8
MANIPUR,2013,Above 5 Years,10,0,10
MANIPUR,2013,Total,508,30,538
MEGHALAYA,2013,Upto 3 months,257,1,258
MEGHALAYA,2013,3-6 months,164,2,166
MEGHALAYA,2013,6-12 months,103,4,107
MEGHALAYA,2013,1-2 Years,94,4,98
MEGHALAYA,2013,2-3 Years,60,0,60
MEGHALAYA,2013,3-5 Years,44,0,44
MEGHALAYA,2013,Above 5 Years,12,0,12
MEGHALAYA,2013,Total,734,11,745
MIZORAM,2013,Upto 3 months,322,51,373
MIZORAM,2013,3-6 months,57,5,62
MIZORAM,2013,6-12 months,17,2,19
MIZORAM,2013,1-2 Years,6,0,6
MIZORAM,2013,2-3 Years,0,0,0
MIZORAM,2013,3-5 Years,0,0,0
MIZORAM,2013,Above 5 Years,0,0,0
MIZORAM,2013,Total,402,58,460
NAGALAND,2013,Upto 3 months,121,4,125
NAGALAND,2013,3-6 months,72,2,74
NAGALAND,2013,6-12 months,67,0,67
NAGALAND,2013,1-2 Years,57,1,58
NAGALAND,2013,2-3 Years,12,0,12
NAGALAND,2013,3-5 Years,2,1,3
NAGALAND,2013,Above 5 Years,2,0,2
NAGALAND,2013,Total,333,8,341
ORISSA,2013,Upto 3 months,4061,214,4275
ORISSA,2013,3-6 months,2708,144,2852
ORISSA,2013,6-12 months,1646,74,1720
ORISSA,2013,1-2 Years,1226,55,1281
ORISSA,2013,2-3 Years,495,23,518
ORISSA,2013,3-5 Years,255,6,261
ORISSA,2013,Above 5 Years,55,3,58
ORISSA,2013,Total,10446,519,10965
PUNJAB,2013,Upto 3 months,4583,253,4836
PUNJAB,2013,3-6 months,4380,182,4562
PUNJAB,2013,6-12 months,3164,153,3317
PUNJAB,2013,1-2 Years,2407,126,2533
PUNJAB,2013,2-3 Years,1845,96,1941
PUNJAB,2013,3-5 Years,930,93,1023
PUNJAB,2013,Above 5 Years,221,73,294
PUNJAB,2013,Total,17530,976,18506
RAJASTHAN,2013,Upto 3 months,3998,89,4087
RAJASTHAN,2013,3-6 months,2347,101,2448
RAJASTHAN,2013,6-12 months,2692,91,2783
RAJASTHAN,2013,1-2 Years,1937,87,2024
RAJASTHAN,2013,2-3 Years,1157,47,1204
RAJASTHAN,2013,3-5 Years,576,23,599
RAJASTHAN,2013,Above 5 Years,96,5,101
RAJASTHAN,2013,Total,12803,443,13246
SIKKIM,2013,Upto 3 months,49,3,52
SIKKIM,2013,3-6 months,37,0,37
SIKKIM,2013,6-12 months,25,0,25
SIKKIM,2013,1-2 Years,7,3,10
SIKKIM,2013,2-3 Years,2,0,2
SIKKIM,2013,3-5 Years,0,0,0
SIKKIM,2013,Above 5 Years,0,0,0
SIKKIM,2013,Total,120,6,126
TAMILNADU,2013,Upto 3 months,3121,299,3420
TAMILNADU,2013,3-6 months,2327,126,2453
TAMILNADU,2013,6-12 months,1664,52,1716
TAMILNADU,2013,1-2 Years,247,19,266
TAMILNADU,2013,2-3 Years,169,0,169
TAMILNADU,2013,3-5 Years,206,1,207
TAMILNADU,2013,Above 5 Years,61,0,61
TAMILNADU,2013,Total,7795,497,8292
TRIPURA,2013,Upto 3 months,268,7,275
TRIPURA,2013,3-6 months,74,3,77
TRIPURA,2013,6-12 months,29,1,30
TRIPURA,2013,1-2 Years,7,0,7
TRIPURA,2013,2-3 Years,5,0,5
TRIPURA,2013,3-5 Years,4,0,4
TRIPURA,2013,Above 5 Years,1,0,1
TRIPURA,2013,Total,388,11,399
UTTAR PRADESH,2013,Upto 3 months,18865,763,19628
UTTAR PRADESH,2013,3-6 months,11770,514,12284
UTTAR PRADESH,2013,6-12 months,9751,467,10218
UTTAR PRADESH,2013,1-2 Years,7546,330,7876
UTTAR PRADESH,2013,2-3 Years,4323,178,4501
UTTAR PRADESH,2013,3-5 Years,2603,76,2679
UTTAR PRADESH,2013,Above 5 Years,893,21,914
UTTAR PRADESH,2013,Total,55751,2349,58100
UTTARANCHAL,2013,Upto 3 months,640,38,678
UTTARANCHAL,2013,3-6 months,365,11,376
UTTARANCHAL,2013,6-12 months,570,39,609
UTTARANCHAL,2013,1-2 Years,214,8,222
UTTARANCHAL,2013,2-3 Years,32,1,33
UTTARANCHAL,2013,3-5 Years,2,0,2
UTTARANCHAL,2013,Above 5 Years,4,0,4
UTTARANCHAL,2013,Total,1827,97,1924
WEST BENGAL,2013,Upto 3 months,7082,466,7548
WEST BENGAL,2013,3-6 months,3116,170,3286
WEST BENGAL,2013,6-12 months,2493,181,2674
WEST BENGAL,2013,1-2 Years,1339,76,1415
WEST BENGAL,2013,2-3 Years,751,39,790
WEST BENGAL,2013,3-5 Years,451,36,487
WEST BENGAL,2013,Above 5 Years,261,10,271
WEST BENGAL,2013,Total,15493,978,16471
A & N ISLANDS,2013,Upto 3 months,57,0,57
A & N ISLANDS,2013,3-6 months,28,0,28
A & N ISLANDS,2013,6-12 months,13,0,13
A & N ISLANDS,2013,1-2 Years,41,4,45
A & N ISLANDS,2013,2-3 Years,29,2,31
A & N ISLANDS,2013,3-5 Years,17,1,18
A & N ISLANDS,2013,Above 5 Years,1,0,1
A & N ISLANDS,2013,Total,186,7,193
CHANDIGARH,2013,Upto 3 months,196,4,200
CHANDIGARH,2013,3-6 months,86,6,92
CHANDIGARH,2013,6-12 months,47,1,48
CHANDIGARH,2013,1-2 Years,36,1,37
CHANDIGARH,2013,2-3 Years,12,0,12
CHANDIGARH,2013,3-5 Years,1,0,1
CHANDIGARH,2013,Above 5 Years,1,0,1
CHANDIGARH,2013,Total,379,12,391
D & N HAVELI,2013,Upto 3 months,5,0,5
D & N HAVELI,2013,3-6 months,12,0,12
D & N HAVELI,2013,6-12 months,11,0,11
D & N HAVELI,2013,1-2 Years,3,0,3
D & N HAVELI,2013,2-3 Years,2,0,2
D & N HAVELI,2013,3-5 Years,2,0,2
D & N HAVELI,2013,Above 5 Years,0,0,0
D & N HAVELI,2013,Total,35,0,35
DAMAN & DIU,2013,Upto 3 months,13,0,13
DAMAN & DIU,2013,3-6 months,10,0,10
DAMAN & DIU,2013,6-12 months,6,0,6
DAMAN & DIU,2013,1-2 Years,9,0,9
DAMAN & DIU,2013,2-3 Years,0,0,0
DAMAN & DIU,2013,3-5 Years,0,0,0
DAMAN & DIU,2013,Above 5 Years,0,0,0
DAMAN & DIU,2013,Total,38,0,38
DELHI,2013,Upto 3 months,3704,133,3837
DELHI,2013,3-6 months,1603,71,1674
DELHI,2013,6-12 months,1549,89,1638
DELHI,2013,1-2 Years,1460,95,1555
DELHI,2013,2-3 Years,657,40,697
DELHI,2013,3-5 Years,548,27,575
DELHI,2013,Above 5 Years,159,19,178
DELHI,2013,Total,9680,474,10154
LAKSHADWEEP,2013,Upto 3 months,0,0,0
LAKSHADWEEP,2013,3-6 months,0,0,0
LAKSHADWEEP,2013,6-12 months,0,0,0
LAKSHADWEEP,2013,1-2 Years,0,0,0
LAKSHADWEEP,2013,2-3 Years,0,0,0
LAKSHADWEEP,2013,3-5 Years,0,0,0
LAKSHADWEEP,2013,Above 5 Years,0,0,0
LAKSHADWEEP,2013,Total,0,0,0
PONDICHERRY,2013,Upto 3 months,82,5,87
PONDICHERRY,2013,3-6 months,61,0,61
PONDICHERRY,2013,6-12 months,40,0,40
PONDICHERRY,2013,1-2 Years,1,0,1
PONDICHERRY,2013,2-3 Years,0,0,0
PONDICHERRY,2013,3-5 Years,0,0,0
PONDICHERRY,2013,Above 5 Years,0,0,0
PONDICHERRY,2013,Total,184,5,189
