STATE/UT,Year,CRIME HEAD,Male 16-18 years,Female 16-18 years,Total 16-18 years,Male 18-30 years,Female 18-30 years,Total 18-30 years,Male 30-50 years,Female 30-50 years,Total 30-50 years,Male Above 50 years,Female Above 50 years,Total Above 50 years,Total Male,Total Female,Grand Total
ANDHRA PRADESH,2001,ARMS ACT,3,0,3,124,6,130,88,6,94,13,0,13,228,12,240
ANDHRA PRADESH,2001,N.D.P.S. ACT,1,0,1,104,9,113,134,7,141,29,0,29,268,16,284
ANDHRA PRADESH,2001,GAMBLING ACT,0,0,0,29,3,32,34,4,38,16,0,16,79,7,86
ANDHRA PRADESH,2001,EXCISE ACT,17,0,17,292,32,324,292,35,327,68,5,73,669,72,741
ANDHRA PRADESH,2001,PROHIBITION ACT,1,0,1,118,2,120,229,24,253,24,6,30,372,32,404
ANDHRA PRADESH,2001,EXPLOSIVE & EXPLOSIVE SUBST. ACT,0,0,0,37,1,38,22,2,24,0,0,0,59,3,62
ANDHRA PRADESH,2001,TERRORIST & DISRUPTIVE ACTIVITIES (TATA),0,0,0,0,0,0,1,0,1,0,0,0,1,0,1
ANDHRA PRADESH,2001,IMMORAL TRAFFIC (PREVENTION) ACT,2,0,2,18,9,27,13,1,14,2,0,2,35,10,45
ANDHRA PRADESH,2001,INDIAN RAILWAYS ACT,4,0,4,66,1,67,56,0,56,16,0,16,142,1,143
ANDHRA PRADESH,2001,REGISTRATION OF FOREIGNERS ACT,0,0,0,4,0,4,8,0,8,0,0,0,12,0,12
ANDHRA PRADESH,2001,PROTECTION OF CIVIL RIGHTS ACT,0,0,0,7,0,7,3,0,3,0,0,0,10,0,10
ANDHRA PRADESH,2001,SC/ST (PREVENTION OF ATROCITIES) ACT,0,0,0,1,0,1,4,0,4,2,0,2,7,0,7
ANDHRA PRADESH,2001,INDIAN PASSPORT ACT,0,0,0,10,0,10,2,0,2,2,0,2,14,0,14
ANDHRA PRADESH,2001,ESSENTIAL COMMODITIES ACT,0,0,0,0,0,0,0,0,0,0,0,0,0,0,0
ANDHRA PRADESH,2001,ANTIQUITIES AND ART TREASURE ACT,0,0,0,2,0,2,4,0,4,0,0,0,6,0,6
ANDHRA PRADESH,2001,DOWRY PROHIBITION ACT,1,0,1,80,8,88,75,6,81,27,0,27,183,14,197
ANDHRA PRADESH,2001,FOREIGN EXCHANGE REGULATION ACT-1973,0,0,0,0,0,0,0,0,0,0,0,0,0,0,0
ANDHRA PRADESH,2001,PREVENTION OF CORRUPTION ACT-1988,0,0,0,1,0,1,1,0,1,0,0,0,2,0,2
ANDHRA PRADESH,2001,CONSER.OF FORGN.EXCH.&PREV. OF SMUG.ACT,0,0,0,5,0,5,0,0,0,2,0,2,7,0,7
ANDHRA PRADESH,2001,OTHER SLL OFFENCE,0,0,0,107,6,113,102,15,117,21,0,21,230,21,251
ANDHRA PRADESH,2001,TOTAL,29,0,29,1005,77,1082,1068,100,1168,222,11,233,2324,188,2512
ANDHRA PRADESH,2002,ARMS ACT,1,0,1,139,4,143,90,2,92,9,0,9,239,6,245
ANDHRA PRADESH,2002,N.D.P.S. ACT,0,0,0,144,7,151,148,17,165,23,1,24,315,25,340
ANDHRA PRADESH,2002,GAMBLING ACT,0,0,0,27,0,27,30,0,30,13,0,13,70,0,70
ANDHRA PRADESH,2002,EXCISE ACT,4,1,5,267,39,306,220,19,239,84,6,90,575,65,640
ANDHRA PRADESH,2002,PROHIBITION ACT,5,0,5,311,30,341,298,51,349,69,12,81,683,93,776
ANDHRA PRADESH,2002,EXPLOSIVE & EXPLOSIVE SUBST. ACT,0,0,0,35,0,35,72,0,72,10,0,10,117,0,117
ANDHRA PRADESH,2002,TERRORIST & DISRUPTIVE ACTIVITIES (TATA),0,0,0,27,2,29,34,0,34,7,0,7,68,2,70
ANDHRA PRADESH,2002,IMMORAL TRAFFIC (PREVENTION) ACT,4,0,4,10,5,15,16,2,18,4,0,4,34,7,41
ANDHRA PRADESH,2002,INDIAN RAILWAYS ACT,0,0,0,35,1,36,31,0,31,2,0,2,68,1,69
ANDHRA PRADESH,2002,REGISTRATION OF FOREIGNERS ACT,0,0,0,3,0,3,3,0,3,0,0,0,6,0,6
ANDHRA PRADESH,2002,PROTECTION OF CIVIL RIGHTS ACT,0,0,0,0,0,0,0,0,0,0,0,0,0,0,0
ANDHRA PRADESH,2002,SC/ST (PREVENTION OF ATROCITIES) ACT,0,0,0,34,0,34,17,0,17,7,0,7,58,0,58
ANDHRA PRADESH,2002,INDIAN PASSPORT ACT,0,0,0,0,0,0,26,0,26,0,0,0,26,0,26
ANDHRA PRADESH,2002,ESSENTIAL COMMODITIES ACT,0,0,0,0,0,0,2,0,2,1,0,1,3,0,3
ANDHRA PRADESH,2002,ANTIQUITIES AND ART TREASURE ACT,0,0,0,0,0,0,0,0,0,0,0,0,0,0,0
ANDHRA PRADESH,2002,DOWRY PROHIBITION ACT,0,1,1,30,6,36,28,4,32,26,1,27,84,12,96
ANDHRA PRADESH,2002,FOREIGN EXCHANGE REGULATION ACT-1973,0,0,0,0,0,0,0,0,0,0,0,0,0,0,0
ANDHRA PRADESH,2002,PREVENTION OF CORRUPTION ACT-1988,0,0,0,1,0,1,3,0,3,0,0,0,4,0,4
ANDHRA PRADESH,2002,CONSER.OF FORGN.EXCH.&PREV. OF SMUG.ACT,0,0,0,0,0,0,0,0,0,0,1,1,0,1,1
ANDHRA PRADESH,2002,OTHER SLL OFFENCE,0,0,0,71,9,80,46,4,50,7,0,7,124,13,137
ANDHRA PRADESH,2002,TOTAL,14,2,16,1134,103,1237,1064,99,1163,262,21,283,2474,225,2699
ANDHRA PRADESH,2003,ARMS ACT,0,0,0,141,5,146,92,1,93,11,0,11,244,6,250
ANDHRA PRADESH,2003,N.D.P.S. ACT,0,0,0,145,7,152,146,16,162,24,0,24,315,23,338
ANDHRA PRADESH,2003,GAMBLING ACT,0,0,0,32,0,32,35,0,35,12,0,12,79,0,79
ANDHRA PRADESH,2003,EXCISE ACT,4,0,4,264,39,303,224,16,240,86,5,91,578,60,638
ANDHRA PRADESH,2003,PROHIBITION ACT,0,0,0,361,28,389,298,48,346,73,12,85,732,88,820
ANDHRA PRADESH,2003,EXPLOSIVE & EXPLOSIVE SUBST. ACT,0,0,0,37,0,37,74,0,74,11,0,11,122,0,122
ANDHRA PRADESH,2003,TERRORIST & DISRUPTIVE ACTIVITIES (TATA),0,0,0,29,2,31,34,1,35,9,0,9,72,3,75
ANDHRA PRADESH,2003,IMMORAL TRAFFIC (PREVENTION) ACT,0,0,0,28,4,32,26,2,28,3,0,3,57,6,63
ANDHRA PRADESH,2003,INDIAN RAILWAYS ACT,0,0,0,39,5,44,32,0,32,6,0,6,77,5,82
ANDHRA PRADESH,2003,REGISTRATION OF FOREIGNERS ACT,0,0,0,2,0,2,2,0,2,0,0,0,4,0,4
ANDHRA PRADESH,2003,PROTECTION OF CIVIL RIGHTS ACT,0,0,0,0,0,0,0,0,0,0,0,0,0,0,0
ANDHRA PRADESH,2003,SC/ST (PREVENTION OF ATROCITIES) ACT,0,0,0,38,0,38,19,0,19,8,0,8,65,0,65
ANDHRA PRADESH,2003,INDIAN PASSPORT ACT,0,0,0,0,0,0,27,0,27,0,0,0,27,0,27
ANDHRA PRADESH,2003,ESSENTIAL COMMODITIES ACT,0,0,0,4,0,4,3,0,3,0,0,0,7,0,7
ANDHRA PRADESH,2003,ANTIQUITIES AND ART TREASURE ACT,0,0,0,0,0,0,0,0,0,0,0,0,0,0,0
ANDHRA PRADESH,2003,DOWRY PROHIBITION ACT,0,0,0,37,7,44,29,3,32,24,1,25,90,11,101
ANDHRA PRADESH,2003,FOREIGN EXCHANGE REGULATION ACT-1973,0,0,0,0,0,0,0,0,0,0,0,0,0,0,0
ANDHRA PRADESH,2003,PREVENTION OF CORRUPTION ACT-1988,0,0,0,6,0,6,3,0,3,1,0,1,10,0,10
ANDHRA PRADESH,2003,CONSER.OF FORGN.EXCH.&PREV. OF SMUG.ACT,0,0,0,2,0,2,0,0,0,0,0,0,2,0,2
ANDHRA PRADESH,2003,OTHER SLL OFFENCE,0,0,0,75,6,81,42,4,46,9,0,9,126,10,136
ANDHRA PRADESH,2003,TOTAL,4,0,4,1240,103,1343,1086,91,1177,277,18,295,2607,212,2819
ANDHRA PRADESH,2004,ARMS ACT,0,0,0,78,5,83,49,0,49,0,0,0,127,5,132
ANDHRA PRADESH,2004,N.D.P.S. ACT,0,0,0,117,13,130,169,15,184,21,12,33,307,40,347
ANDHRA PRADESH,2004,GAMBLING ACT,0,0,0,32,0,32,29,0,29,7,0,7,68,0,68
ANDHRA PRADESH,2004,EXCISE ACT,8,0,8,269,26,295,284,23,307,83,8,91,644,57,701
ANDHRA PRADESH,2004,PROHIBITION ACT,13,0,13,266,38,304,360,34,394,80,27,107,719,99,818
ANDHRA PRADESH,2004,EXPLOSIVE & EXPLOSIVE SUBST. ACT,0,0,0,1,0,1,6,1,7,0,0,0,7,1,8
ANDHRA PRADESH,2004,TERRORIST & DISRUPTIVE ACTIVITIES (TATA),0,0,0,0,0,0,0,0,0,0,0,0,0,0,0
ANDHRA PRADESH,2004,IMMORAL TRAFFIC (PREVENTION) ACT,0,0,0,23,11,34,12,0,12,1,0,1,36,11,47
ANDHRA PRADESH,2004,INDIAN RAILWAYS ACT,0,0,0,92,5,97,79,1,80,20,0,20,191,6,197
ANDHRA PRADESH,2004,REGISTRATION OF FOREIGNERS ACT,0,0,0,0,1,1,0,0,0,0,0,0,0,1,1
ANDHRA PRADESH,2004,PROTECTION OF CIVIL RIGHTS ACT,0,0,0,2,0,2,3,0,3,0,0,0,5,0,5
ANDHRA PRADESH,2004,SC/ST (PREVENTION OF ATROCITIES) ACT,0,0,0,19,0,19,29,0,29,8,0,8,56,0,56
ANDHRA PRADESH,2004,INDIAN PASSPORT ACT,0,0,0,5,0,5,3,0,3,0,0,0,8,0,8
ANDHRA PRADESH,2004,ESSENTIAL COMMODITIES ACT,0,0,0,0,0,0,2,0,2,0,0,0,2,0,2
ANDHRA PRADESH,2004,ANTIQUITIES AND ART TREASURE ACT,0,0,0,0,0,0,0,0,0,0,0,0,0,0,0
ANDHRA PRADESH,2004,DOWRY PROHIBITION ACT,0,0,0,42,0,42,46,6,52,8,0,8,96,6,102
ANDHRA PRADESH,2004,FOREIGN EXCHANGE REGULATION ACT-1973,0,0,0,0,0,0,0,0,0,0,0,0,0,0,0
ANDHRA PRADESH,2004,PREVENTION OF CORRUPTION ACT-1988,0,0,0,0,0,0,0,0,0,0,0,0,0,0,0
ANDHRA PRADESH,2004,CONSER.OF FORGN.EXCH.&PREV. OF SMUG.ACT,0,0,0,0,0,0,0,0,0,0,0,0,0,0,0
ANDHRA PRADESH,2004,OTHER SLL OFFENCE,0,0,0,23,1,24,30,2,32,4,2,6,57,5,62
ANDHRA PRADESH,2004,TOTAL,21,0,21,969,100,1069,1101,82,1183,232,49,281,2323,231,2554
ANDHRA PRADESH,2005,ARMS ACT,0,0,0,93,1,94,55,3,58,3,0,3,151,4,155
ANDHRA PRADESH,2005,N.D.P.S. ACT,0,0,0,105,4,109,204,17,221,19,3,22,328,24,352
ANDHRA PRADESH,2005,GAMBLING ACT,0,0,0,25,0,25,34,0,34,12,0,12,71,0,71
ANDHRA PRADESH,2005,EXCISE ACT,0,0,0,275,15,290,404,48,452,71,10,81,750,73,823
ANDHRA PRADESH,2005,PROHIBITION ACT,0,0,0,160,29,189,233,30,263,47,2,49,440,61,501
ANDHRA PRADESH,2005,EXPLOSIVE & EXPLOSIVE SUBST. ACT,0,0,0,27,2,29,35,6,41,9,0,9,71,8,79
ANDHRA PRADESH,2005,TERRORIST & DISRUPTIVE ACTIVITIES (TATA),0,0,0,0,0,0,1,0,1,0,0,0,1,0,1
ANDHRA PRADESH,2005,IMMORAL TRAFFIC (PREVENTION) ACT,0,0,0,9,14,23,14,7,21,3,0,3,26,21,47
ANDHRA PRADESH,2005,INDIAN RAILWAYS ACT,0,0,0,48,0,48,59,9,68,28,0,28,135,9,144
ANDHRA PRADESH,2005,REGISTRATION OF FOREIGNERS ACT,0,0,0,0,0,0,3,1,4,0,0,0,3,1,4
ANDHRA PRADESH,2005,PROTECTION OF CIVIL RIGHTS ACT,0,0,0,0,0,0,0,0,0,0,0,0,0,0,0
ANDHRA PRADESH,2005,SC/ST (PREVENTION OF ATROCITIES) ACT,0,0,0,15,0,15,40,0,40,5,2,7,60,2,62
ANDHRA PRADESH,2005,INDIAN PASSPORT ACT,0,0,0,0,0,0,13,2,15,0,0,0,13,2,15
ANDHRA PRADESH,2005,ESSENTIAL COMMODITIES ACT,0,0,0,1,0,1,2,0,2,0,0,0,3,0,3
ANDHRA PRADESH,2005,ANTIQUITIES AND ART TREASURE ACT,0,0,0,0,0,0,0,0,0,0,0,0,0,0,0
ANDHRA PRADESH,2005,DOWRY PROHIBITION ACT,0,0,0,33,4,37,53,11,64,10,7,17,96,22,118
ANDHRA PRADESH,2005,FOREIGN EXCHANGE REGULATION ACT-1973,0,0,0,3,0,3,0,0,0,0,0,0,3,0,3
ANDHRA PRADESH,2005,PREVENTION OF CORRUPTION ACT-1988,0,0,0,0,0,0,5,0,5,0,0,0,5,0,5
ANDHRA PRADESH,2005,CONSER.OF FORGN.EXCH.&PREV. OF SMUG.ACT,0,0,0,0,0,0,0,0,0,0,0,0,0,0,0
ANDHRA PRADESH,2005,OTHER SLL OFFENCE,0,0,0,68,2,70,110,3,113,18,0,18,196,5,201
ANDHRA PRADESH,2005,TOTAL,0,0,0,862,71,933,1265,137,1402,225,24,249,2352,232,2584
ANDHRA PRADESH,2006,ARMS ACT,0,0,0,81,4,85,76,0,76,7,0,7,164,4,168
ANDHRA PRADESH,2006,N.D.P.S. ACT,0,0,0,108,7,115,219,18,237,58,2,60,385,27,412
ANDHRA PRADESH,2006,GAMBLING ACT,0,0,0,34,0,34,54,0,54,6,0,6,94,0,94
ANDHRA PRADESH,2006,EXCISE ACT,0,0,0,194,12,206,283,34,317,104,7,111,581,53,634
ANDHRA PRADESH,2006,PROHIBITION ACT,0,0,0,163,10,173,217,32,249,62,0,62,442,42,484
ANDHRA PRADESH,2006,EXPLOSIVE & EXPLOSIVE SUBST. ACT,0,0,0,32,0,32,48,0,48,17,0,17,97,0,97
ANDHRA PRADESH,2006,TERRORIST & DISRUPTIVE ACTIVITIES (TATA),0,0,0,0,0,0,0,0,0,0,0,0,0,0,0
ANDHRA PRADESH,2006,IMMORAL TRAFFIC (PREVENTION) ACT,0,0,0,16,18,34,17,2,19,14,1,15,47,21,68
ANDHRA PRADESH,2006,INDIAN RAILWAYS ACT,0,0,0,54,1,55,80,0,80,55,0,55,189,1,190
ANDHRA PRADESH,2006,REGISTRATION OF FOREIGNERS ACT,0,0,0,4,0,4,2,1,3,0,0,0,6,1,7
ANDHRA PRADESH,2006,PROTECTION OF CIVIL RIGHTS ACT,0,0,0,8,0,8,3,0,3,0,0,0,11,0,11
ANDHRA PRADESH,2006,SC/ST (PREVENTION OF ATROCITIES) ACT,0,0,0,34,2,36,63,3,66,2,2,4,99,7,106
ANDHRA PRADESH,2006,INDIAN PASSPORT ACT,0,0,0,1,0,1,7,0,7,0,0,0,8,0,8
ANDHRA PRADESH,2006,ESSENTIAL COMMODITIES ACT,0,0,0,5,0,5,3,0,3,0,0,0,8,0,8
ANDHRA PRADESH,2006,ANTIQUITIES AND ART TREASURE ACT,0,0,0,1,0,1,4,0,4,1,0,1,6,0,6
ANDHRA PRADESH,2006,DOWRY PROHIBITION ACT,0,0,0,53,0,53,66,10,76,43,5,48,162,15,177
ANDHRA PRADESH,2006,FOREIGN EXCHANGE REGULATION ACT-1973,0,0,0,0,0,0,0,0,0,0,0,0,0,0,0
ANDHRA PRADESH,2006,PREVENTION OF CORRUPTION ACT-1988,0,0,0,0,0,0,2,1,3,0,0,0,2,1,3
ANDHRA PRADESH,2006,CONSER.OF FORGN.EXCH.&PREV. OF SMUG.ACT,0,0,0,0,0,0,0,0,0,2,0,2,2,0,2
ANDHRA PRADESH,2006,OTHER SLL OFFENCE,0,0,0,70,9,79,65,10,75,30,0,30,165,19,184
ANDHRA PRADESH,2006,TOTAL,0,0,0,858,63,921,1209,111,1320,401,17,418,2468,191,2659
ANDHRA PRADESH,2007,ARMS ACT,0,0,0,58,1,59,51,4,55,8,2,10,117,7,124
ANDHRA PRADESH,2007,N.D.P.S. ACT,0,0,0,93,8,101,120,9,129,26,1,27,239,18,257
ANDHRA PRADESH,2007,GAMBLING ACT,0,0,0,20,0,20,10,1,11,1,1,2,31,2,33
ANDHRA PRADESH,2007,EXCISE ACT,0,0,0,132,3,135,174,24,198,74,7,81,380,34,414
ANDHRA PRADESH,2007,PROHIBITION ACT,0,0,0,103,14,117,130,25,155,40,14,54,273,53,326
ANDHRA PRADESH,2007,EXPLOSIVE & EXPLOSIVE SUBST. ACT,0,0,0,49,6,55,10,16,26,2,1,3,61,23,84
ANDHRA PRADESH,2007,TERRORIST & DISRUPTIVE ACTIVITIES (TATA),0,0,0,22,1,23,0,0,0,0,0,0,22,1,23
ANDHRA PRADESH,2007,IMMORAL TRAFFIC (PREVENTION) ACT,0,0,0,10,5,15,23,6,29,0,1,1,33,12,45
ANDHRA PRADESH,2007,INDIAN RAILWAYS ACT,0,0,0,62,0,62,38,0,38,8,0,8,108,0,108
ANDHRA PRADESH,2007,REGISTRATION OF FOREIGNERS ACT,0,0,0,1,0,1,0,0,0,0,0,0,1,0,1
ANDHRA PRADESH,2007,PROTECTION OF CIVIL RIGHTS ACT,0,0,0,13,0,13,0,0,0,0,0,0,13,0,13
ANDHRA PRADESH,2007,SC/ST (PREVENTION OF ATROCITIES) ACT,0,0,0,15,0,15,38,2,40,4,0,4,57,2,59
ANDHRA PRADESH,2007,INDIAN PASSPORT ACT,0,0,0,5,0,5,1,1,2,0,0,0,6,1,7
ANDHRA PRADESH,2007,ESSENTIAL COMMODITIES ACT,0,0,0,2,0,2,2,0,2,0,0,0,4,0,4
ANDHRA PRADESH,2007,ANTIQUITIES AND ART TREASURE ACT,0,0,0,0,0,0,0,0,0,0,0,0,0,0,0
ANDHRA PRADESH,2007,DOWRY PROHIBITION ACT,0,0,0,49,6,55,70,17,87,11,4,15,130,27,157
ANDHRA PRADESH,2007,FOREIGN EXCHANGE REGULATION ACT-1973,0,0,0,0,0,0,0,0,0,0,0,0,0,0,0
ANDHRA PRADESH,2007,PREVENTION OF CORRUPTION ACT-1988,0,0,0,3,0,3,16,0,16,4,0,4,23,0,23
ANDHRA PRADESH,2007,CONSER.OF FORGN.EXCH.&PREV. OF SMUG.ACT,0,0,0,0,0,0,0,0,0,0,0,0,0,0,0
ANDHRA PRADESH,2007,OTHER SLL OFFENCE,0,0,0,35,1,36,82,4,86,10,6,16,127,11,138
ANDHRA PRADESH,2007,TOTAL,0,0,0,672,45,717,765,109,874,188,37,225,1625,191,1816
ANDHRA PRADESH,2008,ARMS ACT,0,0,0,44,1,45,53,1,54,0,0,0,97,2,99
ANDHRA PRADESH,2008,N.D.P.S. ACT,0,0,0,30,3,33,75,3,78,11,0,11,116,6,122
ANDHRA PRADESH,2008,GAMBLING ACT,0,0,0,9,0,9,26,2,28,2,0,2,37,2,39
ANDHRA PRADESH,2008,EXCISE ACT,0,0,0,116,6,122,202,37,239,58,14,72,376,57,433
ANDHRA PRADESH,2008,PROHIBITION ACT,0,0,0,86,41,127,140,56,196,25,20,45,251,117,368
ANDHRA PRADESH,2008,EXPLOSIVE & EXPLOSIVE SUBST. ACT,0,0,0,45,5,50,38,14,52,9,5,14,92,24,116
ANDHRA PRADESH,2008,TERRORIST & DISRUPTIVE ACTIVITIES (TATA),0,0,0,0,0,0,0,0,0,0,0,0,0,0,0
ANDHRA PRADESH,2008,IMMORAL TRAFFIC (PREVENTION) ACT,0,0,0,8,7,15,9,0,9,2,2,4,19,9,28
ANDHRA PRADESH,2008,INDIAN RAILWAYS ACT,0,0,0,59,4,63,53,0,53,19,0,19,131,4,135
ANDHRA PRADESH,2008,REGISTRATION OF FOREIGNERS ACT,0,0,0,1,1,2,0,0,0,0,0,0,1,1,2
ANDHRA PRADESH,2008,PROTECTION OF CIVIL RIGHTS ACT,0,0,0,0,0,0,2,0,2,0,0,0,2,0,2
ANDHRA PRADESH,2008,SC/ST (PREVENTION OF ATROCITIES) ACT,0,0,0,18,1,19,51,7,58,6,0,6,75,8,83
ANDHRA PRADESH,2008,INDIAN PASSPORT ACT,0,0,0,1,0,1,7,0,7,0,0,0,8,0,8
ANDHRA PRADESH,2008,ESSENTIAL COMMODITIES ACT,0,0,0,0,0,0,0,0,0,0,0,0,0,0,0
ANDHRA PRADESH,2008,ANTIQUITIES AND ART TREASURE ACT,0,0,0,0,0,0,0,0,0,0,0,0,0,0,0
ANDHRA PRADESH,2008,DOWRY PROHIBITION ACT,0,0,0,39,0,39,105,13,118,9,7,16,153,20,173
ANDHRA PRADESH,2008,FOREIGN EXCHANGE REGULATION ACT-1973,0,0,0,0,0,0,0,0,0,0,0,0,0,0,0
ANDHRA PRADESH,2008,PREVENTION OF CORRUPTION ACT-1988,0,0,0,5,0,5,14,0,14,6,0,6,25,0,25
ANDHRA PRADESH,2008,CONSER.OF FORGN.EXCH.&PREV. OF SMUG.ACT,0,0,0,0,0,0,0,0,0,0,0,0,0,0,0
ANDHRA PRADESH,2008,OTHER SLL OFFENCE,0,0,0,29,0,29,62,8,70,9,2,11,100,10,110
ANDHRA PRADESH,2008,TOTAL,0,0,0,490,69,559,837,141,978,156,50,206,1483,260,1743
ANDHRA PRADESH,2009,ARMS ACT,0,0,0,66,1,67,70,2,72,8,0,8,144,3,147
ANDHRA PRADESH,2009,N.D.P.S. ACT,0,0,0,66,6,72,58,7,65,8,0,8,132,13,145
ANDHRA PRADESH,2009,GAMBLING ACT,0,0,0,40,0,40,27,1,28,4,0,4,71,1,72
ANDHRA PRADESH,2009,EXCISE ACT,0,0,0,141,2,143,309,19,328,10,8,18,460,29,489
ANDHRA PRADESH,2009,PROHIBITION ACT,0,0,0,94,13,107,133,38,171,27,7,34,254,58,312
ANDHRA PRADESH,2009,EXPLOSIVE & EXPLOSIVE SUBST. ACT,0,0,0,26,1,27,21,0,21,0,0,0,47,1,48
ANDHRA PRADESH,2009,TERRORIST & DISRUPTIVE ACTIVITIES (TATA),0,0,0,0,0,0,0,0,0,0,0,0,0,0,0
ANDHRA PRADESH,2009,IMMORAL TRAFFIC (PREVENTION) ACT,0,0,0,15,7,22,15,4,19,0,0,0,30,11,41
ANDHRA PRADESH,2009,INDIAN RAILWAYS ACT,0,0,0,61,3,64,87,1,88,17,0,17,165,4,169
ANDHRA PRADESH,2009,REGISTRATION OF FOREIGNERS ACT,0,0,0,0,0,0,15,0,15,0,1,1,15,1,16
ANDHRA PRADESH,2009,PROTECTION OF CIVIL RIGHTS ACT,0,0,0,0,0,0,0,0,0,0,0,0,0,0,0
ANDHRA PRADESH,2009,SC/ST (PREVENTION OF ATROCITIES) ACT,0,0,0,29,1,30,39,2,41,9,0,9,77,3,80
ANDHRA PRADESH,2009,INDIAN PASSPORT ACT,0,0,0,0,0,0,0,0,0,0,0,0,0,0,0
ANDHRA PRADESH,2009,ESSENTIAL COMMODITIES ACT,0,0,0,0,0,0,0,0,0,0,0,0,0,0,0
ANDHRA PRADESH,2009,ANTIQUITIES AND ART TREASURE ACT,0,0,0,0,0,0,0,4,4,0,0,0,0,4,4
ANDHRA PRADESH,2009,DOWRY PROHIBITION ACT,0,0,0,29,3,32,36,3,39,3,5,8,68,11,79
ANDHRA PRADESH,2009,FOREIGN EXCHANGE REGULATION ACT-1973,0,0,0,0,0,0,0,0,0,0,0,0,0,0,0
ANDHRA PRADESH,2009,PREVENTION OF CORRUPTION ACT-1988,0,0,0,5,0,5,24,0,24,3,0,3,32,0,32
ANDHRA PRADESH,2009,CONSER.OF FORGN.EXCH.&PREV. OF SMUG.ACT,0,0,0,26,0,26,34,0,34,4,0,4,64,0,64
ANDHRA PRADESH,2009,OTHER SLL OFFENCE,0,0,0,20,0,20,35,12,47,11,0,11,66,12,78
ANDHRA PRADESH,2009,TOTAL,0,0,0,618,37,655,903,93,996,104,21,125,1625,151,1776
ANDHRA PRADESH,2010,ARMS ACT,0,0,0,67,2,69,65,2,67,4,0,4,136,4,140
ANDHRA PRADESH,2010,N.D.P.S. ACT,0,0,0,45,2,47,95,13,108,13,1,14,153,16,169
ANDHRA PRADESH,2010,GAMBLING ACT,0,0,0,3,0,3,9,0,9,2,0,2,14,0,14
ANDHRA PRADESH,2010,EXCISE ACT,0,0,0,83,5,88,217,24,241,31,3,34,331,32,363
ANDHRA PRADESH,2010,PROHIBITION ACT,0,0,0,53,4,57,150,20,170,25,8,33,228,32,260
ANDHRA PRADESH,2010,EXPLOSIVE & EXPLOSIVE SUBST. ACT,0,0,0,6,0,6,14,0,14,3,0,3,23,0,23
ANDHRA PRADESH,2010,TERRORIST & DISRUPTIVE ACTIVITIES (TATA),0,0,0,0,0,0,10,0,10,0,0,0,10,0,10
ANDHRA PRADESH,2010,IMMORAL TRAFFIC (PREVENTION) ACT,0,0,0,11,8,19,21,4,25,0,0,0,32,12,44
ANDHRA PRADESH,2010,INDIAN RAILWAYS ACT,0,0,0,43,3,46,41,2,43,11,0,11,95,5,100
ANDHRA PRADESH,2010,REGISTRATION OF FOREIGNERS ACT,0,0,0,5,0,5,19,0,19,0,0,0,24,0,24
ANDHRA PRADESH,2010,PROTECTION OF CIVIL RIGHTS ACT,0,0,0,0,0,0,6,0,6,0,0,0,6,0,6
ANDHRA PRADESH,2010,SC/ST (PREVENTION OF ATROCITIES) ACT,0,0,0,9,0,9,34,3,37,5,0,5,48,3,51
ANDHRA PRADESH,2010,INDIAN PASSPORT ACT,0,0,0,0,0,0,0,0,0,0,0,0,0,0,0
ANDHRA PRADESH,2010,ESSENTIAL COMMODITIES ACT,0,0,0,0,4,4,0,0,0,0,0,0,0,4,4
ANDHRA PRADESH,2010,ANTIQUITIES AND ART TREASURE ACT,0,0,0,0,0,0,0,0,0,0,0,0,0,0,0
ANDHRA PRADESH,2010,DOWRY PROHIBITION ACT,0,0,0,30,0,30,60,6,66,4,0,4,94,6,100
ANDHRA PRADESH,2010,FOREIGN EXCHANGE REGULATION ACT-1973,0,0,0,0,0,0,0,0,0,0,0,0,0,0,0
ANDHRA PRADESH,2010,PREVENTION OF CORRUPTION ACT-1988,0,0,0,4,0,4,20,0,20,4,0,4,28,0,28
ANDHRA PRADESH,2010,CONSER.OF FORGN.EXCH.&PREV. OF SMUG.ACT,0,0,0,0,0,0,0,0,0,0,0,0,0,0,0
ANDHRA PRADESH,2010,OTHER SLL OFFENCE,0,0,0,20,1,21,75,3,78,4,0,4,99,4,103
ANDHRA PRADESH,2010,TOTAL,0,0,0,379,29,408,836,77,913,106,12,118,1321,118,1439
ANDHRA PRADESH,2011,ARMS ACT,0,0,0,32,1,33,48,2,50,4,0,4,84,3,87
ANDHRA PRADESH,2011,N.D.P.S. ACT,0,0,0,51,3,54,57,3,60,8,3,11,116,9,125
ANDHRA PRADESH,2011,GAMBLING ACT,0,0,0,5,0,5,19,0,19,0,0,0,24,0,24
ANDHRA PRADESH,2011,EXCISE ACT,0,0,0,97,5,102,172,41,213,29,5,34,298,51,349
ANDHRA PRADESH,2011,PROHIBITION ACT,0,0,0,31,15,46,61,36,97,10,1,11,102,52,154
ANDHRA PRADESH,2011,EXPLOSIVE & EXPLOSIVE SUBST. ACT,0,0,0,3,0,3,10,2,12,0,0,0,13,2,15
ANDHRA PRADESH,2011,TERRORIST & DISRUPTIVE ACTIVITIES (TATA),0,0,0,18,7,25,0,0,0,0,0,0,18,7,25
ANDHRA PRADESH,2011,IMMORAL TRAFFIC (PREVENTION) ACT,0,0,0,20,2,22,16,3,19,2,0,2,38,5,43
ANDHRA PRADESH,2011,INDIAN RAILWAYS ACT,0,0,0,3,0,3,33,0,33,4,0,4,40,0,40
ANDHRA PRADESH,2011,REGISTRATION OF FOREIGNERS ACT,0,0,0,0,0,0,36,0,36,1,0,1,37,0,37
ANDHRA PRADESH,2011,PROTECTION OF CIVIL RIGHTS ACT,0,0,0,17,0,17,0,0,0,0,0,0,17,0,17
ANDHRA PRADESH,2011,SC/ST (PREVENTION OF ATROCITIES) ACT,0,0,0,1,0,1,39,1,40,4,1,5,44,2,46
ANDHRA PRADESH,2011,INDIAN PASSPORT ACT,0,0,0,1,0,1,0,0,0,0,0,0,1,0,1
ANDHRA PRADESH,2011,ESSENTIAL COMMODITIES ACT,0,0,0,0,0,0,0,0,0,0,0,0,0,0,0
ANDHRA PRADESH,2011,ANTIQUITIES AND ART TREASURE ACT,0,0,0,0,0,0,0,0,0,0,0,0,0,0,0
ANDHRA PRADESH,2011,DOWRY PROHIBITION ACT,0,0,0,47,1,48,50,3,53,8,0,8,105,4,109
ANDHRA PRADESH,2011,FOREIGN EXCHANGE REGULATION ACT-1973,0,0,0,0,0,0,0,0,0,0,0,0,0,0,0
ANDHRA PRADESH,2011,PREVENTION OF CORRUPTION ACT-1988,0,0,0,0,0,0,0,0,0,0,0,0,0,0,0
ANDHRA PRADESH,2011,CONSER.OF FORGN.EXCH.&PREV. OF SMUG.ACT,0,0,0,0,0,0,0,0,0,0,0,0,0,0,0
ANDHRA PRADESH,2011,OTHER SLL OFFENCE,0,0,0,90,0,90,67,0,67,4,0,4,161,0,161
ANDHRA PRADESH,2011,TOTAL,0,0,0,416,34,450,608,91,699,74,10,84,1098,135,1233
ANDHRA PRADESH,2012,ARMS ACT,0,0,0,33,0,33,78,7,85,6,0,6,117,7,124
ANDHRA PRADESH,2012,N.D.P.S. ACT,0,0,0,90,4,94,100,15,115,12,1,13,202,20,222
ANDHRA PRADESH,2012,GAMBLING ACT,0,0,0,3,0,3,15,0,15,4,0,4,22,0,22
ANDHRA PRADESH,2012,EXCISE ACT,0,0,0,94,8,102,185,53,238,37,9,46,316,70,386
ANDHRA PRADESH,2012,PROHIBITION ACT,0,0,0,36,7,43,91,28,119,37,2,39,164,37,201
ANDHRA PRADESH,2012,EXPLOSIVE & EXPLOSIVE SUBST. ACT,0,0,0,3,0,3,10,0,10,0,0,0,13,0,13
ANDHRA PRADESH,2012,TERRORIST & DISRUPTIVE ACTIVITIES (TATA),0,0,0,0,0,0,0,0,0,0,0,0,0,0,0
ANDHRA PRADESH,2012,IMMORAL TRAFFIC (PREVENTION) ACT,0,0,0,12,0,12,21,3,24,6,0,6,39,3,42
ANDHRA PRADESH,2012,INDIAN RAILWAYS ACT,0,0,0,37,0,37,47,6,53,3,1,4,87,7,94
ANDHRA PRADESH,2012,REGISTRATION OF FOREIGNERS ACT,0,0,0,11,7,18,11,1,12,0,0,0,22,8,30
ANDHRA PRADESH,2012,PROTECTION OF CIVIL RIGHTS ACT,0,0,0,1,0,1,7,3,10,0,0,0,8,3,11
ANDHRA PRADESH,2012,SC/ST (PREVENTION OF ATROCITIES) ACT,0,0,0,37,0,37,43,8,51,13,1,14,93,9,102
ANDHRA PRADESH,2012,INDIAN PASSPORT ACT,0,0,0,13,0,13,0,0,0,0,0,0,13,0,13
ANDHRA PRADESH,2012,ESSENTIAL COMMODITIES ACT,0,0,0,1,0,1,0,0,0,0,0,0,1,0,1
ANDHRA PRADESH,2012,ANTIQUITIES AND ART TREASURE ACT,0,0,0,0,0,0,0,0,0,0,0,0,0,0,0
ANDHRA PRADESH,2012,DOWRY PROHIBITION ACT,0,0,0,59,5,64,90,15,105,22,5,27,171,25,196
ANDHRA PRADESH,2012,FOREIGN EXCHANGE REGULATION ACT-1973,0,0,0,0,0,0,4,0,4,0,1,1,4,1,5
ANDHRA PRADESH,2012,PREVENTION OF CORRUPTION ACT-1988,0,0,0,0,0,0,18,1,19,3,0,3,21,1,22
ANDHRA PRADESH,2012,CONSER.OF FORGN.EXCH.&PREV. OF SMUG.ACT,0,0,0,0,0,0,0,0,0,0,0,0,0,0,0
ANDHRA PRADESH,2012,OTHER SLL OFFENCE,0,0,0,77,3,80,87,6,93,64,9,73,228,18,246
ANDHRA PRADESH,2012,TOTAL,0,0,0,507,34,541,807,146,953,207,29,236,1521,209,1730
ARUNACHAL PRADESH,2009,ARMS ACT,0,0,0,6,0,6,1,0,1,0,0,0,7,0,7
ARUNACHAL PRADESH,2009,N.D.P.S. ACT,0,0,0,0,0,0,0,0,0,0,0,0,0,0,0
ARUNACHAL PRADESH,2009,GAMBLING ACT,0,0,0,0,0,0,0,0,0,0,0,0,0,0,0
ARUNACHAL PRADESH,2009,EXCISE ACT,0,0,0,0,0,0,0,0,0,0,0,0,0,0,0
ARUNACHAL PRADESH,2009,PROHIBITION ACT,0,0,0,0,0,0,0,0,0,0,0,0,0,0,0
ARUNACHAL PRADESH,2009,EXPLOSIVE & EXPLOSIVE SUBST. ACT,0,0,0,0,0,0,0,0,0,0,0,0,0,0,0
ARUNACHAL PRADESH,2009,TERRORIST & DISRUPTIVE ACTIVITIES (TATA),0,0,0,0,0,0,0,0,0,0,0,0,0,0,0
ARUNACHAL PRADESH,2009,IMMORAL TRAFFIC (PREVENTION) ACT,0,0,0,0,0,0,0,0,0,0,0,0,0,0,0
ARUNACHAL PRADESH,2009,INDIAN RAILWAYS ACT,0,0,0,0,0,0,0,0,0,0,0,0,0,0,0
ARUNACHAL PRADESH,2009,REGISTRATION OF FOREIGNERS ACT,0,0,0,0,0,0,0,0,0,0,0,0,0,0,0
ARUNACHAL PRADESH,2009,PROTECTION OF CIVIL RIGHTS ACT,0,0,0,0,0,0,0,0,0,0,0,0,0,0,0
ARUNACHAL PRADESH,2009,SC/ST (PREVENTION OF ATROCITIES) ACT,0,0,0,0,0,0,0,0,0,0,0,0,0,0,0
ARUNACHAL PRADESH,2009,INDIAN PASSPORT ACT,0,0,0,0,0,0,0,0,0,0,0,0,0,0,0
ARUNACHAL PRADESH,2009,ESSENTIAL COMMODITIES ACT,0,0,0,0,0,0,0,0,0,0,0,0,0,0,0
ARUNACHAL PRADESH,2009,ANTIQUITIES AND ART TREASURE ACT,0,0,0,0,0,0,0,0,0,0,0,0,0,0,0
ARUNACHAL PRADESH,2009,DOWRY PROHIBITION ACT,0,0,0,0,0,0,0,0,0,0,0,0,0,0,0
ARUNACHAL PRADESH,2009,FOREIGN EXCHANGE REGULATION ACT-1973,0,0,0,0,0,0,0,0,0,0,0,0,0,0,0
ARUNACHAL PRADESH,2009,PREVENTION OF CORRUPTION ACT-1988,0,0,0,0,0,0,0,0,0,0,0,0,0,0,0
ARUNACHAL PRADESH,2009,CONSER.OF FORGN.EXCH.&PREV. OF SMUG.ACT,0,0,0,0,0,0,0,0,0,0,0,0,0,0,0
ARUNACHAL PRADESH,2009,OTHER SLL OFFENCE,0,0,0,0,0,0,0,0,0,0,0,0,0,0,0
ARUNACHAL PRADESH,2009,TOTAL,0,0,0,6,0,6,1,0,1,0,0,0,7,0,7
ARUNACHAL PRADESH,2010,ARMS ACT,0,0,0,0,0,0,0,0,0,0,0,0,0,0,0
ARUNACHAL PRADESH,2010,N.D.P.S. ACT,0,0,0,0,0,0,1,0,1,0,0,0,1,0,1
ARUNACHAL PRADESH,2010,GAMBLING ACT,0,0,0,0,0,0,0,0,0,0,0,0,0,0,0
ARUNACHAL PRADESH,2010,EXCISE ACT,0,0,0,0,0,0,0,0,0,0,0,0,0,0,0
ARUNACHAL PRADESH,2010,PROHIBITION ACT,0,0,0,0,0,0,0,0,0,0,0,0,0,0,0
ARUNACHAL PRADESH,2010,EXPLOSIVE & EXPLOSIVE SUBST. ACT,0,0,0,0,0,0,0,0,0,0,0,0,0,0,0
ARUNACHAL PRADESH,2010,TERRORIST & DISRUPTIVE ACTIVITIES (TATA),0,0,0,0,0,0,0,0,0,0,0,0,0,0,0
ARUNACHAL PRADESH,2010,IMMORAL TRAFFIC (PREVENTION) ACT,0,0,0,0,0,0,0,0,0,0,0,0,0,0,0
ARUNACHAL PRADESH,2010,INDIAN RAILWAYS ACT,0,0,0,0,0,0,0,0,0,0,0,0,0,0,0
ARUNACHAL PRADESH,2010,REGISTRATION OF FOREIGNERS ACT,0,0,0,0,0,0,0,0,0,0,0,0,0,0,0
ARUNACHAL PRADESH,2010,PROTECTION OF CIVIL RIGHTS ACT,0,0,0,0,0,0,0,0,0,0,0,0,0,0,0
ARUNACHAL PRADESH,2010,SC/ST (PREVENTION OF ATROCITIES) ACT,0,0,0,0,0,0,0,0,0,0,0,0,0,0,0
ARUNACHAL PRADESH,2010,INDIAN PASSPORT ACT,0,0,0,0,0,0,0,0,0,0,0,0,0,0,0
ARUNACHAL PRADESH,2010,ESSENTIAL COMMODITIES ACT,0,0,0,0,0,0,0,0,0,0,0,0,0,0,0
ARUNACHAL PRADESH,2010,ANTIQUITIES AND ART TREASURE ACT,0,0,0,0,0,0,0,0,0,0,0,0,0,0,0
ARUNACHAL PRADESH,2010,DOWRY PROHIBITION ACT,0,0,0,0,0,0,0,0,0,0,0,0,0,0,0
ARUNACHAL PRADESH,2010,FOREIGN EXCHANGE REGULATION ACT-1973,0,0,0,0,0,0,0,0,0,0,0,0,0,0,0
ARUNACHAL PRADESH,2010,PREVENTION OF CORRUPTION ACT-1988,0,0,0,0,0,0,0,0,0,0,0,0,0,0,0
ARUNACHAL PRADESH,2010,CONSER.OF FORGN.EXCH.&PREV. OF SMUG.ACT,0,0,0,0,0,0,0,0,0,0,0,0,0,0,0
ARUNACHAL PRADESH,2010,OTHER SLL OFFENCE,0,0,0,0,0,0,0,0,0,0,0,0,0,0,0
ARUNACHAL PRADESH,2010,TOTAL,0,0,0,0,0,0,1,0,1,0,0,0,1,0,1
ARUNACHAL PRADESH,2011,ARMS ACT,0,0,0,3,0,3,0,0,0,0,0,0,3,0,3
ARUNACHAL PRADESH,2011,N.D.P.S. ACT,0,0,0,2,0,2,0,0,0,0,0,0,2,0,2
ARUNACHAL PRADESH,2011,GAMBLING ACT,0,0,0,0,0,0,0,0,0,0,0,0,0,0,0
ARUNACHAL PRADESH,2011,EXCISE ACT,0,0,0,0,0,0,0,0,0,0,0,0,0,0,0
ARUNACHAL PRADESH,2011,PROHIBITION ACT,0,0,0,0,0,0,0,0,0,0,0,0,0,0,0
ARUNACHAL PRADESH,2011,EXPLOSIVE & EXPLOSIVE SUBST. ACT,0,0,0,0,0,0,0,0,0,0,0,0,0,0,0
ARUNACHAL PRADESH,2011,TERRORIST & DISRUPTIVE ACTIVITIES (TATA),0,0,0,0,0,0,0,0,0,0,0,0,0,0,0
ARUNACHAL PRADESH,2011,IMMORAL TRAFFIC (PREVENTION) ACT,0,0,0,0,0,0,0,0,0,0,0,0,0,0,0
ARUNACHAL PRADESH,2011,INDIAN RAILWAYS ACT,0,0,0,0,0,0,0,0,0,0,0,0,0,0,0
ARUNACHAL PRADESH,2011,REGISTRATION OF FOREIGNERS ACT,0,0,0,0,0,0,0,0,0,0,0,0,0,0,0
ARUNACHAL PRADESH,2011,PROTECTION OF CIVIL RIGHTS ACT,0,0,0,0,0,0,0,0,0,0,0,0,0,0,0
ARUNACHAL PRADESH,2011,SC/ST (PREVENTION OF ATROCITIES) ACT,0,0,0,0,0,0,0,0,0,0,0,0,0,0,0
ARUNACHAL PRADESH,2011,INDIAN PASSPORT ACT,0,0,0,0,0,0,0,0,0,0,0,0,0,0,0
ARUNACHAL PRADESH,2011,ESSENTIAL COMMODITIES ACT,0,0,0,0,0,0,0,0,0,0,0,0,0,0,0
ARUNACHAL PRADESH,2011,ANTIQUITIES AND ART TREASURE ACT,0,0,0,0,0,0,0,0,0,0,0,0,0,0,0
ARUNACHAL PRADESH,2011,DOWRY PROHIBITION ACT,0,0,0,0,0,0,0,0,0,0,0,0,0,0,0
ARUNACHAL PRADESH,2011,FOREIGN EXCHANGE REGULATION ACT-1973,0,0,0,0,0,0,0,0,0,0,0,0,0,0,0
ARUNACHAL PRADESH,2011,PREVENTION OF CORRUPTION ACT-1988,0,0,0,0,0,0,0,0,0,0,0,0,0,0,0
ARUNACHAL PRADESH,2011,CONSER.OF FORGN.EXCH.&PREV. OF SMUG.ACT,0,0,0,0,0,0,0,0,0,0,0,0,0,0,0
ARUNACHAL PRADESH,2011,OTHER SLL OFFENCE,0,0,0,0,0,0,0,0,0,0,0,0,0,0,0
ARUNACHAL PRADESH,2011,TOTAL,0,0,0,5,0,5,0,0,0,0,0,0,5,0,5
ARUNACHAL PRADESH,2012,ARMS ACT,0,0,0,0,0,0,0,0,0,0,0,0,0,0,0
ARUNACHAL PRADESH,2012,N.D.P.S. ACT,0,0,0,1,0,1,0,0,0,0,0,0,1,0,1
ARUNACHAL PRADESH,2012,GAMBLING ACT,0,0,0,0,0,0,0,0,0,0,0,0,0,0,0
ARUNACHAL PRADESH,2012,EXCISE ACT,0,0,0,0,0,0,0,0,0,0,0,0,0,0,0
ARUNACHAL PRADESH,2012,PROHIBITION ACT,0,0,0,0,0,0,0,0,0,0,0,0,0,0,0
ARUNACHAL PRADESH,2012,EXPLOSIVE & EXPLOSIVE SUBST. ACT,0,0,0,0,0,0,0,0,0,0,0,0,0,0,0
ARUNACHAL PRADESH,2012,TERRORIST & DISRUPTIVE ACTIVITIES (TATA),0,0,0,0,0,0,0,0,0,0,0,0,0,0,0
ARUNACHAL PRADESH,2012,IMMORAL TRAFFIC (PREVENTION) ACT,0,0,0,0,0,0,0,0,0,0,0,0,0,0,0
ARUNACHAL PRADESH,2012,INDIAN RAILWAYS ACT,0,0,0,0,0,0,0,0,0,0,0,0,0,0,0
ARUNACHAL PRADESH,2012,REGISTRATION OF FOREIGNERS ACT,0,0,0,0,0,0,0,0,0,0,0,0,0,0,0
ARUNACHAL PRADESH,2012,PROTECTION OF CIVIL RIGHTS ACT,0,0,0,0,0,0,0,0,0,0,0,0,0,0,0
ARUNACHAL PRADESH,2012,SC/ST (PREVENTION OF ATROCITIES) ACT,0,0,0,0,0,0,0,0,0,0,0,0,0,0,0
ARUNACHAL PRADESH,2012,INDIAN PASSPORT ACT,0,0,0,0,0,0,0,0,0,0,0,0,0,0,0
ARUNACHAL PRADESH,2012,ESSENTIAL COMMODITIES ACT,0,0,0,0,0,0,0,0,0,0,0,0,0,0,0
ARUNACHAL PRADESH,2012,ANTIQUITIES AND ART TREASURE ACT,0,0,0,0,0,0,0,0,0,0,0,0,0,0,0
ARUNACHAL PRADESH,2012,DOWRY PROHIBITION ACT,0,0,0,0,0,0,0,0,0,0,0,0,0,0,0
ARUNACHAL PRADESH,2012,FOREIGN EXCHANGE REGULATION ACT-1973,0,0,0,0,0,0,0,0,0,0,0,0,0,0,0
ARUNACHAL PRADESH,2012,PREVENTION OF CORRUPTION ACT-1988,0,0,0,0,0,0,0,0,0,0,0,0,0,0,0
ARUNACHAL PRADESH,2012,CONSER.OF FORGN.EXCH.&PREV. OF SMUG.ACT,0,0,0,0,0,0,0,0,0,0,0,0,0,0,0
ARUNACHAL PRADESH,2012,OTHER SLL OFFENCE,0,0,0,0,0,0,0,0,0,0,0,0,0,0,0
ARUNACHAL PRADESH,2012,TOTAL,0,0,0,1,0,1,0,0,0,0,0,0,1,0,1
ASSAM,2001,ARMS ACT,4,0,4,80,3,83,76,0,76,7,0,7,167,3,170
ASSAM,2001,N.D.P.S. ACT,2,0,2,56,5,61,95,8,103,9,0,9,162,13,175
ASSAM,2001,GAMBLING ACT,0,0,0,19,0,19,11,0,11,4,0,4,34,0,34
ASSAM,2001,EXCISE ACT,0,0,0,8,0,8,8,0,8,1,0,1,17,0,17
ASSAM,2001,PROHIBITION ACT,0,0,0,0,0,0,0,0,0,0,0,0,0,0,0
ASSAM,2001,EXPLOSIVE & EXPLOSIVE SUBST. ACT,0,0,0,51,0,51,33,0,33,2,0,2,86,0,86
ASSAM,2001,TERRORIST & DISRUPTIVE ACTIVITIES (TATA),0,0,0,21,1,22,8,0,8,0,0,0,29,1,30
ASSAM,2001,IMMORAL TRAFFIC (PREVENTION) ACT,0,0,0,3,4,7,0,0,0,0,0,0,3,4,7
ASSAM,2001,INDIAN RAILWAYS ACT,9,0,9,12,0,12,25,0,25,3,0,3,49,0,49
ASSAM,2001,REGISTRATION OF FOREIGNERS ACT,0,0,0,0,0,0,2,0,2,0,0,0,2,0,2
ASSAM,2001,PROTECTION OF CIVIL RIGHTS ACT,0,0,0,0,0,0,0,0,0,0,0,0,0,0,0
ASSAM,2001,SC/ST (PREVENTION OF ATROCITIES) ACT,0,0,0,0,0,0,0,0,0,0,0,0,0,0,0
ASSAM,2001,INDIAN PASSPORT ACT,0,0,0,1,0,1,3,0,3,0,0,0,4,0,4
ASSAM,2001,ESSENTIAL COMMODITIES ACT,0,0,0,0,0,0,0,0,0,0,0,0,0,0,0
ASSAM,2001,ANTIQUITIES AND ART TREASURE ACT,0,0,0,0,0,0,0,0,0,0,0,0,0,0,0
ASSAM,2001,DOWRY PROHIBITION ACT,0,0,0,0,0,0,6,2,8,1,0,1,7,2,9
ASSAM,2001,FOREIGN EXCHANGE REGULATION ACT-1973,0,0,0,4,0,4,0,0,0,0,0,0,4,0,4
ASSAM,2001,PREVENTION OF CORRUPTION ACT-1988,0,0,0,0,0,0,0,0,0,0,0,0,0,0,0
ASSAM,2001,CONSER.OF FORGN.EXCH.&PREV. OF SMUG.ACT,0,0,0,0,0,0,0,0,0,0,0,0,0,0,0
ASSAM,2001,OTHER SLL OFFENCE,2,0,2,51,2,53,31,3,34,0,0,0,84,5,89
ASSAM,2001,TOTAL,17,0,17,306,15,321,298,13,311,27,0,27,648,28,676
ASSAM,2002,ARMS ACT,0,0,0,72,2,74,62,1,63,8,0,8,142,3,145
ASSAM,2002,N.D.P.S. ACT,0,0,0,66,6,72,72,10,82,19,0,19,157,16,173
ASSAM,2002,GAMBLING ACT,2,0,2,23,0,23,6,0,6,2,0,2,33,0,33
ASSAM,2002,EXCISE ACT,1,0,1,7,0,7,6,0,6,1,0,1,15,0,15
ASSAM,2002,PROHIBITION ACT,0,0,0,0,0,0,0,0,0,0,0,0,0,0,0
ASSAM,2002,EXPLOSIVE & EXPLOSIVE SUBST. ACT,0,0,0,16,0,16,13,0,13,0,0,0,29,0,29
ASSAM,2002,TERRORIST & DISRUPTIVE ACTIVITIES (TATA),0,0,0,16,1,17,8,0,8,0,0,0,24,1,25
ASSAM,2002,IMMORAL TRAFFIC (PREVENTION) ACT,0,0,0,6,3,9,0,1,1,1,0,1,7,4,11
ASSAM,2002,INDIAN RAILWAYS ACT,0,0,0,10,0,10,1,0,1,0,0,0,11,0,11
ASSAM,2002,REGISTRATION OF FOREIGNERS ACT,0,0,0,0,0,0,0,0,0,0,0,0,0,0,0
ASSAM,2002,PROTECTION OF CIVIL RIGHTS ACT,0,0,0,0,0,0,0,0,0,0,0,0,0,0,0
ASSAM,2002,SC/ST (PREVENTION OF ATROCITIES) ACT,0,0,0,0,0,0,0,0,0,0,0,0,0,0,0
ASSAM,2002,INDIAN PASSPORT ACT,0,0,0,0,0,0,7,0,7,0,0,0,7,0,7
ASSAM,2002,ESSENTIAL COMMODITIES ACT,0,0,0,0,0,0,0,0,0,0,0,0,0,0,0
ASSAM,2002,ANTIQUITIES AND ART TREASURE ACT,0,0,0,0,0,0,0,0,0,0,0,0,0,0,0
ASSAM,2002,DOWRY PROHIBITION ACT,0,0,0,2,0,2,5,0,5,0,0,0,7,0,7
ASSAM,2002,FOREIGN EXCHANGE REGULATION ACT-1973,0,0,0,0,0,0,0,0,0,0,0,0,0,0,0
ASSAM,2002,PREVENTION OF CORRUPTION ACT-1988,0,0,0,0,0,0,1,0,1,0,0,0,1,0,1
ASSAM,2002,CONSER.OF FORGN.EXCH.&PREV. OF SMUG.ACT,0,0,0,0,0,0,0,0,0,0,0,0,0,0,0
ASSAM,2002,OTHER SLL OFFENCE,0,0,0,50,2,52,48,0,48,5,0,5,103,2,105
ASSAM,2002,TOTAL,3,0,3,268,14,282,229,12,241,36,0,36,536,26,562
ASSAM,2003,ARMS ACT,0,0,0,59,10,69,66,1,67,4,0,4,129,11,140
ASSAM,2003,N.D.P.S. ACT,0,0,0,66,2,68,65,9,74,8,2,10,139,13,152
ASSAM,2003,GAMBLING ACT,0,0,0,19,0,19,9,0,9,4,0,4,32,0,32
ASSAM,2003,EXCISE ACT,0,0,0,7,1,8,13,0,13,5,0,5,25,1,26
ASSAM,2003,PROHIBITION ACT,0,0,0,0,0,0,0,0,0,0,0,0,0,0,0
ASSAM,2003,EXPLOSIVE & EXPLOSIVE SUBST. ACT,0,0,0,9,0,9,2,0,2,0,0,0,11,0,11
ASSAM,2003,TERRORIST & DISRUPTIVE ACTIVITIES (TATA),0,0,0,7,1,8,8,1,9,0,0,0,15,2,17
ASSAM,2003,IMMORAL TRAFFIC (PREVENTION) ACT,0,1,1,3,6,9,3,0,3,0,0,0,6,7,13
ASSAM,2003,INDIAN RAILWAYS ACT,0,0,0,23,0,23,25,0,25,0,0,0,48,0,48
ASSAM,2003,REGISTRATION OF FOREIGNERS ACT,0,0,0,0,0,0,0,0,0,0,0,0,0,0,0
ASSAM,2003,PROTECTION OF CIVIL RIGHTS ACT,0,0,0,0,0,0,0,0,0,0,0,0,0,0,0
ASSAM,2003,SC/ST (PREVENTION OF ATROCITIES) ACT,0,0,0,0,0,0,0,0,0,0,0,0,0,0,0
ASSAM,2003,INDIAN PASSPORT ACT,0,0,0,0,0,0,1,0,1,0,0,0,1,0,1
ASSAM,2003,ESSENTIAL COMMODITIES ACT,0,0,0,0,0,0,0,0,0,0,0,0,0,0,0
ASSAM,2003,ANTIQUITIES AND ART TREASURE ACT,0,0,0,0,0,0,0,0,0,0,0,0,0,0,0
ASSAM,2003,DOWRY PROHIBITION ACT,0,0,0,2,0,2,0,0,0,0,0,0,2,0,2
ASSAM,2003,FOREIGN EXCHANGE REGULATION ACT-1973,0,0,0,0,0,0,0,0,0,0,0,0,0,0,0
ASSAM,2003,PREVENTION OF CORRUPTION ACT-1988,0,0,0,1,0,1,2,2,4,1,0,1,4,2,6
ASSAM,2003,CONSER.OF FORGN.EXCH.&PREV. OF SMUG.ACT,0,0,0,0,0,0,4,0,4,2,0,2,6,0,6
ASSAM,2003,OTHER SLL OFFENCE,0,0,0,68,16,84,60,6,66,4,0,4,132,22,154
ASSAM,2003,TOTAL,0,1,1,264,36,300,258,19,277,28,2,30,550,58,608
ASSAM,2004,ARMS ACT,0,0,0,84,4,88,39,0,39,2,0,2,125,4,129
ASSAM,2004,N.D.P.S. ACT,0,0,0,56,6,62,72,7,79,13,0,13,141,13,154
ASSAM,2004,GAMBLING ACT,0,0,0,9,0,9,29,0,29,0,0,0,38,0,38
ASSAM,2004,EXCISE ACT,0,0,0,21,0,21,14,0,14,0,0,0,35,0,35
ASSAM,2004,PROHIBITION ACT,0,0,0,6,0,6,1,0,1,1,0,1,8,0,8
ASSAM,2004,EXPLOSIVE & EXPLOSIVE SUBST. ACT,0,0,0,18,2,20,11,1,12,1,0,1,30,3,33
ASSAM,2004,TERRORIST & DISRUPTIVE ACTIVITIES (TATA),0,0,0,25,4,29,21,2,23,1,0,1,47,6,53
ASSAM,2004,IMMORAL TRAFFIC (PREVENTION) ACT,0,0,0,6,2,8,7,2,9,2,0,2,15,4,19
ASSAM,2004,INDIAN RAILWAYS ACT,0,0,0,35,0,35,24,0,24,7,0,7,66,0,66
ASSAM,2004,REGISTRATION OF FOREIGNERS ACT,0,0,0,0,0,0,0,0,0,0,0,0,0,0,0
ASSAM,2004,PROTECTION OF CIVIL RIGHTS ACT,0,0,0,0,0,0,0,0,0,0,0,0,0,0,0
ASSAM,2004,SC/ST (PREVENTION OF ATROCITIES) ACT,0,0,0,0,0,0,0,0,0,0,0,0,0,0,0
ASSAM,2004,INDIAN PASSPORT ACT,0,0,0,1,0,1,6,0,6,0,0,0,7,0,7
ASSAM,2004,ESSENTIAL COMMODITIES ACT,0,0,0,0,0,0,2,0,2,0,0,0,2,0,2
ASSAM,2004,ANTIQUITIES AND ART TREASURE ACT,0,0,0,0,0,0,0,0,0,0,0,0,0,0,0
ASSAM,2004,DOWRY PROHIBITION ACT,0,0,0,6,0,6,0,0,0,0,0,0,6,0,6
ASSAM,2004,FOREIGN EXCHANGE REGULATION ACT-1973,0,0,0,0,0,0,0,0,0,0,0,0,0,0,0
ASSAM,2004,PREVENTION OF CORRUPTION ACT-1988,0,0,0,0,0,0,5,0,5,0,0,0,5,0,5
ASSAM,2004,CONSER.OF FORGN.EXCH.&PREV. OF SMUG.ACT,0,0,0,0,0,0,0,0,0,0,0,0,0,0,0
ASSAM,2004,OTHER SLL OFFENCE,0,0,0,46,2,48,45,1,46,10,0,10,101,3,104
ASSAM,2004,TOTAL,0,0,0,313,20,333,276,13,289,37,0,37,626,33,659
ASSAM,2005,ARMS ACT,0,0,0,32,3,35,92,4,96,0,0,0,124,7,131
ASSAM,2005,N.D.P.S. ACT,0,0,0,103,5,108,82,8,90,6,2,8,191,15,206
ASSAM,2005,GAMBLING ACT,0,0,0,27,0,27,14,0,14,7,0,7,48,0,48
ASSAM,2005,EXCISE ACT,0,0,0,16,1,17,17,0,17,7,0,7,40,1,41
ASSAM,2005,PROHIBITION ACT,0,0,0,2,0,2,10,0,10,1,0,1,13,0,13
ASSAM,2005,EXPLOSIVE & EXPLOSIVE SUBST. ACT,0,0,0,41,3,44,3,0,3,0,0,0,44,3,47
ASSAM,2005,TERRORIST & DISRUPTIVE ACTIVITIES (TATA),0,0,0,7,0,7,24,2,26,1,1,2,32,3,35
ASSAM,2005,IMMORAL TRAFFIC (PREVENTION) ACT,0,0,0,1,2,3,0,1,1,0,0,0,1,3,4
ASSAM,2005,INDIAN RAILWAYS ACT,0,0,0,38,3,41,15,0,15,17,0,17,70,3,73
ASSAM,2005,REGISTRATION OF FOREIGNERS ACT,0,0,0,0,0,0,1,0,1,0,0,0,1,0,1
ASSAM,2005,PROTECTION OF CIVIL RIGHTS ACT,0,0,0,0,0,0,0,0,0,0,0,0,0,0,0
ASSAM,2005,SC/ST (PREVENTION OF ATROCITIES) ACT,0,0,0,0,0,0,0,0,0,0,0,0,0,0,0
ASSAM,2005,INDIAN PASSPORT ACT,0,0,0,0,0,0,5,0,5,0,0,0,5,0,5
ASSAM,2005,ESSENTIAL COMMODITIES ACT,0,0,0,3,0,3,5,0,5,7,0,7,15,0,15
ASSAM,2005,ANTIQUITIES AND ART TREASURE ACT,0,0,0,0,0,0,0,0,0,0,0,0,0,0,0
ASSAM,2005,DOWRY PROHIBITION ACT,0,0,0,0,0,0,10,0,10,5,0,5,15,0,15
ASSAM,2005,FOREIGN EXCHANGE REGULATION ACT-1973,0,0,0,1,0,1,0,0,0,0,0,0,1,0,1
ASSAM,2005,PREVENTION OF CORRUPTION ACT-1988,0,0,0,0,0,0,3,0,3,0,0,0,3,0,3
ASSAM,2005,CONSER.OF FORGN.EXCH.&PREV. OF SMUG.ACT,0,0,0,0,0,0,0,0,0,0,0,0,0,0,0
ASSAM,2005,OTHER SLL OFFENCE,0,0,0,38,6,44,38,1,39,0,0,0,76,7,83
ASSAM,2005,TOTAL,0,0,0,309,23,332,319,16,335,51,3,54,679,42,721
ASSAM,2006,ARMS ACT,0,0,0,98,2,100,89,0,89,9,0,9,196,2,198
ASSAM,2006,N.D.P.S. ACT,0,0,0,83,5,88,84,15,99,17,1,18,184,21,205
ASSAM,2006,GAMBLING ACT,0,0,0,17,0,17,14,0,14,2,0,2,33,0,33
ASSAM,2006,EXCISE ACT,0,0,0,16,3,19,20,0,20,2,0,2,38,3,41
ASSAM,2006,PROHIBITION ACT,0,0,0,0,0,0,4,0,4,0,0,0,4,0,4
ASSAM,2006,EXPLOSIVE & EXPLOSIVE SUBST. ACT,0,0,0,50,3,53,23,0,23,0,0,0,73,3,76
ASSAM,2006,TERRORIST & DISRUPTIVE ACTIVITIES (TATA),0,0,0,24,1,25,14,3,17,0,0,0,38,4,42
ASSAM,2006,IMMORAL TRAFFIC (PREVENTION) ACT,0,0,0,12,9,21,4,2,6,0,0,0,16,11,27
ASSAM,2006,INDIAN RAILWAYS ACT,0,0,0,41,0,41,26,0,26,3,0,3,70,0,70
ASSAM,2006,REGISTRATION OF FOREIGNERS ACT,0,0,0,0,0,0,0,0,0,1,0,1,1,0,1
ASSAM,2006,PROTECTION OF CIVIL RIGHTS ACT,0,0,0,0,0,0,0,0,0,0,0,0,0,0,0
ASSAM,2006,SC/ST (PREVENTION OF ATROCITIES) ACT,0,0,0,0,0,0,0,0,0,0,0,0,0,0,0
ASSAM,2006,INDIAN PASSPORT ACT,0,0,0,0,0,0,4,0,4,0,0,0,4,0,4
ASSAM,2006,ESSENTIAL COMMODITIES ACT,0,0,0,6,0,6,9,0,9,0,0,0,15,0,15
ASSAM,2006,ANTIQUITIES AND ART TREASURE ACT,0,0,0,0,0,0,0,0,0,0,0,0,0,0,0
ASSAM,2006,DOWRY PROHIBITION ACT,0,0,0,3,0,3,9,5,14,0,0,0,12,5,17
ASSAM,2006,FOREIGN EXCHANGE REGULATION ACT-1973,0,0,0,0,0,0,0,0,0,0,0,0,0,0,0
ASSAM,2006,PREVENTION OF CORRUPTION ACT-1988,0,0,0,3,0,3,3,0,3,0,0,0,6,0,6
ASSAM,2006,CONSER.OF FORGN.EXCH.&PREV. OF SMUG.ACT,0,0,0,0,0,0,0,0,0,0,0,0,0,0,0
ASSAM,2006,OTHER SLL OFFENCE,0,0,0,14,0,14,21,0,21,0,0,0,35,0,35
ASSAM,2006,TOTAL,0,0,0,367,23,390,324,25,349,34,1,35,725,49,774
ASSAM,2007,ARMS ACT,0,0,0,128,0,128,53,0,53,11,0,11,192,0,192
ASSAM,2007,N.D.P.S. ACT,0,0,0,90,8,98,79,18,97,14,1,15,183,27,210
ASSAM,2007,GAMBLING ACT,0,0,0,6,0,6,6,0,6,3,0,3,15,0,15
ASSAM,2007,EXCISE ACT,0,0,0,2,0,2,5,0,5,4,0,4,11,0,11
ASSAM,2007,PROHIBITION ACT,0,0,0,0,0,0,2,0,2,0,0,0,2,0,2
ASSAM,2007,EXPLOSIVE & EXPLOSIVE SUBST. ACT,0,0,0,39,0,39,24,0,24,0,0,0,63,0,63
ASSAM,2007,TERRORIST & DISRUPTIVE ACTIVITIES (TATA),0,0,0,56,5,61,31,0,31,1,0,1,88,5,93
ASSAM,2007,IMMORAL TRAFFIC (PREVENTION) ACT,0,0,0,8,2,10,0,5,5,0,0,0,8,7,15
ASSAM,2007,INDIAN RAILWAYS ACT,0,0,0,6,0,6,3,0,3,0,0,0,9,0,9
ASSAM,2007,REGISTRATION OF FOREIGNERS ACT,0,0,0,0,0,0,0,0,0,0,0,0,0,0,0
ASSAM,2007,PROTECTION OF CIVIL RIGHTS ACT,0,0,0,0,0,0,0,0,0,0,0,0,0,0,0
ASSAM,2007,SC/ST (PREVENTION OF ATROCITIES) ACT,0,0,0,0,0,0,0,0,0,0,0,0,0,0,0
ASSAM,2007,INDIAN PASSPORT ACT,0,0,0,0,0,0,1,0,1,0,0,0,1,0,1
ASSAM,2007,ESSENTIAL COMMODITIES ACT,0,0,0,1,0,1,0,0,0,0,1,1,1,1,2
ASSAM,2007,ANTIQUITIES AND ART TREASURE ACT,0,0,0,0,0,0,0,0,0,0,0,0,0,0,0
ASSAM,2007,DOWRY PROHIBITION ACT,0,0,0,2,0,2,0,0,0,2,0,2,4,0,4
ASSAM,2007,FOREIGN EXCHANGE REGULATION ACT-1973,0,0,0,0,0,0,0,0,0,0,0,0,0,0,0
ASSAM,2007,PREVENTION OF CORRUPTION ACT-1988,0,0,0,0,0,0,2,0,2,4,0,4,6,0,6
ASSAM,2007,CONSER.OF FORGN.EXCH.&PREV. OF SMUG.ACT,0,0,0,0,0,0,0,0,0,0,0,0,0,0,0
ASSAM,2007,OTHER SLL OFFENCE,0,0,0,27,1,28,7,0,7,4,1,5,38,2,40
ASSAM,2007,TOTAL,0,0,0,365,16,381,213,23,236,43,3,46,621,42,663
ASSAM,2008,ARMS ACT,0,0,0,109,0,109,21,0,21,7,0,7,137,0,137
ASSAM,2008,N.D.P.S. ACT,0,0,0,66,20,86,58,19,77,21,3,24,145,42,187
ASSAM,2008,GAMBLING ACT,0,0,0,15,0,15,9,7,16,0,0,0,24,7,31
ASSAM,2008,EXCISE ACT,0,0,0,2,0,2,5,0,5,1,0,1,8,0,8
ASSAM,2008,PROHIBITION ACT,0,0,0,0,0,0,2,0,2,0,0,0,2,0,2
ASSAM,2008,EXPLOSIVE & EXPLOSIVE SUBST. ACT,0,0,0,2,0,2,1,0,1,1,0,1,4,0,4
ASSAM,2008,TERRORIST & DISRUPTIVE ACTIVITIES (TATA),0,0,0,30,5,35,17,2,19,2,0,2,49,7,56
ASSAM,2008,IMMORAL TRAFFIC (PREVENTION) ACT,0,0,0,6,4,10,0,3,3,0,0,0,6,7,13
ASSAM,2008,INDIAN RAILWAYS ACT,0,0,0,12,0,12,3,0,3,0,0,0,15,0,15
ASSAM,2008,REGISTRATION OF FOREIGNERS ACT,0,0,0,0,0,0,0,0,0,0,0,0,0,0,0
ASSAM,2008,PROTECTION OF CIVIL RIGHTS ACT,0,0,0,0,0,0,0,0,0,0,0,0,0,0,0
ASSAM,2008,SC/ST (PREVENTION OF ATROCITIES) ACT,0,0,0,0,0,0,0,0,0,0,0,0,0,0,0
ASSAM,2008,INDIAN PASSPORT ACT,0,0,0,7,5,12,11,0,11,2,0,2,20,5,25
ASSAM,2008,ESSENTIAL COMMODITIES ACT,0,0,0,1,0,1,1,0,1,1,0,1,3,0,3
ASSAM,2008,ANTIQUITIES AND ART TREASURE ACT,0,0,0,0,0,0,0,0,0,0,0,0,0,0,0
ASSAM,2008,DOWRY PROHIBITION ACT,0,0,0,0,0,0,2,0,2,0,0,0,2,0,2
ASSAM,2008,FOREIGN EXCHANGE REGULATION ACT-1973,0,0,0,2,0,2,3,0,3,0,0,0,5,0,5
ASSAM,2008,PREVENTION OF CORRUPTION ACT-1988,0,0,0,0,0,0,0,0,0,0,0,0,0,0,0
ASSAM,2008,CONSER.OF FORGN.EXCH.&PREV. OF SMUG.ACT,0,0,0,0,0,0,0,0,0,0,0,0,0,0,0
ASSAM,2008,OTHER SLL OFFENCE,0,0,0,14,0,14,8,0,8,0,0,0,22,0,22
ASSAM,2008,TOTAL,0,0,0,266,34,300,141,31,172,35,3,38,442,68,510
ASSAM,2009,ARMS ACT,0,0,0,93,0,93,29,0,29,13,0,13,135,0,135
ASSAM,2009,N.D.P.S. ACT,0,0,0,59,14,73,76,12,88,23,4,27,158,30,188
ASSAM,2009,GAMBLING ACT,0,0,0,14,0,14,6,3,9,0,0,0,20,3,23
ASSAM,2009,EXCISE ACT,0,0,0,4,0,4,5,0,5,2,0,2,11,0,11
ASSAM,2009,PROHIBITION ACT,0,0,0,19,0,19,2,0,2,0,0,0,21,0,21
ASSAM,2009,EXPLOSIVE & EXPLOSIVE SUBST. ACT,0,0,0,35,0,35,3,0,3,3,0,3,41,0,41
ASSAM,2009,TERRORIST & DISRUPTIVE ACTIVITIES (TATA),0,0,0,11,3,14,4,1,5,2,0,2,17,4,21
ASSAM,2009,IMMORAL TRAFFIC (PREVENTION) ACT,0,0,0,5,3,8,0,2,2,0,0,0,5,5,10
ASSAM,2009,INDIAN RAILWAYS ACT,0,0,0,0,0,0,3,0,3,0,0,0,3,0,3
ASSAM,2009,REGISTRATION OF FOREIGNERS ACT,0,0,0,0,0,0,0,0,0,0,0,0,0,0,0
ASSAM,2009,PROTECTION OF CIVIL RIGHTS ACT,0,0,0,0,0,0,0,0,0,0,0,0,0,0,0
ASSAM,2009,SC/ST (PREVENTION OF ATROCITIES) ACT,0,0,0,0,0,0,0,0,0,0,0,0,0,0,0
ASSAM,2009,INDIAN PASSPORT ACT,0,0,0,8,3,11,17,8,25,3,2,5,28,13,41
ASSAM,2009,ESSENTIAL COMMODITIES ACT,0,0,0,1,0,1,2,0,2,1,0,1,4,0,4
ASSAM,2009,ANTIQUITIES AND ART TREASURE ACT,0,0,0,0,0,0,0,0,0,0,0,0,0,0,0
ASSAM,2009,DOWRY PROHIBITION ACT,0,0,0,0,0,0,0,0,0,0,0,0,0,0,0
ASSAM,2009,FOREIGN EXCHANGE REGULATION ACT-1973,0,0,0,0,0,0,2,0,2,0,0,0,2,0,2
ASSAM,2009,PREVENTION OF CORRUPTION ACT-1988,0,0,0,0,0,0,0,0,0,0,0,0,0,0,0
ASSAM,2009,CONSER.OF FORGN.EXCH.&PREV. OF SMUG.ACT,0,0,0,0,0,0,0,0,0,0,0,0,0,0,0
ASSAM,2009,OTHER SLL OFFENCE,0,0,0,28,0,28,16,1,17,0,0,0,44,1,45
ASSAM,2009,TOTAL,0,0,0,277,23,300,165,27,192,47,6,53,489,56,545
ASSAM,2010,ARMS ACT,0,0,0,68,4,72,52,2,54,11,0,11,131,6,137
ASSAM,2010,N.D.P.S. ACT,0,0,0,43,2,45,94,8,102,24,4,28,161,14,175
ASSAM,2010,GAMBLING ACT,0,0,0,17,0,17,11,0,11,5,0,5,33,0,33
ASSAM,2010,EXCISE ACT,0,0,0,4,0,4,5,0,5,2,0,2,11,0,11
ASSAM,2010,PROHIBITION ACT,0,0,0,10,0,10,2,0,2,0,0,0,12,0,12
ASSAM,2010,EXPLOSIVE & EXPLOSIVE SUBST. ACT,0,0,0,12,0,12,12,0,12,0,0,0,24,0,24
ASSAM,2010,TERRORIST & DISRUPTIVE ACTIVITIES (TATA),0,0,0,17,2,19,3,1,4,2,0,2,22,3,25
ASSAM,2010,IMMORAL TRAFFIC (PREVENTION) ACT,0,0,0,5,0,5,1,2,3,0,0,0,6,2,8
ASSAM,2010,INDIAN RAILWAYS ACT,0,0,0,0,0,0,2,0,2,0,0,0,2,0,2
ASSAM,2010,REGISTRATION OF FOREIGNERS ACT,0,0,0,0,0,0,0,0,0,0,0,0,0,0,0
ASSAM,2010,PROTECTION OF CIVIL RIGHTS ACT,0,0,0,0,0,0,0,0,0,0,0,0,0,0,0
ASSAM,2010,SC/ST (PREVENTION OF ATROCITIES) ACT,0,0,0,0,0,0,0,0,0,0,0,0,0,0,0
ASSAM,2010,INDIAN PASSPORT ACT,0,0,0,7,0,7,6,0,6,2,0,2,15,0,15
ASSAM,2010,ESSENTIAL COMMODITIES ACT,0,0,0,1,0,1,1,0,1,0,0,0,2,0,2
ASSAM,2010,ANTIQUITIES AND ART TREASURE ACT,0,0,0,0,0,0,0,0,0,0,0,0,0,0,0
ASSAM,2010,DOWRY PROHIBITION ACT,0,0,0,0,0,0,0,0,0,0,0,0,0,0,0
ASSAM,2010,FOREIGN EXCHANGE REGULATION ACT-1973,0,0,0,0,0,0,1,0,1,0,0,0,1,0,1
ASSAM,2010,PREVENTION OF CORRUPTION ACT-1988,0,0,0,0,0,0,0,0,0,0,0,0,0,0,0
ASSAM,2010,CONSER.OF FORGN.EXCH.&PREV. OF SMUG.ACT,0,0,0,0,0,0,0,0,0,0,0,0,0,0,0
ASSAM,2010,OTHER SLL OFFENCE,0,0,0,26,0,26,8,0,8,2,0,2,36,0,36
ASSAM,2010,TOTAL,0,0,0,210,8,218,198,13,211,48,4,52,456,25,481
ASSAM,2011,ARMS ACT,0,0,0,72,6,78,58,3,61,14,0,14,144,9,153
ASSAM,2011,N.D.P.S. ACT,0,0,0,46,3,49,102,7,109,26,3,29,174,13,187
ASSAM,2011,GAMBLING ACT,0,0,0,19,0,19,12,0,12,5,0,5,36,0,36
ASSAM,2011,EXCISE ACT,0,0,0,6,0,6,7,0,7,4,0,4,17,0,17
ASSAM,2011,PROHIBITION ACT,0,0,0,12,0,12,3,0,3,0,0,0,15,0,15
ASSAM,2011,EXPLOSIVE & EXPLOSIVE SUBST. ACT,0,0,0,14,0,14,13,0,13,0,0,0,27,0,27
ASSAM,2011,TERRORIST & DISRUPTIVE ACTIVITIES (TATA),0,0,0,20,4,24,5,2,7,2,0,2,27,6,33
ASSAM,2011,IMMORAL TRAFFIC (PREVENTION) ACT,0,0,0,7,0,7,2,1,3,0,0,0,9,1,10
ASSAM,2011,INDIAN RAILWAYS ACT,0,0,0,0,0,0,3,0,3,0,0,0,3,0,3
ASSAM,2011,REGISTRATION OF FOREIGNERS ACT,0,0,0,0,0,0,0,0,0,0,0,0,0,0,0
ASSAM,2011,PROTECTION OF CIVIL RIGHTS ACT,0,0,0,0,0,0,0,0,0,0,0,0,0,0,0
ASSAM,2011,SC/ST (PREVENTION OF ATROCITIES) ACT,0,0,0,0,0,0,0,0,0,0,0,0,0,0,0
ASSAM,2011,INDIAN PASSPORT ACT,0,0,0,8,0,8,7,0,7,3,0,3,18,0,18
ASSAM,2011,ESSENTIAL COMMODITIES ACT,0,0,0,2,0,2,2,0,2,0,0,0,4,0,4
ASSAM,2011,ANTIQUITIES AND ART TREASURE ACT,0,0,0,0,0,0,0,0,0,0,0,0,0,0,0
ASSAM,2011,DOWRY PROHIBITION ACT,0,0,0,0,0,0,0,0,0,0,0,0,0,0,0
ASSAM,2011,FOREIGN EXCHANGE REGULATION ACT-1973,0,0,0,0,0,0,2,0,2,0,0,0,2,0,2
ASSAM,2011,PREVENTION OF CORRUPTION ACT-1988,0,0,0,0,0,0,0,0,0,0,0,0,0,0,0
ASSAM,2011,CONSER.OF FORGN.EXCH.&PREV. OF SMUG.ACT,0,0,0,0,0,0,0,0,0,0,0,0,0,0,0
ASSAM,2011,OTHER SLL OFFENCE,0,0,0,28,0,28,10,0,10,4,0,4,42,0,42
ASSAM,2011,TOTAL,0,0,0,234,13,247,226,13,239,58,3,61,518,29,547
ASSAM,2012,ARMS ACT,0,0,0,20,4,24,30,2,32,22,1,23,72,7,79
ASSAM,2012,N.D.P.S. ACT,0,0,0,21,2,23,44,3,47,20,2,22,85,7,92
ASSAM,2012,GAMBLING ACT,0,0,0,9,1,10,10,0,10,2,0,2,21,1,22
ASSAM,2012,EXCISE ACT,0,0,0,3,0,3,4,0,4,2,0,2,9,0,9
ASSAM,2012,PROHIBITION ACT,0,0,0,5,0,5,2,0,2,0,0,0,7,0,7
ASSAM,2012,EXPLOSIVE & EXPLOSIVE SUBST. ACT,0,0,0,12,0,12,11,1,12,0,0,0,23,1,24
ASSAM,2012,TERRORIST & DISRUPTIVE ACTIVITIES (TATA),0,0,0,13,0,13,2,0,2,2,0,2,17,0,17
ASSAM,2012,IMMORAL TRAFFIC (PREVENTION) ACT,0,0,0,3,0,3,2,1,3,0,0,0,5,1,6
ASSAM,2012,INDIAN RAILWAYS ACT,0,0,0,0,0,0,2,0,2,0,0,0,2,0,2
ASSAM,2012,REGISTRATION OF FOREIGNERS ACT,0,0,0,0,0,0,0,0,0,0,0,0,0,0,0
ASSAM,2012,PROTECTION OF CIVIL RIGHTS ACT,0,0,0,0,0,0,0,0,0,0,0,0,0,0,0
ASSAM,2012,SC/ST (PREVENTION OF ATROCITIES) ACT,0,0,0,0,0,0,0,0,0,0,0,0,0,0,0
ASSAM,2012,INDIAN PASSPORT ACT,0,0,0,4,0,4,3,0,3,2,0,2,9,0,9
ASSAM,2012,ESSENTIAL COMMODITIES ACT,0,0,0,2,0,2,2,0,2,0,0,0,4,0,4
ASSAM,2012,ANTIQUITIES AND ART TREASURE ACT,0,0,0,0,0,0,0,0,0,0,0,0,0,0,0
ASSAM,2012,DOWRY PROHIBITION ACT,0,0,0,0,0,0,0,0,0,0,0,0,0,0,0
ASSAM,2012,FOREIGN EXCHANGE REGULATION ACT-1973,0,0,0,0,0,0,2,0,2,0,0,0,2,0,2
ASSAM,2012,PREVENTION OF CORRUPTION ACT-1988,0,0,0,0,0,0,0,0,0,0,0,0,0,0,0
ASSAM,2012,CONSER.OF FORGN.EXCH.&PREV. OF SMUG.ACT,0,0,0,0,0,0,0,0,0,0,0,0,0,0,0
ASSAM,2012,OTHER SLL OFFENCE,0,0,0,8,0,8,7,0,7,2,0,2,17,0,17
ASSAM,2012,TOTAL,0,0,0,100,7,107,121,7,128,52,3,55,273,17,290
BIHAR,2001,ARMS ACT,42,0,42,2026,23,2049,2733,21,2754,62,0,62,4863,44,4907
BIHAR,2001,N.D.P.S. ACT,0,0,0,408,2,410,175,10,185,15,7,22,598,19,617
BIHAR,2001,GAMBLING ACT,0,0,0,168,0,168,179,0,179,20,0,20,367,0,367
BIHAR,2001,EXCISE ACT,32,0,32,107,0,107,185,8,193,30,8,38,354,16,370
BIHAR,2001,PROHIBITION ACT,25,0,25,46,0,46,85,15,100,21,4,25,177,19,196
BIHAR,2001,EXPLOSIVE & EXPLOSIVE SUBST. ACT,0,0,0,51,0,51,88,0,88,8,2,10,147,2,149
BIHAR,2001,TERRORIST & DISRUPTIVE ACTIVITIES (TATA),0,0,0,0,0,0,0,0,0,0,0,0,0,0,0
BIHAR,2001,IMMORAL TRAFFIC (PREVENTION) ACT,0,0,0,0,0,0,375,11,386,0,0,0,375,11,386
BIHAR,2001,INDIAN RAILWAYS ACT,0,0,0,490,20,510,60,0,60,21,3,24,571,23,594
BIHAR,2001,REGISTRATION OF FOREIGNERS ACT,0,0,0,0,0,0,18,0,18,0,0,0,18,0,18
BIHAR,2001,PROTECTION OF CIVIL RIGHTS ACT,0,0,0,38,7,45,31,0,31,0,0,0,69,7,76
BIHAR,2001,SC/ST (PREVENTION OF ATROCITIES) ACT,0,0,0,0,0,0,0,0,0,0,0,0,0,0,0
BIHAR,2001,INDIAN PASSPORT ACT,0,0,0,9,0,9,0,0,0,4,2,6,13,2,15
BIHAR,2001,ESSENTIAL COMMODITIES ACT,0,0,0,20,0,20,16,0,16,10,1,11,46,1,47
BIHAR,2001,ANTIQUITIES AND ART TREASURE ACT,0,0,0,16,0,16,0,0,0,0,0,0,16,0,16
BIHAR,2001,DOWRY PROHIBITION ACT,95,4,99,372,65,437,345,50,395,52,10,62,864,129,993
BIHAR,2001,FOREIGN EXCHANGE REGULATION ACT-1973,0,0,0,0,0,0,0,0,0,0,0,0,0,0,0
BIHAR,2001,PREVENTION OF CORRUPTION ACT-1988,0,0,0,0,0,0,0,0,0,0,0,0,0,0,0
BIHAR,2001,CONSER.OF FORGN.EXCH.&PREV. OF SMUG.ACT,0,0,0,0,0,0,0,0,0,0,0,0,0,0,0
BIHAR,2001,OTHER SLL OFFENCE,50,0,50,231,0,231,145,0,145,44,0,44,470,0,470
BIHAR,2001,TOTAL,244,4,248,3982,117,4099,4435,115,4550,287,37,324,8948,273,9221
BIHAR,2002,ARMS ACT,90,0,90,902,0,902,673,1,674,82,0,82,1747,1,1748
BIHAR,2002,N.D.P.S. ACT,7,0,7,215,18,233,397,21,418,58,0,58,677,39,716
BIHAR,2002,GAMBLING ACT,0,0,0,76,0,76,48,0,48,18,0,18,142,0,142
BIHAR,2002,EXCISE ACT,3,0,3,181,5,186,200,0,200,49,0,49,433,5,438
BIHAR,2002,PROHIBITION ACT,0,0,0,14,0,14,11,0,11,0,0,0,25,0,25
BIHAR,2002,EXPLOSIVE & EXPLOSIVE SUBST. ACT,6,0,6,125,2,127,72,0,72,17,0,17,220,2,222
BIHAR,2002,TERRORIST & DISRUPTIVE ACTIVITIES (TATA),0,0,0,2,0,2,2,0,2,0,0,0,4,0,4
BIHAR,2002,IMMORAL TRAFFIC (PREVENTION) ACT,4,0,4,16,12,28,11,14,25,7,0,7,38,26,64
BIHAR,2002,INDIAN RAILWAYS ACT,27,0,27,298,4,302,193,0,193,51,0,51,569,4,573
BIHAR,2002,REGISTRATION OF FOREIGNERS ACT,0,0,0,1,0,1,3,0,3,0,0,0,4,0,4
BIHAR,2002,PROTECTION OF CIVIL RIGHTS ACT,0,0,0,0,0,0,0,0,0,0,0,0,0,0,0
BIHAR,2002,SC/ST (PREVENTION OF ATROCITIES) ACT,3,0,3,17,0,17,10,0,10,11,0,11,41,0,41
BIHAR,2002,INDIAN PASSPORT ACT,0,0,0,3,0,3,3,0,3,0,0,0,6,0,6
BIHAR,2002,ESSENTIAL COMMODITIES ACT,0,0,0,7,0,7,9,0,9,2,0,2,18,0,18
BIHAR,2002,ANTIQUITIES AND ART TREASURE ACT,0,0,0,0,0,0,0,0,0,0,0,0,0,0,0
BIHAR,2002,DOWRY PROHIBITION ACT,0,0,0,383,40,423,332,57,389,147,21,168,862,118,980
BIHAR,2002,FOREIGN EXCHANGE REGULATION ACT-1973,0,0,0,0,0,0,0,0,0,0,0,0,0,0,0
BIHAR,2002,PREVENTION OF CORRUPTION ACT-1988,0,0,0,3,0,3,7,0,7,0,0,0,10,0,10
BIHAR,2002,CONSER.OF FORGN.EXCH.&PREV. OF SMUG.ACT,0,0,0,0,0,0,4,0,4,0,0,0,4,0,4
BIHAR,2002,OTHER SLL OFFENCE,0,0,0,28,0,28,18,0,18,8,0,8,54,0,54
BIHAR,2002,TOTAL,140,0,140,2271,81,2352,1993,93,2086,450,21,471,4854,195,5049
BIHAR,2003,ARMS ACT,0,0,0,1023,1,1024,1765,1,1766,218,0,218,3006,2,3008
BIHAR,2003,N.D.P.S. ACT,0,0,0,271,10,281,299,14,313,136,2,138,706,26,732
BIHAR,2003,GAMBLING ACT,0,0,0,100,0,100,98,1,99,20,0,20,218,1,219
BIHAR,2003,EXCISE ACT,0,0,0,175,3,178,171,5,176,55,0,55,401,8,409
BIHAR,2003,PROHIBITION ACT,0,0,0,0,0,0,2,0,2,1,0,1,3,0,3
BIHAR,2003,EXPLOSIVE & EXPLOSIVE SUBST. ACT,0,0,0,149,3,152,100,17,117,7,2,9,256,22,278
BIHAR,2003,TERRORIST & DISRUPTIVE ACTIVITIES (TATA),0,0,0,0,0,0,0,0,0,0,0,0,0,0,0
BIHAR,2003,IMMORAL TRAFFIC (PREVENTION) ACT,0,0,0,30,1,31,26,5,31,21,3,24,77,9,86
BIHAR,2003,INDIAN RAILWAYS ACT,0,0,0,333,2,335,283,3,286,111,4,115,727,9,736
BIHAR,2003,REGISTRATION OF FOREIGNERS ACT,0,0,0,0,0,0,0,0,0,0,0,0,0,0,0
BIHAR,2003,PROTECTION OF CIVIL RIGHTS ACT,0,0,0,0,0,0,0,0,0,0,0,0,0,0,0
BIHAR,2003,SC/ST (PREVENTION OF ATROCITIES) ACT,0,0,0,44,2,46,50,0,50,10,0,10,104,2,106
BIHAR,2003,INDIAN PASSPORT ACT,0,0,0,0,0,0,0,0,0,0,0,0,0,0,0
BIHAR,2003,ESSENTIAL COMMODITIES ACT,0,0,0,0,0,0,0,0,0,0,0,0,0,0,0
BIHAR,2003,ANTIQUITIES AND ART TREASURE ACT,0,0,0,0,0,0,0,0,0,0,0,0,0,0,0
BIHAR,2003,DOWRY PROHIBITION ACT,0,0,0,141,11,152,228,111,339,131,9,140,500,131,631
BIHAR,2003,FOREIGN EXCHANGE REGULATION ACT-1973,0,0,0,0,0,0,0,0,0,0,0,0,0,0,0
BIHAR,2003,PREVENTION OF CORRUPTION ACT-1988,0,0,0,0,0,0,0,0,0,0,0,0,0,0,0
BIHAR,2003,CONSER.OF FORGN.EXCH.&PREV. OF SMUG.ACT,0,0,0,0,0,0,0,0,0,0,0,0,0,0,0
BIHAR,2003,OTHER SLL OFFENCE,0,0,0,4,0,4,27,0,27,0,0,0,31,0,31
BIHAR,2003,TOTAL,0,0,0,2270,33,2303,3049,157,3206,710,20,730,6029,210,6239
BIHAR,2004,ARMS ACT,0,0,0,755,3,758,563,3,566,154,0,154,1472,6,1478
BIHAR,2004,N.D.P.S. ACT,0,0,0,203,6,209,208,14,222,122,1,123,533,21,554
BIHAR,2004,GAMBLING ACT,0,0,0,49,0,49,18,0,18,13,0,13,80,0,80
BIHAR,2004,EXCISE ACT,0,0,0,178,4,182,187,1,188,125,0,125,490,5,495
BIHAR,2004,PROHIBITION ACT,0,0,0,22,0,22,29,0,29,6,0,6,57,0,57
BIHAR,2004,EXPLOSIVE & EXPLOSIVE SUBST. ACT,0,0,0,99,1,100,72,2,74,14,0,14,185,3,188
BIHAR,2004,TERRORIST & DISRUPTIVE ACTIVITIES (TATA),0,0,0,0,0,0,0,0,0,0,0,0,0,0,0
BIHAR,2004,IMMORAL TRAFFIC (PREVENTION) ACT,0,0,0,39,3,42,25,0,25,7,0,7,71,3,74
BIHAR,2004,INDIAN RAILWAYS ACT,0,0,0,117,4,121,180,0,180,31,0,31,328,4,332
BIHAR,2004,REGISTRATION OF FOREIGNERS ACT,0,0,0,0,0,0,0,0,0,0,0,0,0,0,0
BIHAR,2004,PROTECTION OF CIVIL RIGHTS ACT,0,0,0,0,0,0,0,0,0,0,0,0,0,0,0
BIHAR,2004,SC/ST (PREVENTION OF ATROCITIES) ACT,0,0,0,75,0,75,52,0,52,27,0,27,154,0,154
BIHAR,2004,INDIAN PASSPORT ACT,0,0,0,0,0,0,0,0,0,0,0,0,0,0,0
BIHAR,2004,ESSENTIAL COMMODITIES ACT,0,0,0,0,0,0,2,0,2,0,0,0,2,0,2
BIHAR,2004,ANTIQUITIES AND ART TREASURE ACT,0,0,0,0,0,0,0,0,0,0,0,0,0,0,0
BIHAR,2004,DOWRY PROHIBITION ACT,0,0,0,167,6,173,217,35,252,103,8,111,487,49,536
BIHAR,2004,FOREIGN EXCHANGE REGULATION ACT-1973,0,0,0,0,0,0,0,0,0,0,0,0,0,0,0
BIHAR,2004,PREVENTION OF CORRUPTION ACT-1988,0,0,0,4,0,4,4,0,4,0,0,0,8,0,8
BIHAR,2004,CONSER.OF FORGN.EXCH.&PREV. OF SMUG.ACT,0,0,0,0,0,0,0,0,0,0,0,0,0,0,0
BIHAR,2004,OTHER SLL OFFENCE,0,0,0,10,0,10,14,0,14,4,0,4,28,0,28
BIHAR,2004,TOTAL,0,0,0,1718,27,1745,1571,55,1626,606,9,615,3895,91,3986
BIHAR,2005,ARMS ACT,0,0,0,1077,8,1085,255,4,259,262,2,264,1594,14,1608
BIHAR,2005,N.D.P.S. ACT,0,0,0,327,9,336,337,14,351,130,5,135,794,28,822
BIHAR,2005,GAMBLING ACT,0,0,0,164,2,166,138,1,139,25,0,25,327,3,330
BIHAR,2005,EXCISE ACT,0,0,0,306,14,320,375,9,384,176,3,179,857,26,883
BIHAR,2005,PROHIBITION ACT,0,0,0,7,0,7,16,0,16,3,0,3,26,0,26
BIHAR,2005,EXPLOSIVE & EXPLOSIVE SUBST. ACT,0,0,0,195,0,195,210,0,210,45,0,45,450,0,450
BIHAR,2005,TERRORIST & DISRUPTIVE ACTIVITIES (TATA),0,0,0,50,5,55,16,0,16,2,0,2,68,5,73
BIHAR,2005,IMMORAL TRAFFIC (PREVENTION) ACT,0,0,0,94,21,115,61,4,65,15,0,15,170,25,195
BIHAR,2005,INDIAN RAILWAYS ACT,0,0,0,338,1,339,287,1,288,62,0,62,687,2,689
BIHAR,2005,REGISTRATION OF FOREIGNERS ACT,0,0,0,0,0,0,0,0,0,0,0,0,0,0,0
BIHAR,2005,PROTECTION OF CIVIL RIGHTS ACT,0,0,0,0,0,0,0,0,0,0,0,0,0,0,0
BIHAR,2005,SC/ST (PREVENTION OF ATROCITIES) ACT,0,0,0,140,63,203,153,48,201,85,0,85,378,111,489
BIHAR,2005,INDIAN PASSPORT ACT,0,0,0,56,2,58,64,9,73,12,2,14,132,13,145
BIHAR,2005,ESSENTIAL COMMODITIES ACT,0,0,0,24,3,27,46,2,48,16,4,20,86,9,95
BIHAR,2005,ANTIQUITIES AND ART TREASURE ACT,0,0,0,0,0,0,0,0,0,0,0,0,0,0,0
BIHAR,2005,DOWRY PROHIBITION ACT,0,0,0,817,10,827,980,16,996,938,11,949,2735,37,2772
BIHAR,2005,FOREIGN EXCHANGE REGULATION ACT-1973,0,0,0,7,0,7,6,0,6,3,0,3,16,0,16
BIHAR,2005,PREVENTION OF CORRUPTION ACT-1988,0,0,0,8,0,8,7,0,7,0,0,0,15,0,15
BIHAR,2005,CONSER.OF FORGN.EXCH.&PREV. OF SMUG.ACT,0,0,0,1,0,1,0,0,0,0,0,0,1,0,1
BIHAR,2005,OTHER SLL OFFENCE,0,0,0,0,1,1,36,2,38,0,0,0,36,3,39
BIHAR,2005,TOTAL,0,0,0,3611,139,3750,2987,110,3097,1774,27,1801,8372,276,8648
BIHAR,2006,ARMS ACT,0,0,0,568,2,570,1252,6,1258,279,0,279,2099,8,2107
BIHAR,2006,N.D.P.S. ACT,0,0,0,31,0,31,42,0,42,26,0,26,99,0,99
BIHAR,2006,GAMBLING ACT,0,0,0,0,0,0,0,0,0,0,0,0,0,0,0
BIHAR,2006,EXCISE ACT,0,0,0,16,0,16,538,5,543,160,0,160,714,5,719
BIHAR,2006,PROHIBITION ACT,0,0,0,92,0,92,124,0,124,10,0,10,226,0,226
BIHAR,2006,EXPLOSIVE & EXPLOSIVE SUBST. ACT,0,0,0,218,0,218,171,0,171,216,0,216,605,0,605
BIHAR,2006,TERRORIST & DISRUPTIVE ACTIVITIES (TATA),0,0,0,0,0,0,0,0,0,0,0,0,0,0,0
BIHAR,2006,IMMORAL TRAFFIC (PREVENTION) ACT,0,0,0,126,0,126,218,0,218,23,0,23,367,0,367
BIHAR,2006,INDIAN RAILWAYS ACT,0,0,0,231,0,231,438,0,438,92,0,92,761,0,761
BIHAR,2006,REGISTRATION OF FOREIGNERS ACT,0,0,0,0,0,0,0,0,0,0,0,0,0,0,0
BIHAR,2006,PROTECTION OF CIVIL RIGHTS ACT,0,0,0,0,0,0,0,0,0,0,0,0,0,0,0
BIHAR,2006,SC/ST (PREVENTION OF ATROCITIES) ACT,0,0,0,61,0,61,178,0,178,57,0,57,296,0,296
BIHAR,2006,INDIAN PASSPORT ACT,0,0,0,2,0,2,3,0,3,5,0,5,10,0,10
BIHAR,2006,ESSENTIAL COMMODITIES ACT,0,0,0,33,0,33,60,0,60,29,0,29,122,0,122
BIHAR,2006,ANTIQUITIES AND ART TREASURE ACT,0,0,0,0,0,0,0,0,0,0,0,0,0,0,0
BIHAR,2006,DOWRY PROHIBITION ACT,0,0,0,104,50,154,463,37,500,183,86,269,750,173,923
BIHAR,2006,FOREIGN EXCHANGE REGULATION ACT-1973,0,0,0,18,1,19,155,0,155,12,0,12,185,1,186
BIHAR,2006,PREVENTION OF CORRUPTION ACT-1988,0,0,0,0,0,0,0,0,0,0,0,0,0,0,0
BIHAR,2006,CONSER.OF FORGN.EXCH.&PREV. OF SMUG.ACT,0,0,0,0,0,0,0,0,0,0,0,0,0,0,0
BIHAR,2006,OTHER SLL OFFENCE,0,0,0,24,7,31,36,9,45,3,1,4,63,17,80
BIHAR,2006,TOTAL,0,0,0,1524,60,1584,3678,57,3735,1095,87,1182,6297,204,6501
BIHAR,2007,ARMS ACT,0,0,0,796,0,796,869,6,875,130,0,130,1795,6,1801
BIHAR,2007,N.D.P.S. ACT,0,0,0,58,2,60,47,0,47,17,0,17,122,2,124
BIHAR,2007,GAMBLING ACT,0,0,0,0,0,0,0,0,0,0,0,0,0,0,0
BIHAR,2007,EXCISE ACT,0,0,0,25,4,29,337,5,342,90,3,93,452,12,464
BIHAR,2007,PROHIBITION ACT,0,0,0,138,0,138,104,0,104,11,0,11,253,0,253
BIHAR,2007,EXPLOSIVE & EXPLOSIVE SUBST. ACT,0,0,0,302,0,302,121,0,121,103,0,103,526,0,526
BIHAR,2007,TERRORIST & DISRUPTIVE ACTIVITIES (TATA),0,0,0,0,0,0,0,0,0,0,0,0,0,0,0
BIHAR,2007,IMMORAL TRAFFIC (PREVENTION) ACT,0,0,0,151,2,153,160,6,166,22,3,25,333,11,344
BIHAR,2007,INDIAN RAILWAYS ACT,0,0,0,317,0,317,320,0,320,41,0,41,678,0,678
BIHAR,2007,REGISTRATION OF FOREIGNERS ACT,0,0,0,0,0,0,0,0,0,0,0,0,0,0,0
BIHAR,2007,PROTECTION OF CIVIL RIGHTS ACT,0,0,0,0,0,0,0,0,0,0,0,0,0,0,0
BIHAR,2007,SC/ST (PREVENTION OF ATROCITIES) ACT,0,0,0,93,0,93,125,0,125,26,0,26,244,0,244
BIHAR,2007,INDIAN PASSPORT ACT,0,0,0,3,0,3,2,0,2,2,0,2,7,0,7
BIHAR,2007,ESSENTIAL COMMODITIES ACT,0,0,0,50,0,50,52,0,52,13,0,13,115,0,115
BIHAR,2007,ANTIQUITIES AND ART TREASURE ACT,0,0,0,0,0,0,0,0,0,0,0,0,0,0,0
BIHAR,2007,DOWRY PROHIBITION ACT,0,0,0,157,63,220,290,28,318,78,41,119,525,132,657
BIHAR,2007,FOREIGN EXCHANGE REGULATION ACT-1973,0,0,0,20,3,23,113,0,113,7,0,7,140,3,143
BIHAR,2007,PREVENTION OF CORRUPTION ACT-1988,0,0,0,0,0,0,0,0,0,0,0,0,0,0,0
BIHAR,2007,CONSER.OF FORGN.EXCH.&PREV. OF SMUG.ACT,0,0,0,0,0,0,0,0,0,0,0,0,0,0,0
BIHAR,2007,OTHER SLL OFFENCE,0,0,0,35,10,45,223,12,235,19,1,20,277,23,300
BIHAR,2007,TOTAL,0,0,0,2145,84,2229,2763,57,2820,559,48,607,5467,189,5656
BIHAR,2008,ARMS ACT,0,0,0,768,2,770,1057,6,1063,139,0,139,1964,8,1972
BIHAR,2008,N.D.P.S. ACT,0,0,0,43,5,48,42,0,42,26,0,26,111,5,116
BIHAR,2008,GAMBLING ACT,0,0,0,0,0,0,0,0,0,0,0,0,0,0,0
BIHAR,2008,EXCISE ACT,0,0,0,21,5,26,314,5,319,85,12,97,420,22,442
BIHAR,2008,PROHIBITION ACT,0,0,0,117,0,117,110,0,110,10,0,10,237,0,237
BIHAR,2008,EXPLOSIVE & EXPLOSIVE SUBST. ACT,0,0,0,278,0,278,115,0,115,112,0,112,505,0,505
BIHAR,2008,TERRORIST & DISRUPTIVE ACTIVITIES (TATA),0,0,0,0,0,0,0,0,0,0,0,0,0,0,0
BIHAR,2008,IMMORAL TRAFFIC (PREVENTION) ACT,0,0,0,126,7,133,170,0,170,17,2,19,313,9,322
BIHAR,2008,INDIAN RAILWAYS ACT,0,0,0,268,0,268,421,0,421,46,0,46,735,0,735
BIHAR,2008,REGISTRATION OF FOREIGNERS ACT,0,0,0,0,0,0,0,0,0,0,0,0,0,0,0
BIHAR,2008,PROTECTION OF CIVIL RIGHTS ACT,0,0,0,0,0,0,0,0,0,0,0,0,0,0,0
BIHAR,2008,SC/ST (PREVENTION OF ATROCITIES) ACT,0,0,0,61,0,61,122,0,122,28,0,28,211,0,211
BIHAR,2008,INDIAN PASSPORT ACT,0,0,0,2,0,2,3,0,3,1,0,1,6,0,6
BIHAR,2008,ESSENTIAL COMMODITIES ACT,0,0,0,33,0,33,60,0,60,14,0,14,107,0,107
BIHAR,2008,ANTIQUITIES AND ART TREASURE ACT,0,0,0,0,0,0,0,0,0,0,0,0,0,0,0
BIHAR,2008,DOWRY PROHIBITION ACT,0,0,0,104,62,166,385,37,422,66,16,82,555,115,670
BIHAR,2008,FOREIGN EXCHANGE REGULATION ACT-1973,0,0,0,18,1,19,135,0,135,6,0,6,159,1,160
BIHAR,2008,PREVENTION OF CORRUPTION ACT-1988,0,0,0,0,0,0,0,0,0,0,0,0,0,0,0
BIHAR,2008,CONSER.OF FORGN.EXCH.&PREV. OF SMUG.ACT,0,0,0,0,0,0,0,0,0,0,0,0,0,0,0
BIHAR,2008,OTHER SLL OFFENCE,0,0,0,24,7,31,141,9,150,39,1,40,204,17,221
BIHAR,2008,TOTAL,0,0,0,1863,89,1952,3075,57,3132,589,31,620,5527,177,5704
BIHAR,2009,ARMS ACT,0,0,0,723,2,725,936,5,941,85,0,85,1744,7,1751
BIHAR,2009,N.D.P.S. ACT,0,0,0,39,4,43,37,0,37,21,0,21,97,4,101
BIHAR,2009,GAMBLING ACT,0,0,0,0,0,0,0,0,0,0,0,0,0,0,0
BIHAR,2009,EXCISE ACT,0,0,0,20,6,26,277,6,283,52,9,61,349,21,370
BIHAR,2009,PROHIBITION ACT,0,0,0,98,0,98,98,0,98,9,0,9,205,0,205
BIHAR,2009,EXPLOSIVE & EXPLOSIVE SUBST. ACT,0,0,0,252,0,252,102,0,102,81,0,81,435,0,435
BIHAR,2009,TERRORIST & DISRUPTIVE ACTIVITIES (TATA),0,0,0,2,0,2,0,0,0,0,0,0,2,0,2
BIHAR,2009,IMMORAL TRAFFIC (PREVENTION) ACT,0,0,0,107,6,113,123,0,123,16,3,19,246,9,255
BIHAR,2009,INDIAN RAILWAYS ACT,0,0,0,244,0,244,307,0,307,26,0,26,577,0,577
BIHAR,2009,REGISTRATION OF FOREIGNERS ACT,0,0,0,0,0,0,0,0,0,0,0,0,0,0,0
BIHAR,2009,PROTECTION OF CIVIL RIGHTS ACT,0,0,0,0,0,0,0,0,0,0,0,0,0,0,0
BIHAR,2009,SC/ST (PREVENTION OF ATROCITIES) ACT,0,0,0,54,0,54,117,0,117,25,0,25,196,0,196
BIHAR,2009,INDIAN PASSPORT ACT,0,0,0,2,0,2,3,0,3,0,0,0,5,0,5
BIHAR,2009,ESSENTIAL COMMODITIES ACT,0,0,0,29,0,29,49,0,49,13,0,13,91,0,91
BIHAR,2009,ANTIQUITIES AND ART TREASURE ACT,0,0,0,0,0,0,0,0,0,0,0,0,0,0,0
BIHAR,2009,DOWRY PROHIBITION ACT,0,0,0,87,46,133,354,32,386,52,11,63,493,89,582
BIHAR,2009,FOREIGN EXCHANGE REGULATION ACT-1973,0,0,0,14,1,15,127,0,127,6,0,6,147,1,148
BIHAR,2009,PREVENTION OF CORRUPTION ACT-1988,0,0,0,0,0,0,0,0,0,0,0,0,0,0,0
BIHAR,2009,CONSER.OF FORGN.EXCH.&PREV. OF SMUG.ACT,0,0,0,0,0,0,0,0,0,0,0,0,0,0,0
BIHAR,2009,OTHER SLL OFFENCE,0,0,0,23,6,29,127,8,135,32,1,33,182,15,197
BIHAR,2009,TOTAL,0,0,0,1694,71,1765,2657,51,2708,418,24,442,4769,146,4915
BIHAR,2010,ARMS ACT,0,0,0,616,2,618,809,4,813,72,0,72,1497,6,1503
BIHAR,2010,N.D.P.S. ACT,0,0,0,30,3,33,33,0,33,17,0,17,80,3,83
BIHAR,2010,GAMBLING ACT,0,0,0,0,0,0,0,0,0,0,0,0,0,0,0
BIHAR,2010,EXCISE ACT,0,0,0,19,5,24,233,5,238,44,7,51,296,17,313
BIHAR,2010,PROHIBITION ACT,0,0,0,85,0,85,87,0,87,8,0,8,180,0,180
BIHAR,2010,EXPLOSIVE & EXPLOSIVE SUBST. ACT,0,0,0,239,0,239,94,0,94,73,0,73,406,0,406
BIHAR,2010,TERRORIST & DISRUPTIVE ACTIVITIES (TATA),0,0,0,2,0,2,0,0,0,0,0,0,2,0,2
BIHAR,2010,IMMORAL TRAFFIC (PREVENTION) ACT,0,0,0,102,7,109,105,0,105,17,3,20,224,10,234
BIHAR,2010,INDIAN RAILWAYS ACT,0,0,0,207,0,207,268,0,268,20,0,20,495,0,495
BIHAR,2010,REGISTRATION OF FOREIGNERS ACT,0,0,0,0,0,0,0,0,0,0,0,0,0,0,0
BIHAR,2010,PROTECTION OF CIVIL RIGHTS ACT,0,0,0,0,0,0,0,0,0,0,0,0,0,0,0
BIHAR,2010,SC/ST (PREVENTION OF ATROCITIES) ACT,0,0,0,47,0,47,100,0,100,21,0,21,168,0,168
BIHAR,2010,INDIAN PASSPORT ACT,0,0,0,3,0,3,2,0,2,0,0,0,5,0,5
BIHAR,2010,ESSENTIAL COMMODITIES ACT,0,0,0,27,0,27,42,0,42,11,0,11,80,0,80
BIHAR,2010,ANTIQUITIES AND ART TREASURE ACT,0,0,0,0,0,0,0,0,0,0,0,0,0,0,0
BIHAR,2010,DOWRY PROHIBITION ACT,0,0,0,74,40,114,302,29,331,45,10,55,421,79,500
BIHAR,2010,FOREIGN EXCHANGE REGULATION ACT-1973,0,0,0,11,0,11,108,0,108,4,0,4,123,0,123
BIHAR,2010,PREVENTION OF CORRUPTION ACT-1988,0,0,0,0,0,0,0,0,0,0,0,0,0,0,0
BIHAR,2010,CONSER.OF FORGN.EXCH.&PREV. OF SMUG.ACT,0,0,0,0,0,0,0,0,0,0,0,0,0,0,0
BIHAR,2010,OTHER SLL OFFENCE,0,0,0,25,8,33,118,7,125,26,0,26,169,15,184
BIHAR,2010,TOTAL,0,0,0,1487,65,1552,2301,45,2346,358,20,378,4146,130,4276
BIHAR,2011,ARMS ACT,0,0,0,532,3,535,528,1,529,196,0,196,1256,4,1260
BIHAR,2011,N.D.P.S. ACT,0,0,0,253,11,264,304,31,335,103,8,111,660,50,710
BIHAR,2011,GAMBLING ACT,0,0,0,103,1,104,152,0,152,35,0,35,290,1,291
BIHAR,2011,EXCISE ACT,0,0,0,166,3,169,255,3,258,85,0,85,506,6,512
BIHAR,2011,PROHIBITION ACT,0,0,0,16,0,16,4,0,4,1,0,1,21,0,21
BIHAR,2011,EXPLOSIVE & EXPLOSIVE SUBST. ACT,0,0,0,88,0,88,91,1,92,20,0,20,199,1,200
BIHAR,2011,TERRORIST & DISRUPTIVE ACTIVITIES (TATA),0,0,0,0,0,0,3,0,3,0,0,0,3,0,3
BIHAR,2011,IMMORAL TRAFFIC (PREVENTION) ACT,0,0,0,25,6,31,27,4,31,5,0,5,57,10,67
BIHAR,2011,INDIAN RAILWAYS ACT,0,0,0,192,2,194,148,4,152,21,0,21,361,6,367
BIHAR,2011,REGISTRATION OF FOREIGNERS ACT,0,0,0,0,0,0,0,0,0,0,0,0,0,0,0
BIHAR,2011,PROTECTION OF CIVIL RIGHTS ACT,0,0,0,0,0,0,3,0,3,2,0,2,5,0,5
BIHAR,2011,SC/ST (PREVENTION OF ATROCITIES) ACT,0,0,0,124,0,124,159,4,163,64,1,65,347,5,352
BIHAR,2011,INDIAN PASSPORT ACT,0,0,0,1,0,1,0,0,0,1,0,1,2,0,2
BIHAR,2011,ESSENTIAL COMMODITIES ACT,0,0,0,37,0,37,56,0,56,15,0,15,108,0,108
BIHAR,2011,ANTIQUITIES AND ART TREASURE ACT,0,0,0,0,0,0,0,0,0,0,0,0,0,0,0
BIHAR,2011,DOWRY PROHIBITION ACT,0,0,0,194,6,200,195,9,204,82,0,82,471,15,486
BIHAR,2011,FOREIGN EXCHANGE REGULATION ACT-1973,0,0,0,0,0,0,0,0,0,0,0,0,0,0,0
BIHAR,2011,PREVENTION OF CORRUPTION ACT-1988,0,0,0,5,2,7,19,2,21,0,0,0,24,4,28
BIHAR,2011,CONSER.OF FORGN.EXCH.&PREV. OF SMUG.ACT,0,0,0,15,0,15,14,0,14,10,0,10,39,0,39
BIHAR,2011,OTHER SLL OFFENCE,0,0,0,67,5,72,55,0,55,34,3,37,156,8,164
BIHAR,2011,TOTAL,0,0,0,1818,39,1857,2013,59,2072,674,12,686,4505,110,4615
BIHAR,2012,ARMS ACT,0,0,0,603,6,609,535,2,537,132,0,132,1270,8,1278
BIHAR,2012,N.D.P.S. ACT,0,0,0,224,12,236,363,31,394,98,3,101,685,46,731
BIHAR,2012,GAMBLING ACT,0,0,0,61,0,61,88,0,88,16,0,16,165,0,165
BIHAR,2012,EXCISE ACT,0,0,0,291,7,298,413,8,421,126,3,129,830,18,848
BIHAR,2012,PROHIBITION ACT,0,0,0,11,2,13,8,0,8,0,0,0,19,2,21
BIHAR,2012,EXPLOSIVE & EXPLOSIVE SUBST. ACT,0,0,0,66,0,66,86,0,86,22,0,22,174,0,174
BIHAR,2012,TERRORIST & DISRUPTIVE ACTIVITIES (TATA),0,0,0,0,0,0,4,0,4,0,0,0,4,0,4
BIHAR,2012,IMMORAL TRAFFIC (PREVENTION) ACT,0,0,0,35,14,49,32,7,39,4,0,4,71,21,92
BIHAR,2012,INDIAN RAILWAYS ACT,0,0,0,283,9,292,296,2,298,43,0,43,622,11,633
BIHAR,2012,REGISTRATION OF FOREIGNERS ACT,0,0,0,2,0,2,1,0,1,0,0,0,3,0,3
BIHAR,2012,PROTECTION OF CIVIL RIGHTS ACT,0,0,0,19,0,19,18,0,18,5,0,5,42,0,42
BIHAR,2012,SC/ST (PREVENTION OF ATROCITIES) ACT,0,0,0,129,0,129,169,0,169,93,0,93,391,0,391
BIHAR,2012,INDIAN PASSPORT ACT,0,0,0,17,0,17,19,0,19,1,0,1,37,0,37
BIHAR,2012,ESSENTIAL COMMODITIES ACT,0,0,0,22,0,22,35,0,35,10,0,10,67,0,67
BIHAR,2012,ANTIQUITIES AND ART TREASURE ACT,0,0,0,25,0,25,13,0,13,2,0,2,40,0,40
BIHAR,2012,DOWRY PROHIBITION ACT,0,0,0,118,7,125,68,6,74,65,3,68,251,16,267
BIHAR,2012,FOREIGN EXCHANGE REGULATION ACT-1973,0,0,0,3,0,3,2,0,2,2,0,2,7,0,7
BIHAR,2012,PREVENTION OF CORRUPTION ACT-1988,0,0,0,3,0,3,4,0,4,6,0,6,13,0,13
BIHAR,2012,CONSER.OF FORGN.EXCH.&PREV. OF SMUG.ACT,0,0,0,18,0,18,13,0,13,8,0,8,39,0,39
BIHAR,2012,OTHER SLL OFFENCE,0,0,0,10,0,10,28,0,28,1,0,1,39,0,39
BIHAR,2012,TOTAL,0,0,0,1940,57,1997,2195,56,2251,634,9,643,4769,122,4891
CHHATTISGARH,2012,ARMS ACT,0,0,0,102,2,104,40,2,42,12,0,12,154,4,158
CHHATTISGARH,2012,N.D.P.S. ACT,0,0,0,188,10,198,156,18,174,39,11,50,383,39,422
CHHATTISGARH,2012,GAMBLING ACT,0,0,0,0,0,0,0,0,0,0,0,0,0,0,0
CHHATTISGARH,2012,EXCISE ACT,0,0,0,164,2,166,151,18,169,47,0,47,362,20,382
CHHATTISGARH,2012,PROHIBITION ACT,0,0,0,0,0,0,0,0,0,0,0,0,0,0,0
CHHATTISGARH,2012,EXPLOSIVE & EXPLOSIVE SUBST. ACT,0,0,0,1,1,2,0,0,0,0,0,0,1,1,2
CHHATTISGARH,2012,TERRORIST & DISRUPTIVE ACTIVITIES (TATA),0,0,0,0,0,0,0,0,0,0,0,0,0,0,0
CHHATTISGARH,2012,IMMORAL TRAFFIC (PREVENTION) ACT,0,0,0,0,0,0,0,0,0,0,0,0,0,0,0
CHHATTISGARH,2012,INDIAN RAILWAYS ACT,0,0,0,57,0,57,27,0,27,3,0,3,87,0,87
CHHATTISGARH,2012,REGISTRATION OF FOREIGNERS ACT,0,0,0,0,0,0,1,0,1,0,0,0,1,0,1
CHHATTISGARH,2012,PROTECTION OF CIVIL RIGHTS ACT,0,0,0,4,0,4,6,0,6,4,0,4,14,0,14
CHHATTISGARH,2012,SC/ST (PREVENTION OF ATROCITIES) ACT,0,0,0,2,0,2,1,1,2,1,0,1,4,1,5
CHHATTISGARH,2012,INDIAN PASSPORT ACT,0,0,0,0,1,1,1,0,1,0,1,1,1,2,3
CHHATTISGARH,2012,ESSENTIAL COMMODITIES ACT,0,0,0,0,0,0,0,0,0,0,0,0,0,0,0
CHHATTISGARH,2012,ANTIQUITIES AND ART TREASURE ACT,0,0,0,0,0,0,0,0,0,0,0,0,0,0,0
CHHATTISGARH,2012,DOWRY PROHIBITION ACT,0,0,0,1,0,1,0,0,0,0,0,0,1,0,1
CHHATTISGARH,2012,FOREIGN EXCHANGE REGULATION ACT-1973,0,0,0,0,0,0,0,0,0,0,0,0,0,0,0
CHHATTISGARH,2012,PREVENTION OF CORRUPTION ACT-1988,0,0,0,0,0,0,2,0,2,0,0,0,2,0,2
CHHATTISGARH,2012,CONSER.OF FORGN.EXCH.&PREV. OF SMUG.ACT,0,0,0,0,0,0,0,0,0,0,0,0,0,0,0
CHHATTISGARH,2012,OTHER SLL OFFENCE,0,0,0,49,5,54,66,5,71,35,1,36,150,11,161
CHHATTISGARH,2012,TOTAL,0,0,0,568,21,589,451,44,495,141,13,154,1160,78,1238
CHHATTISGARH,2001,ARMS ACT,11,0,11,68,0,68,38,0,38,6,0,6,123,0,123
CHHATTISGARH,2001,N.D.P.S. ACT,0,0,0,49,7,56,39,7,46,14,0,14,102,14,116
CHHATTISGARH,2001,GAMBLING ACT,0,0,0,2,0,2,3,0,3,0,0,0,5,0,5
CHHATTISGARH,2001,EXCISE ACT,9,0,9,67,1,68,69,2,71,17,0,17,162,3,165
CHHATTISGARH,2001,PROHIBITION ACT,7,0,7,9,0,9,11,0,11,5,0,5,32,0,32
CHHATTISGARH,2001,EXPLOSIVE & EXPLOSIVE SUBST. ACT,0,0,0,1,0,1,2,0,2,0,0,0,3,0,3
CHHATTISGARH,2001,TERRORIST & DISRUPTIVE ACTIVITIES (TATA),0,0,0,0,0,0,1,0,1,0,0,0,1,0,1
CHHATTISGARH,2001,IMMORAL TRAFFIC (PREVENTION) ACT,0,0,0,0,0,0,0,1,1,0,0,0,0,1,1
CHHATTISGARH,2001,INDIAN RAILWAYS ACT,12,0,12,17,0,17,18,0,18,9,0,9,56,0,56
CHHATTISGARH,2001,REGISTRATION OF FOREIGNERS ACT,0,0,0,0,0,0,0,0,0,0,0,0,0,0,0
CHHATTISGARH,2001,PROTECTION OF CIVIL RIGHTS ACT,0,0,0,0,0,0,0,0,0,0,0,0,0,0,0
CHHATTISGARH,2001,SC/ST (PREVENTION OF ATROCITIES) ACT,0,0,0,4,0,4,5,0,5,2,0,2,11,0,11
CHHATTISGARH,2001,INDIAN PASSPORT ACT,0,0,0,0,0,0,0,0,0,0,0,0,0,0,0
CHHATTISGARH,2001,ESSENTIAL COMMODITIES ACT,0,0,0,0,0,0,0,0,0,0,0,0,0,0,0
CHHATTISGARH,2001,ANTIQUITIES AND ART TREASURE ACT,0,0,0,0,0,0,0,0,0,0,0,0,0,0,0
CHHATTISGARH,2001,DOWRY PROHIBITION ACT,0,0,0,45,2,47,41,6,47,8,1,9,94,9,103
CHHATTISGARH,2001,FOREIGN EXCHANGE REGULATION ACT-1973,0,0,0,0,0,0,0,0,0,0,0,0,0,0,0
CHHATTISGARH,2001,PREVENTION OF CORRUPTION ACT-1988,0,0,0,0,0,0,2,0,2,0,0,0,2,0,2
CHHATTISGARH,2001,CONSER.OF FORGN.EXCH.&PREV. OF SMUG.ACT,0,0,0,0,0,0,0,0,0,0,0,0,0,0,0
CHHATTISGARH,2001,OTHER SLL OFFENCE,2,0,2,85,0,85,46,0,46,17,0,17,150,0,150
CHHATTISGARH,2001,TOTAL,41,0,41,347,10,357,275,16,291,78,1,79,741,27,768
CHHATTISGARH,2002,ARMS ACT,4,0,4,33,0,33,45,0,45,12,0,12,94,0,94
CHHATTISGARH,2002,N.D.P.S. ACT,4,0,4,61,4,65,72,12,84,16,8,24,153,24,177
CHHATTISGARH,2002,GAMBLING ACT,2,0,2,5,0,5,15,0,15,2,0,2,24,0,24
CHHATTISGARH,2002,EXCISE ACT,3,0,3,39,3,42,57,7,64,24,3,27,123,13,136
CHHATTISGARH,2002,PROHIBITION ACT,0,0,0,0,0,0,0,0,0,0,0,0,0,0,0
CHHATTISGARH,2002,EXPLOSIVE & EXPLOSIVE SUBST. ACT,0,0,0,0,0,0,1,0,1,0,0,0,1,0,1
CHHATTISGARH,2002,TERRORIST & DISRUPTIVE ACTIVITIES (TATA),0,0,0,0,0,0,0,0,0,0,0,0,0,0,0
CHHATTISGARH,2002,IMMORAL TRAFFIC (PREVENTION) ACT,0,0,0,0,0,0,5,0,5,0,0,0,5,0,5
CHHATTISGARH,2002,INDIAN RAILWAYS ACT,11,0,11,31,2,33,42,1,43,14,0,14,98,3,101
CHHATTISGARH,2002,REGISTRATION OF FOREIGNERS ACT,0,0,0,0,0,0,0,0,0,0,0,0,0,0,0
CHHATTISGARH,2002,PROTECTION OF CIVIL RIGHTS ACT,0,0,0,0,0,0,0,0,0,0,0,0,0,0,0
CHHATTISGARH,2002,SC/ST (PREVENTION OF ATROCITIES) ACT,0,0,0,2,0,2,1,0,1,0,0,0,3,0,3
CHHATTISGARH,2002,INDIAN PASSPORT ACT,0,0,0,0,0,0,0,0,0,0,0,0,0,0,0
CHHATTISGARH,2002,ESSENTIAL COMMODITIES ACT,0,0,0,1,0,1,1,0,1,0,0,0,2,0,2
CHHATTISGARH,2002,ANTIQUITIES AND ART TREASURE ACT,0,0,0,0,0,0,0,0,0,0,0,0,0,0,0
CHHATTISGARH,2002,DOWRY PROHIBITION ACT,0,0,0,7,0,7,17,3,20,5,1,6,29,4,33
CHHATTISGARH,2002,FOREIGN EXCHANGE REGULATION ACT-1973,0,0,0,0,0,0,0,0,0,0,0,0,0,0,0
CHHATTISGARH,2002,PREVENTION OF CORRUPTION ACT-1988,0,0,0,0,0,0,0,0,0,0,0,0,0,0,0
CHHATTISGARH,2002,CONSER.OF FORGN.EXCH.&PREV. OF SMUG.ACT,0,0,0,0,0,0,0,0,0,0,0,0,0,0,0
CHHATTISGARH,2002,OTHER SLL OFFENCE,0,0,0,14,0,14,19,0,19,0,0,0,33,0,33
CHHATTISGARH,2002,TOTAL,24,0,24,193,9,202,275,23,298,73,12,85,565,44,609
CHHATTISGARH,2003,ARMS ACT,11,0,11,43,0,43,57,0,57,14,0,14,125,0,125
CHHATTISGARH,2003,N.D.P.S. ACT,5,0,5,24,4,28,49,9,58,18,0,18,96,13,109
CHHATTISGARH,2003,GAMBLING ACT,0,0,0,10,0,10,10,0,10,2,0,2,22,0,22
CHHATTISGARH,2003,EXCISE ACT,8,0,8,29,0,29,38,3,41,11,1,12,86,4,90
CHHATTISGARH,2003,PROHIBITION ACT,3,0,3,8,0,8,10,0,10,3,0,3,24,0,24
CHHATTISGARH,2003,EXPLOSIVE & EXPLOSIVE SUBST. ACT,0,0,0,0,0,0,0,0,0,0,0,0,0,0,0
CHHATTISGARH,2003,TERRORIST & DISRUPTIVE ACTIVITIES (TATA),0,0,0,0,0,0,0,0,0,0,0,0,0,0,0
CHHATTISGARH,2003,IMMORAL TRAFFIC (PREVENTION) ACT,0,0,0,0,0,0,2,0,2,0,0,0,2,0,2
CHHATTISGARH,2003,INDIAN RAILWAYS ACT,13,0,13,23,0,23,23,0,23,12,1,13,71,1,72
CHHATTISGARH,2003,REGISTRATION OF FOREIGNERS ACT,0,0,0,0,0,0,0,0,0,0,0,0,0,0,0
CHHATTISGARH,2003,PROTECTION OF CIVIL RIGHTS ACT,0,0,0,0,0,0,0,0,0,0,0,0,0,0,0
CHHATTISGARH,2003,SC/ST (PREVENTION OF ATROCITIES) ACT,0,0,0,11,0,11,1,0,1,0,0,0,12,0,12
CHHATTISGARH,2003,INDIAN PASSPORT ACT,0,0,0,0,0,0,0,0,0,0,0,0,0,0,0
CHHATTISGARH,2003,ESSENTIAL COMMODITIES ACT,0,0,0,0,0,0,0,0,0,0,0,0,0,0,0
CHHATTISGARH,2003,ANTIQUITIES AND ART TREASURE ACT,0,0,0,0,0,0,0,0,0,0,0,0,0,0,0
CHHATTISGARH,2003,DOWRY PROHIBITION ACT,1,0,1,2,0,2,3,3,6,1,0,1,7,3,10
CHHATTISGARH,2003,FOREIGN EXCHANGE REGULATION ACT-1973,0,0,0,0,0,0,0,0,0,0,0,0,0,0,0
CHHATTISGARH,2003,PREVENTION OF CORRUPTION ACT-1988,0,0,0,0,0,0,0,0,0,0,0,0,0,0,0
CHHATTISGARH,2003,CONSER.OF FORGN.EXCH.&PREV. OF SMUG.ACT,0,0,0,0,0,0,0,0,0,0,0,0,0,0,0
CHHATTISGARH,2003,OTHER SLL OFFENCE,3,0,3,14,0,14,21,0,21,13,0,13,51,0,51
CHHATTISGARH,2003,TOTAL,44,0,44,164,4,168,214,15,229,74,2,76,496,21,517
CHHATTISGARH,2004,ARMS ACT,0,0,0,82,0,82,37,0,37,4,0,4,123,0,123
CHHATTISGARH,2004,N.D.P.S. ACT,0,0,0,82,6,88,59,14,73,12,0,12,153,20,173
CHHATTISGARH,2004,GAMBLING ACT,0,0,0,6,0,6,4,0,4,0,0,0,10,0,10
CHHATTISGARH,2004,EXCISE ACT,0,0,0,33,1,34,35,4,39,1,3,4,69,8,77
CHHATTISGARH,2004,PROHIBITION ACT,0,0,0,0,0,0,0,0,0,0,0,0,0,0,0
CHHATTISGARH,2004,EXPLOSIVE & EXPLOSIVE SUBST. ACT,0,0,0,0,0,0,2,2,4,0,0,0,2,2,4
CHHATTISGARH,2004,TERRORIST & DISRUPTIVE ACTIVITIES (TATA),0,0,0,0,0,0,0,0,0,0,0,0,0,0,0
CHHATTISGARH,2004,IMMORAL TRAFFIC (PREVENTION) ACT,0,0,0,0,0,0,0,0,0,0,0,0,0,0,0
CHHATTISGARH,2004,INDIAN RAILWAYS ACT,0,0,0,30,0,30,29,0,29,0,0,0,59,0,59
CHHATTISGARH,2004,REGISTRATION OF FOREIGNERS ACT,0,0,0,0,0,0,0,0,0,0,0,0,0,0,0
CHHATTISGARH,2004,PROTECTION OF CIVIL RIGHTS ACT,0,0,0,0,0,0,0,0,0,0,0,0,0,0,0
CHHATTISGARH,2004,SC/ST (PREVENTION OF ATROCITIES) ACT,0,0,0,7,0,7,8,0,8,0,0,0,15,0,15
CHHATTISGARH,2004,INDIAN PASSPORT ACT,0,0,0,0,0,0,0,0,0,0,0,0,0,0,0
CHHATTISGARH,2004,ESSENTIAL COMMODITIES ACT,0,0,0,0,0,0,0,0,0,0,0,0,0,0,0
CHHATTISGARH,2004,ANTIQUITIES AND ART TREASURE ACT,0,0,0,0,0,0,0,0,0,0,0,0,0,0,0
CHHATTISGARH,2004,DOWRY PROHIBITION ACT,0,0,0,5,0,5,3,0,3,0,0,0,8,0,8
CHHATTISGARH,2004,FOREIGN EXCHANGE REGULATION ACT-1973,0,0,0,0,0,0,0,0,0,0,0,0,0,0,0
CHHATTISGARH,2004,PREVENTION OF CORRUPTION ACT-1988,0,0,0,0,0,0,0,0,0,0,0,0,0,0,0
CHHATTISGARH,2004,CONSER.OF FORGN.EXCH.&PREV. OF SMUG.ACT,0,0,0,0,0,0,0,0,0,0,0,0,0,0,0
CHHATTISGARH,2004,OTHER SLL OFFENCE,1,0,1,29,2,31,30,3,33,9,0,9,69,5,74
CHHATTISGARH,2004,TOTAL,1,0,1,274,9,283,207,23,230,26,3,29,508,35,543
CHHATTISGARH,2005,ARMS ACT,0,0,0,62,2,64,41,2,43,2,0,2,105,4,109
CHHATTISGARH,2005,N.D.P.S. ACT,0,0,0,61,9,70,64,9,73,21,2,23,146,20,166
CHHATTISGARH,2005,GAMBLING ACT,0,0,0,3,0,3,3,1,4,0,0,0,6,1,7
CHHATTISGARH,2005,EXCISE ACT,0,0,0,36,0,36,28,6,34,23,0,23,87,6,93
CHHATTISGARH,2005,PROHIBITION ACT,0,0,0,2,0,2,1,0,1,0,0,0,3,0,3
CHHATTISGARH,2005,EXPLOSIVE & EXPLOSIVE SUBST. ACT,0,0,0,5,0,5,2,2,4,0,0,0,7,2,9
CHHATTISGARH,2005,TERRORIST & DISRUPTIVE ACTIVITIES (TATA),0,0,0,0,0,0,0,0,0,0,0,0,0,0,0
CHHATTISGARH,2005,IMMORAL TRAFFIC (PREVENTION) ACT,0,0,0,0,0,0,0,0,0,0,0,0,0,0,0
CHHATTISGARH,2005,INDIAN RAILWAYS ACT,0,0,0,88,0,88,62,4,66,2,6,8,152,10,162
CHHATTISGARH,2005,REGISTRATION OF FOREIGNERS ACT,0,0,0,0,0,0,0,0,0,0,0,0,0,0,0
CHHATTISGARH,2005,PROTECTION OF CIVIL RIGHTS ACT,0,0,0,0,0,0,0,0,0,0,0,0,0,0,0
CHHATTISGARH,2005,SC/ST (PREVENTION OF ATROCITIES) ACT,0,0,0,0,0,0,1,0,1,0,0,0,1,0,1
CHHATTISGARH,2005,INDIAN PASSPORT ACT,0,0,0,1,0,1,2,0,2,0,0,0,3,0,3
CHHATTISGARH,2005,ESSENTIAL COMMODITIES ACT,0,0,0,0,0,0,0,0,0,0,0,0,0,0,0
CHHATTISGARH,2005,ANTIQUITIES AND ART TREASURE ACT,0,0,0,0,0,0,0,0,0,0,0,0,0,0,0
CHHATTISGARH,2005,DOWRY PROHIBITION ACT,0,0,0,0,0,0,0,0,0,0,0,0,0,0,0
CHHATTISGARH,2005,FOREIGN EXCHANGE REGULATION ACT-1973,0,0,0,0,0,0,0,0,0,0,0,0,0,0,0
CHHATTISGARH,2005,PREVENTION OF CORRUPTION ACT-1988,0,0,0,0,0,0,0,0,0,0,0,0,0,0,0
CHHATTISGARH,2005,CONSER.OF FORGN.EXCH.&PREV. OF SMUG.ACT,0,0,0,0,0,0,0,0,0,0,0,0,0,0,0
CHHATTISGARH,2005,OTHER SLL OFFENCE,0,0,0,49,0,49,74,0,74,8,1,9,131,1,132
CHHATTISGARH,2005,TOTAL,0,0,0,307,11,318,278,24,302,56,9,65,641,44,685
CHHATTISGARH,2006,ARMS ACT,0,0,0,127,5,132,65,0,65,6,0,6,198,5,203
CHHATTISGARH,2006,N.D.P.S. ACT,0,0,0,115,7,122,111,14,125,16,1,17,242,22,264
CHHATTISGARH,2006,GAMBLING ACT,0,0,0,18,1,19,4,0,4,2,0,2,24,1,25
CHHATTISGARH,2006,EXCISE ACT,0,0,0,74,7,81,44,8,52,12,1,13,130,16,146
CHHATTISGARH,2006,PROHIBITION ACT,0,0,0,0,0,0,0,0,0,0,0,0,0,0,0
CHHATTISGARH,2006,EXPLOSIVE & EXPLOSIVE SUBST. ACT,0,0,0,0,0,0,1,0,1,0,0,0,1,0,1
CHHATTISGARH,2006,TERRORIST & DISRUPTIVE ACTIVITIES (TATA),0,0,0,0,0,0,0,0,0,0,0,0,0,0,0
CHHATTISGARH,2006,IMMORAL TRAFFIC (PREVENTION) ACT,0,0,0,0,0,0,0,0,0,0,0,0,0,0,0
CHHATTISGARH,2006,INDIAN RAILWAYS ACT,0,0,0,89,4,93,31,1,32,9,0,9,129,5,134
CHHATTISGARH,2006,REGISTRATION OF FOREIGNERS ACT,0,0,0,0,0,0,0,0,0,0,0,0,0,0,0
CHHATTISGARH,2006,PROTECTION OF CIVIL RIGHTS ACT,0,0,0,3,0,3,3,0,3,1,0,1,7,0,7
CHHATTISGARH,2006,SC/ST (PREVENTION OF ATROCITIES) ACT,0,0,0,2,0,2,0,0,0,0,0,0,2,0,2
CHHATTISGARH,2006,INDIAN PASSPORT ACT,0,0,0,0,0,0,0,0,0,0,0,0,0,0,0
CHHATTISGARH,2006,ESSENTIAL COMMODITIES ACT,0,0,0,0,0,0,0,0,0,0,0,0,0,0,0
CHHATTISGARH,2006,ANTIQUITIES AND ART TREASURE ACT,0,0,0,0,0,0,0,0,0,0,0,0,0,0,0
CHHATTISGARH,2006,DOWRY PROHIBITION ACT,0,0,0,13,0,13,6,2,8,0,0,0,19,2,21
CHHATTISGARH,2006,FOREIGN EXCHANGE REGULATION ACT-1973,0,0,0,0,0,0,0,0,0,0,0,0,0,0,0
CHHATTISGARH,2006,PREVENTION OF CORRUPTION ACT-1988,0,0,0,0,0,0,0,0,0,0,0,0,0,0,0
CHHATTISGARH,2006,CONSER.OF FORGN.EXCH.&PREV. OF SMUG.ACT,0,0,0,0,0,0,0,0,0,0,0,0,0,0,0
CHHATTISGARH,2006,OTHER SLL OFFENCE,0,0,0,50,0,50,19,2,21,9,0,9,78,2,80
CHHATTISGARH,2006,TOTAL,0,0,0,491,24,515,284,27,311,55,2,57,830,53,883
CHHATTISGARH,2007,ARMS ACT,0,0,0,76,2,78,61,1,62,4,0,4,141,3,144
CHHATTISGARH,2007,N.D.P.S. ACT,0,0,0,101,10,111,60,12,72,22,3,25,183,25,208
CHHATTISGARH,2007,GAMBLING ACT,0,0,0,20,1,21,8,0,8,7,0,7,35,1,36
CHHATTISGARH,2007,EXCISE ACT,0,0,0,81,6,87,46,5,51,11,2,13,138,13,151
CHHATTISGARH,2007,PROHIBITION ACT,0,0,0,0,0,0,2,0,2,0,0,0,2,0,2
CHHATTISGARH,2007,EXPLOSIVE & EXPLOSIVE SUBST. ACT,0,0,0,3,0,3,0,0,0,0,0,0,3,0,3
CHHATTISGARH,2007,TERRORIST & DISRUPTIVE ACTIVITIES (TATA),0,0,0,0,0,0,0,0,0,0,0,0,0,0,0
CHHATTISGARH,2007,IMMORAL TRAFFIC (PREVENTION) ACT,0,0,0,0,0,0,0,0,0,0,0,0,0,0,0
CHHATTISGARH,2007,INDIAN RAILWAYS ACT,0,0,0,59,2,61,49,2,51,11,0,11,119,4,123
CHHATTISGARH,2007,REGISTRATION OF FOREIGNERS ACT,0,0,0,0,0,0,0,0,0,0,0,0,0,0,0
CHHATTISGARH,2007,PROTECTION OF CIVIL RIGHTS ACT,0,0,0,0,0,0,0,0,0,0,0,0,0,0,0
CHHATTISGARH,2007,SC/ST (PREVENTION OF ATROCITIES) ACT,0,0,0,9,1,10,10,1,11,6,2,8,25,4,29
CHHATTISGARH,2007,INDIAN PASSPORT ACT,0,0,0,0,0,0,0,0,0,0,0,0,0,0,0
CHHATTISGARH,2007,ESSENTIAL COMMODITIES ACT,0,0,0,0,0,0,0,0,0,0,0,0,0,0,0
CHHATTISGARH,2007,ANTIQUITIES AND ART TREASURE ACT,0,0,0,0,0,0,0,0,0,0,0,0,0,0,0
CHHATTISGARH,2007,DOWRY PROHIBITION ACT,0,0,0,0,0,0,0,0,0,0,0,0,0,0,0
CHHATTISGARH,2007,FOREIGN EXCHANGE REGULATION ACT-1973,0,0,0,0,0,0,0,0,0,0,0,0,0,0,0
CHHATTISGARH,2007,PREVENTION OF CORRUPTION ACT-1988,0,0,0,0,0,0,0,0,0,0,0,0,0,0,0
CHHATTISGARH,2007,CONSER.OF FORGN.EXCH.&PREV. OF SMUG.ACT,0,0,0,0,0,0,0,0,0,0,0,0,0,0,0
CHHATTISGARH,2007,OTHER SLL OFFENCE,0,0,0,16,0,16,71,1,72,16,1,17,103,2,105
CHHATTISGARH,2007,TOTAL,0,0,0,365,22,387,307,22,329,77,8,85,749,52,801
CHHATTISGARH,2008,ARMS ACT,0,0,0,59,2,61,52,1,53,4,0,4,115,3,118
CHHATTISGARH,2008,N.D.P.S. ACT,0,0,0,56,11,67,47,6,53,8,2,10,111,19,130
CHHATTISGARH,2008,GAMBLING ACT,0,0,0,5,0,5,10,0,10,2,0,2,17,0,17
CHHATTISGARH,2008,EXCISE ACT,0,0,0,47,3,50,75,5,80,9,6,15,131,14,145
CHHATTISGARH,2008,PROHIBITION ACT,0,0,0,11,0,11,0,1,1,5,0,5,16,1,17
CHHATTISGARH,2008,EXPLOSIVE & EXPLOSIVE SUBST. ACT,0,0,0,10,0,10,0,0,0,0,0,0,10,0,10
CHHATTISGARH,2008,TERRORIST & DISRUPTIVE ACTIVITIES (TATA),0,0,0,0,0,0,0,0,0,0,0,0,0,0,0
CHHATTISGARH,2008,IMMORAL TRAFFIC (PREVENTION) ACT,0,0,0,0,0,0,0,0,0,0,0,0,0,0,0
CHHATTISGARH,2008,INDIAN RAILWAYS ACT,0,0,0,19,1,20,56,0,56,6,0,6,81,1,82
CHHATTISGARH,2008,REGISTRATION OF FOREIGNERS ACT,0,0,0,0,0,0,0,0,0,0,0,0,0,0,0
CHHATTISGARH,2008,PROTECTION OF CIVIL RIGHTS ACT,0,0,0,0,0,0,0,0,0,0,0,0,0,0,0
CHHATTISGARH,2008,SC/ST (PREVENTION OF ATROCITIES) ACT,0,0,0,12,1,13,15,0,15,0,0,0,27,1,28
CHHATTISGARH,2008,INDIAN PASSPORT ACT,0,0,0,0,0,0,0,0,0,0,0,0,0,0,0
CHHATTISGARH,2008,ESSENTIAL COMMODITIES ACT,0,0,0,0,0,0,0,0,0,0,0,0,0,0,0
CHHATTISGARH,2008,ANTIQUITIES AND ART TREASURE ACT,0,0,0,0,0,0,0,0,0,0,0,0,0,0,0
CHHATTISGARH,2008,DOWRY PROHIBITION ACT,0,0,0,11,2,13,11,1,12,6,0,6,28,3,31
CHHATTISGARH,2008,FOREIGN EXCHANGE REGULATION ACT-1973,0,0,0,0,0,0,0,0,0,0,0,0,0,0,0
CHHATTISGARH,2008,PREVENTION OF CORRUPTION ACT-1988,0,0,0,0,0,0,0,0,0,0,0,0,0,0,0
CHHATTISGARH,2008,CONSER.OF FORGN.EXCH.&PREV. OF SMUG.ACT,0,0,0,0,0,0,0,0,0,0,0,0,0,0,0
CHHATTISGARH,2008,OTHER SLL OFFENCE,0,0,0,38,0,38,78,0,78,18,1,19,134,1,135
CHHATTISGARH,2008,TOTAL,0,0,0,268,20,288,344,14,358,58,9,67,670,43,713
CHHATTISGARH,2009,ARMS ACT,1,0,1,122,2,124,36,0,36,3,0,3,162,2,164
CHHATTISGARH,2009,N.D.P.S. ACT,0,0,0,82,11,93,59,9,68,13,1,14,154,21,175
CHHATTISGARH,2009,GAMBLING ACT,0,0,0,3,0,3,1,0,1,0,0,0,4,0,4
CHHATTISGARH,2009,EXCISE ACT,0,0,0,78,2,80,40,1,41,13,1,14,131,4,135
CHHATTISGARH,2009,PROHIBITION ACT,0,0,0,9,0,9,3,0,3,2,0,2,14,0,14
CHHATTISGARH,2009,EXPLOSIVE & EXPLOSIVE SUBST. ACT,0,0,0,0,0,0,0,0,0,0,0,0,0,0,0
CHHATTISGARH,2009,TERRORIST & DISRUPTIVE ACTIVITIES (TATA),0,0,0,0,0,0,1,0,1,0,0,0,1,0,1
CHHATTISGARH,2009,IMMORAL TRAFFIC (PREVENTION) ACT,0,0,0,1,0,1,1,0,1,0,0,0,2,0,2
CHHATTISGARH,2009,INDIAN RAILWAYS ACT,0,0,0,24,0,24,20,0,20,5,0,5,49,0,49
CHHATTISGARH,2009,REGISTRATION OF FOREIGNERS ACT,0,0,0,0,0,0,1,0,1,0,0,0,1,0,1
CHHATTISGARH,2009,PROTECTION OF CIVIL RIGHTS ACT,0,0,0,0,0,0,0,0,0,0,0,0,0,0,0
CHHATTISGARH,2009,SC/ST (PREVENTION OF ATROCITIES) ACT,0,0,0,6,0,6,2,0,2,2,0,2,10,0,10
CHHATTISGARH,2009,INDIAN PASSPORT ACT,0,0,0,0,0,0,0,0,0,0,0,0,0,0,0
CHHATTISGARH,2009,ESSENTIAL COMMODITIES ACT,0,0,0,0,0,0,3,0,3,4,0,4,7,0,7
CHHATTISGARH,2009,ANTIQUITIES AND ART TREASURE ACT,0,0,0,0,0,0,0,0,0,0,0,0,0,0,0
CHHATTISGARH,2009,DOWRY PROHIBITION ACT,0,0,0,1,0,1,1,0,1,0,0,0,2,0,2
CHHATTISGARH,2009,FOREIGN EXCHANGE REGULATION ACT-1973,0,0,0,0,0,0,0,0,0,0,0,0,0,0,0
CHHATTISGARH,2009,PREVENTION OF CORRUPTION ACT-1988,0,0,0,0,0,0,0,0,0,0,0,0,0,0,0
CHHATTISGARH,2009,CONSER.OF FORGN.EXCH.&PREV. OF SMUG.ACT,0,0,0,0,0,0,0,0,0,0,0,0,0,0,0
CHHATTISGARH,2009,OTHER SLL OFFENCE,0,0,0,109,8,117,72,0,72,8,0,8,189,8,197
CHHATTISGARH,2009,TOTAL,1,0,1,435,23,458,240,10,250,50,2,52,726,35,761
CHHATTISGARH,2010,ARMS ACT,6,0,6,83,0,83,43,0,43,3,0,3,135,0,135
CHHATTISGARH,2010,N.D.P.S. ACT,13,0,13,145,7,152,90,15,105,21,3,24,269,25,294
CHHATTISGARH,2010,GAMBLING ACT,3,0,3,14,1,15,8,1,9,18,0,18,43,2,45
CHHATTISGARH,2010,EXCISE ACT,0,0,0,52,6,58,49,3,52,14,1,15,115,10,125
CHHATTISGARH,2010,PROHIBITION ACT,0,0,0,1,0,1,0,0,0,0,0,0,1,0,1
CHHATTISGARH,2010,EXPLOSIVE & EXPLOSIVE SUBST. ACT,0,0,0,1,0,1,0,0,0,0,0,0,1,0,1
CHHATTISGARH,2010,TERRORIST & DISRUPTIVE ACTIVITIES (TATA),0,0,0,0,0,0,0,0,0,0,0,0,0,0,0
CHHATTISGARH,2010,IMMORAL TRAFFIC (PREVENTION) ACT,0,0,0,0,1,1,0,0,0,0,0,0,0,1,1
CHHATTISGARH,2010,INDIAN RAILWAYS ACT,9,0,9,56,0,56,13,7,20,4,0,4,82,7,89
CHHATTISGARH,2010,REGISTRATION OF FOREIGNERS ACT,0,0,0,0,0,0,3,0,3,0,0,0,3,0,3
CHHATTISGARH,2010,PROTECTION OF CIVIL RIGHTS ACT,0,0,0,0,0,0,2,0,2,1,0,1,3,0,3
CHHATTISGARH,2010,SC/ST (PREVENTION OF ATROCITIES) ACT,0,0,0,12,0,12,13,0,13,0,0,0,25,0,25
CHHATTISGARH,2010,INDIAN PASSPORT ACT,0,0,0,0,0,0,0,0,0,0,0,0,0,0,0
CHHATTISGARH,2010,ESSENTIAL COMMODITIES ACT,0,0,0,0,0,0,0,0,0,0,0,0,0,0,0
CHHATTISGARH,2010,ANTIQUITIES AND ART TREASURE ACT,0,0,0,0,0,0,0,0,0,0,0,0,0,0,0
CHHATTISGARH,2010,DOWRY PROHIBITION ACT,0,0,0,1,0,1,0,0,0,0,0,0,1,0,1
CHHATTISGARH,2010,FOREIGN EXCHANGE REGULATION ACT-1973,0,0,0,0,0,0,0,0,0,0,0,0,0,0,0
CHHATTISGARH,2010,PREVENTION OF CORRUPTION ACT-1988,0,0,0,0,0,0,0,0,0,0,0,0,0,0,0
CHHATTISGARH,2010,CONSER.OF FORGN.EXCH.&PREV. OF SMUG.ACT,0,0,0,2,0,2,2,0,2,0,0,0,4,0,4
CHHATTISGARH,2010,OTHER SLL OFFENCE,36,0,36,75,2,77,83,5,88,61,4,65,255,11,266
CHHATTISGARH,2010,TOTAL,67,0,67,442,17,459,306,31,337,122,8,130,937,56,993
CHHATTISGARH,2011,ARMS ACT,0,0,0,66,0,66,47,0,47,2,0,2,115,0,115
CHHATTISGARH,2011,N.D.P.S. ACT,0,0,0,153,9,162,127,15,142,30,7,37,310,31,341
CHHATTISGARH,2011,GAMBLING ACT,0,0,0,8,0,8,4,0,4,0,0,0,12,0,12
CHHATTISGARH,2011,EXCISE ACT,0,0,0,151,2,153,102,9,111,31,1,32,284,12,296
CHHATTISGARH,2011,PROHIBITION ACT,0,0,0,6,0,6,0,0,0,0,0,0,6,0,6
CHHATTISGARH,2011,EXPLOSIVE & EXPLOSIVE SUBST. ACT,0,0,0,1,0,1,0,0,0,0,0,0,1,0,1
CHHATTISGARH,2011,TERRORIST & DISRUPTIVE ACTIVITIES (TATA),0,0,0,0,0,0,0,0,0,0,0,0,0,0,0
CHHATTISGARH,2011,IMMORAL TRAFFIC (PREVENTION) ACT,0,0,0,0,0,0,0,0,0,0,0,0,0,0,0
CHHATTISGARH,2011,INDIAN RAILWAYS ACT,0,0,0,44,0,44,19,0,19,4,0,4,67,0,67
CHHATTISGARH,2011,REGISTRATION OF FOREIGNERS ACT,0,0,0,0,0,0,0,1,1,0,0,0,0,1,1
CHHATTISGARH,2011,PROTECTION OF CIVIL RIGHTS ACT,0,0,0,0,0,0,0,0,0,0,0,0,0,0,0
CHHATTISGARH,2011,SC/ST (PREVENTION OF ATROCITIES) ACT,0,0,0,4,0,4,7,0,7,8,0,8,19,0,19
CHHATTISGARH,2011,INDIAN PASSPORT ACT,0,0,0,0,0,0,0,0,0,0,0,0,0,0,0
CHHATTISGARH,2011,ESSENTIAL COMMODITIES ACT,0,0,0,0,0,0,0,0,0,0,0,0,0,0,0
CHHATTISGARH,2011,ANTIQUITIES AND ART TREASURE ACT,0,0,0,0,0,0,0,0,0,0,0,0,0,0,0
CHHATTISGARH,2011,DOWRY PROHIBITION ACT,0,0,0,0,0,0,0,0,0,0,0,0,0,0,0
CHHATTISGARH,2011,FOREIGN EXCHANGE REGULATION ACT-1973,0,0,0,0,0,0,0,0,0,0,0,0,0,0,0
CHHATTISGARH,2011,PREVENTION OF CORRUPTION ACT-1988,0,0,0,0,0,0,0,0,0,0,0,0,0,0,0
CHHATTISGARH,2011,CONSER.OF FORGN.EXCH.&PREV. OF SMUG.ACT,0,0,0,0,0,0,0,0,0,0,0,0,0,0,0
CHHATTISGARH,2011,OTHER SLL OFFENCE,0,0,0,109,12,121,94,8,102,85,0,85,288,20,308
CHHATTISGARH,2011,TOTAL,0,0,0,542,23,565,400,33,433,160,8,168,1102,64,1166
GOA,2001,ARMS ACT,0,0,0,0,0,0,0,0,0,0,0,0,0,0,0
GOA,2001,N.D.P.S. ACT,0,0,0,0,0,0,0,0,0,0,0,0,0,0,0
GOA,2001,GAMBLING ACT,0,0,0,0,0,0,0,0,0,0,0,0,0,0,0
GOA,2001,EXCISE ACT,0,0,0,0,0,0,0,0,0,0,0,0,0,0,0
GOA,2001,PROHIBITION ACT,0,0,0,0,0,0,0,0,0,0,0,0,0,0,0
GOA,2001,EXPLOSIVE & EXPLOSIVE SUBST. ACT,0,0,0,0,0,0,0,0,0,0,0,0,0,0,0
GOA,2001,TERRORIST & DISRUPTIVE ACTIVITIES (TATA),0,0,0,0,0,0,0,0,0,0,0,0,0,0,0
GOA,2001,IMMORAL TRAFFIC (PREVENTION) ACT,0,0,0,0,0,0,0,0,0,0,0,0,0,0,0
GOA,2001,INDIAN RAILWAYS ACT,0,0,0,0,0,0,0,0,0,0,0,0,0,0,0
GOA,2001,REGISTRATION OF FOREIGNERS ACT,0,0,0,0,0,0,0,0,0,0,0,0,0,0,0
GOA,2001,PROTECTION OF CIVIL RIGHTS ACT,0,0,0,0,0,0,0,0,0,0,0,0,0,0,0
GOA,2001,SC/ST (PREVENTION OF ATROCITIES) ACT,0,0,0,0,0,0,0,0,0,0,0,0,0,0,0
GOA,2001,INDIAN PASSPORT ACT,0,0,0,0,0,0,0,0,0,0,0,0,0,0,0
GOA,2001,ESSENTIAL COMMODITIES ACT,0,0,0,0,0,0,0,0,0,0,0,0,0,0,0
GOA,2001,ANTIQUITIES AND ART TREASURE ACT,0,0,0,0,0,0,0,0,0,0,0,0,0,0,0
GOA,2001,DOWRY PROHIBITION ACT,0,0,0,0,0,0,0,0,0,0,0,0,0,0,0
GOA,2001,FOREIGN EXCHANGE REGULATION ACT-1973,0,0,0,0,0,0,0,0,0,0,0,0,0,0,0
GOA,2001,PREVENTION OF CORRUPTION ACT-1988,0,0,0,0,0,0,0,0,0,0,0,0,0,0,0
GOA,2001,CONSER.OF FORGN.EXCH.&PREV. OF SMUG.ACT,0,0,0,0,0,0,0,0,0,0,0,0,0,0,0
GOA,2001,OTHER SLL OFFENCE,0,0,0,0,0,0,0,0,0,0,0,0,0,0,0
GOA,2001,TOTAL,0,0,0,0,0,0,0,0,0,0,0,0,0,0,0
GOA,2002,ARMS ACT,0,0,0,0,0,0,0,0,0,0,0,0,0,0,0
GOA,2002,N.D.P.S. ACT,0,0,0,0,0,0,0,0,0,0,0,0,0,0,0
GOA,2002,GAMBLING ACT,0,0,0,0,0,0,0,0,0,0,0,0,0,0,0
GOA,2002,EXCISE ACT,0,0,0,0,0,0,0,0,0,0,0,0,0,0,0
GOA,2002,PROHIBITION ACT,0,0,0,0,0,0,0,0,0,0,0,0,0,0,0
GOA,2002,EXPLOSIVE & EXPLOSIVE SUBST. ACT,0,0,0,0,0,0,0,0,0,0,0,0,0,0,0
GOA,2002,TERRORIST & DISRUPTIVE ACTIVITIES (TATA),0,0,0,0,0,0,0,0,0,0,0,0,0,0,0
GOA,2002,IMMORAL TRAFFIC (PREVENTION) ACT,0,0,0,0,1,1,0,4,4,0,0,0,0,5,5
GOA,2002,INDIAN RAILWAYS ACT,0,0,0,0,0,0,0,0,0,0,0,0,0,0,0
GOA,2002,REGISTRATION OF FOREIGNERS ACT,0,0,0,0,0,0,0,0,0,0,0,0,0,0,0
GOA,2002,PROTECTION OF CIVIL RIGHTS ACT,0,0,0,0,0,0,0,0,0,0,0,0,0,0,0
GOA,2002,SC/ST (PREVENTION OF ATROCITIES) ACT,0,0,0,0,0,0,0,0,0,0,0,0,0,0,0
GOA,2002,INDIAN PASSPORT ACT,0,0,0,0,0,0,0,0,0,0,0,0,0,0,0
GOA,2002,ESSENTIAL COMMODITIES ACT,0,0,0,0,0,0,0,0,0,0,0,0,0,0,0
GOA,2002,ANTIQUITIES AND ART TREASURE ACT,0,0,0,0,0,0,0,0,0,0,0,0,0,0,0
GOA,2002,DOWRY PROHIBITION ACT,0,0,0,0,0,0,0,0,0,0,0,0,0,0,0
GOA,2002,FOREIGN EXCHANGE REGULATION ACT-1973,0,0,0,0,0,0,0,0,0,0,0,0,0,0,0
GOA,2002,PREVENTION OF CORRUPTION ACT-1988,0,0,0,0,0,0,0,0,0,0,0,0,0,0,0
GOA,2002,CONSER.OF FORGN.EXCH.&PREV. OF SMUG.ACT,0,0,0,0,0,0,0,0,0,0,0,0,0,0,0
GOA,2002,OTHER SLL OFFENCE,0,0,0,0,0,0,0,0,0,3,0,3,3,0,3
GOA,2002,TOTAL,0,0,0,0,1,1,0,4,4,3,0,3,3,5,8
GOA,2003,ARMS ACT,0,0,0,0,0,0,0,0,0,0,0,0,0,0,0
GOA,2003,N.D.P.S. ACT,0,0,0,14,0,14,26,1,27,1,0,1,41,1,42
GOA,2003,GAMBLING ACT,0,0,0,0,0,0,0,0,0,0,0,0,0,0,0
GOA,2003,EXCISE ACT,0,0,0,0,0,0,0,0,0,0,0,0,0,0,0
GOA,2003,PROHIBITION ACT,0,0,0,0,0,0,0,0,0,0,0,0,0,0,0
GOA,2003,EXPLOSIVE & EXPLOSIVE SUBST. ACT,0,0,0,0,0,0,0,0,0,0,0,0,0,0,0
GOA,2003,TERRORIST & DISRUPTIVE ACTIVITIES (TATA),0,0,0,0,0,0,0,0,0,0,0,0,0,0,0
GOA,2003,IMMORAL TRAFFIC (PREVENTION) ACT,0,0,0,0,0,0,0,2,2,0,0,0,0,2,2
GOA,2003,INDIAN RAILWAYS ACT,0,0,0,0,0,0,0,0,0,0,0,0,0,0,0
GOA,2003,REGISTRATION OF FOREIGNERS ACT,0,0,0,0,0,0,0,0,0,0,0,0,0,0,0
GOA,2003,PROTECTION OF CIVIL RIGHTS ACT,0,0,0,0,0,0,0,0,0,0,0,0,0,0,0
GOA,2003,SC/ST (PREVENTION OF ATROCITIES) ACT,0,0,0,0,0,0,0,0,0,0,0,0,0,0,0
GOA,2003,INDIAN PASSPORT ACT,0,0,0,0,0,0,0,0,0,0,0,0,0,0,0
GOA,2003,ESSENTIAL COMMODITIES ACT,0,0,0,0,0,0,0,0,0,0,0,0,0,0,0
GOA,2003,ANTIQUITIES AND ART TREASURE ACT,0,0,0,0,0,0,0,0,0,0,0,0,0,0,0
GOA,2003,DOWRY PROHIBITION ACT,0,0,0,0,0,0,0,0,0,0,0,0,0,0,0
GOA,2003,FOREIGN EXCHANGE REGULATION ACT-1973,0,0,0,0,0,0,0,0,0,0,0,0,0,0,0
GOA,2003,PREVENTION OF CORRUPTION ACT-1988,0,0,0,0,0,0,0,0,0,0,0,0,0,0,0
GOA,2003,CONSER.OF FORGN.EXCH.&PREV. OF SMUG.ACT,0,0,0,0,0,0,0,0,0,0,0,0,0,0,0
GOA,2003,OTHER SLL OFFENCE,0,0,0,0,0,0,6,1,7,0,0,0,6,1,7
GOA,2003,TOTAL,0,0,0,14,0,14,32,4,36,1,0,1,47,4,51
GOA,2004,ARMS ACT,0,0,0,0,0,0,0,0,0,0,0,0,0,0,0
GOA,2004,N.D.P.S. ACT,0,0,0,15,0,15,27,1,28,1,0,1,43,1,44
GOA,2004,GAMBLING ACT,0,0,0,0,0,0,0,0,0,0,0,0,0,0,0
GOA,2004,EXCISE ACT,0,0,0,0,0,0,0,0,0,0,0,0,0,0,0
GOA,2004,PROHIBITION ACT,0,0,0,0,0,0,0,0,0,0,0,0,0,0,0
GOA,2004,EXPLOSIVE & EXPLOSIVE SUBST. ACT,0,0,0,0,0,0,0,0,0,0,0,0,0,0,0
GOA,2004,TERRORIST & DISRUPTIVE ACTIVITIES (TATA),0,0,0,0,0,0,0,0,0,0,0,0,0,0,0
GOA,2004,IMMORAL TRAFFIC (PREVENTION) ACT,0,0,0,0,0,0,0,2,2,0,0,0,0,2,2
GOA,2004,INDIAN RAILWAYS ACT,0,0,0,2,0,2,0,0,0,0,0,0,2,0,2
GOA,2004,REGISTRATION OF FOREIGNERS ACT,0,0,0,0,0,0,0,0,0,0,0,0,0,0,0
GOA,2004,PROTECTION OF CIVIL RIGHTS ACT,0,0,0,0,0,0,0,0,0,0,0,0,0,0,0
GOA,2004,SC/ST (PREVENTION OF ATROCITIES) ACT,0,0,0,0,0,0,0,0,0,0,0,0,0,0,0
GOA,2004,INDIAN PASSPORT ACT,0,0,0,0,0,0,0,0,0,0,0,0,0,0,0
GOA,2004,ESSENTIAL COMMODITIES ACT,0,0,0,0,0,0,0,0,0,0,0,0,0,0,0
GOA,2004,ANTIQUITIES AND ART TREASURE ACT,0,0,0,0,0,0,0,0,0,0,0,0,0,0,0
GOA,2004,DOWRY PROHIBITION ACT,0,0,0,0,0,0,0,0,0,0,0,0,0,0,0
GOA,2004,FOREIGN EXCHANGE REGULATION ACT-1973,0,0,0,0,0,0,0,0,0,0,0,0,0,0,0
GOA,2004,PREVENTION OF CORRUPTION ACT-1988,0,0,0,0,0,0,0,0,0,0,0,0,0,0,0
GOA,2004,CONSER.OF FORGN.EXCH.&PREV. OF SMUG.ACT,0,0,0,0,0,0,0,0,0,0,0,0,0,0,0
GOA,2004,OTHER SLL OFFENCE,0,0,0,4,0,4,8,0,8,0,0,0,12,0,12
GOA,2004,TOTAL,0,0,0,21,0,21,35,3,38,1,0,1,57,3,60
GOA,2005,ARMS ACT,0,0,0,0,0,0,0,0,0,0,0,0,0,0,0
GOA,2005,N.D.P.S. ACT,0,0,0,29,1,30,12,0,12,0,0,0,41,1,42
GOA,2005,GAMBLING ACT,0,0,0,0,0,0,0,0,0,0,0,0,0,0,0
GOA,2005,EXCISE ACT,0,0,0,0,0,0,0,0,0,0,0,0,0,0,0
GOA,2005,PROHIBITION ACT,0,0,0,0,0,0,0,0,0,0,0,0,0,0,0
GOA,2005,EXPLOSIVE & EXPLOSIVE SUBST. ACT,0,0,0,0,0,0,0,0,0,0,0,0,0,0,0
GOA,2005,TERRORIST & DISRUPTIVE ACTIVITIES (TATA),0,0,0,0,0,0,0,0,0,0,0,0,0,0,0
GOA,2005,IMMORAL TRAFFIC (PREVENTION) ACT,0,0,0,0,6,6,0,4,4,1,0,1,1,10,11
GOA,2005,INDIAN RAILWAYS ACT,0,0,0,2,0,2,0,0,0,0,0,0,2,0,2
GOA,2005,REGISTRATION OF FOREIGNERS ACT,0,0,0,0,0,0,0,0,0,0,0,0,0,0,0
GOA,2005,PROTECTION OF CIVIL RIGHTS ACT,0,0,0,0,0,0,0,0,0,0,0,0,0,0,0
GOA,2005,SC/ST (PREVENTION OF ATROCITIES) ACT,0,0,0,0,0,0,0,0,0,0,0,0,0,0,0
GOA,2005,INDIAN PASSPORT ACT,0,0,0,0,0,0,0,0,0,0,0,0,0,0,0
GOA,2005,ESSENTIAL COMMODITIES ACT,0,0,0,0,0,0,0,0,0,0,0,0,0,0,0
GOA,2005,ANTIQUITIES AND ART TREASURE ACT,0,0,0,0,0,0,0,0,0,0,0,0,0,0,0
GOA,2005,DOWRY PROHIBITION ACT,0,0,0,0,0,0,0,0,0,0,0,0,0,0,0
GOA,2005,FOREIGN EXCHANGE REGULATION ACT-1973,0,0,0,0,0,0,0,0,0,0,0,0,0,0,0
GOA,2005,PREVENTION OF CORRUPTION ACT-1988,0,0,0,0,0,0,0,0,0,0,0,0,0,0,0
GOA,2005,CONSER.OF FORGN.EXCH.&PREV. OF SMUG.ACT,0,0,0,0,0,0,0,0,0,0,0,0,0,0,0
GOA,2005,OTHER SLL OFFENCE,0,0,0,4,0,4,4,0,4,0,0,0,8,0,8
GOA,2005,TOTAL,0,0,0,35,7,42,16,4,20,1,0,1,52,11,63
GOA,2006,ARMS ACT,0,0,0,0,0,0,1,0,1,0,0,0,1,0,1
GOA,2006,N.D.P.S. ACT,0,0,0,17,0,17,18,3,21,2,0,2,37,3,40
GOA,2006,GAMBLING ACT,0,0,0,0,0,0,0,0,0,0,0,0,0,0,0
GOA,2006,EXCISE ACT,0,0,0,0,0,0,0,0,0,0,0,0,0,0,0
GOA,2006,PROHIBITION ACT,0,0,0,0,0,0,0,0,0,0,0,0,0,0,0
GOA,2006,EXPLOSIVE & EXPLOSIVE SUBST. ACT,0,0,0,0,0,0,0,0,0,0,0,0,0,0,0
GOA,2006,TERRORIST & DISRUPTIVE ACTIVITIES (TATA),0,0,0,0,0,0,0,0,0,0,0,0,0,0,0
GOA,2006,IMMORAL TRAFFIC (PREVENTION) ACT,0,0,0,1,0,1,1,0,1,0,0,0,2,0,2
GOA,2006,INDIAN RAILWAYS ACT,0,0,0,0,0,0,0,0,0,0,0,0,0,0,0
GOA,2006,REGISTRATION OF FOREIGNERS ACT,0,0,0,0,0,0,0,0,0,0,0,0,0,0,0
GOA,2006,PROTECTION OF CIVIL RIGHTS ACT,0,0,0,0,0,0,0,0,0,0,0,0,0,0,0
GOA,2006,SC/ST (PREVENTION OF ATROCITIES) ACT,0,0,0,0,0,0,0,0,0,0,0,0,0,0,0
GOA,2006,INDIAN PASSPORT ACT,0,0,0,0,0,0,0,0,0,0,0,0,0,0,0
GOA,2006,ESSENTIAL COMMODITIES ACT,0,0,0,0,0,0,0,0,0,0,0,0,0,0,0
GOA,2006,ANTIQUITIES AND ART TREASURE ACT,0,0,0,0,0,0,0,0,0,0,0,0,0,0,0
GOA,2006,DOWRY PROHIBITION ACT,0,0,0,0,0,0,0,0,0,0,0,0,0,0,0
GOA,2006,FOREIGN EXCHANGE REGULATION ACT-1973,0,0,0,0,0,0,0,0,0,0,0,0,0,0,0
GOA,2006,PREVENTION OF CORRUPTION ACT-1988,0,0,0,0,0,0,0,0,0,0,0,0,0,0,0
GOA,2006,CONSER.OF FORGN.EXCH.&PREV. OF SMUG.ACT,0,0,0,0,0,0,0,0,0,0,0,0,0,0,0
GOA,2006,OTHER SLL OFFENCE,0,0,0,0,0,0,0,0,0,0,0,0,0,0,0
GOA,2006,TOTAL,0,0,0,18,0,18,20,3,23,2,0,2,40,3,43
GOA,2007,ARMS ACT,0,0,0,0,0,0,0,0,0,0,0,0,0,0,0
GOA,2007,N.D.P.S. ACT,0,0,0,26,1,27,10,0,10,2,0,2,38,1,39
GOA,2007,GAMBLING ACT,0,0,0,1,0,1,0,0,0,0,0,0,1,0,1
GOA,2007,EXCISE ACT,0,0,0,4,0,4,0,0,0,0,0,0,4,0,4
GOA,2007,PROHIBITION ACT,0,0,0,0,0,0,0,0,0,0,0,0,0,0,0
GOA,2007,EXPLOSIVE & EXPLOSIVE SUBST. ACT,0,0,0,4,0,4,1,0,1,0,0,0,5,0,5
GOA,2007,TERRORIST & DISRUPTIVE ACTIVITIES (TATA),0,0,0,0,0,0,0,0,0,0,0,0,0,0,0
GOA,2007,IMMORAL TRAFFIC (PREVENTION) ACT,0,0,0,2,0,2,2,0,2,0,0,0,4,0,4
GOA,2007,INDIAN RAILWAYS ACT,0,0,0,1,0,1,0,0,0,0,0,0,1,0,1
GOA,2007,REGISTRATION OF FOREIGNERS ACT,0,0,0,0,0,0,0,0,0,0,0,0,0,0,0
GOA,2007,PROTECTION OF CIVIL RIGHTS ACT,0,0,0,0,0,0,0,0,0,0,0,0,0,0,0
GOA,2007,SC/ST (PREVENTION OF ATROCITIES) ACT,0,0,0,0,0,0,0,0,0,0,0,0,0,0,0
GOA,2007,INDIAN PASSPORT ACT,0,0,0,2,1,3,0,0,0,0,0,0,2,1,3
GOA,2007,ESSENTIAL COMMODITIES ACT,0,0,0,0,0,0,0,0,0,0,0,0,0,0,0
GOA,2007,ANTIQUITIES AND ART TREASURE ACT,0,0,0,0,0,0,0,0,0,0,0,0,0,0,0
GOA,2007,DOWRY PROHIBITION ACT,0,0,0,0,0,0,0,0,0,0,0,0,0,0,0
GOA,2007,FOREIGN EXCHANGE REGULATION ACT-1973,0,0,0,0,0,0,0,0,0,0,0,0,0,0,0
GOA,2007,PREVENTION OF CORRUPTION ACT-1988,0,0,0,0,0,0,0,0,0,0,0,0,0,0,0
GOA,2007,CONSER.OF FORGN.EXCH.&PREV. OF SMUG.ACT,0,0,0,0,0,0,0,0,0,0,0,0,0,0,0
GOA,2007,OTHER SLL OFFENCE,0,0,0,1,0,1,0,0,0,0,0,0,1,0,1
GOA,2007,TOTAL,0,0,0,41,2,43,13,0,13,2,0,2,56,2,58
GOA,2008,ARMS ACT,0,0,0,0,0,0,1,0,1,0,0,0,1,0,1
GOA,2008,N.D.P.S. ACT,0,0,0,4,0,4,0,0,0,0,0,0,4,0,4
GOA,2008,GAMBLING ACT,0,0,0,8,0,8,19,1,20,4,1,5,31,2,33
GOA,2008,EXCISE ACT,0,0,0,3,0,3,0,0,0,0,0,0,3,0,3
GOA,2008,PROHIBITION ACT,0,0,0,4,0,4,0,0,0,0,0,0,4,0,4
GOA,2008,EXPLOSIVE & EXPLOSIVE SUBST. ACT,0,0,0,1,0,1,0,0,0,0,0,0,1,0,1
GOA,2008,TERRORIST & DISRUPTIVE ACTIVITIES (TATA),0,0,0,0,0,0,0,0,0,0,0,0,0,0,0
GOA,2008,IMMORAL TRAFFIC (PREVENTION) ACT,0,0,0,0,0,0,0,0,0,0,0,0,0,0,0
GOA,2008,INDIAN RAILWAYS ACT,0,0,0,3,0,3,0,0,0,0,0,0,3,0,3
GOA,2008,REGISTRATION OF FOREIGNERS ACT,0,0,0,0,0,0,0,0,0,0,0,0,0,0,0
GOA,2008,PROTECTION OF CIVIL RIGHTS ACT,0,0,0,0,0,0,0,0,0,0,0,0,0,0,0
GOA,2008,SC/ST (PREVENTION OF ATROCITIES) ACT,0,0,0,0,0,0,0,0,0,0,0,0,0,0,0
GOA,2008,INDIAN PASSPORT ACT,0,0,0,1,0,1,0,0,0,0,0,0,1,0,1
GOA,2008,ESSENTIAL COMMODITIES ACT,0,0,0,0,0,0,0,0,0,0,0,0,0,0,0
GOA,2008,ANTIQUITIES AND ART TREASURE ACT,0,0,0,0,0,0,0,0,0,0,0,0,0,0,0
GOA,2008,DOWRY PROHIBITION ACT,0,0,0,0,0,0,0,0,0,0,0,0,0,0,0
GOA,2008,FOREIGN EXCHANGE REGULATION ACT-1973,0,0,0,0,0,0,0,0,0,0,0,0,0,0,0
GOA,2008,PREVENTION OF CORRUPTION ACT-1988,0,0,0,0,0,0,0,0,0,0,0,0,0,0,0
GOA,2008,CONSER.OF FORGN.EXCH.&PREV. OF SMUG.ACT,0,0,0,0,0,0,0,0,0,0,0,0,0,0,0
GOA,2008,OTHER SLL OFFENCE,0,0,0,0,0,0,1,0,1,0,0,0,1,0,1
GOA,2008,TOTAL,0,0,0,24,0,24,21,1,22,4,1,5,49,2,51
GOA,2009,ARMS ACT,0,0,0,0,0,0,0,0,0,0,0,0,0,0,0
GOA,2009,N.D.P.S. ACT,0,0,0,10,1,11,16,0,16,5,1,6,31,2,33
GOA,2009,GAMBLING ACT,0,0,0,1,0,1,0,0,0,0,0,0,1,0,1
GOA,2009,EXCISE ACT,0,0,0,0,0,0,0,0,0,0,0,0,0,0,0
GOA,2009,PROHIBITION ACT,0,0,0,0,0,0,0,0,0,0,0,0,0,0,0
GOA,2009,EXPLOSIVE & EXPLOSIVE SUBST. ACT,0,0,0,0,0,0,0,0,0,0,0,0,0,0,0
GOA,2009,TERRORIST & DISRUPTIVE ACTIVITIES (TATA),0,0,0,0,0,0,0,0,0,0,0,0,0,0,0
GOA,2009,IMMORAL TRAFFIC (PREVENTION) ACT,0,0,0,0,0,0,0,0,0,0,0,0,0,0,0
GOA,2009,INDIAN RAILWAYS ACT,0,0,0,0,0,0,0,0,0,0,0,0,0,0,0
GOA,2009,REGISTRATION OF FOREIGNERS ACT,0,0,0,0,0,0,0,0,0,0,0,0,0,0,0
GOA,2009,PROTECTION OF CIVIL RIGHTS ACT,0,0,0,0,0,0,0,0,0,0,0,0,0,0,0
GOA,2009,SC/ST (PREVENTION OF ATROCITIES) ACT,0,0,0,0,0,0,0,0,0,0,0,0,0,0,0
GOA,2009,INDIAN PASSPORT ACT,0,0,0,0,0,0,0,0,0,0,0,0,0,0,0
GOA,2009,ESSENTIAL COMMODITIES ACT,0,0,0,0,0,0,0,0,0,0,0,0,0,0,0
GOA,2009,ANTIQUITIES AND ART TREASURE ACT,0,0,0,0,0,0,0,0,0,0,0,0,0,0,0
GOA,2009,DOWRY PROHIBITION ACT,0,0,0,0,0,0,0,0,0,0,0,0,0,0,0
GOA,2009,FOREIGN EXCHANGE REGULATION ACT-1973,0,0,0,0,0,0,0,0,0,0,0,0,0,0,0
GOA,2009,PREVENTION OF CORRUPTION ACT-1988,0,0,0,0,0,0,0,0,0,0,0,0,0,0,0
GOA,2009,CONSER.OF FORGN.EXCH.&PREV. OF SMUG.ACT,0,0,0,0,0,0,1,0,1,0,0,0,1,0,1
GOA,2009,OTHER SLL OFFENCE,0,0,0,0,0,0,0,0,0,0,0,0,0,0,0
GOA,2009,TOTAL,0,0,0,11,1,12,17,0,17,5,1,6,33,2,35
GOA,2010,ARMS ACT,0,0,0,14,0,14,11,0,11,0,0,0,25,0,25
GOA,2010,N.D.P.S. ACT,0,0,0,8,0,8,5,4,9,1,0,1,14,4,18
GOA,2010,GAMBLING ACT,0,0,0,1,0,1,0,0,0,0,0,0,1,0,1
GOA,2010,EXCISE ACT,0,0,0,0,0,0,0,0,0,0,0,0,0,0,0
GOA,2010,PROHIBITION ACT,0,0,0,0,0,0,0,0,0,0,0,0,0,0,0
GOA,2010,EXPLOSIVE & EXPLOSIVE SUBST. ACT,0,0,0,6,0,6,0,0,0,0,0,0,6,0,6
GOA,2010,TERRORIST & DISRUPTIVE ACTIVITIES (TATA),0,0,0,0,0,0,4,0,4,0,0,0,4,0,4
GOA,2010,IMMORAL TRAFFIC (PREVENTION) ACT,0,0,0,10,0,10,0,5,5,0,0,0,10,5,15
GOA,2010,INDIAN RAILWAYS ACT,0,0,0,5,0,5,0,0,0,0,0,0,5,0,5
GOA,2010,REGISTRATION OF FOREIGNERS ACT,0,0,0,0,0,0,0,0,0,0,0,0,0,0,0
GOA,2010,PROTECTION OF CIVIL RIGHTS ACT,0,0,0,0,0,0,0,0,0,0,0,0,0,0,0
GOA,2010,SC/ST (PREVENTION OF ATROCITIES) ACT,0,0,0,2,0,2,0,0,0,0,0,0,2,0,2
GOA,2010,INDIAN PASSPORT ACT,0,0,0,2,0,2,3,0,3,1,0,1,6,0,6
GOA,2010,ESSENTIAL COMMODITIES ACT,0,0,0,0,0,0,0,0,0,0,0,0,0,0,0
GOA,2010,ANTIQUITIES AND ART TREASURE ACT,0,0,0,0,0,0,0,0,0,0,0,0,0,0,0
GOA,2010,DOWRY PROHIBITION ACT,0,0,0,0,0,0,0,0,0,0,0,0,0,0,0
GOA,2010,FOREIGN EXCHANGE REGULATION ACT-1973,0,0,0,0,0,0,0,0,0,0,0,0,0,0,0
GOA,2010,PREVENTION OF CORRUPTION ACT-1988,0,0,0,0,0,0,3,0,3,0,0,0,3,0,3
GOA,2010,CONSER.OF FORGN.EXCH.&PREV. OF SMUG.ACT,0,0,0,0,0,0,0,0,0,0,0,0,0,0,0
GOA,2010,OTHER SLL OFFENCE,0,0,0,0,0,0,0,0,0,0,0,0,0,0,0
GOA,2010,TOTAL,0,0,0,48,0,48,26,9,35,2,0,2,76,9,85
GOA,2011,ARMS ACT,0,0,0,1,0,1,0,0,0,0,0,0,1,0,1
GOA,2011,N.D.P.S. ACT,0,0,0,26,0,26,20,5,25,2,4,6,48,9,57
GOA,2011,GAMBLING ACT,0,0,0,0,0,0,0,0,0,0,0,0,0,0,0
GOA,2011,EXCISE ACT,0,0,0,0,0,0,0,0,0,0,0,0,0,0,0
GOA,2011,PROHIBITION ACT,0,0,0,0,0,0,0,0,0,0,0,0,0,0,0
GOA,2011,EXPLOSIVE & EXPLOSIVE SUBST. ACT,0,0,0,5,0,5,1,0,1,0,0,0,6,0,6
GOA,2011,TERRORIST & DISRUPTIVE ACTIVITIES (TATA),0,0,0,0,0,0,0,0,0,0,0,0,0,0,0
GOA,2011,IMMORAL TRAFFIC (PREVENTION) ACT,0,0,0,4,0,4,2,1,3,0,0,0,6,1,7
GOA,2011,INDIAN RAILWAYS ACT,0,0,0,0,0,0,0,0,0,0,0,0,0,0,0
GOA,2011,REGISTRATION OF FOREIGNERS ACT,0,0,0,0,0,0,0,0,0,0,0,0,0,0,0
GOA,2011,PROTECTION OF CIVIL RIGHTS ACT,0,0,0,0,0,0,0,0,0,0,0,0,0,0,0
GOA,2011,SC/ST (PREVENTION OF ATROCITIES) ACT,0,0,0,0,0,0,0,0,0,0,0,0,0,0,0
GOA,2011,INDIAN PASSPORT ACT,0,0,0,4,0,4,3,0,3,0,0,0,7,0,7
GOA,2011,ESSENTIAL COMMODITIES ACT,0,0,0,0,0,0,0,0,0,0,0,0,0,0,0
GOA,2011,ANTIQUITIES AND ART TREASURE ACT,0,0,0,0,0,0,0,0,0,0,0,0,0,0,0
GOA,2011,DOWRY PROHIBITION ACT,0,0,0,3,0,3,0,0,0,0,0,0,3,0,3
GOA,2011,FOREIGN EXCHANGE REGULATION ACT-1973,0,0,0,0,0,0,0,0,0,0,0,0,0,0,0
GOA,2011,PREVENTION OF CORRUPTION ACT-1988,0,0,0,0,0,0,0,0,0,0,0,0,0,0,0
GOA,2011,CONSER.OF FORGN.EXCH.&PREV. OF SMUG.ACT,0,0,0,0,0,0,0,0,0,0,0,0,0,0,0
GOA,2011,OTHER SLL OFFENCE,0,0,0,0,0,0,0,0,0,0,0,0,0,0,0
GOA,2011,TOTAL,0,0,0,43,0,43,26,6,32,2,4,6,71,10,81
GOA,2012,ARMS ACT,0,0,0,0,0,0,0,0,0,0,0,0,0,0,0
GOA,2012,N.D.P.S. ACT,0,0,0,35,2,37,18,3,21,1,1,2,54,6,60
GOA,2012,GAMBLING ACT,0,0,0,0,0,0,0,0,0,0,0,0,0,0,0
GOA,2012,EXCISE ACT,0,0,0,0,0,0,0,0,0,0,0,0,0,0,0
GOA,2012,PROHIBITION ACT,0,0,0,0,0,0,0,0,0,0,0,0,0,0,0
GOA,2012,EXPLOSIVE & EXPLOSIVE SUBST. ACT,0,0,0,5,0,5,1,0,1,0,0,0,6,0,6
GOA,2012,TERRORIST & DISRUPTIVE ACTIVITIES (TATA),0,0,0,0,0,0,0,0,0,0,0,0,0,0,0
GOA,2012,IMMORAL TRAFFIC (PREVENTION) ACT,0,0,0,5,3,8,1,0,1,0,0,0,6,3,9
GOA,2012,INDIAN RAILWAYS ACT,0,0,0,0,0,0,0,0,0,0,0,0,0,0,0
GOA,2012,REGISTRATION OF FOREIGNERS ACT,0,0,0,0,0,0,0,0,0,0,0,0,0,0,0
GOA,2012,PROTECTION OF CIVIL RIGHTS ACT,0,0,0,0,0,0,0,0,0,0,0,0,0,0,0
GOA,2012,SC/ST (PREVENTION OF ATROCITIES) ACT,0,0,0,0,0,0,0,0,0,0,0,0,0,0,0
GOA,2012,INDIAN PASSPORT ACT,0,0,0,2,0,2,0,0,0,0,0,0,2,0,2
GOA,2012,ESSENTIAL COMMODITIES ACT,0,0,0,0,0,0,0,0,0,0,0,0,0,0,0
GOA,2012,ANTIQUITIES AND ART TREASURE ACT,0,0,0,0,0,0,0,0,0,0,0,0,0,0,0
GOA,2012,DOWRY PROHIBITION ACT,0,0,0,0,0,0,0,0,0,0,0,0,0,0,0
GOA,2012,FOREIGN EXCHANGE REGULATION ACT-1973,0,0,0,0,0,0,0,0,0,0,0,0,0,0,0
GOA,2012,PREVENTION OF CORRUPTION ACT-1988,0,0,0,0,0,0,0,0,0,0,0,0,0,0,0
GOA,2012,CONSER.OF FORGN.EXCH.&PREV. OF SMUG.ACT,0,0,0,0,0,0,0,0,0,0,0,0,0,0,0
GOA,2012,OTHER SLL OFFENCE,0,0,0,0,0,0,0,0,0,0,0,0,0,0,0
GOA,2012,TOTAL,0,0,0,47,5,52,20,3,23,1,1,2,68,9,77
GUJARAT,2001,ARMS ACT,0,0,0,61,0,61,59,0,59,24,0,24,144,0,144
GUJARAT,2001,N.D.P.S. ACT,9,0,9,165,14,179,186,5,191,18,1,19,378,20,398
GUJARAT,2001,GAMBLING ACT,0,0,0,9,0,9,5,0,5,0,0,0,14,0,14
GUJARAT,2001,EXCISE ACT,0,0,0,20,0,20,10,0,10,3,0,3,33,0,33
GUJARAT,2001,PROHIBITION ACT,10,0,10,150,9,159,118,14,132,28,0,28,306,23,329
GUJARAT,2001,EXPLOSIVE & EXPLOSIVE SUBST. ACT,0,0,0,0,0,0,0,0,0,0,0,0,0,0,0
GUJARAT,2001,TERRORIST & DISRUPTIVE ACTIVITIES (TATA),0,0,0,12,0,12,19,0,19,30,0,30,61,0,61
GUJARAT,2001,IMMORAL TRAFFIC (PREVENTION) ACT,0,0,0,0,0,0,0,0,0,0,0,0,0,0,0
GUJARAT,2001,INDIAN RAILWAYS ACT,0,0,0,19,0,19,5,0,5,3,0,3,27,0,27
GUJARAT,2001,REGISTRATION OF FOREIGNERS ACT,0,0,0,2,0,2,0,0,0,0,0,0,2,0,2
GUJARAT,2001,PROTECTION OF CIVIL RIGHTS ACT,0,0,0,0,0,0,0,0,0,0,0,0,0,0,0
GUJARAT,2001,SC/ST (PREVENTION OF ATROCITIES) ACT,0,0,0,1,0,1,7,0,7,1,0,1,9,0,9
GUJARAT,2001,INDIAN PASSPORT ACT,0,0,0,0,0,0,0,0,0,0,0,0,0,0,0
GUJARAT,2001,ESSENTIAL COMMODITIES ACT,0,0,0,0,0,0,0,0,0,0,0,0,0,0,0
GUJARAT,2001,ANTIQUITIES AND ART TREASURE ACT,0,0,0,0,0,0,0,0,0,0,0,0,0,0,0
GUJARAT,2001,DOWRY PROHIBITION ACT,0,0,0,19,1,20,13,1,14,4,0,4,36,2,38
GUJARAT,2001,FOREIGN EXCHANGE REGULATION ACT-1973,0,0,0,0,0,0,0,0,0,0,0,0,0,0,0
GUJARAT,2001,PREVENTION OF CORRUPTION ACT-1988,0,0,0,0,0,0,2,0,2,0,0,0,2,0,2
GUJARAT,2001,CONSER.OF FORGN.EXCH.&PREV. OF SMUG.ACT,0,0,0,0,0,0,0,0,0,0,0,0,0,0,0
GUJARAT,2001,OTHER SLL OFFENCE,0,0,0,5,3,8,105,0,105,102,0,102,212,3,215
GUJARAT,2001,TOTAL,19,0,19,463,27,490,529,20,549,213,1,214,1224,48,1272
GUJARAT,2002,ARMS ACT,0,0,0,74,0,74,60,0,60,31,0,31,165,0,165
GUJARAT,2002,N.D.P.S. ACT,0,0,0,198,8,206,181,8,189,21,0,21,400,16,416
GUJARAT,2002,GAMBLING ACT,0,0,0,11,0,11,8,1,9,0,0,0,19,1,20
GUJARAT,2002,EXCISE ACT,0,0,0,5,0,5,9,0,9,6,0,6,20,0,20
GUJARAT,2002,PROHIBITION ACT,0,0,0,170,12,182,141,14,155,37,1,38,348,27,375
GUJARAT,2002,EXPLOSIVE & EXPLOSIVE SUBST. ACT,0,0,0,0,0,0,0,0,0,0,0,0,0,0,0
GUJARAT,2002,TERRORIST & DISRUPTIVE ACTIVITIES (TATA),0,0,0,17,0,17,8,0,8,41,0,41,66,0,66
GUJARAT,2002,IMMORAL TRAFFIC (PREVENTION) ACT,0,0,0,0,0,0,0,0,0,0,0,0,0,0,0
GUJARAT,2002,INDIAN RAILWAYS ACT,0,0,0,26,0,26,30,0,30,6,0,6,62,0,62
GUJARAT,2002,REGISTRATION OF FOREIGNERS ACT,0,0,0,0,0,0,0,0,0,0,0,0,0,0,0
GUJARAT,2002,PROTECTION OF CIVIL RIGHTS ACT,0,0,0,4,0,4,0,0,0,0,0,0,4,0,4
GUJARAT,2002,SC/ST (PREVENTION OF ATROCITIES) ACT,0,0,0,0,0,0,0,0,0,0,0,0,0,0,0
GUJARAT,2002,INDIAN PASSPORT ACT,0,0,0,0,0,0,15,0,15,10,0,10,25,0,25
GUJARAT,2002,ESSENTIAL COMMODITIES ACT,0,0,0,0,0,0,0,0,0,0,0,0,0,0,0
GUJARAT,2002,ANTIQUITIES AND ART TREASURE ACT,0,0,0,0,0,0,0,0,0,0,0,0,0,0,0
GUJARAT,2002,DOWRY PROHIBITION ACT,0,0,0,7,0,7,6,0,6,0,0,0,13,0,13
GUJARAT,2002,FOREIGN EXCHANGE REGULATION ACT-1973,0,0,0,2,0,2,2,0,2,0,0,0,4,0,4
GUJARAT,2002,PREVENTION OF CORRUPTION ACT-1988,0,0,0,11,0,11,7,0,7,0,0,0,18,0,18
GUJARAT,2002,CONSER.OF FORGN.EXCH.&PREV. OF SMUG.ACT,0,0,0,0,0,0,0,0,0,0,0,0,0,0,0
GUJARAT,2002,OTHER SLL OFFENCE,0,0,0,94,1,95,84,1,85,37,0,37,215,2,217
GUJARAT,2002,TOTAL,0,0,0,619,21,640,551,24,575,189,1,190,1359,46,1405
GUJARAT,2003,ARMS ACT,0,0,0,37,0,37,24,0,24,12,0,12,73,0,73
GUJARAT,2003,N.D.P.S. ACT,3,0,3,214,13,227,118,18,136,16,1,17,351,32,383
GUJARAT,2003,GAMBLING ACT,0,0,0,0,0,0,0,0,0,0,0,0,0,0,0
GUJARAT,2003,EXCISE ACT,0,0,0,0,0,0,0,0,0,0,0,0,0,0,0
GUJARAT,2003,PROHIBITION ACT,32,0,32,303,27,330,138,9,147,13,0,13,486,36,522
GUJARAT,2003,EXPLOSIVE & EXPLOSIVE SUBST. ACT,0,0,0,1,0,1,2,0,2,0,0,0,3,0,3
GUJARAT,2003,TERRORIST & DISRUPTIVE ACTIVITIES (TATA),0,0,0,2,0,2,4,0,4,18,0,18,24,0,24
GUJARAT,2003,IMMORAL TRAFFIC (PREVENTION) ACT,0,0,0,0,0,0,0,0,0,0,0,0,0,0,0
GUJARAT,2003,INDIAN RAILWAYS ACT,0,0,0,4,0,4,1,0,1,0,0,0,5,0,5
GUJARAT,2003,REGISTRATION OF FOREIGNERS ACT,0,0,0,0,0,0,0,0,0,0,0,0,0,0,0
GUJARAT,2003,PROTECTION OF CIVIL RIGHTS ACT,0,0,0,0,0,0,0,0,0,0,0,0,0,0,0
GUJARAT,2003,SC/ST (PREVENTION OF ATROCITIES) ACT,0,0,0,0,0,0,0,0,0,0,0,0,0,0,0
GUJARAT,2003,INDIAN PASSPORT ACT,0,0,0,29,0,29,45,0,45,17,0,17,91,0,91
GUJARAT,2003,ESSENTIAL COMMODITIES ACT,0,0,0,0,0,0,0,0,0,0,0,0,0,0,0
GUJARAT,2003,ANTIQUITIES AND ART TREASURE ACT,0,0,0,0,0,0,0,0,0,0,0,0,0,0,0
GUJARAT,2003,DOWRY PROHIBITION ACT,0,0,0,21,3,24,14,3,17,4,0,4,39,6,45
GUJARAT,2003,FOREIGN EXCHANGE REGULATION ACT-1973,0,0,0,0,0,0,0,0,0,0,0,0,0,0,0
GUJARAT,2003,PREVENTION OF CORRUPTION ACT-1988,0,0,0,13,0,13,11,0,11,5,0,5,29,0,29
GUJARAT,2003,CONSER.OF FORGN.EXCH.&PREV. OF SMUG.ACT,0,0,0,0,0,0,0,0,0,0,0,0,0,0,0
GUJARAT,2003,OTHER SLL OFFENCE,0,0,0,46,3,49,69,2,71,11,0,11,126,5,131
GUJARAT,2003,TOTAL,35,0,35,670,46,716,426,32,458,96,1,97,1227,79,1306
GUJARAT,2004,ARMS ACT,0,0,0,90,0,90,44,0,44,7,0,7,141,0,141
GUJARAT,2004,N.D.P.S. ACT,3,0,3,205,11,216,104,15,119,9,1,10,321,27,348
GUJARAT,2004,GAMBLING ACT,0,0,0,12,0,12,12,0,12,3,0,3,27,0,27
GUJARAT,2004,EXCISE ACT,0,0,0,1,0,1,10,0,10,2,0,2,13,0,13
GUJARAT,2004,PROHIBITION ACT,0,0,0,254,26,280,210,10,220,33,8,41,497,44,541
GUJARAT,2004,EXPLOSIVE & EXPLOSIVE SUBST. ACT,0,0,0,1,0,1,1,0,1,0,0,0,2,0,2
GUJARAT,2004,TERRORIST & DISRUPTIVE ACTIVITIES (TATA),0,0,0,4,1,5,4,1,5,0,0,0,8,2,10
GUJARAT,2004,IMMORAL TRAFFIC (PREVENTION) ACT,0,0,0,0,0,0,0,0,0,0,0,0,0,0,0
GUJARAT,2004,INDIAN RAILWAYS ACT,0,0,0,41,0,41,38,0,38,9,0,9,88,0,88
GUJARAT,2004,REGISTRATION OF FOREIGNERS ACT,0,0,0,3,0,3,2,0,2,0,0,0,5,0,5
GUJARAT,2004,PROTECTION OF CIVIL RIGHTS ACT,0,0,0,0,0,0,0,0,0,0,0,0,0,0,0
GUJARAT,2004,SC/ST (PREVENTION OF ATROCITIES) ACT,1,0,1,0,0,0,4,0,4,0,0,0,5,0,5
GUJARAT,2004,INDIAN PASSPORT ACT,0,0,0,23,1,24,14,0,14,0,0,0,37,1,38
GUJARAT,2004,ESSENTIAL COMMODITIES ACT,0,0,0,0,0,0,0,0,0,0,0,0,0,0,0
GUJARAT,2004,ANTIQUITIES AND ART TREASURE ACT,0,0,0,0,0,0,2,0,2,0,0,0,2,0,2
GUJARAT,2004,DOWRY PROHIBITION ACT,0,0,0,10,0,10,0,0,0,0,0,0,10,0,10
GUJARAT,2004,FOREIGN EXCHANGE REGULATION ACT-1973,0,0,0,9,6,15,6,0,6,0,0,0,15,6,21
GUJARAT,2004,PREVENTION OF CORRUPTION ACT-1988,0,0,0,0,0,0,0,0,0,0,0,0,0,0,0
GUJARAT,2004,CONSER.OF FORGN.EXCH.&PREV. OF SMUG.ACT,0,0,0,24,0,24,17,0,17,0,0,0,41,0,41
GUJARAT,2004,OTHER SLL OFFENCE,0,0,0,121,13,134,229,6,235,21,0,21,371,19,390
GUJARAT,2004,TOTAL,4,0,4,798,58,856,697,32,729,84,9,93,1583,99,1682
GUJARAT,2005,ARMS ACT,0,0,0,75,0,75,16,0,16,3,0,3,94,0,94
GUJARAT,2005,N.D.P.S. ACT,0,0,0,161,10,171,103,5,108,19,2,21,283,17,300
GUJARAT,2005,GAMBLING ACT,0,0,0,18,0,18,14,1,15,0,0,0,32,1,33
GUJARAT,2005,EXCISE ACT,0,0,0,0,0,0,0,0,0,2,0,2,2,0,2
GUJARAT,2005,PROHIBITION ACT,0,0,0,201,16,217,252,24,276,45,0,45,498,40,538
GUJARAT,2005,EXPLOSIVE & EXPLOSIVE SUBST. ACT,0,0,0,3,0,3,1,0,1,0,0,0,4,0,4
GUJARAT,2005,TERRORIST & DISRUPTIVE ACTIVITIES (TATA),0,0,0,5,0,5,0,0,0,0,0,0,5,0,5
GUJARAT,2005,IMMORAL TRAFFIC (PREVENTION) ACT,0,0,0,2,0,2,0,0,0,0,0,0,2,0,2
GUJARAT,2005,INDIAN RAILWAYS ACT,0,0,0,23,0,23,12,0,12,0,0,0,35,0,35
GUJARAT,2005,REGISTRATION OF FOREIGNERS ACT,0,0,0,0,0,0,0,0,0,0,0,0,0,0,0
GUJARAT,2005,PROTECTION OF CIVIL RIGHTS ACT,0,0,0,0,0,0,0,0,0,0,0,0,0,0,0
GUJARAT,2005,SC/ST (PREVENTION OF ATROCITIES) ACT,0,0,0,14,0,14,6,0,6,0,0,0,20,0,20
GUJARAT,2005,INDIAN PASSPORT ACT,0,0,0,3,0,3,5,0,5,3,0,3,11,0,11
GUJARAT,2005,ESSENTIAL COMMODITIES ACT,0,0,0,0,0,0,5,0,5,0,0,0,5,0,5
GUJARAT,2005,ANTIQUITIES AND ART TREASURE ACT,0,0,0,0,0,0,0,0,0,0,0,0,0,0,0
GUJARAT,2005,DOWRY PROHIBITION ACT,0,0,0,4,0,4,18,1,19,0,0,0,22,1,23
GUJARAT,2005,FOREIGN EXCHANGE REGULATION ACT-1973,0,0,0,0,0,0,0,0,0,0,0,0,0,0,0
GUJARAT,2005,PREVENTION OF CORRUPTION ACT-1988,0,0,0,5,0,5,14,1,15,0,0,0,19,1,20
GUJARAT,2005,CONSER.OF FORGN.EXCH.&PREV. OF SMUG.ACT,0,0,0,0,0,0,0,0,0,0,0,0,0,0,0
GUJARAT,2005,OTHER SLL OFFENCE,0,0,0,13,0,13,12,0,12,10,0,10,35,0,35
GUJARAT,2005,TOTAL,0,0,0,527,26,553,458,32,490,82,2,84,1067,60,1127
GUJARAT,2006,ARMS ACT,0,0,0,66,0,66,16,0,16,7,0,7,89,0,89
GUJARAT,2006,N.D.P.S. ACT,0,0,0,147,8,155,85,11,96,17,2,19,249,21,270
GUJARAT,2006,GAMBLING ACT,0,0,0,41,0,41,36,0,36,2,0,2,79,0,79
GUJARAT,2006,EXCISE ACT,0,0,0,2,0,2,2,0,2,2,0,2,6,0,6
GUJARAT,2006,PROHIBITION ACT,0,0,0,194,15,209,186,19,205,60,0,60,440,34,474
GUJARAT,2006,EXPLOSIVE & EXPLOSIVE SUBST. ACT,0,0,0,5,0,5,4,0,4,0,0,0,9,0,9
GUJARAT,2006,TERRORIST & DISRUPTIVE ACTIVITIES (TATA),0,0,0,0,0,0,5,0,5,1,0,1,6,0,6
GUJARAT,2006,IMMORAL TRAFFIC (PREVENTION) ACT,0,0,0,2,1,3,3,5,8,1,1,2,6,7,13
GUJARAT,2006,INDIAN RAILWAYS ACT,0,0,0,21,0,21,30,0,30,5,0,5,56,0,56
GUJARAT,2006,REGISTRATION OF FOREIGNERS ACT,0,0,0,1,0,1,0,0,0,0,0,0,1,0,1
GUJARAT,2006,PROTECTION OF CIVIL RIGHTS ACT,0,0,0,0,0,0,0,0,0,0,0,0,0,0,0
GUJARAT,2006,SC/ST (PREVENTION OF ATROCITIES) ACT,0,0,0,3,0,3,2,0,2,0,0,0,5,0,5
GUJARAT,2006,INDIAN PASSPORT ACT,0,0,0,2,1,3,3,0,3,0,0,0,5,1,6
GUJARAT,2006,ESSENTIAL COMMODITIES ACT,0,0,0,0,0,0,0,0,0,0,0,0,0,0,0
GUJARAT,2006,ANTIQUITIES AND ART TREASURE ACT,0,0,0,0,0,0,0,0,0,0,0,0,0,0,0
GUJARAT,2006,DOWRY PROHIBITION ACT,0,0,0,2,0,2,8,0,8,0,0,0,10,0,10
GUJARAT,2006,FOREIGN EXCHANGE REGULATION ACT-1973,0,0,0,0,0,0,0,0,0,0,0,0,0,0,0
GUJARAT,2006,PREVENTION OF CORRUPTION ACT-1988,0,0,0,0,0,0,4,0,4,0,0,0,4,0,4
GUJARAT,2006,CONSER.OF FORGN.EXCH.&PREV. OF SMUG.ACT,0,0,0,6,0,6,0,0,0,0,0,0,6,0,6
GUJARAT,2006,OTHER SLL OFFENCE,0,0,0,38,0,38,51,1,52,4,0,4,93,1,94
GUJARAT,2006,TOTAL,0,0,0,530,25,555,435,36,471,99,3,102,1064,64,1128
GUJARAT,2007,ARMS ACT,0,0,0,39,0,39,32,0,32,1,0,1,72,0,72
GUJARAT,2007,N.D.P.S. ACT,0,0,0,74,17,91,57,8,65,21,0,21,152,25,177
GUJARAT,2007,GAMBLING ACT,0,0,0,22,0,22,30,0,30,1,0,1,53,0,53
GUJARAT,2007,EXCISE ACT,0,0,0,28,0,28,7,0,7,0,0,0,35,0,35
GUJARAT,2007,PROHIBITION ACT,0,0,0,157,8,165,230,4,234,8,0,8,395,12,407
GUJARAT,2007,EXPLOSIVE & EXPLOSIVE SUBST. ACT,0,0,0,3,0,3,1,0,1,0,0,0,4,0,4
GUJARAT,2007,TERRORIST & DISRUPTIVE ACTIVITIES (TATA),0,0,0,0,0,0,2,0,2,1,0,1,3,0,3
GUJARAT,2007,IMMORAL TRAFFIC (PREVENTION) ACT,0,0,0,8,5,13,6,2,8,1,0,1,15,7,22
GUJARAT,2007,INDIAN RAILWAYS ACT,0,0,0,8,0,8,7,0,7,0,0,0,15,0,15
GUJARAT,2007,REGISTRATION OF FOREIGNERS ACT,0,0,0,1,0,1,2,1,3,0,0,0,3,1,4
GUJARAT,2007,PROTECTION OF CIVIL RIGHTS ACT,0,0,0,0,0,0,0,0,0,0,0,0,0,0,0
GUJARAT,2007,SC/ST (PREVENTION OF ATROCITIES) ACT,0,0,0,9,0,9,6,0,6,4,0,4,19,0,19
GUJARAT,2007,INDIAN PASSPORT ACT,0,0,0,12,1,13,6,0,6,1,0,1,19,1,20
GUJARAT,2007,ESSENTIAL COMMODITIES ACT,0,0,0,0,0,0,0,0,0,0,0,0,0,0,0
GUJARAT,2007,ANTIQUITIES AND ART TREASURE ACT,0,0,0,0,0,0,0,0,0,0,0,0,0,0,0
GUJARAT,2007,DOWRY PROHIBITION ACT,0,0,0,9,0,9,0,0,0,0,0,0,9,0,9
GUJARAT,2007,FOREIGN EXCHANGE REGULATION ACT-1973,0,0,0,0,0,0,0,0,0,0,0,0,0,0,0
GUJARAT,2007,PREVENTION OF CORRUPTION ACT-1988,0,0,0,0,0,0,7,0,7,0,0,0,7,0,7
GUJARAT,2007,CONSER.OF FORGN.EXCH.&PREV. OF SMUG.ACT,0,0,0,0,0,0,0,0,0,0,0,0,0,0,0
GUJARAT,2007,OTHER SLL OFFENCE,0,0,0,42,5,47,40,5,45,20,0,20,102,10,112
GUJARAT,2007,TOTAL,0,0,0,412,36,448,433,20,453,58,0,58,903,56,959
GUJARAT,2008,ARMS ACT,0,0,0,56,0,56,44,0,44,4,0,4,104,0,104
GUJARAT,2008,N.D.P.S. ACT,0,0,0,63,5,68,85,10,95,21,2,23,169,17,186
GUJARAT,2008,GAMBLING ACT,0,0,0,21,0,21,29,0,29,1,0,1,51,0,51
GUJARAT,2008,EXCISE ACT,0,0,0,12,0,12,23,0,23,0,0,0,35,0,35
GUJARAT,2008,PROHIBITION ACT,0,0,0,169,0,169,187,7,194,25,0,25,381,7,388
GUJARAT,2008,EXPLOSIVE & EXPLOSIVE SUBST. ACT,0,0,0,45,0,45,5,0,5,0,0,0,50,0,50
GUJARAT,2008,TERRORIST & DISRUPTIVE ACTIVITIES (TATA),0,0,0,38,0,38,47,2,49,24,0,24,109,2,111
GUJARAT,2008,IMMORAL TRAFFIC (PREVENTION) ACT,0,0,0,1,0,1,8,3,11,0,0,0,9,3,12
GUJARAT,2008,INDIAN RAILWAYS ACT,0,0,0,36,1,37,23,2,25,1,0,1,60,3,63
GUJARAT,2008,REGISTRATION OF FOREIGNERS ACT,0,0,0,1,0,1,2,0,2,0,0,0,3,0,3
GUJARAT,2008,PROTECTION OF CIVIL RIGHTS ACT,0,0,0,0,0,0,3,0,3,0,0,0,3,0,3
GUJARAT,2008,SC/ST (PREVENTION OF ATROCITIES) ACT,0,0,0,0,0,0,4,0,4,1,0,1,5,0,5
GUJARAT,2008,INDIAN PASSPORT ACT,0,0,0,22,3,25,13,2,15,0,0,0,35,5,40
GUJARAT,2008,ESSENTIAL COMMODITIES ACT,0,0,0,0,0,0,0,0,0,0,0,0,0,0,0
GUJARAT,2008,ANTIQUITIES AND ART TREASURE ACT,0,0,0,0,0,0,0,0,0,0,0,0,0,0,0
GUJARAT,2008,DOWRY PROHIBITION ACT,0,0,0,18,0,18,16,0,16,7,0,7,41,0,41
GUJARAT,2008,FOREIGN EXCHANGE REGULATION ACT-1973,0,0,0,0,0,0,0,0,0,0,0,0,0,0,0
GUJARAT,2008,PREVENTION OF CORRUPTION ACT-1988,0,0,0,4,0,4,2,0,2,0,0,0,6,0,6
GUJARAT,2008,CONSER.OF FORGN.EXCH.&PREV. OF SMUG.ACT,0,0,0,0,0,0,0,0,0,0,0,0,0,0,0
GUJARAT,2008,OTHER SLL OFFENCE,0,0,0,63,6,69,52,7,59,15,2,17,130,15,145
GUJARAT,2008,TOTAL,0,0,0,549,15,564,543,33,576,99,4,103,1191,52,1243
GUJARAT,2009,ARMS ACT,0,0,0,42,0,42,25,0,25,3,0,3,70,0,70
GUJARAT,2009,N.D.P.S. ACT,0,0,0,78,3,81,105,10,115,24,1,25,207,14,221
GUJARAT,2009,GAMBLING ACT,0,0,0,3,0,3,2,0,2,0,0,0,5,0,5
GUJARAT,2009,EXCISE ACT,0,0,0,0,0,0,4,0,4,0,0,0,4,0,4
GUJARAT,2009,PROHIBITION ACT,0,0,0,193,7,200,184,8,192,18,0,18,395,15,410
GUJARAT,2009,EXPLOSIVE & EXPLOSIVE SUBST. ACT,0,0,0,57,0,57,24,0,24,0,0,0,81,0,81
GUJARAT,2009,TERRORIST & DISRUPTIVE ACTIVITIES (TATA),0,0,0,2,0,2,22,0,22,10,0,10,34,0,34
GUJARAT,2009,IMMORAL TRAFFIC (PREVENTION) ACT,0,0,0,3,0,3,13,2,15,0,0,0,16,2,18
GUJARAT,2009,INDIAN RAILWAYS ACT,0,0,0,7,5,12,15,0,15,3,0,3,25,5,30
GUJARAT,2009,REGISTRATION OF FOREIGNERS ACT,0,0,0,0,0,0,0,0,0,0,0,0,0,0,0
GUJARAT,2009,PROTECTION OF CIVIL RIGHTS ACT,0,0,0,0,0,0,0,0,0,0,0,0,0,0,0
GUJARAT,2009,SC/ST (PREVENTION OF ATROCITIES) ACT,0,0,0,2,0,2,4,0,4,1,0,1,7,0,7
GUJARAT,2009,INDIAN PASSPORT ACT,0,0,0,16,2,18,9,1,10,2,2,4,27,5,32
GUJARAT,2009,ESSENTIAL COMMODITIES ACT,0,0,0,0,0,0,0,0,0,0,0,0,0,0,0
GUJARAT,2009,ANTIQUITIES AND ART TREASURE ACT,0,0,0,10,0,10,8,0,8,0,0,0,18,0,18
GUJARAT,2009,DOWRY PROHIBITION ACT,0,0,0,11,0,11,13,0,13,4,0,4,28,0,28
GUJARAT,2009,FOREIGN EXCHANGE REGULATION ACT-1973,0,0,0,0,0,0,0,0,0,0,0,0,0,0,0
GUJARAT,2009,PREVENTION OF CORRUPTION ACT-1988,0,0,0,10,0,10,6,0,6,0,0,0,16,0,16
GUJARAT,2009,CONSER.OF FORGN.EXCH.&PREV. OF SMUG.ACT,0,0,0,30,0,30,11,0,11,0,0,0,41,0,41
GUJARAT,2009,OTHER SLL OFFENCE,0,0,0,0,0,0,182,0,182,0,0,0,182,0,182
GUJARAT,2009,TOTAL,0,0,0,464,17,481,627,21,648,65,3,68,1156,41,1197
GUJARAT,2010,ARMS ACT,0,0,0,48,1,49,24,0,24,4,0,4,76,1,77
GUJARAT,2010,N.D.P.S. ACT,0,0,0,110,4,114,105,9,114,36,2,38,251,15,266
GUJARAT,2010,GAMBLING ACT,0,0,0,6,0,6,7,0,7,1,0,1,14,0,14
GUJARAT,2010,EXCISE ACT,0,0,0,1,0,1,2,0,2,1,0,1,4,0,4
GUJARAT,2010,PROHIBITION ACT,0,0,0,161,2,163,119,6,125,62,1,63,342,9,351
GUJARAT,2010,EXPLOSIVE & EXPLOSIVE SUBST. ACT,0,0,0,58,0,58,27,0,27,0,0,0,85,0,85
GUJARAT,2010,TERRORIST & DISRUPTIVE ACTIVITIES (TATA),0,0,0,1,0,1,31,0,31,10,0,10,42,0,42
GUJARAT,2010,IMMORAL TRAFFIC (PREVENTION) ACT,0,0,0,4,0,4,8,1,9,0,0,0,12,1,13
GUJARAT,2010,INDIAN RAILWAYS ACT,0,0,0,5,0,5,11,0,11,1,0,1,17,0,17
GUJARAT,2010,REGISTRATION OF FOREIGNERS ACT,0,0,0,4,0,4,1,0,1,1,0,1,6,0,6
GUJARAT,2010,PROTECTION OF CIVIL RIGHTS ACT,0,0,0,0,0,0,0,0,0,0,0,0,0,0,0
GUJARAT,2010,SC/ST (PREVENTION OF ATROCITIES) ACT,0,0,0,2,0,2,9,0,9,1,0,1,12,0,12
GUJARAT,2010,INDIAN PASSPORT ACT,0,0,0,21,3,24,10,0,10,0,0,0,31,3,34
GUJARAT,2010,ESSENTIAL COMMODITIES ACT,0,0,0,0,0,0,0,0,0,0,0,0,0,0,0
GUJARAT,2010,ANTIQUITIES AND ART TREASURE ACT,0,0,0,0,0,0,0,0,0,0,0,0,0,0,0
GUJARAT,2010,DOWRY PROHIBITION ACT,0,0,0,12,0,12,17,0,17,4,0,4,33,0,33
GUJARAT,2010,FOREIGN EXCHANGE REGULATION ACT-1973,0,0,0,0,0,0,0,0,0,0,0,0,0,0,0
GUJARAT,2010,PREVENTION OF CORRUPTION ACT-1988,0,0,0,8,0,8,4,0,4,0,0,0,12,0,12
GUJARAT,2010,CONSER.OF FORGN.EXCH.&PREV. OF SMUG.ACT,0,0,0,0,0,0,0,0,0,0,0,0,0,0,0
GUJARAT,2010,OTHER SLL OFFENCE,0,0,0,162,1,163,125,1,126,27,0,27,314,2,316
GUJARAT,2010,TOTAL,0,0,0,603,11,614,500,17,517,148,3,151,1251,31,1282
GUJARAT,2011,ARMS ACT,0,0,0,40,0,40,32,0,32,12,0,12,84,0,84
GUJARAT,2011,N.D.P.S. ACT,0,0,0,106,7,113,140,4,144,14,1,15,260,12,272
GUJARAT,2011,GAMBLING ACT,0,0,0,5,0,5,0,0,0,2,0,2,7,0,7
GUJARAT,2011,EXCISE ACT,0,0,0,0,0,0,0,0,0,0,0,0,0,0,0
GUJARAT,2011,PROHIBITION ACT,0,0,0,123,6,129,112,4,116,19,0,19,254,10,264
GUJARAT,2011,EXPLOSIVE & EXPLOSIVE SUBST. ACT,0,0,0,2,0,2,11,1,12,1,0,1,14,1,15
GUJARAT,2011,TERRORIST & DISRUPTIVE ACTIVITIES (TATA),0,0,0,0,0,0,0,0,0,1,0,1,1,0,1
GUJARAT,2011,IMMORAL TRAFFIC (PREVENTION) ACT,0,0,0,1,3,4,3,0,3,0,0,0,4,3,7
GUJARAT,2011,INDIAN RAILWAYS ACT,0,0,0,19,0,19,11,0,11,1,0,1,31,0,31
GUJARAT,2011,REGISTRATION OF FOREIGNERS ACT,0,0,0,0,0,0,0,0,0,0,0,0,0,0,0
GUJARAT,2011,PROTECTION OF CIVIL RIGHTS ACT,0,0,0,0,0,0,0,0,0,0,0,0,0,0,0
GUJARAT,2011,SC/ST (PREVENTION OF ATROCITIES) ACT,0,0,0,19,0,19,13,0,13,1,0,1,33,0,33
GUJARAT,2011,INDIAN PASSPORT ACT,0,0,0,35,1,36,13,2,15,0,0,0,48,3,51
GUJARAT,2011,ESSENTIAL COMMODITIES ACT,0,0,0,0,0,0,0,0,0,0,0,0,0,0,0
GUJARAT,2011,ANTIQUITIES AND ART TREASURE ACT,0,0,0,0,0,0,0,0,0,0,0,0,0,0,0
GUJARAT,2011,DOWRY PROHIBITION ACT,0,0,0,11,0,11,30,1,31,6,2,8,47,3,50
GUJARAT,2011,FOREIGN EXCHANGE REGULATION ACT-1973,0,0,0,0,0,0,0,0,0,0,0,0,0,0,0
GUJARAT,2011,PREVENTION OF CORRUPTION ACT-1988,0,0,0,20,0,20,39,0,39,4,0,4,63,0,63
GUJARAT,2011,CONSER.OF FORGN.EXCH.&PREV. OF SMUG.ACT,0,0,0,2,1,3,2,0,2,0,0,0,4,1,5
GUJARAT,2011,OTHER SLL OFFENCE,0,0,0,65,2,67,36,0,36,12,0,12,113,2,115
GUJARAT,2011,TOTAL,0,0,0,448,20,468,442,12,454,73,3,76,963,35,998
GUJARAT,2012,ARMS ACT,0,0,0,35,0,35,34,0,34,9,0,9,78,0,78
GUJARAT,2012,N.D.P.S. ACT,0,0,0,77,3,80,67,3,70,18,0,18,162,6,168
GUJARAT,2012,GAMBLING ACT,0,0,0,0,0,0,2,0,2,0,0,0,2,0,2
GUJARAT,2012,EXCISE ACT,0,0,0,0,0,0,0,0,0,0,0,0,0,0,0
GUJARAT,2012,PROHIBITION ACT,0,0,0,76,2,78,101,6,107,17,0,17,194,8,202
GUJARAT,2012,EXPLOSIVE & EXPLOSIVE SUBST. ACT,0,0,0,24,0,24,34,0,34,0,0,0,58,0,58
GUJARAT,2012,TERRORIST & DISRUPTIVE ACTIVITIES (TATA),0,0,0,0,0,0,0,0,0,1,0,1,1,0,1
GUJARAT,2012,IMMORAL TRAFFIC (PREVENTION) ACT,0,0,0,2,1,3,4,1,5,0,0,0,6,2,8
GUJARAT,2012,INDIAN RAILWAYS ACT,0,0,0,0,0,0,4,0,4,4,0,4,8,0,8
GUJARAT,2012,REGISTRATION OF FOREIGNERS ACT,0,0,0,0,0,0,3,0,3,0,0,0,3,0,3
GUJARAT,2012,PROTECTION OF CIVIL RIGHTS ACT,0,0,0,0,0,0,2,0,2,0,0,0,2,0,2
GUJARAT,2012,SC/ST (PREVENTION OF ATROCITIES) ACT,0,0,0,3,0,3,7,0,7,0,0,0,10,0,10
GUJARAT,2012,INDIAN PASSPORT ACT,0,0,0,19,3,22,22,1,23,7,0,7,48,4,52
GUJARAT,2012,ESSENTIAL COMMODITIES ACT,0,0,0,0,0,0,0,0,0,0,0,0,0,0,0
GUJARAT,2012,ANTIQUITIES AND ART TREASURE ACT,0,0,0,0,0,0,0,0,0,0,0,0,0,0,0
GUJARAT,2012,DOWRY PROHIBITION ACT,0,0,0,5,0,5,16,1,17,3,2,5,24,3,27
GUJARAT,2012,FOREIGN EXCHANGE REGULATION ACT-1973,0,0,0,0,0,0,2,1,3,0,0,0,2,1,3
GUJARAT,2012,PREVENTION OF CORRUPTION ACT-1988,0,0,0,12,0,12,14,0,14,3,0,3,29,0,29
GUJARAT,2012,CONSER.OF FORGN.EXCH.&PREV. OF SMUG.ACT,0,0,0,17,2,19,2,0,2,0,0,0,19,2,21
GUJARAT,2012,OTHER SLL OFFENCE,0,0,0,17,0,17,48,2,50,4,2,6,69,4,73
GUJARAT,2012,TOTAL,0,0,0,287,11,298,362,15,377,66,4,70,715,30,745
HARYANA,2001,ARMS ACT,15,0,15,156,0,156,107,0,107,16,0,16,294,0,294
HARYANA,2001,N.D.P.S. ACT,0,0,0,242,7,249,356,12,368,58,1,59,656,20,676
HARYANA,2001,GAMBLING ACT,0,0,0,10,0,10,23,0,23,6,0,6,39,0,39
HARYANA,2001,EXCISE ACT,17,0,17,142,0,142,179,2,181,49,0,49,387,2,389
HARYANA,2001,PROHIBITION ACT,0,0,0,4,0,4,4,0,4,9,0,9,17,0,17
HARYANA,2001,EXPLOSIVE & EXPLOSIVE SUBST. ACT,0,0,0,0,0,0,7,0,7,0,0,0,7,0,7
HARYANA,2001,TERRORIST & DISRUPTIVE ACTIVITIES (TATA),0,0,0,4,0,4,0,0,0,0,0,0,4,0,4
HARYANA,2001,IMMORAL TRAFFIC (PREVENTION) ACT,0,0,0,3,2,5,2,0,2,0,0,0,5,2,7
HARYANA,2001,INDIAN RAILWAYS ACT,2,0,2,36,0,36,16,0,16,5,0,5,59,0,59
HARYANA,2001,REGISTRATION OF FOREIGNERS ACT,0,0,0,0,0,0,0,0,0,0,0,0,0,0,0
HARYANA,2001,PROTECTION OF CIVIL RIGHTS ACT,0,0,0,0,0,0,0,0,0,0,0,0,0,0,0
HARYANA,2001,SC/ST (PREVENTION OF ATROCITIES) ACT,0,0,0,7,1,8,8,0,8,0,0,0,15,1,16
HARYANA,2001,INDIAN PASSPORT ACT,0,0,0,4,0,4,4,0,4,0,0,0,8,0,8
HARYANA,2001,ESSENTIAL COMMODITIES ACT,0,0,0,5,0,5,10,0,10,0,0,0,15,0,15
HARYANA,2001,ANTIQUITIES AND ART TREASURE ACT,0,0,0,0,0,0,0,0,0,0,0,0,0,0,0
HARYANA,2001,DOWRY PROHIBITION ACT,0,0,0,12,3,15,65,7,72,6,1,7,83,11,94
HARYANA,2001,FOREIGN EXCHANGE REGULATION ACT-1973,0,0,0,3,0,3,0,0,0,0,0,0,3,0,3
HARYANA,2001,PREVENTION OF CORRUPTION ACT-1988,0,0,0,5,0,5,19,1,20,6,0,6,30,1,31
HARYANA,2001,CONSER.OF FORGN.EXCH.&PREV. OF SMUG.ACT,0,0,0,0,0,0,0,0,0,0,0,0,0,0,0
HARYANA,2001,OTHER SLL OFFENCE,3,0,3,22,0,22,22,1,23,13,0,13,60,1,61
HARYANA,2001,TOTAL,37,0,37,655,13,668,822,23,845,168,2,170,1682,38,1720
HARYANA,2002,ARMS ACT,27,0,27,139,0,139,82,0,82,15,0,15,263,0,263
HARYANA,2002,N.D.P.S. ACT,0,0,0,264,5,269,224,5,229,76,2,78,564,12,576
HARYANA,2002,GAMBLING ACT,2,0,2,24,0,24,30,0,30,9,0,9,65,0,65
HARYANA,2002,EXCISE ACT,7,0,7,135,0,135,104,2,106,26,0,26,272,2,274
HARYANA,2002,PROHIBITION ACT,0,0,0,2,0,2,0,0,0,0,0,0,2,0,2
HARYANA,2002,EXPLOSIVE & EXPLOSIVE SUBST. ACT,0,0,0,0,0,0,0,0,0,0,0,0,0,0,0
HARYANA,2002,TERRORIST & DISRUPTIVE ACTIVITIES (TATA),0,0,0,0,0,0,0,0,0,0,0,0,0,0,0
HARYANA,2002,IMMORAL TRAFFIC (PREVENTION) ACT,0,0,0,17,3,20,12,1,13,3,0,3,32,4,36
HARYANA,2002,INDIAN RAILWAYS ACT,1,0,1,19,0,19,6,0,6,4,0,4,30,0,30
HARYANA,2002,REGISTRATION OF FOREIGNERS ACT,0,0,0,9,0,9,3,0,3,0,0,0,12,0,12
HARYANA,2002,PROTECTION OF CIVIL RIGHTS ACT,0,0,0,0,0,0,0,0,0,0,0,0,0,0,0
HARYANA,2002,SC/ST (PREVENTION OF ATROCITIES) ACT,0,0,0,2,0,2,6,0,6,0,0,0,8,0,8
HARYANA,2002,INDIAN PASSPORT ACT,11,0,11,12,0,12,12,0,12,1,0,1,36,0,36
HARYANA,2002,ESSENTIAL COMMODITIES ACT,0,0,0,3,0,3,6,0,6,3,0,3,12,0,12
HARYANA,2002,ANTIQUITIES AND ART TREASURE ACT,0,0,0,0,0,0,0,0,0,0,0,0,0,0,0
HARYANA,2002,DOWRY PROHIBITION ACT,0,0,0,35,7,42,23,16,39,24,10,34,82,33,115
HARYANA,2002,FOREIGN EXCHANGE REGULATION ACT-1973,0,0,0,0,0,0,0,0,0,1,0,1,1,0,1
HARYANA,2002,PREVENTION OF CORRUPTION ACT-1988,0,0,0,7,0,7,23,2,25,2,0,2,32,2,34
HARYANA,2002,CONSER.OF FORGN.EXCH.&PREV. OF SMUG.ACT,0,0,0,0,0,0,0,0,0,0,0,0,0,0,0
HARYANA,2002,OTHER SLL OFFENCE,0,0,0,20,0,20,24,1,25,7,0,7,51,1,52
HARYANA,2002,TOTAL,48,0,48,688,15,703,555,27,582,171,12,183,1462,54,1516
HARYANA,2003,ARMS ACT,10,0,10,153,0,153,79,0,79,9,0,9,251,0,251
HARYANA,2003,N.D.P.S. ACT,0,0,0,283,6,289,321,7,328,63,0,63,667,13,680
HARYANA,2003,GAMBLING ACT,0,0,0,18,0,18,17,0,17,5,0,5,40,0,40
HARYANA,2003,EXCISE ACT,12,0,12,128,0,128,196,0,196,41,0,41,377,0,377
HARYANA,2003,PROHIBITION ACT,0,0,0,0,0,0,0,0,0,0,0,0,0,0,0
HARYANA,2003,EXPLOSIVE & EXPLOSIVE SUBST. ACT,0,0,0,26,0,26,2,0,2,0,0,0,28,0,28
HARYANA,2003,TERRORIST & DISRUPTIVE ACTIVITIES (TATA),0,0,0,1,0,1,13,0,13,0,0,0,14,0,14
HARYANA,2003,IMMORAL TRAFFIC (PREVENTION) ACT,0,0,0,24,3,27,19,2,21,5,0,5,48,5,53
HARYANA,2003,INDIAN RAILWAYS ACT,12,0,12,26,0,26,9,0,9,4,0,4,51,0,51
HARYANA,2003,REGISTRATION OF FOREIGNERS ACT,0,0,0,6,0,6,0,0,0,4,0,4,10,0,10
HARYANA,2003,PROTECTION OF CIVIL RIGHTS ACT,0,0,0,0,0,0,0,0,0,0,0,0,0,0,0
HARYANA,2003,SC/ST (PREVENTION OF ATROCITIES) ACT,0,0,0,8,0,8,14,0,14,0,0,0,22,0,22
HARYANA,2003,INDIAN PASSPORT ACT,0,0,0,6,0,6,5,0,5,3,0,3,14,0,14
HARYANA,2003,ESSENTIAL COMMODITIES ACT,0,0,0,13,0,13,8,0,8,0,0,0,21,0,21
HARYANA,2003,ANTIQUITIES AND ART TREASURE ACT,0,0,0,0,0,0,0,0,0,0,0,0,0,0,0
HARYANA,2003,DOWRY PROHIBITION ACT,0,0,0,28,3,31,23,5,28,40,0,40,91,8,99
HARYANA,2003,FOREIGN EXCHANGE REGULATION ACT-1973,0,0,0,3,0,3,0,0,0,0,0,0,3,0,3
HARYANA,2003,PREVENTION OF CORRUPTION ACT-1988,0,0,0,5,0,5,25,0,25,0,0,0,30,0,30
HARYANA,2003,CONSER.OF FORGN.EXCH.&PREV. OF SMUG.ACT,0,0,0,10,0,10,0,0,0,0,0,0,10,0,10
HARYANA,2003,OTHER SLL OFFENCE,0,0,0,4,0,4,7,0,7,1,0,1,12,0,12
HARYANA,2003,TOTAL,34,0,34,742,12,754,738,14,752,175,0,175,1689,26,1715
HARYANA,2004,ARMS ACT,0,0,0,151,0,151,76,0,76,4,0,4,231,0,231
HARYANA,2004,N.D.P.S. ACT,0,0,0,238,13,251,312,16,328,100,0,100,650,29,679
HARYANA,2004,GAMBLING ACT,0,0,0,31,3,34,15,3,18,1,0,1,47,6,53
HARYANA,2004,EXCISE ACT,0,0,0,165,0,165,122,0,122,54,0,54,341,0,341
HARYANA,2004,PROHIBITION ACT,0,0,0,0,0,0,0,0,0,0,0,0,0,0,0
HARYANA,2004,EXPLOSIVE & EXPLOSIVE SUBST. ACT,0,0,0,0,0,0,3,0,3,0,0,0,3,0,3
HARYANA,2004,TERRORIST & DISRUPTIVE ACTIVITIES (TATA),0,0,0,5,0,5,0,0,0,0,0,0,5,0,5
HARYANA,2004,IMMORAL TRAFFIC (PREVENTION) ACT,0,0,0,9,7,16,4,3,7,0,0,0,13,10,23
HARYANA,2004,INDIAN RAILWAYS ACT,0,0,0,51,3,54,9,0,9,4,0,4,64,3,67
HARYANA,2004,REGISTRATION OF FOREIGNERS ACT,0,0,0,13,0,13,2,0,2,0,0,0,15,0,15
HARYANA,2004,PROTECTION OF CIVIL RIGHTS ACT,0,0,0,8,0,8,2,0,2,0,0,0,10,0,10
HARYANA,2004,SC/ST (PREVENTION OF ATROCITIES) ACT,0,0,0,13,0,13,8,0,8,0,0,0,21,0,21
HARYANA,2004,INDIAN PASSPORT ACT,0,0,0,0,0,0,0,0,0,1,0,1,1,0,1
HARYANA,2004,ESSENTIAL COMMODITIES ACT,0,0,0,0,0,0,2,0,2,0,0,0,2,0,2
HARYANA,2004,ANTIQUITIES AND ART TREASURE ACT,0,0,0,1,0,1,1,0,1,0,0,0,2,0,2
HARYANA,2004,DOWRY PROHIBITION ACT,0,0,0,40,10,50,10,1,11,0,0,0,50,11,61
HARYANA,2004,FOREIGN EXCHANGE REGULATION ACT-1973,0,0,0,3,2,5,0,0,0,0,0,0,3,2,5
HARYANA,2004,PREVENTION OF CORRUPTION ACT-1988,0,0,0,4,0,4,5,0,5,1,0,1,10,0,10
HARYANA,2004,CONSER.OF FORGN.EXCH.&PREV. OF SMUG.ACT,0,0,0,0,0,0,0,0,0,0,0,0,0,0,0
HARYANA,2004,OTHER SLL OFFENCE,2,0,2,81,3,84,69,8,77,11,0,11,163,11,174
HARYANA,2004,TOTAL,2,0,2,813,41,854,640,31,671,176,0,176,1631,72,1703
HARYANA,2005,ARMS ACT,0,0,0,81,0,81,29,0,29,15,0,15,125,0,125
HARYANA,2005,N.D.P.S. ACT,4,0,4,241,7,248,332,13,345,91,1,92,668,21,689
HARYANA,2005,GAMBLING ACT,4,0,4,58,0,58,47,0,47,12,0,12,121,0,121
HARYANA,2005,EXCISE ACT,0,0,0,202,4,206,112,1,113,58,0,58,372,5,377
HARYANA,2005,PROHIBITION ACT,0,0,0,9,0,9,4,0,4,0,0,0,13,0,13
HARYANA,2005,EXPLOSIVE & EXPLOSIVE SUBST. ACT,0,0,0,1,0,1,1,0,1,0,0,0,2,0,2
HARYANA,2005,TERRORIST & DISRUPTIVE ACTIVITIES (TATA),0,0,0,2,3,5,3,1,4,0,0,0,5,4,9
HARYANA,2005,IMMORAL TRAFFIC (PREVENTION) ACT,0,0,0,9,8,17,0,0,0,0,0,0,9,8,17
HARYANA,2005,INDIAN RAILWAYS ACT,0,0,0,46,4,50,4,0,4,0,0,0,50,4,54
HARYANA,2005,REGISTRATION OF FOREIGNERS ACT,0,0,0,0,0,0,0,0,0,0,0,0,0,0,0
HARYANA,2005,PROTECTION OF CIVIL RIGHTS ACT,0,0,0,0,0,0,0,0,0,0,0,0,0,0,0
HARYANA,2005,SC/ST (PREVENTION OF ATROCITIES) ACT,0,0,0,4,0,4,2,0,2,0,0,0,6,0,6
HARYANA,2005,INDIAN PASSPORT ACT,0,0,0,0,0,0,0,0,0,0,0,0,0,0,0
HARYANA,2005,ESSENTIAL COMMODITIES ACT,0,0,0,0,0,0,1,0,1,0,0,0,1,0,1
HARYANA,2005,ANTIQUITIES AND ART TREASURE ACT,0,0,0,0,0,0,0,0,0,0,0,0,0,0,0
HARYANA,2005,DOWRY PROHIBITION ACT,0,0,0,0,0,0,1,0,1,0,0,0,1,0,1
HARYANA,2005,FOREIGN EXCHANGE REGULATION ACT-1973,0,0,0,0,0,0,0,0,0,0,0,0,0,0,0
HARYANA,2005,PREVENTION OF CORRUPTION ACT-1988,0,0,0,0,0,0,6,0,6,2,0,2,8,0,8
HARYANA,2005,CONSER.OF FORGN.EXCH.&PREV. OF SMUG.ACT,0,0,0,0,0,0,0,0,0,0,0,0,0,0,0
HARYANA,2005,OTHER SLL OFFENCE,0,0,0,10,0,10,3,0,3,3,0,3,16,0,16
HARYANA,2005,TOTAL,8,0,8,663,26,689,545,15,560,181,1,182,1397,42,1439
HARYANA,2006,ARMS ACT,0,0,0,25,0,25,127,0,127,64,0,64,216,0,216
HARYANA,2006,N.D.P.S. ACT,0,1,1,141,0,141,275,4,279,90,1,91,506,6,512
HARYANA,2006,GAMBLING ACT,0,0,0,25,0,25,39,0,39,46,0,46,110,0,110
HARYANA,2006,EXCISE ACT,0,0,0,80,0,80,228,0,228,65,0,65,373,0,373
HARYANA,2006,PROHIBITION ACT,0,0,0,0,0,0,0,0,0,0,0,0,0,0,0
HARYANA,2006,EXPLOSIVE & EXPLOSIVE SUBST. ACT,0,0,0,4,0,4,0,0,0,0,0,0,4,0,4
HARYANA,2006,TERRORIST & DISRUPTIVE ACTIVITIES (TATA),0,0,0,0,0,0,0,0,0,1,0,1,1,0,1
HARYANA,2006,IMMORAL TRAFFIC (PREVENTION) ACT,0,1,1,14,0,14,9,14,23,0,0,0,23,15,38
HARYANA,2006,INDIAN RAILWAYS ACT,0,0,0,0,0,0,60,0,60,8,0,8,68,0,68
HARYANA,2006,REGISTRATION OF FOREIGNERS ACT,0,0,0,33,0,33,4,0,4,0,0,0,37,0,37
HARYANA,2006,PROTECTION OF CIVIL RIGHTS ACT,0,0,0,0,0,0,0,0,0,0,0,0,0,0,0
HARYANA,2006,SC/ST (PREVENTION OF ATROCITIES) ACT,0,0,0,5,0,5,4,0,4,0,0,0,9,0,9
HARYANA,2006,INDIAN PASSPORT ACT,0,0,0,7,0,7,0,0,0,1,0,1,8,0,8
HARYANA,2006,ESSENTIAL COMMODITIES ACT,0,0,0,5,0,5,13,0,13,0,0,0,18,0,18
HARYANA,2006,ANTIQUITIES AND ART TREASURE ACT,0,0,0,0,0,0,0,0,0,0,0,0,0,0,0
HARYANA,2006,DOWRY PROHIBITION ACT,0,0,0,22,0,22,30,19,49,4,0,4,56,19,75
HARYANA,2006,FOREIGN EXCHANGE REGULATION ACT-1973,0,0,0,8,0,8,1,0,1,0,0,0,9,0,9
HARYANA,2006,PREVENTION OF CORRUPTION ACT-1988,0,0,0,11,0,11,17,0,17,0,0,0,28,0,28
HARYANA,2006,CONSER.OF FORGN.EXCH.&PREV. OF SMUG.ACT,0,0,0,0,0,0,0,0,0,0,0,0,0,0,0
HARYANA,2006,OTHER SLL OFFENCE,0,1,1,8,1,9,14,1,15,3,0,3,25,3,28
HARYANA,2006,TOTAL,0,3,3,388,1,389,821,38,859,282,1,283,1491,43,1534
HARYANA,2007,ARMS ACT,0,0,0,125,0,125,77,0,77,14,0,14,216,0,216
HARYANA,2007,N.D.P.S. ACT,0,0,0,241,1,242,175,4,179,83,1,84,499,6,505
HARYANA,2007,GAMBLING ACT,0,0,0,25,0,25,39,0,39,6,0,6,70,0,70
HARYANA,2007,EXCISE ACT,0,0,0,180,0,180,128,0,128,65,0,65,373,0,373
HARYANA,2007,PROHIBITION ACT,0,0,0,0,0,0,0,0,0,0,0,0,0,0,0
HARYANA,2007,EXPLOSIVE & EXPLOSIVE SUBST. ACT,0,0,0,4,0,4,0,0,0,0,0,0,4,0,4
HARYANA,2007,TERRORIST & DISRUPTIVE ACTIVITIES (TATA),0,0,0,0,0,0,0,0,0,1,0,1,1,0,1
HARYANA,2007,IMMORAL TRAFFIC (PREVENTION) ACT,0,1,1,14,11,25,9,4,13,0,0,0,23,16,39
HARYANA,2007,INDIAN RAILWAYS ACT,0,0,0,64,0,64,43,0,43,8,0,8,115,0,115
HARYANA,2007,REGISTRATION OF FOREIGNERS ACT,0,0,0,33,6,39,4,0,4,0,0,0,37,6,43
HARYANA,2007,PROTECTION OF CIVIL RIGHTS ACT,0,0,0,0,0,0,0,0,0,0,0,0,0,0,0
HARYANA,2007,SC/ST (PREVENTION OF ATROCITIES) ACT,0,0,0,5,0,5,4,0,4,0,0,0,9,0,9
HARYANA,2007,INDIAN PASSPORT ACT,0,0,0,7,0,7,0,0,0,1,0,1,8,0,8
HARYANA,2007,ESSENTIAL COMMODITIES ACT,0,0,0,5,0,5,13,0,13,0,0,0,18,0,18
HARYANA,2007,ANTIQUITIES AND ART TREASURE ACT,0,0,0,0,0,0,0,0,0,0,0,0,0,0,0
HARYANA,2007,DOWRY PROHIBITION ACT,0,0,0,22,1,23,30,9,39,4,1,5,56,11,67
HARYANA,2007,FOREIGN EXCHANGE REGULATION ACT-1973,0,0,0,8,0,8,1,0,1,0,0,0,9,0,9
HARYANA,2007,PREVENTION OF CORRUPTION ACT-1988,0,0,0,11,0,11,17,0,17,0,0,0,28,0,28
HARYANA,2007,CONSER.OF FORGN.EXCH.&PREV. OF SMUG.ACT,0,0,0,0,0,0,0,0,0,0,0,0,0,0,0
HARYANA,2007,OTHER SLL OFFENCE,0,1,1,8,1,9,14,1,15,3,0,3,25,3,28
HARYANA,2007,TOTAL,0,2,2,752,20,772,554,18,572,185,2,187,1491,42,1533
HARYANA,2008,ARMS ACT,0,0,0,151,0,151,98,0,98,11,0,11,260,0,260
HARYANA,2008,N.D.P.S. ACT,1,0,1,184,6,190,186,3,189,73,1,74,444,10,454
HARYANA,2008,GAMBLING ACT,0,0,0,28,0,28,12,0,12,2,0,2,42,0,42
HARYANA,2008,EXCISE ACT,0,0,0,169,1,170,116,0,116,27,0,27,312,1,313
HARYANA,2008,PROHIBITION ACT,0,0,0,39,0,39,14,0,14,0,0,0,53,0,53
HARYANA,2008,EXPLOSIVE & EXPLOSIVE SUBST. ACT,0,0,0,3,1,4,3,0,3,0,0,0,6,1,7
HARYANA,2008,TERRORIST & DISRUPTIVE ACTIVITIES (TATA),0,0,0,0,0,0,0,0,0,0,0,0,0,0,0
HARYANA,2008,IMMORAL TRAFFIC (PREVENTION) ACT,0,0,0,51,21,72,8,7,15,0,0,0,59,28,87
HARYANA,2008,INDIAN RAILWAYS ACT,0,0,0,54,0,54,13,0,13,2,0,2,69,0,69
HARYANA,2008,REGISTRATION OF FOREIGNERS ACT,0,0,0,33,4,37,8,3,11,0,0,0,41,7,48
HARYANA,2008,PROTECTION OF CIVIL RIGHTS ACT,0,0,0,6,0,6,5,0,5,0,0,0,11,0,11
HARYANA,2008,SC/ST (PREVENTION OF ATROCITIES) ACT,0,0,0,5,0,5,2,0,2,0,0,0,7,0,7
HARYANA,2008,INDIAN PASSPORT ACT,0,0,0,0,0,0,4,0,4,0,0,0,4,0,4
HARYANA,2008,ESSENTIAL COMMODITIES ACT,0,0,0,0,0,0,3,0,3,0,0,0,3,0,3
HARYANA,2008,ANTIQUITIES AND ART TREASURE ACT,0,0,0,0,0,0,0,0,0,0,0,0,0,0,0
HARYANA,2008,DOWRY PROHIBITION ACT,0,0,0,25,0,25,22,8,30,0,4,4,47,12,59
HARYANA,2008,FOREIGN EXCHANGE REGULATION ACT-1973,0,0,0,0,0,0,0,0,0,0,0,0,0,0,0
HARYANA,2008,PREVENTION OF CORRUPTION ACT-1988,0,0,0,27,0,27,21,0,21,0,0,0,48,0,48
HARYANA,2008,CONSER.OF FORGN.EXCH.&PREV. OF SMUG.ACT,0,0,0,0,0,0,0,0,0,0,0,0,0,0,0
HARYANA,2008,OTHER SLL OFFENCE,0,0,0,17,3,20,14,0,14,9,0,9,40,3,43
HARYANA,2008,TOTAL,1,0,1,792,36,828,529,21,550,124,5,129,1446,62,1508
HARYANA,2009,ARMS ACT,0,0,0,149,0,149,75,0,75,21,0,21,245,0,245
HARYANA,2009,N.D.P.S. ACT,0,0,0,164,7,171,220,10,230,65,2,67,449,19,468
HARYANA,2009,GAMBLING ACT,0,0,0,10,0,10,8,0,8,1,0,1,19,0,19
HARYANA,2009,EXCISE ACT,0,0,0,89,0,89,56,4,60,21,0,21,166,4,170
HARYANA,2009,PROHIBITION ACT,0,0,0,4,0,4,0,0,0,0,0,0,4,0,4
HARYANA,2009,EXPLOSIVE & EXPLOSIVE SUBST. ACT,0,0,0,5,1,6,2,0,2,0,0,0,7,1,8
HARYANA,2009,TERRORIST & DISRUPTIVE ACTIVITIES (TATA),0,0,0,0,0,0,0,0,0,0,0,0,0,0,0
HARYANA,2009,IMMORAL TRAFFIC (PREVENTION) ACT,0,0,0,21,14,35,8,3,11,2,0,2,31,17,48
HARYANA,2009,INDIAN RAILWAYS ACT,0,0,0,41,0,41,16,0,16,3,0,3,60,0,60
HARYANA,2009,REGISTRATION OF FOREIGNERS ACT,0,0,0,4,5,9,3,2,5,3,1,4,10,8,18
HARYANA,2009,PROTECTION OF CIVIL RIGHTS ACT,0,0,0,0,0,0,0,0,0,0,0,0,0,0,0
HARYANA,2009,SC/ST (PREVENTION OF ATROCITIES) ACT,0,0,0,3,0,3,4,0,4,1,0,1,8,0,8
HARYANA,2009,INDIAN PASSPORT ACT,0,0,0,0,0,0,2,0,2,0,0,0,2,0,2
HARYANA,2009,ESSENTIAL COMMODITIES ACT,0,0,0,2,0,2,2,0,2,0,0,0,4,0,4
HARYANA,2009,ANTIQUITIES AND ART TREASURE ACT,0,0,0,0,0,0,0,0,0,0,0,0,0,0,0
HARYANA,2009,DOWRY PROHIBITION ACT,0,0,0,6,0,6,18,2,20,0,1,1,24,3,27
HARYANA,2009,FOREIGN EXCHANGE REGULATION ACT-1973,0,0,0,0,0,0,0,0,0,0,0,0,0,0,0
HARYANA,2009,PREVENTION OF CORRUPTION ACT-1988,0,0,0,2,0,2,5,0,5,0,0,0,7,0,7
HARYANA,2009,CONSER.OF FORGN.EXCH.&PREV. OF SMUG.ACT,0,0,0,0,0,0,0,0,0,0,0,0,0,0,0
HARYANA,2009,OTHER SLL OFFENCE,0,0,0,38,0,38,11,0,11,11,0,11,60,0,60
HARYANA,2009,TOTAL,0,0,0,538,27,565,430,21,451,128,4,132,1096,52,1148
HARYANA,2010,ARMS ACT,0,0,0,107,0,107,106,0,106,9,0,9,222,0,222
HARYANA,2010,N.D.P.S. ACT,0,0,0,179,3,182,147,12,159,64,1,65,390,16,406
HARYANA,2010,GAMBLING ACT,0,0,0,12,0,12,7,0,7,0,0,0,19,0,19
HARYANA,2010,EXCISE ACT,0,0,0,108,0,108,72,2,74,21,0,21,201,2,203
HARYANA,2010,PROHIBITION ACT,0,0,0,2,0,2,4,0,4,0,0,0,6,0,6
HARYANA,2010,EXPLOSIVE & EXPLOSIVE SUBST. ACT,0,0,0,4,1,5,4,0,4,0,0,0,8,1,9
HARYANA,2010,TERRORIST & DISRUPTIVE ACTIVITIES (TATA),0,0,0,0,0,0,1,0,1,0,0,0,1,0,1
HARYANA,2010,IMMORAL TRAFFIC (PREVENTION) ACT,0,0,0,15,8,23,10,2,12,2,0,2,27,10,37
HARYANA,2010,INDIAN RAILWAYS ACT,0,0,0,30,3,33,21,0,21,0,0,0,51,3,54
HARYANA,2010,REGISTRATION OF FOREIGNERS ACT,0,0,0,15,1,16,1,2,3,0,2,2,16,5,21
HARYANA,2010,PROTECTION OF CIVIL RIGHTS ACT,0,0,0,0,0,0,0,0,0,0,0,0,0,0,0
HARYANA,2010,SC/ST (PREVENTION OF ATROCITIES) ACT,0,0,0,12,0,12,2,0,2,0,0,0,14,0,14
HARYANA,2010,INDIAN PASSPORT ACT,0,0,0,0,0,0,0,0,0,0,0,0,0,0,0
HARYANA,2010,ESSENTIAL COMMODITIES ACT,0,0,0,6,0,6,0,0,0,0,0,0,6,0,6
HARYANA,2010,ANTIQUITIES AND ART TREASURE ACT,0,0,0,0,0,0,0,0,0,0,0,0,0,0,0
HARYANA,2010,DOWRY PROHIBITION ACT,0,0,0,25,0,25,9,0,9,0,0,0,34,0,34
HARYANA,2010,FOREIGN EXCHANGE REGULATION ACT-1973,0,0,0,0,0,0,0,0,0,0,0,0,0,0,0
HARYANA,2010,PREVENTION OF CORRUPTION ACT-1988,0,0,0,11,0,11,12,0,12,4,0,4,27,0,27
HARYANA,2010,CONSER.OF FORGN.EXCH.&PREV. OF SMUG.ACT,0,0,0,0,0,0,0,0,0,0,0,0,0,0,0
HARYANA,2010,OTHER SLL OFFENCE,0,0,0,38,0,38,23,0,23,13,0,13,74,0,74
HARYANA,2010,TOTAL,0,0,0,564,16,580,419,18,437,113,3,116,1096,37,1133
HARYANA,2011,ARMS ACT,0,0,0,131,0,131,57,0,57,8,0,8,196,0,196
HARYANA,2011,N.D.P.S. ACT,0,0,0,117,5,122,151,6,157,52,0,52,320,11,331
HARYANA,2011,GAMBLING ACT,0,0,0,7,0,7,1,0,1,0,0,0,8,0,8
HARYANA,2011,EXCISE ACT,0,0,0,44,0,44,65,0,65,8,0,8,117,0,117
HARYANA,2011,PROHIBITION ACT,0,0,0,5,0,5,5,0,5,2,0,2,12,0,12
HARYANA,2011,EXPLOSIVE & EXPLOSIVE SUBST. ACT,0,0,0,5,1,6,3,0,3,0,0,0,8,1,9
HARYANA,2011,TERRORIST & DISRUPTIVE ACTIVITIES (TATA),0,0,0,0,0,0,0,0,0,0,0,0,0,0,0
HARYANA,2011,IMMORAL TRAFFIC (PREVENTION) ACT,0,0,0,17,17,34,2,2,4,0,0,0,19,19,38
HARYANA,2011,INDIAN RAILWAYS ACT,0,0,0,27,0,27,12,0,12,0,0,0,39,0,39
HARYANA,2011,REGISTRATION OF FOREIGNERS ACT,0,0,0,20,1,21,6,2,8,0,2,2,26,5,31
HARYANA,2011,PROTECTION OF CIVIL RIGHTS ACT,0,0,0,0,0,0,0,0,0,0,0,0,0,0,0
HARYANA,2011,SC/ST (PREVENTION OF ATROCITIES) ACT,0,0,0,3,0,3,1,0,1,0,0,0,4,0,4
HARYANA,2011,INDIAN PASSPORT ACT,0,0,0,0,0,0,2,0,2,0,0,0,2,0,2
HARYANA,2011,ESSENTIAL COMMODITIES ACT,0,0,0,4,0,4,5,0,5,0,0,0,9,0,9
HARYANA,2011,ANTIQUITIES AND ART TREASURE ACT,0,0,0,0,0,0,0,0,0,0,0,0,0,0,0
HARYANA,2011,DOWRY PROHIBITION ACT,0,0,0,6,2,8,10,2,12,0,2,2,16,6,22
HARYANA,2011,FOREIGN EXCHANGE REGULATION ACT-1973,0,0,0,0,0,0,0,0,0,0,0,0,0,0,0
HARYANA,2011,PREVENTION OF CORRUPTION ACT-1988,0,0,0,1,0,1,7,0,7,4,0,4,12,0,12
HARYANA,2011,CONSER.OF FORGN.EXCH.&PREV. OF SMUG.ACT,0,0,0,0,0,0,0,0,0,0,0,0,0,0,0
HARYANA,2011,OTHER SLL OFFENCE,0,0,0,11,0,11,15,0,15,2,0,2,28,0,28
HARYANA,2011,TOTAL,0,0,0,398,26,424,342,12,354,76,4,80,816,42,858
HARYANA,2012,ARMS ACT,0,0,0,110,0,110,68,0,68,12,0,12,190,0,190
HARYANA,2012,N.D.P.S. ACT,0,0,0,236,2,238,156,0,156,66,1,67,458,3,461
HARYANA,2012,GAMBLING ACT,0,0,0,9,0,9,8,0,8,0,0,0,17,0,17
HARYANA,2012,EXCISE ACT,0,0,0,47,0,47,46,0,46,11,0,11,104,0,104
HARYANA,2012,PROHIBITION ACT,0,0,0,0,0,0,0,0,0,0,0,0,0,0,0
HARYANA,2012,EXPLOSIVE & EXPLOSIVE SUBST. ACT,0,0,0,9,0,9,1,0,1,0,0,0,10,0,10
HARYANA,2012,TERRORIST & DISRUPTIVE ACTIVITIES (TATA),0,0,0,0,0,0,0,0,0,0,0,0,0,0,0
HARYANA,2012,IMMORAL TRAFFIC (PREVENTION) ACT,0,0,0,15,3,18,11,1,12,0,0,0,26,4,30
HARYANA,2012,INDIAN RAILWAYS ACT,0,0,0,42,0,42,21,0,21,0,0,0,63,0,63
HARYANA,2012,REGISTRATION OF FOREIGNERS ACT,0,0,0,0,0,0,0,0,0,0,0,0,0,0,0
HARYANA,2012,PROTECTION OF CIVIL RIGHTS ACT,0,0,0,0,0,0,0,0,0,0,0,0,0,0,0
HARYANA,2012,SC/ST (PREVENTION OF ATROCITIES) ACT,0,0,0,7,0,7,1,0,1,0,0,0,8,0,8
HARYANA,2012,INDIAN PASSPORT ACT,0,0,0,9,0,9,2,0,2,2,0,2,13,0,13
HARYANA,2012,ESSENTIAL COMMODITIES ACT,0,0,0,3,0,3,5,0,5,0,0,0,8,0,8
HARYANA,2012,ANTIQUITIES AND ART TREASURE ACT,0,0,0,0,0,0,0,0,0,0,0,0,0,0,0
HARYANA,2012,DOWRY PROHIBITION ACT,0,0,0,15,2,17,22,3,25,0,0,0,37,5,42
HARYANA,2012,FOREIGN EXCHANGE REGULATION ACT-1973,0,0,0,0,0,0,0,0,0,0,0,0,0,0,0
HARYANA,2012,PREVENTION OF CORRUPTION ACT-1988,0,0,0,9,0,9,8,0,8,9,0,9,26,0,26
HARYANA,2012,CONSER.OF FORGN.EXCH.&PREV. OF SMUG.ACT,0,0,0,0,0,0,0,0,0,0,0,0,0,0,0
HARYANA,2012,OTHER SLL OFFENCE,0,0,0,0,0,0,1,0,1,1,0,1,2,0,2
HARYANA,2012,TOTAL,0,0,0,511,7,518,350,4,354,101,1,102,962,12,974
HIMACHAL PRADESH,2001,ARMS ACT,0,0,0,0,0,0,0,0,0,0,0,0,0,0,0
HIMACHAL PRADESH,2001,N.D.P.S. ACT,0,0,0,0,0,0,0,0,0,0,0,0,0,0,0
HIMACHAL PRADESH,2001,GAMBLING ACT,0,0,0,9,2,11,5,2,7,8,0,8,22,4,26
HIMACHAL PRADESH,2001,EXCISE ACT,0,0,0,0,0,0,5,0,5,4,0,4,9,0,9
HIMACHAL PRADESH,2001,PROHIBITION ACT,0,0,0,0,0,0,0,0,0,0,0,0,0,0,0
HIMACHAL PRADESH,2001,EXPLOSIVE & EXPLOSIVE SUBST. ACT,0,0,0,0,0,0,0,0,0,0,0,0,0,0,0
HIMACHAL PRADESH,2001,TERRORIST & DISRUPTIVE ACTIVITIES (TATA),0,0,0,0,0,0,0,0,0,0,0,0,0,0,0
HIMACHAL PRADESH,2001,IMMORAL TRAFFIC (PREVENTION) ACT,0,0,0,0,0,0,0,0,0,0,0,0,0,0,0
HIMACHAL PRADESH,2001,INDIAN RAILWAYS ACT,0,0,0,0,0,0,0,0,0,0,0,0,0,0,0
HIMACHAL PRADESH,2001,REGISTRATION OF FOREIGNERS ACT,0,0,0,0,0,0,0,0,0,0,0,0,0,0,0
HIMACHAL PRADESH,2001,PROTECTION OF CIVIL RIGHTS ACT,0,0,0,0,0,0,0,0,0,0,0,0,0,0,0
HIMACHAL PRADESH,2001,SC/ST (PREVENTION OF ATROCITIES) ACT,0,0,0,0,0,0,0,0,0,0,0,0,0,0,0
HIMACHAL PRADESH,2001,INDIAN PASSPORT ACT,0,0,0,0,0,0,0,0,0,0,0,0,0,0,0
HIMACHAL PRADESH,2001,ESSENTIAL COMMODITIES ACT,0,0,0,0,0,0,0,0,0,0,0,0,0,0,0
HIMACHAL PRADESH,2001,ANTIQUITIES AND ART TREASURE ACT,0,0,0,0,0,0,0,0,0,0,0,0,0,0,0
HIMACHAL PRADESH,2001,DOWRY PROHIBITION ACT,0,0,0,0,0,0,0,0,0,0,0,0,0,0,0
HIMACHAL PRADESH,2001,FOREIGN EXCHANGE REGULATION ACT-1973,0,0,0,0,0,0,0,0,0,0,0,0,0,0,0
HIMACHAL PRADESH,2001,PREVENTION OF CORRUPTION ACT-1988,0,0,0,0,0,0,0,0,0,0,0,0,0,0,0
HIMACHAL PRADESH,2001,CONSER.OF FORGN.EXCH.&PREV. OF SMUG.ACT,0,0,0,0,0,0,0,0,0,0,0,0,0,0,0
HIMACHAL PRADESH,2001,OTHER SLL OFFENCE,0,0,0,0,0,0,0,0,0,0,0,0,0,0,0
HIMACHAL PRADESH,2001,TOTAL,0,0,0,9,2,11,10,2,12,12,0,12,31,4,35
HIMACHAL PRADESH,2002,ARMS ACT,0,0,0,0,0,0,0,0,0,0,0,0,0,0,0
HIMACHAL PRADESH,2002,N.D.P.S. ACT,0,0,0,91,6,97,86,7,93,7,0,7,184,13,197
HIMACHAL PRADESH,2002,GAMBLING ACT,0,0,0,2,0,2,0,0,0,0,0,0,2,0,2
HIMACHAL PRADESH,2002,EXCISE ACT,0,0,0,3,0,3,3,0,3,0,0,0,6,0,6
HIMACHAL PRADESH,2002,PROHIBITION ACT,0,0,0,0,0,0,0,0,0,0,0,0,0,0,0
HIMACHAL PRADESH,2002,EXPLOSIVE & EXPLOSIVE SUBST. ACT,0,0,0,0,0,0,0,0,0,0,0,0,0,0,0
HIMACHAL PRADESH,2002,TERRORIST & DISRUPTIVE ACTIVITIES (TATA),0,0,0,0,0,0,0,0,0,0,0,0,0,0,0
HIMACHAL PRADESH,2002,IMMORAL TRAFFIC (PREVENTION) ACT,0,0,0,0,0,0,0,0,0,0,0,0,0,0,0
HIMACHAL PRADESH,2002,INDIAN RAILWAYS ACT,0,0,0,0,0,0,0,0,0,0,0,0,0,0,0
HIMACHAL PRADESH,2002,REGISTRATION OF FOREIGNERS ACT,0,0,0,2,0,2,1,0,1,0,0,0,3,0,3
HIMACHAL PRADESH,2002,PROTECTION OF CIVIL RIGHTS ACT,0,0,0,0,0,0,0,0,0,0,0,0,0,0,0
HIMACHAL PRADESH,2002,SC/ST (PREVENTION OF ATROCITIES) ACT,0,0,0,0,0,0,0,0,0,0,0,0,0,0,0
HIMACHAL PRADESH,2002,INDIAN PASSPORT ACT,0,0,0,0,0,0,0,0,0,0,0,0,0,0,0
HIMACHAL PRADESH,2002,ESSENTIAL COMMODITIES ACT,0,0,0,0,0,0,0,0,0,0,0,0,0,0,0
HIMACHAL PRADESH,2002,ANTIQUITIES AND ART TREASURE ACT,0,0,0,0,0,0,0,0,0,0,0,0,0,0,0
HIMACHAL PRADESH,2002,DOWRY PROHIBITION ACT,0,0,0,0,0,0,0,0,0,0,0,0,0,0,0
HIMACHAL PRADESH,2002,FOREIGN EXCHANGE REGULATION ACT-1973,0,0,0,0,0,0,0,0,0,0,0,0,0,0,0
HIMACHAL PRADESH,2002,PREVENTION OF CORRUPTION ACT-1988,0,0,0,0,0,0,0,0,0,0,0,0,0,0,0
HIMACHAL PRADESH,2002,CONSER.OF FORGN.EXCH.&PREV. OF SMUG.ACT,0,0,0,0,0,0,0,0,0,0,0,0,0,0,0
HIMACHAL PRADESH,2002,OTHER SLL OFFENCE,0,0,0,6,0,6,1,0,1,0,0,0,7,0,7
HIMACHAL PRADESH,2002,TOTAL,0,0,0,104,6,110,91,7,98,7,0,7,202,13,215
HIMACHAL PRADESH,2003,ARMS ACT,0,0,0,0,0,0,0,0,0,0,0,0,0,0,0
HIMACHAL PRADESH,2003,N.D.P.S. ACT,0,0,0,87,4,91,97,3,100,13,0,13,197,7,204
HIMACHAL PRADESH,2003,GAMBLING ACT,0,0,0,0,0,0,0,0,0,0,0,0,0,0,0
HIMACHAL PRADESH,2003,EXCISE ACT,0,0,0,7,0,7,6,0,6,0,0,0,13,0,13
HIMACHAL PRADESH,2003,PROHIBITION ACT,0,0,0,0,0,0,0,0,0,0,0,0,0,0,0
HIMACHAL PRADESH,2003,EXPLOSIVE & EXPLOSIVE SUBST. ACT,0,0,0,0,0,0,0,0,0,0,0,0,0,0,0
HIMACHAL PRADESH,2003,TERRORIST & DISRUPTIVE ACTIVITIES (TATA),0,0,0,0,0,0,0,0,0,0,0,0,0,0,0
HIMACHAL PRADESH,2003,IMMORAL TRAFFIC (PREVENTION) ACT,0,0,0,0,0,0,0,0,0,0,0,0,0,0,0
HIMACHAL PRADESH,2003,INDIAN RAILWAYS ACT,0,0,0,0,0,0,0,0,0,0,0,0,0,0,0
HIMACHAL PRADESH,2003,REGISTRATION OF FOREIGNERS ACT,0,0,0,0,0,0,0,0,0,0,0,0,0,0,0
HIMACHAL PRADESH,2003,PROTECTION OF CIVIL RIGHTS ACT,0,0,0,0,0,0,0,0,0,0,0,0,0,0,0
HIMACHAL PRADESH,2003,SC/ST (PREVENTION OF ATROCITIES) ACT,0,0,0,0,0,0,0,0,0,0,0,0,0,0,0
HIMACHAL PRADESH,2003,INDIAN PASSPORT ACT,0,0,0,0,0,0,0,0,0,0,0,0,0,0,0
HIMACHAL PRADESH,2003,ESSENTIAL COMMODITIES ACT,0,0,0,0,0,0,0,0,0,0,0,0,0,0,0
HIMACHAL PRADESH,2003,ANTIQUITIES AND ART TREASURE ACT,0,0,0,0,0,0,0,0,0,0,0,0,0,0,0
HIMACHAL PRADESH,2003,DOWRY PROHIBITION ACT,0,0,0,0,0,0,0,0,0,0,0,0,0,0,0
HIMACHAL PRADESH,2003,FOREIGN EXCHANGE REGULATION ACT-1973,0,0,0,0,0,0,0,0,0,0,0,0,0,0,0
HIMACHAL PRADESH,2003,PREVENTION OF CORRUPTION ACT-1988,0,0,0,0,0,0,0,0,0,0,0,0,0,0,0
HIMACHAL PRADESH,2003,CONSER.OF FORGN.EXCH.&PREV. OF SMUG.ACT,0,0,0,0,0,0,0,0,0,0,0,0,0,0,0
HIMACHAL PRADESH,2003,OTHER SLL OFFENCE,0,0,0,1,0,1,0,0,0,0,0,0,1,0,1
HIMACHAL PRADESH,2003,TOTAL,0,0,0,95,4,99,103,3,106,13,0,13,211,7,218
HIMACHAL PRADESH,2004,ARMS ACT,0,0,0,5,0,5,0,0,0,0,0,0,5,0,5
HIMACHAL PRADESH,2004,N.D.P.S. ACT,0,0,0,69,0,69,85,9,94,10,1,11,164,10,174
HIMACHAL PRADESH,2004,GAMBLING ACT,0,0,0,0,0,0,0,0,0,0,0,0,0,0,0
HIMACHAL PRADESH,2004,EXCISE ACT,0,0,0,2,0,2,3,0,3,0,0,0,5,0,5
HIMACHAL PRADESH,2004,PROHIBITION ACT,0,0,0,0,0,0,0,0,0,0,0,0,0,0,0
HIMACHAL PRADESH,2004,EXPLOSIVE & EXPLOSIVE SUBST. ACT,0,0,0,0,0,0,0,0,0,0,0,0,0,0,0
HIMACHAL PRADESH,2004,TERRORIST & DISRUPTIVE ACTIVITIES (TATA),0,0,0,0,0,0,0,0,0,0,0,0,0,0,0
HIMACHAL PRADESH,2004,IMMORAL TRAFFIC (PREVENTION) ACT,0,0,0,0,0,0,0,0,0,0,0,0,0,0,0
HIMACHAL PRADESH,2004,INDIAN RAILWAYS ACT,0,0,0,0,0,0,0,0,0,0,0,0,0,0,0
HIMACHAL PRADESH,2004,REGISTRATION OF FOREIGNERS ACT,0,0,0,0,0,0,0,0,0,0,0,0,0,0,0
HIMACHAL PRADESH,2004,PROTECTION OF CIVIL RIGHTS ACT,0,0,0,0,0,0,0,0,0,0,0,0,0,0,0
HIMACHAL PRADESH,2004,SC/ST (PREVENTION OF ATROCITIES) ACT,0,0,0,0,0,0,0,0,0,0,0,0,0,0,0
HIMACHAL PRADESH,2004,INDIAN PASSPORT ACT,0,0,0,0,0,0,0,0,0,0,0,0,0,0,0
HIMACHAL PRADESH,2004,ESSENTIAL COMMODITIES ACT,0,0,0,0,0,0,0,0,0,0,0,0,0,0,0
HIMACHAL PRADESH,2004,ANTIQUITIES AND ART TREASURE ACT,0,0,0,0,0,0,0,0,0,0,0,0,0,0,0
HIMACHAL PRADESH,2004,DOWRY PROHIBITION ACT,0,0,0,0,0,0,0,0,0,0,0,0,0,0,0
HIMACHAL PRADESH,2004,FOREIGN EXCHANGE REGULATION ACT-1973,0,0,0,0,0,0,1,0,1,0,0,0,1,0,1
HIMACHAL PRADESH,2004,PREVENTION OF CORRUPTION ACT-1988,0,0,0,0,0,0,0,0,0,0,0,0,0,0,0
HIMACHAL PRADESH,2004,CONSER.OF FORGN.EXCH.&PREV. OF SMUG.ACT,0,0,0,0,0,0,0,0,0,0,0,0,0,0,0
HIMACHAL PRADESH,2004,OTHER SLL OFFENCE,0,0,0,4,0,4,2,0,2,0,0,0,6,0,6
HIMACHAL PRADESH,2004,TOTAL,0,0,0,80,0,80,91,9,100,10,1,11,181,10,191
HIMACHAL PRADESH,2005,ARMS ACT,0,0,0,3,0,3,1,0,1,0,0,0,4,0,4
HIMACHAL PRADESH,2005,N.D.P.S. ACT,0,0,0,77,1,78,64,1,65,4,1,5,145,3,148
HIMACHAL PRADESH,2005,GAMBLING ACT,0,0,0,0,0,0,0,0,0,0,0,0,0,0,0
HIMACHAL PRADESH,2005,EXCISE ACT,0,0,0,9,0,9,2,0,2,0,0,0,11,0,11
HIMACHAL PRADESH,2005,PROHIBITION ACT,0,0,0,0,0,0,0,0,0,0,0,0,0,0,0
HIMACHAL PRADESH,2005,EXPLOSIVE & EXPLOSIVE SUBST. ACT,0,0,0,0,0,0,0,0,0,0,0,0,0,0,0
HIMACHAL PRADESH,2005,TERRORIST & DISRUPTIVE ACTIVITIES (TATA),0,0,0,0,0,0,0,0,0,0,0,0,0,0,0
HIMACHAL PRADESH,2005,IMMORAL TRAFFIC (PREVENTION) ACT,0,0,0,0,0,0,0,0,0,0,0,0,0,0,0
HIMACHAL PRADESH,2005,INDIAN RAILWAYS ACT,0,0,0,0,0,0,0,0,0,0,0,0,0,0,0
HIMACHAL PRADESH,2005,REGISTRATION OF FOREIGNERS ACT,0,0,0,0,0,0,0,0,0,0,0,0,0,0,0
HIMACHAL PRADESH,2005,PROTECTION OF CIVIL RIGHTS ACT,0,0,0,0,0,0,0,0,0,0,0,0,0,0,0
HIMACHAL PRADESH,2005,SC/ST (PREVENTION OF ATROCITIES) ACT,0,0,0,0,0,0,0,0,0,0,0,0,0,0,0
HIMACHAL PRADESH,2005,INDIAN PASSPORT ACT,0,0,0,0,0,0,0,0,0,0,0,0,0,0,0
HIMACHAL PRADESH,2005,ESSENTIAL COMMODITIES ACT,0,0,0,0,0,0,0,0,0,0,0,0,0,0,0
HIMACHAL PRADESH,2005,ANTIQUITIES AND ART TREASURE ACT,0,0,0,0,0,0,0,0,0,0,0,0,0,0,0
HIMACHAL PRADESH,2005,DOWRY PROHIBITION ACT,0,0,0,0,0,0,0,0,0,0,0,0,0,0,0
HIMACHAL PRADESH,2005,FOREIGN EXCHANGE REGULATION ACT-1973,0,0,0,0,0,0,0,0,0,0,0,0,0,0,0
HIMACHAL PRADESH,2005,PREVENTION OF CORRUPTION ACT-1988,0,0,0,1,0,1,1,0,1,0,0,0,2,0,2
HIMACHAL PRADESH,2005,CONSER.OF FORGN.EXCH.&PREV. OF SMUG.ACT,0,0,0,0,0,0,0,0,0,0,0,0,0,0,0
HIMACHAL PRADESH,2005,OTHER SLL OFFENCE,0,0,0,1,0,1,0,0,0,0,0,0,1,0,1
HIMACHAL PRADESH,2005,TOTAL,0,0,0,91,1,92,68,1,69,4,1,5,163,3,166
HIMACHAL PRADESH,2006,ARMS ACT,0,0,0,2,0,2,1,0,1,0,0,0,3,0,3
HIMACHAL PRADESH,2006,N.D.P.S. ACT,0,0,0,22,2,24,146,7,153,27,0,27,195,9,204
HIMACHAL PRADESH,2006,GAMBLING ACT,0,0,0,0,0,0,0,0,0,0,0,0,0,0,0
HIMACHAL PRADESH,2006,EXCISE ACT,0,0,0,2,0,2,1,0,1,0,0,0,3,0,3
HIMACHAL PRADESH,2006,PROHIBITION ACT,0,0,0,0,0,0,0,0,0,0,0,0,0,0,0
HIMACHAL PRADESH,2006,EXPLOSIVE & EXPLOSIVE SUBST. ACT,0,0,0,0,0,0,0,0,0,0,0,0,0,0,0
HIMACHAL PRADESH,2006,TERRORIST & DISRUPTIVE ACTIVITIES (TATA),0,0,0,0,0,0,0,0,0,0,0,0,0,0,0
HIMACHAL PRADESH,2006,IMMORAL TRAFFIC (PREVENTION) ACT,0,0,0,0,0,0,0,0,0,0,0,0,0,0,0
HIMACHAL PRADESH,2006,INDIAN RAILWAYS ACT,0,0,0,0,0,0,0,0,0,0,0,0,0,0,0
HIMACHAL PRADESH,2006,REGISTRATION OF FOREIGNERS ACT,0,0,0,0,0,0,1,0,1,0,0,0,1,0,1
HIMACHAL PRADESH,2006,PROTECTION OF CIVIL RIGHTS ACT,0,0,0,0,0,0,0,0,0,0,0,0,0,0,0
HIMACHAL PRADESH,2006,SC/ST (PREVENTION OF ATROCITIES) ACT,0,0,0,0,0,0,0,0,0,0,0,0,0,0,0
HIMACHAL PRADESH,2006,INDIAN PASSPORT ACT,0,0,0,0,0,0,0,0,0,0,0,0,0,0,0
HIMACHAL PRADESH,2006,ESSENTIAL COMMODITIES ACT,0,0,0,0,0,0,0,0,0,0,0,0,0,0,0
HIMACHAL PRADESH,2006,ANTIQUITIES AND ART TREASURE ACT,0,0,0,0,0,0,0,0,0,0,0,0,0,0,0
HIMACHAL PRADESH,2006,DOWRY PROHIBITION ACT,0,0,0,0,0,0,0,0,0,0,0,0,0,0,0
HIMACHAL PRADESH,2006,FOREIGN EXCHANGE REGULATION ACT-1973,0,0,0,0,0,0,0,0,0,0,0,0,0,0,0
HIMACHAL PRADESH,2006,PREVENTION OF CORRUPTION ACT-1988,0,0,0,0,0,0,0,0,0,0,0,0,0,0,0
HIMACHAL PRADESH,2006,CONSER.OF FORGN.EXCH.&PREV. OF SMUG.ACT,0,0,0,0,0,0,0,0,0,0,0,0,0,0,0
HIMACHAL PRADESH,2006,OTHER SLL OFFENCE,0,0,0,0,0,0,0,0,0,0,0,0,0,0,0
HIMACHAL PRADESH,2006,TOTAL,0,0,0,26,2,28,149,7,156,27,0,27,202,9,211
HIMACHAL PRADESH,2007,ARMS ACT,0,0,0,1,0,1,0,0,0,0,0,0,1,0,1
HIMACHAL PRADESH,2007,N.D.P.S. ACT,0,0,0,50,1,51,58,3,61,7,0,7,115,4,119
HIMACHAL PRADESH,2007,GAMBLING ACT,0,0,0,0,0,0,0,0,0,0,0,0,0,0,0
HIMACHAL PRADESH,2007,EXCISE ACT,0,0,0,5,0,5,2,0,2,1,0,1,8,0,8
HIMACHAL PRADESH,2007,PROHIBITION ACT,0,0,0,0,0,0,0,0,0,0,0,0,0,0,0
HIMACHAL PRADESH,2007,EXPLOSIVE & EXPLOSIVE SUBST. ACT,0,0,0,0,0,0,0,0,0,0,0,0,0,0,0
HIMACHAL PRADESH,2007,TERRORIST & DISRUPTIVE ACTIVITIES (TATA),0,0,0,0,0,0,0,0,0,0,0,0,0,0,0
HIMACHAL PRADESH,2007,IMMORAL TRAFFIC (PREVENTION) ACT,0,0,0,0,0,0,0,0,0,0,0,0,0,0,0
HIMACHAL PRADESH,2007,INDIAN RAILWAYS ACT,0,0,0,0,0,0,0,0,0,0,0,0,0,0,0
HIMACHAL PRADESH,2007,REGISTRATION OF FOREIGNERS ACT,0,0,0,0,0,0,0,0,0,0,0,0,0,0,0
HIMACHAL PRADESH,2007,PROTECTION OF CIVIL RIGHTS ACT,0,0,0,0,0,0,0,0,0,0,0,0,0,0,0
HIMACHAL PRADESH,2007,SC/ST (PREVENTION OF ATROCITIES) ACT,0,0,0,0,0,0,0,0,0,0,0,0,0,0,0
HIMACHAL PRADESH,2007,INDIAN PASSPORT ACT,0,0,0,0,0,0,1,0,1,0,0,0,1,0,1
HIMACHAL PRADESH,2007,ESSENTIAL COMMODITIES ACT,0,0,0,0,0,0,0,0,0,0,0,0,0,0,0
HIMACHAL PRADESH,2007,ANTIQUITIES AND ART TREASURE ACT,0,0,0,0,0,0,0,0,0,0,0,0,0,0,0
HIMACHAL PRADESH,2007,DOWRY PROHIBITION ACT,0,0,0,0,0,0,0,0,0,0,0,0,0,0,0
HIMACHAL PRADESH,2007,FOREIGN EXCHANGE REGULATION ACT-1973,0,0,0,0,0,0,0,0,0,0,0,0,0,0,0
HIMACHAL PRADESH,2007,PREVENTION OF CORRUPTION ACT-1988,0,0,0,0,0,0,0,0,0,0,0,0,0,0,0
HIMACHAL PRADESH,2007,CONSER.OF FORGN.EXCH.&PREV. OF SMUG.ACT,0,0,0,0,0,0,0,0,0,0,0,0,0,0,0
HIMACHAL PRADESH,2007,OTHER SLL OFFENCE,0,0,0,10,1,11,10,0,10,7,0,7,27,1,28
HIMACHAL PRADESH,2007,TOTAL,0,0,0,66,2,68,71,3,74,15,0,15,152,5,157
HIMACHAL PRADESH,2008,ARMS ACT,0,0,0,0,0,0,0,0,0,0,0,0,0,0,0
HIMACHAL PRADESH,2008,N.D.P.S. ACT,0,0,0,61,1,62,44,2,46,18,0,18,123,3,126
HIMACHAL PRADESH,2008,GAMBLING ACT,0,0,0,1,0,1,0,0,0,0,0,0,1,0,1
HIMACHAL PRADESH,2008,EXCISE ACT,0,0,0,0,0,0,2,0,2,0,0,0,2,0,2
HIMACHAL PRADESH,2008,PROHIBITION ACT,0,0,0,0,0,0,0,0,0,0,0,0,0,0,0
HIMACHAL PRADESH,2008,EXPLOSIVE & EXPLOSIVE SUBST. ACT,0,0,0,0,0,0,0,0,0,0,0,0,0,0,0
HIMACHAL PRADESH,2008,TERRORIST & DISRUPTIVE ACTIVITIES (TATA),0,0,0,0,0,0,0,0,0,0,0,0,0,0,0
HIMACHAL PRADESH,2008,IMMORAL TRAFFIC (PREVENTION) ACT,0,0,0,0,0,0,0,0,0,0,0,0,0,0,0
HIMACHAL PRADESH,2008,INDIAN RAILWAYS ACT,0,0,0,0,0,0,0,0,0,0,0,0,0,0,0
HIMACHAL PRADESH,2008,REGISTRATION OF FOREIGNERS ACT,0,0,0,1,1,2,1,0,1,0,0,0,2,1,3
HIMACHAL PRADESH,2008,PROTECTION OF CIVIL RIGHTS ACT,0,0,0,0,0,0,0,0,0,0,0,0,0,0,0
HIMACHAL PRADESH,2008,SC/ST (PREVENTION OF ATROCITIES) ACT,0,0,0,0,0,0,0,0,0,0,0,0,0,0,0
HIMACHAL PRADESH,2008,INDIAN PASSPORT ACT,0,0,0,0,0,0,0,0,0,0,0,0,0,0,0
HIMACHAL PRADESH,2008,ESSENTIAL COMMODITIES ACT,0,0,0,0,0,0,0,0,0,0,0,0,0,0,0
HIMACHAL PRADESH,2008,ANTIQUITIES AND ART TREASURE ACT,0,0,0,0,0,0,0,0,0,0,0,0,0,0,0
HIMACHAL PRADESH,2008,DOWRY PROHIBITION ACT,0,0,0,0,0,0,0,0,0,0,0,0,0,0,0
HIMACHAL PRADESH,2008,FOREIGN EXCHANGE REGULATION ACT-1973,0,0,0,0,0,0,0,0,0,0,0,0,0,0,0
HIMACHAL PRADESH,2008,PREVENTION OF CORRUPTION ACT-1988,0,0,0,0,0,0,1,0,1,0,0,0,1,0,1
HIMACHAL PRADESH,2008,CONSER.OF FORGN.EXCH.&PREV. OF SMUG.ACT,0,0,0,0,0,0,0,0,0,0,0,0,0,0,0
HIMACHAL PRADESH,2008,OTHER SLL OFFENCE,0,0,0,0,0,0,0,0,0,0,0,0,0,0,0
HIMACHAL PRADESH,2008,TOTAL,0,0,0,63,2,65,48,2,50,18,0,18,129,4,133
HIMACHAL PRADESH,2009,ARMS ACT,0,0,0,1,0,1,1,0,1,0,0,0,2,0,2
HIMACHAL PRADESH,2009,N.D.P.S. ACT,0,0,0,94,2,96,93,4,97,7,0,7,194,6,200
HIMACHAL PRADESH,2009,GAMBLING ACT,0,0,0,0,0,0,0,0,0,0,0,0,0,0,0
HIMACHAL PRADESH,2009,EXCISE ACT,0,0,0,3,0,3,2,0,2,0,0,0,5,0,5
HIMACHAL PRADESH,2009,PROHIBITION ACT,0,0,0,0,0,0,0,0,0,0,0,0,0,0,0
HIMACHAL PRADESH,2009,EXPLOSIVE & EXPLOSIVE SUBST. ACT,0,0,0,1,0,1,2,0,2,0,0,0,3,0,3
HIMACHAL PRADESH,2009,TERRORIST & DISRUPTIVE ACTIVITIES (TATA),0,0,0,0,0,0,0,0,0,0,0,0,0,0,0
HIMACHAL PRADESH,2009,IMMORAL TRAFFIC (PREVENTION) ACT,0,0,0,0,0,0,0,0,0,0,0,0,0,0,0
HIMACHAL PRADESH,2009,INDIAN RAILWAYS ACT,0,0,0,0,0,0,0,0,0,0,0,0,0,0,0
HIMACHAL PRADESH,2009,REGISTRATION OF FOREIGNERS ACT,0,0,0,2,0,2,0,0,0,0,0,0,2,0,2
HIMACHAL PRADESH,2009,PROTECTION OF CIVIL RIGHTS ACT,0,0,0,0,0,0,0,0,0,0,0,0,0,0,0
HIMACHAL PRADESH,2009,SC/ST (PREVENTION OF ATROCITIES) ACT,0,0,0,0,0,0,0,0,0,0,0,0,0,0,0
HIMACHAL PRADESH,2009,INDIAN PASSPORT ACT,0,0,0,0,0,0,0,0,0,0,0,0,0,0,0
HIMACHAL PRADESH,2009,ESSENTIAL COMMODITIES ACT,0,0,0,0,0,0,0,0,0,0,0,0,0,0,0
HIMACHAL PRADESH,2009,ANTIQUITIES AND ART TREASURE ACT,0,0,0,0,0,0,0,0,0,0,0,0,0,0,0
HIMACHAL PRADESH,2009,DOWRY PROHIBITION ACT,0,0,0,0,0,0,0,0,0,0,0,0,0,0,0
HIMACHAL PRADESH,2009,FOREIGN EXCHANGE REGULATION ACT-1973,0,0,0,0,0,0,0,0,0,0,0,0,0,0,0
HIMACHAL PRADESH,2009,PREVENTION OF CORRUPTION ACT-1988,0,0,0,0,0,0,0,0,0,0,0,0,0,0,0
HIMACHAL PRADESH,2009,CONSER.OF FORGN.EXCH.&PREV. OF SMUG.ACT,0,0,0,0,0,0,0,0,0,0,0,0,0,0,0
HIMACHAL PRADESH,2009,OTHER SLL OFFENCE,0,0,0,0,0,0,0,0,0,0,0,0,0,0,0
HIMACHAL PRADESH,2009,TOTAL,0,0,0,101,2,103,98,4,102,7,0,7,206,6,212
HIMACHAL PRADESH,2010,ARMS ACT,0,0,0,0,0,0,0,0,0,0,0,0,0,0,0
HIMACHAL PRADESH,2010,N.D.P.S. ACT,0,0,0,81,1,82,88,4,92,46,0,46,215,5,220
HIMACHAL PRADESH,2010,GAMBLING ACT,0,0,0,0,0,0,0,0,0,0,0,0,0,0,0
HIMACHAL PRADESH,2010,EXCISE ACT,0,0,0,0,0,0,0,0,0,0,0,0,0,0,0
HIMACHAL PRADESH,2010,PROHIBITION ACT,0,0,0,0,0,0,0,0,0,0,0,0,0,0,0
HIMACHAL PRADESH,2010,EXPLOSIVE & EXPLOSIVE SUBST. ACT,0,0,0,3,0,3,0,0,0,0,0,0,3,0,3
HIMACHAL PRADESH,2010,TERRORIST & DISRUPTIVE ACTIVITIES (TATA),0,0,0,0,0,0,0,0,0,0,0,0,0,0,0
HIMACHAL PRADESH,2010,IMMORAL TRAFFIC (PREVENTION) ACT,0,0,0,0,0,0,0,0,0,0,0,0,0,0,0
HIMACHAL PRADESH,2010,INDIAN RAILWAYS ACT,0,0,0,0,0,0,0,0,0,0,0,0,0,0,0
HIMACHAL PRADESH,2010,REGISTRATION OF FOREIGNERS ACT,0,0,0,0,0,0,0,0,0,0,0,0,0,0,0
HIMACHAL PRADESH,2010,PROTECTION OF CIVIL RIGHTS ACT,0,0,0,0,0,0,0,0,0,0,0,0,0,0,0
HIMACHAL PRADESH,2010,SC/ST (PREVENTION OF ATROCITIES) ACT,0,0,0,0,0,0,0,0,0,0,0,0,0,0,0
HIMACHAL PRADESH,2010,INDIAN PASSPORT ACT,0,0,0,0,0,0,0,0,0,0,0,0,0,0,0
HIMACHAL PRADESH,2010,ESSENTIAL COMMODITIES ACT,0,0,0,0,0,0,0,0,0,0,0,0,0,0,0
HIMACHAL PRADESH,2010,ANTIQUITIES AND ART TREASURE ACT,0,0,0,0,0,0,0,0,0,0,0,0,0,0,0
HIMACHAL PRADESH,2010,DOWRY PROHIBITION ACT,0,0,0,0,0,0,0,0,0,0,0,0,0,0,0
HIMACHAL PRADESH,2010,FOREIGN EXCHANGE REGULATION ACT-1973,0,0,0,0,0,0,0,0,0,0,0,0,0,0,0
HIMACHAL PRADESH,2010,PREVENTION OF CORRUPTION ACT-1988,0,0,0,0,0,0,1,0,1,0,0,0,1,0,1
HIMACHAL PRADESH,2010,CONSER.OF FORGN.EXCH.&PREV. OF SMUG.ACT,0,0,0,0,0,0,0,0,0,0,0,0,0,0,0
HIMACHAL PRADESH,2010,OTHER SLL OFFENCE,0,0,0,1,0,1,1,0,1,0,0,0,2,0,2
HIMACHAL PRADESH,2010,TOTAL,0,0,0,85,1,86,90,4,94,46,0,46,221,5,226
HIMACHAL PRADESH,2011,ARMS ACT,0,0,0,0,0,0,0,0,0,0,0,0,0,0,0
HIMACHAL PRADESH,2011,N.D.P.S. ACT,0,0,0,55,0,55,67,1,68,11,0,11,133,1,134
HIMACHAL PRADESH,2011,GAMBLING ACT,0,0,0,0,0,0,0,0,0,0,0,0,0,0,0
HIMACHAL PRADESH,2011,EXCISE ACT,0,0,0,0,0,0,1,0,1,1,0,1,2,0,2
HIMACHAL PRADESH,2011,PROHIBITION ACT,0,0,0,0,0,0,0,0,0,0,0,0,0,0,0
HIMACHAL PRADESH,2011,EXPLOSIVE & EXPLOSIVE SUBST. ACT,0,0,0,0,0,0,0,0,0,0,0,0,0,0,0
HIMACHAL PRADESH,2011,TERRORIST & DISRUPTIVE ACTIVITIES (TATA),0,0,0,0,0,0,0,0,0,0,0,0,0,0,0
HIMACHAL PRADESH,2011,IMMORAL TRAFFIC (PREVENTION) ACT,0,0,0,0,0,0,0,0,0,0,0,0,0,0,0
HIMACHAL PRADESH,2011,INDIAN RAILWAYS ACT,0,0,0,0,0,0,0,0,0,0,0,0,0,0,0
HIMACHAL PRADESH,2011,REGISTRATION OF FOREIGNERS ACT,0,0,0,0,0,0,0,0,0,0,0,0,0,0,0
HIMACHAL PRADESH,2011,PROTECTION OF CIVIL RIGHTS ACT,0,0,0,0,0,0,0,0,0,0,0,0,0,0,0
HIMACHAL PRADESH,2011,SC/ST (PREVENTION OF ATROCITIES) ACT,0,0,0,3,0,3,0,0,0,2,0,2,5,0,5
HIMACHAL PRADESH,2011,INDIAN PASSPORT ACT,0,0,0,0,0,0,0,0,0,0,0,0,0,0,0
HIMACHAL PRADESH,2011,ESSENTIAL COMMODITIES ACT,0,0,0,0,0,0,0,0,0,0,0,0,0,0,0
HIMACHAL PRADESH,2011,ANTIQUITIES AND ART TREASURE ACT,0,0,0,0,0,0,0,0,0,0,0,0,0,0,0
HIMACHAL PRADESH,2011,DOWRY PROHIBITION ACT,0,0,0,0,0,0,0,0,0,0,0,0,0,0,0
HIMACHAL PRADESH,2011,FOREIGN EXCHANGE REGULATION ACT-1973,0,0,0,0,0,0,0,0,0,0,0,0,0,0,0
HIMACHAL PRADESH,2011,PREVENTION OF CORRUPTION ACT-1988,0,0,0,0,0,0,0,0,0,0,0,0,0,0,0
HIMACHAL PRADESH,2011,CONSER.OF FORGN.EXCH.&PREV. OF SMUG.ACT,0,0,0,0,0,0,0,0,0,0,0,0,0,0,0
HIMACHAL PRADESH,2011,OTHER SLL OFFENCE,0,0,0,6,0,6,2,2,4,0,0,0,8,2,10
HIMACHAL PRADESH,2011,TOTAL,0,0,0,64,0,64,70,3,73,14,0,14,148,3,151
HIMACHAL PRADESH,2012,ARMS ACT,0,0,0,2,0,2,0,0,0,0,0,0,2,0,2
HIMACHAL PRADESH,2012,N.D.P.S. ACT,0,0,0,81,0,81,78,1,79,13,1,14,172,2,174
HIMACHAL PRADESH,2012,GAMBLING ACT,0,0,0,0,0,0,0,0,0,0,0,0,0,0,0
HIMACHAL PRADESH,2012,EXCISE ACT,0,0,0,2,0,2,1,0,1,0,0,0,3,0,3
HIMACHAL PRADESH,2012,PROHIBITION ACT,0,0,0,0,0,0,0,0,0,0,0,0,0,0,0
HIMACHAL PRADESH,2012,EXPLOSIVE & EXPLOSIVE SUBST. ACT,0,0,0,0,0,0,0,0,0,0,0,0,0,0,0
HIMACHAL PRADESH,2012,TERRORIST & DISRUPTIVE ACTIVITIES (TATA),0,0,0,0,0,0,0,0,0,0,0,0,0,0,0
HIMACHAL PRADESH,2012,IMMORAL TRAFFIC (PREVENTION) ACT,0,0,0,0,0,0,0,0,0,0,0,0,0,0,0
HIMACHAL PRADESH,2012,INDIAN RAILWAYS ACT,0,0,0,0,0,0,0,0,0,0,0,0,0,0,0
HIMACHAL PRADESH,2012,REGISTRATION OF FOREIGNERS ACT,0,0,0,0,0,0,2,0,2,0,0,0,2,0,2
HIMACHAL PRADESH,2012,PROTECTION OF CIVIL RIGHTS ACT,0,0,0,0,0,0,0,0,0,0,0,0,0,0,0
HIMACHAL PRADESH,2012,SC/ST (PREVENTION OF ATROCITIES) ACT,0,0,0,0,0,0,0,0,0,0,0,0,0,0,0
HIMACHAL PRADESH,2012,INDIAN PASSPORT ACT,0,0,0,0,0,0,0,0,0,0,0,0,0,0,0
HIMACHAL PRADESH,2012,ESSENTIAL COMMODITIES ACT,0,0,0,0,0,0,0,0,0,0,0,0,0,0,0
HIMACHAL PRADESH,2012,ANTIQUITIES AND ART TREASURE ACT,0,0,0,0,0,0,0,0,0,0,0,0,0,0,0
HIMACHAL PRADESH,2012,DOWRY PROHIBITION ACT,0,0,0,0,0,0,0,0,0,0,0,0,0,0,0
HIMACHAL PRADESH,2012,FOREIGN EXCHANGE REGULATION ACT-1973,0,0,0,0,0,0,0,0,0,0,0,0,0,0,0
HIMACHAL PRADESH,2012,PREVENTION OF CORRUPTION ACT-1988,0,0,0,0,0,0,2,0,2,0,0,0,2,0,2
HIMACHAL PRADESH,2012,CONSER.OF FORGN.EXCH.&PREV. OF SMUG.ACT,0,0,0,0,0,0,0,0,0,0,0,0,0,0,0
HIMACHAL PRADESH,2012,OTHER SLL OFFENCE,0,0,0,5,0,5,5,0,5,1,1,2,11,1,12
HIMACHAL PRADESH,2012,TOTAL,0,0,0,90,0,90,88,1,89,14,2,16,192,3,195
JAMMU & KASHMIR,2001,ARMS ACT,11,0,11,166,0,166,106,0,106,12,0,12,295,0,295
JAMMU & KASHMIR,2001,N.D.P.S. ACT,2,0,2,29,1,30,19,1,20,3,0,3,53,2,55
JAMMU & KASHMIR,2001,GAMBLING ACT,0,0,0,0,0,0,0,0,0,0,0,0,0,0,0
JAMMU & KASHMIR,2001,EXCISE ACT,0,0,0,1,0,1,0,0,0,0,0,0,1,0,1
JAMMU & KASHMIR,2001,PROHIBITION ACT,0,0,0,0,0,0,0,0,0,0,0,0,0,0,0
JAMMU & KASHMIR,2001,EXPLOSIVE & EXPLOSIVE SUBST. ACT,1,0,1,22,0,22,2,0,2,0,0,0,25,0,25
JAMMU & KASHMIR,2001,TERRORIST & DISRUPTIVE ACTIVITIES (TATA),0,0,0,3,0,3,3,0,3,1,0,1,7,0,7
JAMMU & KASHMIR,2001,IMMORAL TRAFFIC (PREVENTION) ACT,0,0,0,0,0,0,0,0,0,0,0,0,0,0,0
JAMMU & KASHMIR,2001,INDIAN RAILWAYS ACT,0,0,0,0,0,0,0,0,0,0,0,0,0,0,0
JAMMU & KASHMIR,2001,REGISTRATION OF FOREIGNERS ACT,2,0,2,0,0,0,1,0,1,1,0,1,4,0,4
JAMMU & KASHMIR,2001,PROTECTION OF CIVIL RIGHTS ACT,0,0,0,0,0,0,0,0,0,0,0,0,0,0,0
JAMMU & KASHMIR,2001,SC/ST (PREVENTION OF ATROCITIES) ACT,0,0,0,0,0,0,0,0,0,0,0,0,0,0,0
JAMMU & KASHMIR,2001,INDIAN PASSPORT ACT,0,0,0,0,0,0,0,0,0,0,0,0,0,0,0
JAMMU & KASHMIR,2001,ESSENTIAL COMMODITIES ACT,5,0,5,8,0,8,2,0,2,0,0,0,15,0,15
JAMMU & KASHMIR,2001,ANTIQUITIES AND ART TREASURE ACT,0,0,0,0,0,0,0,0,0,0,0,0,0,0,0
JAMMU & KASHMIR,2001,DOWRY PROHIBITION ACT,0,0,0,0,0,0,0,0,0,0,0,0,0,0,0
JAMMU & KASHMIR,2001,FOREIGN EXCHANGE REGULATION ACT-1973,0,0,0,0,0,0,0,0,0,0,0,0,0,0,0
JAMMU & KASHMIR,2001,PREVENTION OF CORRUPTION ACT-1988,0,0,0,3,0,3,0,0,0,0,0,0,3,0,3
JAMMU & KASHMIR,2001,CONSER.OF FORGN.EXCH.&PREV. OF SMUG.ACT,0,0,0,0,0,0,0,0,0,0,0,0,0,0,0
JAMMU & KASHMIR,2001,OTHER SLL OFFENCE,1,0,1,45,1,46,0,0,0,7,1,8,53,2,55
JAMMU & KASHMIR,2001,TOTAL,22,0,22,277,2,279,133,1,134,24,1,25,456,4,460
JAMMU & KASHMIR,2002,ARMS ACT,0,0,0,51,0,51,31,0,31,2,0,2,84,0,84
JAMMU & KASHMIR,2002,N.D.P.S. ACT,3,0,3,19,1,20,38,2,40,9,0,9,69,3,72
JAMMU & KASHMIR,2002,GAMBLING ACT,1,0,1,3,0,3,6,0,6,1,0,1,11,0,11
JAMMU & KASHMIR,2002,EXCISE ACT,0,0,0,0,0,0,1,0,1,0,0,0,1,0,1
JAMMU & KASHMIR,2002,PROHIBITION ACT,0,0,0,0,0,0,0,0,0,0,0,0,0,0,0
JAMMU & KASHMIR,2002,EXPLOSIVE & EXPLOSIVE SUBST. ACT,0,0,0,4,0,4,6,0,6,2,0,2,12,0,12
JAMMU & KASHMIR,2002,TERRORIST & DISRUPTIVE ACTIVITIES (TATA),0,0,0,5,0,5,2,0,2,0,0,0,7,0,7
JAMMU & KASHMIR,2002,IMMORAL TRAFFIC (PREVENTION) ACT,0,0,0,0,0,0,0,0,0,0,0,0,0,0,0
JAMMU & KASHMIR,2002,INDIAN RAILWAYS ACT,0,0,0,2,0,2,0,0,0,2,0,2,4,0,4
JAMMU & KASHMIR,2002,REGISTRATION OF FOREIGNERS ACT,0,0,0,0,0,0,0,0,0,1,0,1,1,0,1
JAMMU & KASHMIR,2002,PROTECTION OF CIVIL RIGHTS ACT,0,0,0,0,0,0,0,0,0,0,0,0,0,0,0
JAMMU & KASHMIR,2002,SC/ST (PREVENTION OF ATROCITIES) ACT,0,0,0,0,0,0,0,0,0,0,0,0,0,0,0
JAMMU & KASHMIR,2002,INDIAN PASSPORT ACT,0,0,0,0,0,0,0,0,0,0,0,0,0,0,0
JAMMU & KASHMIR,2002,ESSENTIAL COMMODITIES ACT,0,0,0,4,0,4,0,0,0,3,0,3,7,0,7
JAMMU & KASHMIR,2002,ANTIQUITIES AND ART TREASURE ACT,0,0,0,2,0,2,0,0,0,5,0,5,7,0,7
JAMMU & KASHMIR,2002,DOWRY PROHIBITION ACT,0,0,0,0,0,0,0,0,0,0,0,0,0,0,0
JAMMU & KASHMIR,2002,FOREIGN EXCHANGE REGULATION ACT-1973,0,0,0,0,0,0,0,0,0,0,0,0,0,0,0
JAMMU & KASHMIR,2002,PREVENTION OF CORRUPTION ACT-1988,0,0,0,0,0,0,0,0,0,0,0,0,0,0,0
JAMMU & KASHMIR,2002,CONSER.OF FORGN.EXCH.&PREV. OF SMUG.ACT,0,0,0,0,0,0,0,0,0,0,0,0,0,0,0
JAMMU & KASHMIR,2002,OTHER SLL OFFENCE,0,0,0,46,0,46,22,0,22,4,0,4,72,0,72
JAMMU & KASHMIR,2002,TOTAL,4,0,4,136,1,137,106,2,108,29,0,29,275,3,278
JAMMU & KASHMIR,2003,ARMS ACT,6,0,6,115,2,117,43,0,43,5,0,5,169,2,171
JAMMU & KASHMIR,2003,N.D.P.S. ACT,2,0,2,34,0,34,18,2,20,4,0,4,58,2,60
JAMMU & KASHMIR,2003,GAMBLING ACT,1,0,1,2,0,2,0,0,0,0,0,0,3,0,3
JAMMU & KASHMIR,2003,EXCISE ACT,0,0,0,0,0,0,13,0,13,0,0,0,13,0,13
JAMMU & KASHMIR,2003,PROHIBITION ACT,0,0,0,0,0,0,0,0,0,0,0,0,0,0,0
JAMMU & KASHMIR,2003,EXPLOSIVE & EXPLOSIVE SUBST. ACT,1,0,1,26,0,26,7,0,7,4,0,4,38,0,38
JAMMU & KASHMIR,2003,TERRORIST & DISRUPTIVE ACTIVITIES (TATA),0,0,0,17,0,17,5,0,5,2,0,2,24,0,24
JAMMU & KASHMIR,2003,IMMORAL TRAFFIC (PREVENTION) ACT,0,0,0,0,0,0,0,0,0,3,0,3,3,0,3
JAMMU & KASHMIR,2003,INDIAN RAILWAYS ACT,0,0,0,0,0,0,0,0,0,0,0,0,0,0,0
JAMMU & KASHMIR,2003,REGISTRATION OF FOREIGNERS ACT,1,0,1,10,0,10,7,0,7,0,1,1,18,1,19
JAMMU & KASHMIR,2003,PROTECTION OF CIVIL RIGHTS ACT,0,0,0,0,0,0,0,0,0,0,0,0,0,0,0
JAMMU & KASHMIR,2003,SC/ST (PREVENTION OF ATROCITIES) ACT,0,0,0,0,0,0,0,0,0,0,0,0,0,0,0
JAMMU & KASHMIR,2003,INDIAN PASSPORT ACT,0,0,0,104,0,104,0,0,0,0,0,0,104,0,104
JAMMU & KASHMIR,2003,ESSENTIAL COMMODITIES ACT,2,0,2,0,0,0,0,0,0,0,0,0,2,0,2
JAMMU & KASHMIR,2003,ANTIQUITIES AND ART TREASURE ACT,0,0,0,0,0,0,0,0,0,0,0,0,0,0,0
JAMMU & KASHMIR,2003,DOWRY PROHIBITION ACT,0,0,0,0,0,0,0,0,0,0,0,0,0,0,0
JAMMU & KASHMIR,2003,FOREIGN EXCHANGE REGULATION ACT-1973,0,0,0,0,0,0,0,0,0,0,0,0,0,0,0
JAMMU & KASHMIR,2003,PREVENTION OF CORRUPTION ACT-1988,0,0,0,0,0,0,0,0,0,0,0,0,0,0,0
JAMMU & KASHMIR,2003,CONSER.OF FORGN.EXCH.&PREV. OF SMUG.ACT,0,0,0,0,0,0,0,0,0,0,0,0,0,0,0
JAMMU & KASHMIR,2003,OTHER SLL OFFENCE,0,0,0,23,1,24,69,0,69,2,0,2,94,1,95
JAMMU & KASHMIR,2003,TOTAL,13,0,13,331,3,334,162,2,164,20,1,21,526,6,532
JAMMU & KASHMIR,2004,ARMS ACT,1,0,1,96,0,96,51,0,51,16,0,16,164,0,164
JAMMU & KASHMIR,2004,N.D.P.S. ACT,0,0,0,41,0,41,27,1,28,6,0,6,74,1,75
JAMMU & KASHMIR,2004,GAMBLING ACT,0,0,0,0,0,0,0,0,0,0,0,0,0,0,0
JAMMU & KASHMIR,2004,EXCISE ACT,0,0,0,1,0,1,0,0,0,0,0,0,1,0,1
JAMMU & KASHMIR,2004,PROHIBITION ACT,0,0,0,2,0,2,0,0,0,0,0,0,2,0,2
JAMMU & KASHMIR,2004,EXPLOSIVE & EXPLOSIVE SUBST. ACT,0,0,0,3,0,3,4,0,4,1,0,1,8,0,8
JAMMU & KASHMIR,2004,TERRORIST & DISRUPTIVE ACTIVITIES (TATA),0,0,0,29,0,29,16,0,16,0,0,0,45,0,45
JAMMU & KASHMIR,2004,IMMORAL TRAFFIC (PREVENTION) ACT,0,0,0,0,0,0,0,0,0,0,0,0,0,0,0
JAMMU & KASHMIR,2004,INDIAN RAILWAYS ACT,0,0,0,0,0,0,0,0,0,0,0,0,0,0,0
JAMMU & KASHMIR,2004,REGISTRATION OF FOREIGNERS ACT,2,0,2,7,0,7,4,0,4,2,0,2,15,0,15
JAMMU & KASHMIR,2004,PROTECTION OF CIVIL RIGHTS ACT,0,0,0,0,0,0,0,0,0,0,0,0,0,0,0
JAMMU & KASHMIR,2004,SC/ST (PREVENTION OF ATROCITIES) ACT,0,0,0,0,0,0,0,0,0,0,0,0,0,0,0
JAMMU & KASHMIR,2004,INDIAN PASSPORT ACT,0,0,0,1,0,1,0,0,0,0,0,0,1,0,1
JAMMU & KASHMIR,2004,ESSENTIAL COMMODITIES ACT,0,0,0,0,0,0,0,0,0,0,0,0,0,0,0
JAMMU & KASHMIR,2004,ANTIQUITIES AND ART TREASURE ACT,0,0,0,0,0,0,0,0,0,0,0,0,0,0,0
JAMMU & KASHMIR,2004,DOWRY PROHIBITION ACT,0,0,0,0,0,0,0,2,2,0,0,0,0,2,2
JAMMU & KASHMIR,2004,FOREIGN EXCHANGE REGULATION ACT-1973,0,0,0,0,0,0,0,0,0,0,0,0,0,0,0
JAMMU & KASHMIR,2004,PREVENTION OF CORRUPTION ACT-1988,0,0,0,0,0,0,0,0,0,0,0,0,0,0,0
JAMMU & KASHMIR,2004,CONSER.OF FORGN.EXCH.&PREV. OF SMUG.ACT,0,0,0,0,0,0,0,0,0,0,0,0,0,0,0
JAMMU & KASHMIR,2004,OTHER SLL OFFENCE,0,0,0,13,0,13,7,0,7,2,0,2,22,0,22
JAMMU & KASHMIR,2004,TOTAL,3,0,3,193,0,193,109,3,112,27,0,27,332,3,335
JAMMU & KASHMIR,2005,ARMS ACT,0,0,0,103,1,104,53,0,53,6,0,6,162,1,163
JAMMU & KASHMIR,2005,N.D.P.S. ACT,0,0,0,44,0,44,73,0,73,22,0,22,139,0,139
JAMMU & KASHMIR,2005,GAMBLING ACT,0,0,0,0,0,0,0,0,0,0,0,0,0,0,0
JAMMU & KASHMIR,2005,EXCISE ACT,0,0,0,2,0,2,0,0,0,0,0,0,2,0,2
JAMMU & KASHMIR,2005,PROHIBITION ACT,0,0,0,0,0,0,0,0,0,0,0,0,0,0,0
JAMMU & KASHMIR,2005,EXPLOSIVE & EXPLOSIVE SUBST. ACT,0,0,0,32,0,32,18,0,18,6,0,6,56,0,56
JAMMU & KASHMIR,2005,TERRORIST & DISRUPTIVE ACTIVITIES (TATA),0,0,0,27,0,27,16,0,16,2,0,2,45,0,45
JAMMU & KASHMIR,2005,IMMORAL TRAFFIC (PREVENTION) ACT,0,0,0,0,1,1,0,0,0,0,0,0,0,1,1
JAMMU & KASHMIR,2005,INDIAN RAILWAYS ACT,0,0,0,0,0,0,0,0,0,0,0,0,0,0,0
JAMMU & KASHMIR,2005,REGISTRATION OF FOREIGNERS ACT,1,0,1,7,0,7,8,0,8,2,0,2,18,0,18
JAMMU & KASHMIR,2005,PROTECTION OF CIVIL RIGHTS ACT,0,0,0,0,0,0,0,0,0,0,0,0,0,0,0
JAMMU & KASHMIR,2005,SC/ST (PREVENTION OF ATROCITIES) ACT,0,0,0,0,0,0,0,0,0,0,0,0,0,0,0
JAMMU & KASHMIR,2005,INDIAN PASSPORT ACT,0,0,0,0,0,0,1,0,1,0,0,0,1,0,1
JAMMU & KASHMIR,2005,ESSENTIAL COMMODITIES ACT,0,0,0,0,0,0,0,0,0,0,0,0,0,0,0
JAMMU & KASHMIR,2005,ANTIQUITIES AND ART TREASURE ACT,0,0,0,0,0,0,0,0,0,0,0,0,0,0,0
JAMMU & KASHMIR,2005,DOWRY PROHIBITION ACT,0,0,0,0,0,0,0,0,0,0,0,0,0,0,0
JAMMU & KASHMIR,2005,FOREIGN EXCHANGE REGULATION ACT-1973,0,0,0,0,0,0,0,0,0,0,0,0,0,0,0
JAMMU & KASHMIR,2005,PREVENTION OF CORRUPTION ACT-1988,0,0,0,0,0,0,0,0,0,1,0,1,1,0,1
JAMMU & KASHMIR,2005,CONSER.OF FORGN.EXCH.&PREV. OF SMUG.ACT,0,0,0,0,0,0,0,0,0,0,0,0,0,0,0
JAMMU & KASHMIR,2005,OTHER SLL OFFENCE,0,0,0,17,0,17,11,0,11,5,0,5,33,0,33
JAMMU & KASHMIR,2005,TOTAL,1,0,1,232,2,234,180,0,180,44,0,44,457,2,459
JAMMU & KASHMIR,2006,ARMS ACT,0,0,0,38,0,38,57,0,57,2,0,2,97,0,97
JAMMU & KASHMIR,2006,N.D.P.S. ACT,0,0,0,52,0,52,50,0,50,14,0,14,116,0,116
JAMMU & KASHMIR,2006,GAMBLING ACT,0,0,0,0,0,0,0,0,0,0,0,0,0,0,0
JAMMU & KASHMIR,2006,EXCISE ACT,0,0,0,1,0,1,1,0,1,0,0,0,2,0,2
JAMMU & KASHMIR,2006,PROHIBITION ACT,0,0,0,0,0,0,0,0,0,0,0,0,0,0,0
JAMMU & KASHMIR,2006,EXPLOSIVE & EXPLOSIVE SUBST. ACT,0,0,0,45,0,45,25,0,25,8,0,8,78,0,78
JAMMU & KASHMIR,2006,TERRORIST & DISRUPTIVE ACTIVITIES (TATA),0,0,0,14,0,14,1,0,1,0,0,0,15,0,15
JAMMU & KASHMIR,2006,IMMORAL TRAFFIC (PREVENTION) ACT,0,0,0,0,0,0,0,0,0,0,0,0,0,0,0
JAMMU & KASHMIR,2006,INDIAN RAILWAYS ACT,0,0,0,6,0,6,6,0,6,0,0,0,12,0,12
JAMMU & KASHMIR,2006,REGISTRATION OF FOREIGNERS ACT,4,0,4,22,0,22,10,0,10,5,0,5,41,0,41
JAMMU & KASHMIR,2006,PROTECTION OF CIVIL RIGHTS ACT,0,0,0,0,0,0,0,0,0,0,0,0,0,0,0
JAMMU & KASHMIR,2006,SC/ST (PREVENTION OF ATROCITIES) ACT,0,0,0,0,0,0,0,0,0,0,0,0,0,0,0
JAMMU & KASHMIR,2006,INDIAN PASSPORT ACT,0,0,0,0,0,0,0,0,0,0,0,0,0,0,0
JAMMU & KASHMIR,2006,ESSENTIAL COMMODITIES ACT,0,0,0,0,0,0,0,0,0,0,0,0,0,0,0
JAMMU & KASHMIR,2006,ANTIQUITIES AND ART TREASURE ACT,0,0,0,0,0,0,0,0,0,0,0,0,0,0,0
JAMMU & KASHMIR,2006,DOWRY PROHIBITION ACT,0,0,0,0,0,0,0,0,0,0,0,0,0,0,0
JAMMU & KASHMIR,2006,FOREIGN EXCHANGE REGULATION ACT-1973,0,0,0,0,0,0,0,0,0,0,0,0,0,0,0
JAMMU & KASHMIR,2006,PREVENTION OF CORRUPTION ACT-1988,0,0,0,0,0,0,0,0,0,0,0,0,0,0,0
JAMMU & KASHMIR,2006,CONSER.OF FORGN.EXCH.&PREV. OF SMUG.ACT,0,0,0,0,0,0,0,0,0,0,0,0,0,0,0
JAMMU & KASHMIR,2006,OTHER SLL OFFENCE,0,0,0,38,0,38,6,0,6,0,0,0,44,0,44
JAMMU & KASHMIR,2006,TOTAL,4,0,4,216,0,216,156,0,156,29,0,29,405,0,405
JAMMU & KASHMIR,2007,ARMS ACT,0,0,0,141,2,143,62,0,62,0,0,0,203,2,205
JAMMU & KASHMIR,2007,N.D.P.S. ACT,0,0,0,66,0,66,64,0,64,39,0,39,169,0,169
JAMMU & KASHMIR,2007,GAMBLING ACT,0,0,0,2,0,2,1,0,1,0,0,0,3,0,3
JAMMU & KASHMIR,2007,EXCISE ACT,0,0,0,1,0,1,0,0,0,0,0,0,1,0,1
JAMMU & KASHMIR,2007,PROHIBITION ACT,0,0,0,1,0,1,0,0,0,0,0,0,1,0,1
JAMMU & KASHMIR,2007,EXPLOSIVE & EXPLOSIVE SUBST. ACT,0,0,0,13,0,13,10,0,10,17,0,17,40,0,40
JAMMU & KASHMIR,2007,TERRORIST & DISRUPTIVE ACTIVITIES (TATA),0,0,0,1,0,1,2,0,2,1,0,1,4,0,4
JAMMU & KASHMIR,2007,IMMORAL TRAFFIC (PREVENTION) ACT,0,0,0,3,0,3,1,0,1,0,0,0,4,0,4
JAMMU & KASHMIR,2007,INDIAN RAILWAYS ACT,0,0,0,0,0,0,0,0,0,0,0,0,0,0,0
JAMMU & KASHMIR,2007,REGISTRATION OF FOREIGNERS ACT,0,0,0,45,2,47,16,0,16,4,0,4,65,2,67
JAMMU & KASHMIR,2007,PROTECTION OF CIVIL RIGHTS ACT,0,0,0,0,0,0,0,0,0,0,0,0,0,0,0
JAMMU & KASHMIR,2007,SC/ST (PREVENTION OF ATROCITIES) ACT,0,0,0,0,0,0,0,0,0,0,0,0,0,0,0
JAMMU & KASHMIR,2007,INDIAN PASSPORT ACT,0,0,0,0,0,0,1,0,1,0,0,0,1,0,1
JAMMU & KASHMIR,2007,ESSENTIAL COMMODITIES ACT,0,0,0,0,0,0,0,0,0,0,0,0,0,0,0
JAMMU & KASHMIR,2007,ANTIQUITIES AND ART TREASURE ACT,0,0,0,0,0,0,0,0,0,0,0,0,0,0,0
JAMMU & KASHMIR,2007,DOWRY PROHIBITION ACT,0,0,0,0,0,0,0,0,0,0,0,0,0,0,0
JAMMU & KASHMIR,2007,FOREIGN EXCHANGE REGULATION ACT-1973,0,0,0,0,0,0,0,0,0,0,0,0,0,0,0
JAMMU & KASHMIR,2007,PREVENTION OF CORRUPTION ACT-1988,0,0,0,1,0,1,0,0,0,0,0,0,1,0,1
JAMMU & KASHMIR,2007,CONSER.OF FORGN.EXCH.&PREV. OF SMUG.ACT,0,0,0,0,0,0,0,0,0,0,0,0,0,0,0
JAMMU & KASHMIR,2007,OTHER SLL OFFENCE,0,0,0,8,0,8,27,0,27,1,0,1,36,0,36
JAMMU & KASHMIR,2007,TOTAL,0,0,0,282,4,286,184,0,184,62,0,62,528,4,532
JAMMU & KASHMIR,2008,ARMS ACT,0,0,0,0,0,0,0,0,0,0,0,0,0,0,0
JAMMU & KASHMIR,2008,N.D.P.S. ACT,0,0,0,90,1,91,46,1,47,18,0,18,154,2,156
JAMMU & KASHMIR,2008,GAMBLING ACT,0,0,0,86,0,86,85,0,85,24,0,24,195,0,195
JAMMU & KASHMIR,2008,EXCISE ACT,0,0,0,0,0,0,0,0,0,0,0,0,0,0,0
JAMMU & KASHMIR,2008,PROHIBITION ACT,0,0,0,0,0,0,1,0,1,0,0,0,1,0,1
JAMMU & KASHMIR,2008,EXPLOSIVE & EXPLOSIVE SUBST. ACT,0,0,0,41,1,42,27,0,27,4,0,4,72,1,73
JAMMU & KASHMIR,2008,TERRORIST & DISRUPTIVE ACTIVITIES (TATA),0,0,0,3,0,3,0,0,0,2,0,2,5,0,5
JAMMU & KASHMIR,2008,IMMORAL TRAFFIC (PREVENTION) ACT,0,0,0,0,0,0,0,0,0,0,0,0,0,0,0
JAMMU & KASHMIR,2008,INDIAN RAILWAYS ACT,0,0,0,2,0,2,3,0,3,0,0,0,5,0,5
JAMMU & KASHMIR,2008,REGISTRATION OF FOREIGNERS ACT,1,0,1,23,0,23,9,0,9,4,1,5,37,1,38
JAMMU & KASHMIR,2008,PROTECTION OF CIVIL RIGHTS ACT,0,0,0,0,0,0,0,0,0,0,0,0,0,0,0
JAMMU & KASHMIR,2008,SC/ST (PREVENTION OF ATROCITIES) ACT,0,0,0,0,0,0,0,0,0,0,0,0,0,0,0
JAMMU & KASHMIR,2008,INDIAN PASSPORT ACT,0,0,0,0,0,0,0,0,0,0,0,0,0,0,0
JAMMU & KASHMIR,2008,ESSENTIAL COMMODITIES ACT,0,0,0,0,0,0,0,0,0,0,0,0,0,0,0
JAMMU & KASHMIR,2008,ANTIQUITIES AND ART TREASURE ACT,0,0,0,0,0,0,0,0,0,0,0,0,0,0,0
JAMMU & KASHMIR,2008,DOWRY PROHIBITION ACT,0,0,0,0,0,0,0,0,0,0,0,0,0,0,0
JAMMU & KASHMIR,2008,FOREIGN EXCHANGE REGULATION ACT-1973,0,0,0,0,0,0,0,0,0,0,0,0,0,0,0
JAMMU & KASHMIR,2008,PREVENTION OF CORRUPTION ACT-1988,0,0,0,3,0,3,3,0,3,0,0,0,6,0,6
JAMMU & KASHMIR,2008,CONSER.OF FORGN.EXCH.&PREV. OF SMUG.ACT,0,0,0,0,0,0,0,0,0,0,0,0,0,0,0
JAMMU & KASHMIR,2008,OTHER SLL OFFENCE,0,0,0,11,0,11,10,0,10,0,0,0,21,0,21
JAMMU & KASHMIR,2008,TOTAL,1,0,1,259,2,261,184,1,185,52,1,53,496,4,500
JAMMU & KASHMIR,2009,ARMS ACT,0,0,0,82,0,82,37,0,37,12,0,12,131,0,131
JAMMU & KASHMIR,2009,N.D.P.S. ACT,0,0,0,79,0,79,57,5,62,17,0,17,153,5,158
JAMMU & KASHMIR,2009,GAMBLING ACT,0,0,0,8,0,8,13,0,13,0,0,0,21,0,21
JAMMU & KASHMIR,2009,EXCISE ACT,0,0,0,0,0,0,0,0,0,0,0,0,0,0,0
JAMMU & KASHMIR,2009,PROHIBITION ACT,0,0,0,0,0,0,0,0,0,0,0,0,0,0,0
JAMMU & KASHMIR,2009,EXPLOSIVE & EXPLOSIVE SUBST. ACT,0,0,0,11,0,11,8,1,9,0,0,0,19,1,20
JAMMU & KASHMIR,2009,TERRORIST & DISRUPTIVE ACTIVITIES (TATA),0,0,0,0,0,0,6,0,6,0,0,0,6,0,6
JAMMU & KASHMIR,2009,IMMORAL TRAFFIC (PREVENTION) ACT,0,0,0,0,0,0,0,0,0,0,0,0,0,0,0
JAMMU & KASHMIR,2009,INDIAN RAILWAYS ACT,0,0,0,4,0,4,0,0,0,0,0,0,4,0,4
JAMMU & KASHMIR,2009,REGISTRATION OF FOREIGNERS ACT,0,0,0,11,0,11,6,1,7,4,0,4,21,1,22
JAMMU & KASHMIR,2009,PROTECTION OF CIVIL RIGHTS ACT,0,0,0,0,0,0,0,0,0,0,0,0,0,0,0
JAMMU & KASHMIR,2009,SC/ST (PREVENTION OF ATROCITIES) ACT,0,0,0,0,0,0,0,0,0,0,0,0,0,0,0
JAMMU & KASHMIR,2009,INDIAN PASSPORT ACT,0,0,0,0,0,0,0,0,0,0,0,0,0,0,0
JAMMU & KASHMIR,2009,ESSENTIAL COMMODITIES ACT,0,0,0,0,0,0,0,0,0,0,0,0,0,0,0
JAMMU & KASHMIR,2009,ANTIQUITIES AND ART TREASURE ACT,0,0,0,0,0,0,0,0,0,0,0,0,0,0,0
JAMMU & KASHMIR,2009,DOWRY PROHIBITION ACT,0,0,0,0,0,0,0,0,0,0,0,0,0,0,0
JAMMU & KASHMIR,2009,FOREIGN EXCHANGE REGULATION ACT-1973,0,0,0,0,0,0,0,0,0,0,0,0,0,0,0
JAMMU & KASHMIR,2009,PREVENTION OF CORRUPTION ACT-1988,0,0,0,0,0,0,0,0,0,0,0,0,0,0,0
JAMMU & KASHMIR,2009,CONSER.OF FORGN.EXCH.&PREV. OF SMUG.ACT,0,0,0,0,0,0,0,0,0,0,0,0,0,0,0
JAMMU & KASHMIR,2009,OTHER SLL OFFENCE,0,0,0,32,0,32,53,0,53,0,0,0,85,0,85
JAMMU & KASHMIR,2009,TOTAL,0,0,0,227,0,227,180,7,187,33,0,33,440,7,447
JAMMU & KASHMIR,2010,ARMS ACT,0,0,0,140,0,140,61,2,63,4,0,4,205,2,207
JAMMU & KASHMIR,2010,N.D.P.S. ACT,0,0,0,162,0,162,289,2,291,14,0,14,465,2,467
JAMMU & KASHMIR,2010,GAMBLING ACT,0,0,0,0,0,0,0,0,0,0,0,0,0,0,0
JAMMU & KASHMIR,2010,EXCISE ACT,0,0,0,0,0,0,0,0,0,0,0,0,0,0,0
JAMMU & KASHMIR,2010,PROHIBITION ACT,0,0,0,0,0,0,0,0,0,0,0,0,0,0,0
JAMMU & KASHMIR,2010,EXPLOSIVE & EXPLOSIVE SUBST. ACT,0,0,0,5,0,5,5,0,5,2,0,2,12,0,12
JAMMU & KASHMIR,2010,TERRORIST & DISRUPTIVE ACTIVITIES (TATA),0,0,0,0,0,0,1,0,1,0,0,0,1,0,1
JAMMU & KASHMIR,2010,IMMORAL TRAFFIC (PREVENTION) ACT,0,0,0,0,0,0,0,0,0,0,0,0,0,0,0
JAMMU & KASHMIR,2010,INDIAN RAILWAYS ACT,0,0,0,0,0,0,0,0,0,0,0,0,0,0,0
JAMMU & KASHMIR,2010,REGISTRATION OF FOREIGNERS ACT,0,0,0,21,0,21,10,0,10,0,0,0,31,0,31
JAMMU & KASHMIR,2010,PROTECTION OF CIVIL RIGHTS ACT,0,0,0,0,0,0,0,0,0,0,0,0,0,0,0
JAMMU & KASHMIR,2010,SC/ST (PREVENTION OF ATROCITIES) ACT,0,0,0,0,0,0,0,0,0,0,0,0,0,0,0
JAMMU & KASHMIR,2010,INDIAN PASSPORT ACT,0,0,0,0,0,0,0,0,0,0,0,0,0,0,0
JAMMU & KASHMIR,2010,ESSENTIAL COMMODITIES ACT,0,0,0,0,0,0,0,0,0,0,0,0,0,0,0
JAMMU & KASHMIR,2010,ANTIQUITIES AND ART TREASURE ACT,0,0,0,0,0,0,0,0,0,0,0,0,0,0,0
JAMMU & KASHMIR,2010,DOWRY PROHIBITION ACT,0,0,0,0,0,0,0,0,0,0,0,0,0,0,0
JAMMU & KASHMIR,2010,FOREIGN EXCHANGE REGULATION ACT-1973,0,0,0,0,0,0,0,0,0,0,0,0,0,0,0
JAMMU & KASHMIR,2010,PREVENTION OF CORRUPTION ACT-1988,0,0,0,0,0,0,0,0,0,0,0,0,0,0,0
JAMMU & KASHMIR,2010,CONSER.OF FORGN.EXCH.&PREV. OF SMUG.ACT,0,0,0,41,0,41,16,0,16,3,0,3,60,0,60
JAMMU & KASHMIR,2010,OTHER SLL OFFENCE,0,0,0,18,3,21,22,1,23,9,0,9,49,4,53
JAMMU & KASHMIR,2010,TOTAL,0,0,0,387,3,390,404,5,409,32,0,32,823,8,831
JAMMU & KASHMIR,2011,ARMS ACT,0,0,0,43,1,44,61,1,62,5,0,5,109,2,111
JAMMU & KASHMIR,2011,N.D.P.S. ACT,0,0,0,152,2,154,99,1,100,24,1,25,275,4,279
JAMMU & KASHMIR,2011,GAMBLING ACT,0,0,0,0,0,0,0,0,0,0,0,0,0,0,0
JAMMU & KASHMIR,2011,EXCISE ACT,0,0,0,0,0,0,0,0,0,0,0,0,0,0,0
JAMMU & KASHMIR,2011,PROHIBITION ACT,0,0,0,0,0,0,0,0,0,0,0,0,0,0,0
JAMMU & KASHMIR,2011,EXPLOSIVE & EXPLOSIVE SUBST. ACT,0,0,0,20,0,20,3,0,3,3,0,3,26,0,26
JAMMU & KASHMIR,2011,TERRORIST & DISRUPTIVE ACTIVITIES (TATA),0,0,0,1,0,1,1,0,1,0,0,0,2,0,2
JAMMU & KASHMIR,2011,IMMORAL TRAFFIC (PREVENTION) ACT,0,0,0,0,0,0,0,0,0,0,0,0,0,0,0
JAMMU & KASHMIR,2011,INDIAN RAILWAYS ACT,0,0,0,0,0,0,0,0,0,0,0,0,0,0,0
JAMMU & KASHMIR,2011,REGISTRATION OF FOREIGNERS ACT,0,0,0,6,0,6,8,0,8,0,0,0,14,0,14
JAMMU & KASHMIR,2011,PROTECTION OF CIVIL RIGHTS ACT,0,0,0,0,0,0,0,0,0,0,0,0,0,0,0
JAMMU & KASHMIR,2011,SC/ST (PREVENTION OF ATROCITIES) ACT,0,0,0,0,0,0,0,0,0,0,0,0,0,0,0
JAMMU & KASHMIR,2011,INDIAN PASSPORT ACT,0,0,0,19,0,19,10,0,10,3,0,3,32,0,32
JAMMU & KASHMIR,2011,ESSENTIAL COMMODITIES ACT,0,0,0,0,0,0,0,0,0,0,0,0,0,0,0
JAMMU & KASHMIR,2011,ANTIQUITIES AND ART TREASURE ACT,0,0,0,0,0,0,0,0,0,0,0,0,0,0,0
JAMMU & KASHMIR,2011,DOWRY PROHIBITION ACT,0,0,0,0,0,0,0,0,0,0,0,0,0,0,0
JAMMU & KASHMIR,2011,FOREIGN EXCHANGE REGULATION ACT-1973,0,0,0,0,0,0,0,0,0,0,0,0,0,0,0
JAMMU & KASHMIR,2011,PREVENTION OF CORRUPTION ACT-1988,0,0,0,0,0,0,0,0,0,0,0,0,0,0,0
JAMMU & KASHMIR,2011,CONSER.OF FORGN.EXCH.&PREV. OF SMUG.ACT,0,0,0,1,0,1,1,0,1,0,0,0,2,0,2
JAMMU & KASHMIR,2011,OTHER SLL OFFENCE,0,0,0,30,0,30,61,0,61,17,0,17,108,0,108
JAMMU & KASHMIR,2011,TOTAL,0,0,0,272,3,275,244,2,246,52,1,53,568,6,574
JAMMU & KASHMIR,2012,ARMS ACT,0,0,0,87,0,87,70,0,70,6,0,6,163,0,163
JAMMU & KASHMIR,2012,N.D.P.S. ACT,0,0,0,109,1,110,99,0,99,36,1,37,244,2,246
JAMMU & KASHMIR,2012,GAMBLING ACT,0,0,0,0,0,0,2,0,2,0,0,0,2,0,2
JAMMU & KASHMIR,2012,EXCISE ACT,0,0,0,1,0,1,0,0,0,0,0,0,1,0,1
JAMMU & KASHMIR,2012,PROHIBITION ACT,0,0,0,0,0,0,0,0,0,0,0,0,0,0,0
JAMMU & KASHMIR,2012,EXPLOSIVE & EXPLOSIVE SUBST. ACT,0,0,0,2,0,2,10,0,10,2,0,2,14,0,14
JAMMU & KASHMIR,2012,TERRORIST & DISRUPTIVE ACTIVITIES (TATA),0,0,0,0,0,0,0,0,0,0,0,0,0,0,0
JAMMU & KASHMIR,2012,IMMORAL TRAFFIC (PREVENTION) ACT,0,0,0,0,0,0,1,0,1,0,0,0,1,0,1
JAMMU & KASHMIR,2012,INDIAN RAILWAYS ACT,0,0,0,0,0,0,1,0,1,0,0,0,1,0,1
JAMMU & KASHMIR,2012,REGISTRATION OF FOREIGNERS ACT,0,0,0,13,3,16,5,0,5,0,0,0,18,3,21
JAMMU & KASHMIR,2012,PROTECTION OF CIVIL RIGHTS ACT,0,0,0,0,0,0,0,0,0,0,0,0,0,0,0
JAMMU & KASHMIR,2012,SC/ST (PREVENTION OF ATROCITIES) ACT,0,0,0,0,0,0,0,0,0,0,0,0,0,0,0
JAMMU & KASHMIR,2012,INDIAN PASSPORT ACT,0,0,0,0,0,0,2,0,2,0,0,0,2,0,2
JAMMU & KASHMIR,2012,ESSENTIAL COMMODITIES ACT,0,0,0,0,0,0,0,0,0,0,0,0,0,0,0
JAMMU & KASHMIR,2012,ANTIQUITIES AND ART TREASURE ACT,0,0,0,0,0,0,0,0,0,0,0,0,0,0,0
JAMMU & KASHMIR,2012,DOWRY PROHIBITION ACT,0,0,0,2,0,2,4,1,5,1,0,1,7,1,8
JAMMU & KASHMIR,2012,FOREIGN EXCHANGE REGULATION ACT-1973,0,0,0,0,0,0,0,0,0,0,0,0,0,0,0
JAMMU & KASHMIR,2012,PREVENTION OF CORRUPTION ACT-1988,0,0,0,0,0,0,0,0,0,0,0,0,0,0,0
JAMMU & KASHMIR,2012,CONSER.OF FORGN.EXCH.&PREV. OF SMUG.ACT,0,0,0,0,0,0,0,0,0,0,0,0,0,0,0
JAMMU & KASHMIR,2012,OTHER SLL OFFENCE,0,0,0,16,0,16,17,1,18,5,0,5,38,1,39
JAMMU & KASHMIR,2012,TOTAL,0,0,0,230,4,234,211,2,213,50,1,51,491,7,498
JHARKHAND,2001,ARMS ACT,24,0,24,275,7,282,220,4,224,41,0,41,560,11,571
JHARKHAND,2001,N.D.P.S. ACT,0,0,0,39,1,40,20,0,20,5,0,5,64,1,65
JHARKHAND,2001,GAMBLING ACT,0,0,0,12,0,12,8,0,8,6,0,6,26,0,26
JHARKHAND,2001,EXCISE ACT,92,0,92,73,3,76,53,5,58,48,0,48,266,8,274
JHARKHAND,2001,PROHIBITION ACT,0,0,0,5,0,5,2,0,2,0,0,0,7,0,7
JHARKHAND,2001,EXPLOSIVE & EXPLOSIVE SUBST. ACT,39,0,39,101,1,102,92,0,92,36,0,36,268,1,269
JHARKHAND,2001,TERRORIST & DISRUPTIVE ACTIVITIES (TATA),0,0,0,0,0,0,0,0,0,0,0,0,0,0,0
JHARKHAND,2001,IMMORAL TRAFFIC (PREVENTION) ACT,0,0,0,1,0,1,0,0,0,0,0,0,1,0,1
JHARKHAND,2001,INDIAN RAILWAYS ACT,82,0,82,95,0,95,60,0,60,33,0,33,270,0,270
JHARKHAND,2001,REGISTRATION OF FOREIGNERS ACT,0,0,0,13,0,13,22,0,22,0,0,0,35,0,35
JHARKHAND,2001,PROTECTION OF CIVIL RIGHTS ACT,0,0,0,0,0,0,0,0,0,0,0,0,0,0,0
JHARKHAND,2001,SC/ST (PREVENTION OF ATROCITIES) ACT,0,0,0,74,0,74,30,1,31,5,0,5,109,1,110
JHARKHAND,2001,INDIAN PASSPORT ACT,0,0,0,0,0,0,0,0,0,0,0,0,0,0,0
JHARKHAND,2001,ESSENTIAL COMMODITIES ACT,0,0,0,0,0,0,4,0,4,0,0,0,4,0,4
JHARKHAND,2001,ANTIQUITIES AND ART TREASURE ACT,0,0,0,0,0,0,0,0,0,0,0,0,0,0,0
JHARKHAND,2001,DOWRY PROHIBITION ACT,55,0,55,103,7,110,78,11,89,28,0,28,264,18,282
JHARKHAND,2001,FOREIGN EXCHANGE REGULATION ACT-1973,0,0,0,4,0,4,0,0,0,0,0,0,4,0,4
JHARKHAND,2001,PREVENTION OF CORRUPTION ACT-1988,0,0,0,0,0,0,0,0,0,2,0,2,2,0,2
JHARKHAND,2001,CONSER.OF FORGN.EXCH.&PREV. OF SMUG.ACT,0,0,0,0,0,0,0,0,0,0,0,0,0,0,0
JHARKHAND,2001,OTHER SLL OFFENCE,0,0,0,0,0,0,27,0,27,8,3,11,35,3,38
JHARKHAND,2001,TOTAL,292,0,292,795,19,814,616,21,637,212,3,215,1915,43,1958
JHARKHAND,2002,ARMS ACT,12,0,12,249,0,249,149,0,149,16,0,16,426,0,426
JHARKHAND,2002,N.D.P.S. ACT,0,0,0,20,1,21,33,1,34,6,0,6,59,2,61
JHARKHAND,2002,GAMBLING ACT,0,0,0,7,0,7,16,0,16,7,0,7,30,0,30
JHARKHAND,2002,EXCISE ACT,8,0,8,73,1,74,114,6,120,20,0,20,215,7,222
JHARKHAND,2002,PROHIBITION ACT,0,0,0,0,0,0,3,0,3,4,0,4,7,0,7
JHARKHAND,2002,EXPLOSIVE & EXPLOSIVE SUBST. ACT,4,0,4,104,0,104,49,0,49,4,0,4,161,0,161
JHARKHAND,2002,TERRORIST & DISRUPTIVE ACTIVITIES (TATA),0,0,0,0,0,0,4,0,4,0,0,0,4,0,4
JHARKHAND,2002,IMMORAL TRAFFIC (PREVENTION) ACT,0,0,0,4,0,4,0,1,1,0,0,0,4,1,5
JHARKHAND,2002,INDIAN RAILWAYS ACT,7,0,7,73,2,75,49,3,52,14,0,14,143,5,148
JHARKHAND,2002,REGISTRATION OF FOREIGNERS ACT,0,0,0,5,0,5,0,0,0,0,0,0,5,0,5
JHARKHAND,2002,PROTECTION OF CIVIL RIGHTS ACT,0,0,0,0,0,0,0,0,0,0,0,0,0,0,0
JHARKHAND,2002,SC/ST (PREVENTION OF ATROCITIES) ACT,0,0,0,8,0,8,13,0,13,3,0,3,24,0,24
JHARKHAND,2002,INDIAN PASSPORT ACT,0,0,0,0,0,0,0,0,0,0,0,0,0,0,0
JHARKHAND,2002,ESSENTIAL COMMODITIES ACT,0,0,0,0,0,0,0,0,0,0,0,0,0,0,0
JHARKHAND,2002,ANTIQUITIES AND ART TREASURE ACT,0,0,0,0,0,0,0,0,0,0,0,0,0,0,0
JHARKHAND,2002,DOWRY PROHIBITION ACT,5,4,9,117,8,125,135,15,150,24,5,29,281,32,313
JHARKHAND,2002,FOREIGN EXCHANGE REGULATION ACT-1973,0,0,0,0,0,0,0,0,0,0,0,0,0,0,0
JHARKHAND,2002,PREVENTION OF CORRUPTION ACT-1988,0,0,0,0,0,0,67,0,67,42,0,42,109,0,109
JHARKHAND,2002,CONSER.OF FORGN.EXCH.&PREV. OF SMUG.ACT,0,0,0,0,0,0,0,0,0,0,0,0,0,0,0
JHARKHAND,2002,OTHER SLL OFFENCE,9,2,11,97,9,106,129,2,131,13,3,16,248,16,264
JHARKHAND,2002,TOTAL,45,6,51,757,21,778,761,28,789,153,8,161,1716,63,1779
JHARKHAND,2003,ARMS ACT,8,0,8,249,1,250,198,2,200,21,0,21,476,3,479
JHARKHAND,2003,N.D.P.S. ACT,0,0,0,13,1,14,30,1,31,1,0,1,44,2,46
JHARKHAND,2003,GAMBLING ACT,2,0,2,14,0,14,69,1,70,13,0,13,98,1,99
JHARKHAND,2003,EXCISE ACT,5,0,5,53,0,53,44,2,46,23,1,24,125,3,128
JHARKHAND,2003,PROHIBITION ACT,0,0,0,5,0,5,10,0,10,2,0,2,17,0,17
JHARKHAND,2003,EXPLOSIVE & EXPLOSIVE SUBST. ACT,1,0,1,70,0,70,75,2,77,11,0,11,157,2,159
JHARKHAND,2003,TERRORIST & DISRUPTIVE ACTIVITIES (TATA),0,0,0,3,0,3,0,0,0,0,0,0,3,0,3
JHARKHAND,2003,IMMORAL TRAFFIC (PREVENTION) ACT,0,0,0,5,0,5,2,0,2,0,0,0,7,0,7
JHARKHAND,2003,INDIAN RAILWAYS ACT,5,0,5,107,0,107,123,0,123,27,0,27,262,0,262
JHARKHAND,2003,REGISTRATION OF FOREIGNERS ACT,0,0,0,0,0,0,0,0,0,0,0,0,0,0,0
JHARKHAND,2003,PROTECTION OF CIVIL RIGHTS ACT,0,0,0,0,0,0,0,0,0,0,0,0,0,0,0
JHARKHAND,2003,SC/ST (PREVENTION OF ATROCITIES) ACT,0,0,0,2,0,2,17,0,17,3,0,3,22,0,22
JHARKHAND,2003,INDIAN PASSPORT ACT,0,0,0,0,0,0,0,0,0,0,0,0,0,0,0
JHARKHAND,2003,ESSENTIAL COMMODITIES ACT,0,0,0,0,0,0,3,0,3,2,0,2,5,0,5
JHARKHAND,2003,ANTIQUITIES AND ART TREASURE ACT,0,0,0,0,0,0,0,0,0,0,0,0,0,0,0
JHARKHAND,2003,DOWRY PROHIBITION ACT,0,0,0,52,2,54,147,6,153,22,3,25,221,11,232
JHARKHAND,2003,FOREIGN EXCHANGE REGULATION ACT-1973,0,0,0,0,0,0,0,0,0,0,0,0,0,0,0
JHARKHAND,2003,PREVENTION OF CORRUPTION ACT-1988,0,0,0,5,0,5,42,0,42,27,0,27,74,0,74
JHARKHAND,2003,CONSER.OF FORGN.EXCH.&PREV. OF SMUG.ACT,0,0,0,0,0,0,0,0,0,0,0,0,0,0,0
JHARKHAND,2003,OTHER SLL OFFENCE,2,2,4,110,10,120,103,12,115,5,0,5,220,24,244
JHARKHAND,2003,TOTAL,23,2,25,688,14,702,863,26,889,157,4,161,1731,46,1777
JHARKHAND,2004,ARMS ACT,2,0,2,317,2,319,160,3,163,33,0,33,512,5,517
JHARKHAND,2004,N.D.P.S. ACT,0,0,0,34,3,37,21,2,23,4,0,4,59,5,64
JHARKHAND,2004,GAMBLING ACT,0,0,0,3,0,3,56,0,56,9,0,9,68,0,68
JHARKHAND,2004,EXCISE ACT,0,0,0,78,0,78,96,0,96,39,0,39,213,0,213
JHARKHAND,2004,PROHIBITION ACT,0,0,0,0,0,0,0,0,0,0,0,0,0,0,0
JHARKHAND,2004,EXPLOSIVE & EXPLOSIVE SUBST. ACT,0,0,0,66,0,66,69,0,69,32,0,32,167,0,167
JHARKHAND,2004,TERRORIST & DISRUPTIVE ACTIVITIES (TATA),0,0,0,15,2,17,17,1,18,0,0,0,32,3,35
JHARKHAND,2004,IMMORAL TRAFFIC (PREVENTION) ACT,0,0,0,12,4,16,10,5,15,1,0,1,23,9,32
JHARKHAND,2004,INDIAN RAILWAYS ACT,0,0,0,126,2,128,115,3,118,11,0,11,252,5,257
JHARKHAND,2004,REGISTRATION OF FOREIGNERS ACT,0,0,0,0,0,0,0,0,0,0,0,0,0,0,0
JHARKHAND,2004,PROTECTION OF CIVIL RIGHTS ACT,0,0,0,0,0,0,0,0,0,0,0,0,0,0,0
JHARKHAND,2004,SC/ST (PREVENTION OF ATROCITIES) ACT,0,0,0,9,0,9,19,2,21,8,0,8,36,2,38
JHARKHAND,2004,INDIAN PASSPORT ACT,0,0,0,10,0,10,0,0,0,0,0,0,10,0,10
JHARKHAND,2004,ESSENTIAL COMMODITIES ACT,0,0,0,0,0,0,3,0,3,1,0,1,4,0,4
JHARKHAND,2004,ANTIQUITIES AND ART TREASURE ACT,0,0,0,0,0,0,0,0,0,0,0,0,0,0,0
JHARKHAND,2004,DOWRY PROHIBITION ACT,0,0,0,77,4,81,178,21,199,28,0,28,283,25,308
JHARKHAND,2004,FOREIGN EXCHANGE REGULATION ACT-1973,0,0,0,0,0,0,0,0,0,0,0,0,0,0,0
JHARKHAND,2004,PREVENTION OF CORRUPTION ACT-1988,0,0,0,6,0,6,23,0,23,10,0,10,39,0,39
JHARKHAND,2004,CONSER.OF FORGN.EXCH.&PREV. OF SMUG.ACT,0,0,0,0,3,3,4,0,4,0,0,0,4,3,7
JHARKHAND,2004,OTHER SLL OFFENCE,0,0,0,24,0,24,12,2,14,5,0,5,41,2,43
JHARKHAND,2004,TOTAL,2,0,2,777,20,797,783,39,822,181,0,181,1743,59,1802
JHARKHAND,2005,ARMS ACT,4,0,4,308,2,310,291,2,293,39,0,39,642,4,646
JHARKHAND,2005,N.D.P.S. ACT,0,0,0,28,0,28,42,2,44,5,0,5,75,2,77
JHARKHAND,2005,GAMBLING ACT,0,0,0,9,0,9,10,0,10,0,0,0,19,0,19
JHARKHAND,2005,EXCISE ACT,0,0,0,119,7,126,151,5,156,29,1,30,299,13,312
JHARKHAND,2005,PROHIBITION ACT,0,0,0,9,1,10,0,0,0,0,0,0,9,1,10
JHARKHAND,2005,EXPLOSIVE & EXPLOSIVE SUBST. ACT,0,0,0,110,2,112,121,0,121,21,0,21,252,2,254
JHARKHAND,2005,TERRORIST & DISRUPTIVE ACTIVITIES (TATA),0,0,0,0,0,0,0,0,0,0,0,0,0,0,0
JHARKHAND,2005,IMMORAL TRAFFIC (PREVENTION) ACT,0,0,0,3,2,5,0,0,0,0,0,0,3,2,5
JHARKHAND,2005,INDIAN RAILWAYS ACT,0,0,0,197,3,200,158,2,160,35,0,35,390,5,395
JHARKHAND,2005,REGISTRATION OF FOREIGNERS ACT,0,0,0,0,0,0,0,0,0,0,0,0,0,0,0
JHARKHAND,2005,PROTECTION OF CIVIL RIGHTS ACT,0,0,0,0,0,0,0,0,0,0,0,0,0,0,0
JHARKHAND,2005,SC/ST (PREVENTION OF ATROCITIES) ACT,0,0,0,17,1,18,16,1,17,2,2,4,35,4,39
JHARKHAND,2005,INDIAN PASSPORT ACT,0,0,0,0,0,0,0,0,0,0,0,0,0,0,0
JHARKHAND,2005,ESSENTIAL COMMODITIES ACT,0,0,0,0,0,0,1,0,1,0,0,0,1,0,1
JHARKHAND,2005,ANTIQUITIES AND ART TREASURE ACT,0,0,0,0,0,0,0,0,0,0,0,0,0,0,0
JHARKHAND,2005,DOWRY PROHIBITION ACT,0,0,0,61,3,64,51,5,56,29,0,29,141,8,149
JHARKHAND,2005,FOREIGN EXCHANGE REGULATION ACT-1973,0,0,0,0,0,0,0,0,0,0,0,0,0,0,0
JHARKHAND,2005,PREVENTION OF CORRUPTION ACT-1988,0,0,0,5,0,5,19,0,19,12,0,12,36,0,36
JHARKHAND,2005,CONSER.OF FORGN.EXCH.&PREV. OF SMUG.ACT,0,0,0,0,0,0,0,0,0,0,0,0,0,0,0
JHARKHAND,2005,OTHER SLL OFFENCE,0,0,0,13,4,17,9,2,11,2,0,2,24,6,30
JHARKHAND,2005,TOTAL,4,0,4,879,25,904,869,19,888,174,3,177,1926,47,1973
JHARKHAND,2006,ARMS ACT,0,0,0,316,4,320,270,1,271,34,0,34,620,5,625
JHARKHAND,2006,N.D.P.S. ACT,0,0,0,24,1,25,25,0,25,9,0,9,58,1,59
JHARKHAND,2006,GAMBLING ACT,0,0,0,14,0,14,13,0,13,0,0,0,27,0,27
JHARKHAND,2006,EXCISE ACT,3,0,3,81,0,81,190,1,191,55,4,59,329,5,334
JHARKHAND,2006,PROHIBITION ACT,0,0,0,3,0,3,4,0,4,1,0,1,8,0,8
JHARKHAND,2006,EXPLOSIVE & EXPLOSIVE SUBST. ACT,0,0,0,89,2,91,75,1,76,14,0,14,178,3,181
JHARKHAND,2006,TERRORIST & DISRUPTIVE ACTIVITIES (TATA),0,0,0,0,0,0,0,0,0,0,0,0,0,0,0
JHARKHAND,2006,IMMORAL TRAFFIC (PREVENTION) ACT,0,0,0,0,0,0,2,0,2,0,0,0,2,0,2
JHARKHAND,2006,INDIAN RAILWAYS ACT,0,0,0,177,1,178,103,1,104,32,1,33,312,3,315
JHARKHAND,2006,REGISTRATION OF FOREIGNERS ACT,0,0,0,0,0,0,0,0,0,0,0,0,0,0,0
JHARKHAND,2006,PROTECTION OF CIVIL RIGHTS ACT,0,0,0,0,0,0,0,0,0,0,0,0,0,0,0
JHARKHAND,2006,SC/ST (PREVENTION OF ATROCITIES) ACT,0,0,0,22,0,22,12,0,12,7,1,8,41,1,42
JHARKHAND,2006,INDIAN PASSPORT ACT,0,0,0,0,0,0,0,0,0,0,0,0,0,0,0
JHARKHAND,2006,ESSENTIAL COMMODITIES ACT,0,0,0,0,0,0,0,0,0,0,0,0,0,0,0
JHARKHAND,2006,ANTIQUITIES AND ART TREASURE ACT,0,0,0,0,0,0,0,0,0,0,0,0,0,0,0
JHARKHAND,2006,DOWRY PROHIBITION ACT,0,0,0,54,11,65,42,5,47,13,1,14,109,17,126
JHARKHAND,2006,FOREIGN EXCHANGE REGULATION ACT-1973,0,0,0,0,0,0,0,0,0,0,0,0,0,0,0
JHARKHAND,2006,PREVENTION OF CORRUPTION ACT-1988,0,0,0,2,0,2,13,0,13,14,0,14,29,0,29
JHARKHAND,2006,CONSER.OF FORGN.EXCH.&PREV. OF SMUG.ACT,0,0,0,0,0,0,0,0,0,0,0,0,0,0,0
JHARKHAND,2006,OTHER SLL OFFENCE,0,0,0,17,0,17,32,0,32,9,1,10,58,1,59
JHARKHAND,2006,TOTAL,3,0,3,799,19,818,781,9,790,188,8,196,1771,36,1807
JHARKHAND,2007,ARMS ACT,0,0,0,261,7,268,103,1,104,34,0,34,398,8,406
JHARKHAND,2007,N.D.P.S. ACT,0,0,0,28,0,28,46,0,46,4,0,4,78,0,78
JHARKHAND,2007,GAMBLING ACT,0,0,0,21,0,21,16,0,16,2,0,2,39,0,39
JHARKHAND,2007,EXCISE ACT,0,0,0,94,2,96,86,0,86,8,0,8,188,2,190
JHARKHAND,2007,PROHIBITION ACT,0,0,0,0,2,2,0,0,0,0,0,0,0,2,2
JHARKHAND,2007,EXPLOSIVE & EXPLOSIVE SUBST. ACT,0,0,0,87,1,88,72,1,73,3,0,3,162,2,164
JHARKHAND,2007,TERRORIST & DISRUPTIVE ACTIVITIES (TATA),0,0,0,0,0,0,0,0,0,0,0,0,0,0,0
JHARKHAND,2007,IMMORAL TRAFFIC (PREVENTION) ACT,0,0,0,12,0,12,9,0,9,0,0,0,21,0,21
JHARKHAND,2007,INDIAN RAILWAYS ACT,0,0,0,146,0,146,91,3,94,6,0,6,243,3,246
JHARKHAND,2007,REGISTRATION OF FOREIGNERS ACT,0,0,0,0,0,0,0,0,0,0,0,0,0,0,0
JHARKHAND,2007,PROTECTION OF CIVIL RIGHTS ACT,0,0,0,0,0,0,0,0,0,0,0,0,0,0,0
JHARKHAND,2007,SC/ST (PREVENTION OF ATROCITIES) ACT,0,0,0,10,0,10,6,0,6,0,0,0,16,0,16
JHARKHAND,2007,INDIAN PASSPORT ACT,0,0,0,0,0,0,0,0,0,1,0,1,1,0,1
JHARKHAND,2007,ESSENTIAL COMMODITIES ACT,0,0,0,0,0,0,0,0,0,0,0,0,0,0,0
JHARKHAND,2007,ANTIQUITIES AND ART TREASURE ACT,0,0,0,0,0,0,0,0,0,0,0,0,0,0,0
JHARKHAND,2007,DOWRY PROHIBITION ACT,0,0,0,43,0,43,50,0,50,7,1,8,100,1,101
JHARKHAND,2007,FOREIGN EXCHANGE REGULATION ACT-1973,0,0,0,0,0,0,0,0,0,0,0,0,0,0,0
JHARKHAND,2007,PREVENTION OF CORRUPTION ACT-1988,0,0,0,0,0,0,9,0,9,0,0,0,9,0,9
JHARKHAND,2007,CONSER.OF FORGN.EXCH.&PREV. OF SMUG.ACT,0,0,0,0,0,0,0,0,0,0,0,0,0,0,0
JHARKHAND,2007,OTHER SLL OFFENCE,0,0,0,46,2,48,52,0,52,10,0,10,108,2,110
JHARKHAND,2007,TOTAL,0,0,0,748,14,762,540,5,545,75,1,76,1363,20,1383
JHARKHAND,2008,ARMS ACT,0,0,0,329,2,331,206,1,207,33,0,33,568,3,571
JHARKHAND,2008,N.D.P.S. ACT,0,0,0,63,1,64,36,2,38,14,0,14,113,3,116
JHARKHAND,2008,GAMBLING ACT,0,0,0,28,0,28,36,0,36,0,0,0,64,0,64
JHARKHAND,2008,EXCISE ACT,0,0,0,84,1,85,84,0,84,35,0,35,203,1,204
JHARKHAND,2008,PROHIBITION ACT,0,0,0,5,0,5,1,0,1,0,0,0,6,0,6
JHARKHAND,2008,EXPLOSIVE & EXPLOSIVE SUBST. ACT,0,0,0,57,0,57,30,0,30,2,0,2,89,0,89
JHARKHAND,2008,TERRORIST & DISRUPTIVE ACTIVITIES (TATA),0,0,0,2,0,2,1,0,1,0,0,0,3,0,3
JHARKHAND,2008,IMMORAL TRAFFIC (PREVENTION) ACT,0,0,0,6,4,10,2,0,2,0,0,0,8,4,12
JHARKHAND,2008,INDIAN RAILWAYS ACT,0,0,0,180,1,181,72,0,72,22,0,22,274,1,275
JHARKHAND,2008,REGISTRATION OF FOREIGNERS ACT,0,0,0,0,0,0,0,0,0,0,0,0,0,0,0
JHARKHAND,2008,PROTECTION OF CIVIL RIGHTS ACT,0,0,0,0,0,0,0,0,0,0,0,0,0,0,0
JHARKHAND,2008,SC/ST (PREVENTION OF ATROCITIES) ACT,0,0,0,26,0,26,21,0,21,9,0,9,56,0,56
JHARKHAND,2008,INDIAN PASSPORT ACT,0,0,0,0,0,0,0,0,0,0,0,0,0,0,0
JHARKHAND,2008,ESSENTIAL COMMODITIES ACT,0,0,0,1,0,1,4,0,4,0,0,0,5,0,5
JHARKHAND,2008,ANTIQUITIES AND ART TREASURE ACT,0,0,0,2,0,2,0,0,0,0,0,0,2,0,2
JHARKHAND,2008,DOWRY PROHIBITION ACT,0,0,0,78,2,80,42,4,46,15,5,20,135,11,146
JHARKHAND,2008,FOREIGN EXCHANGE REGULATION ACT-1973,0,0,0,0,0,0,0,0,0,0,0,0,0,0,0
JHARKHAND,2008,PREVENTION OF CORRUPTION ACT-1988,0,0,0,41,0,41,2,0,2,0,0,0,43,0,43
JHARKHAND,2008,CONSER.OF FORGN.EXCH.&PREV. OF SMUG.ACT,0,0,0,0,0,0,0,0,0,0,0,0,0,0,0
JHARKHAND,2008,OTHER SLL OFFENCE,0,0,0,93,2,95,63,7,70,19,2,21,175,11,186
JHARKHAND,2008,TOTAL,0,0,0,995,13,1008,600,14,614,149,7,156,1744,34,1778
JHARKHAND,2009,ARMS ACT,0,0,0,324,9,333,169,6,175,36,0,36,529,15,544
JHARKHAND,2009,N.D.P.S. ACT,0,0,0,22,0,22,14,2,16,4,0,4,40,2,42
JHARKHAND,2009,GAMBLING ACT,0,0,0,3,0,3,5,0,5,0,0,0,8,0,8
JHARKHAND,2009,EXCISE ACT,0,0,0,95,0,95,91,2,93,33,0,33,219,2,221
JHARKHAND,2009,PROHIBITION ACT,0,0,0,0,0,0,0,0,0,0,0,0,0,0,0
JHARKHAND,2009,EXPLOSIVE & EXPLOSIVE SUBST. ACT,0,0,0,51,0,51,43,2,45,1,0,1,95,2,97
JHARKHAND,2009,TERRORIST & DISRUPTIVE ACTIVITIES (TATA),0,0,0,16,0,16,3,3,6,0,0,0,19,3,22
JHARKHAND,2009,IMMORAL TRAFFIC (PREVENTION) ACT,0,0,0,10,0,10,2,2,4,0,0,0,12,2,14
JHARKHAND,2009,INDIAN RAILWAYS ACT,0,0,0,141,2,143,46,0,46,15,0,15,202,2,204
JHARKHAND,2009,REGISTRATION OF FOREIGNERS ACT,0,0,0,31,0,31,0,0,0,0,0,0,31,0,31
JHARKHAND,2009,PROTECTION OF CIVIL RIGHTS ACT,0,0,0,0,0,0,0,0,0,0,0,0,0,0,0
JHARKHAND,2009,SC/ST (PREVENTION OF ATROCITIES) ACT,0,0,0,13,1,14,18,1,19,3,0,3,34,2,36
JHARKHAND,2009,INDIAN PASSPORT ACT,0,0,0,4,0,4,0,0,0,0,0,0,4,0,4
JHARKHAND,2009,ESSENTIAL COMMODITIES ACT,0,0,0,0,0,0,0,0,0,1,0,1,1,0,1
JHARKHAND,2009,ANTIQUITIES AND ART TREASURE ACT,0,0,0,0,0,0,0,0,0,0,0,0,0,0,0
JHARKHAND,2009,DOWRY PROHIBITION ACT,0,0,0,53,10,63,46,8,54,12,0,12,111,18,129
JHARKHAND,2009,FOREIGN EXCHANGE REGULATION ACT-1973,0,0,0,0,0,0,6,0,6,2,0,2,8,0,8
JHARKHAND,2009,PREVENTION OF CORRUPTION ACT-1988,0,0,0,0,0,0,3,0,3,2,0,2,5,0,5
JHARKHAND,2009,CONSER.OF FORGN.EXCH.&PREV. OF SMUG.ACT,0,0,0,4,0,4,0,0,0,0,0,0,4,0,4
JHARKHAND,2009,OTHER SLL OFFENCE,0,0,0,30,0,30,20,0,20,3,0,3,53,0,53
JHARKHAND,2009,TOTAL,0,0,0,797,22,819,466,26,492,112,0,112,1375,48,1423
JHARKHAND,2010,ARMS ACT,0,0,0,429,6,435,315,3,318,17,1,18,761,10,771
JHARKHAND,2010,N.D.P.S. ACT,0,0,0,51,0,51,54,1,55,0,0,0,105,1,106
JHARKHAND,2010,GAMBLING ACT,0,0,0,20,0,20,11,0,11,4,0,4,35,0,35
JHARKHAND,2010,EXCISE ACT,0,0,0,90,1,91,118,2,120,22,1,23,230,4,234
JHARKHAND,2010,PROHIBITION ACT,0,0,0,0,0,0,0,0,0,0,0,0,0,0,0
JHARKHAND,2010,EXPLOSIVE & EXPLOSIVE SUBST. ACT,0,0,0,53,0,53,39,0,39,5,0,5,97,0,97
JHARKHAND,2010,TERRORIST & DISRUPTIVE ACTIVITIES (TATA),0,0,0,8,0,8,3,0,3,0,0,0,11,0,11
JHARKHAND,2010,IMMORAL TRAFFIC (PREVENTION) ACT,0,0,0,4,5,9,2,2,4,0,0,0,6,7,13
JHARKHAND,2010,INDIAN RAILWAYS ACT,0,0,0,134,0,134,72,0,72,6,0,6,212,0,212
JHARKHAND,2010,REGISTRATION OF FOREIGNERS ACT,0,0,0,0,0,0,0,0,0,0,0,0,0,0,0
JHARKHAND,2010,PROTECTION OF CIVIL RIGHTS ACT,0,0,0,0,0,0,0,0,0,0,0,0,0,0,0
JHARKHAND,2010,SC/ST (PREVENTION OF ATROCITIES) ACT,0,0,0,18,0,18,21,0,21,4,0,4,43,0,43
JHARKHAND,2010,INDIAN PASSPORT ACT,0,0,0,0,0,0,0,0,0,0,0,0,0,0,0
JHARKHAND,2010,ESSENTIAL COMMODITIES ACT,0,0,0,5,0,5,2,0,2,0,0,0,7,0,7
JHARKHAND,2010,ANTIQUITIES AND ART TREASURE ACT,0,0,0,0,0,0,0,0,0,0,0,0,0,0,0
JHARKHAND,2010,DOWRY PROHIBITION ACT,0,0,0,63,8,71,41,4,45,14,3,17,118,15,133
JHARKHAND,2010,FOREIGN EXCHANGE REGULATION ACT-1973,0,0,0,0,0,0,5,0,5,0,0,0,5,0,5
JHARKHAND,2010,PREVENTION OF CORRUPTION ACT-1988,0,0,0,9,0,9,25,2,27,2,1,3,36,3,39
JHARKHAND,2010,CONSER.OF FORGN.EXCH.&PREV. OF SMUG.ACT,0,0,0,1,0,1,1,0,1,0,0,0,2,0,2
JHARKHAND,2010,OTHER SLL OFFENCE,0,0,0,95,5,100,61,4,65,4,0,4,160,9,169
JHARKHAND,2010,TOTAL,0,0,0,980,25,1005,770,18,788,78,6,84,1828,49,1877
JHARKHAND,2011,ARMS ACT,0,0,0,455,12,467,333,4,337,24,0,24,812,16,828
JHARKHAND,2011,N.D.P.S. ACT,0,0,0,81,0,81,56,1,57,15,0,15,152,1,153
JHARKHAND,2011,GAMBLING ACT,0,0,0,7,0,7,7,0,7,7,0,7,21,0,21
JHARKHAND,2011,EXCISE ACT,0,0,0,100,0,100,129,3,132,23,1,24,252,4,256
JHARKHAND,2011,PROHIBITION ACT,0,0,0,7,0,7,13,0,13,9,1,10,29,1,30
JHARKHAND,2011,EXPLOSIVE & EXPLOSIVE SUBST. ACT,0,0,0,102,0,102,82,0,82,16,1,17,200,1,201
JHARKHAND,2011,TERRORIST & DISRUPTIVE ACTIVITIES (TATA),0,0,0,6,0,6,2,0,2,0,0,0,8,0,8
JHARKHAND,2011,IMMORAL TRAFFIC (PREVENTION) ACT,0,0,0,12,9,21,8,4,12,0,0,0,20,13,33
JHARKHAND,2011,INDIAN RAILWAYS ACT,0,0,0,124,0,124,87,0,87,13,0,13,224,0,224
JHARKHAND,2011,REGISTRATION OF FOREIGNERS ACT,0,0,0,0,0,0,0,0,0,0,0,0,0,0,0
JHARKHAND,2011,PROTECTION OF CIVIL RIGHTS ACT,0,0,0,0,0,0,0,0,0,0,0,0,0,0,0
JHARKHAND,2011,SC/ST (PREVENTION OF ATROCITIES) ACT,0,0,0,23,0,23,24,0,24,10,0,10,57,0,57
JHARKHAND,2011,INDIAN PASSPORT ACT,0,0,0,0,0,0,0,0,0,0,0,0,0,0,0
JHARKHAND,2011,ESSENTIAL COMMODITIES ACT,0,0,0,0,0,0,8,4,12,0,0,0,8,4,12
JHARKHAND,2011,ANTIQUITIES AND ART TREASURE ACT,0,0,0,0,0,0,2,0,2,0,0,0,2,0,2
JHARKHAND,2011,DOWRY PROHIBITION ACT,0,0,0,75,5,80,69,10,79,29,5,34,173,20,193
JHARKHAND,2011,FOREIGN EXCHANGE REGULATION ACT-1973,0,0,0,0,0,0,0,0,0,0,0,0,0,0,0
JHARKHAND,2011,PREVENTION OF CORRUPTION ACT-1988,0,0,0,0,0,0,25,2,27,21,0,21,46,2,48
JHARKHAND,2011,CONSER.OF FORGN.EXCH.&PREV. OF SMUG.ACT,0,0,0,0,0,0,0,0,0,0,0,0,0,0,0
JHARKHAND,2011,OTHER SLL OFFENCE,0,0,0,62,0,62,29,0,29,7,0,7,98,0,98
JHARKHAND,2011,TOTAL,0,0,0,1054,26,1080,874,28,902,174,8,182,2102,62,2164
JHARKHAND,2012,ARMS ACT,0,0,0,395,14,409,311,4,315,49,0,49,755,18,773
JHARKHAND,2012,N.D.P.S. ACT,0,0,0,70,2,72,94,4,98,15,0,15,179,6,185
JHARKHAND,2012,GAMBLING ACT,0,0,0,17,0,17,18,7,25,6,0,6,41,7,48
JHARKHAND,2012,EXCISE ACT,0,0,0,73,0,73,135,0,135,48,0,48,256,0,256
JHARKHAND,2012,PROHIBITION ACT,0,0,0,4,0,4,18,0,18,4,2,6,26,2,28
JHARKHAND,2012,EXPLOSIVE & EXPLOSIVE SUBST. ACT,0,0,0,77,0,77,78,1,79,7,0,7,162,1,163
JHARKHAND,2012,TERRORIST & DISRUPTIVE ACTIVITIES (TATA),0,0,0,0,0,0,6,0,6,0,0,0,6,0,6
JHARKHAND,2012,IMMORAL TRAFFIC (PREVENTION) ACT,0,0,0,3,0,3,6,5,11,0,0,0,9,5,14
JHARKHAND,2012,INDIAN RAILWAYS ACT,0,0,0,62,2,64,91,0,91,20,0,20,173,2,175
JHARKHAND,2012,REGISTRATION OF FOREIGNERS ACT,0,0,0,0,0,0,0,0,0,0,0,0,0,0,0
JHARKHAND,2012,PROTECTION OF CIVIL RIGHTS ACT,0,0,0,0,0,0,0,2,2,0,0,0,0,2,2
JHARKHAND,2012,SC/ST (PREVENTION OF ATROCITIES) ACT,0,0,0,30,0,30,31,0,31,8,0,8,69,0,69
JHARKHAND,2012,INDIAN PASSPORT ACT,0,0,0,0,0,0,0,0,0,0,0,0,0,0,0
JHARKHAND,2012,ESSENTIAL COMMODITIES ACT,0,0,0,3,0,3,10,0,10,0,1,1,13,1,14
JHARKHAND,2012,ANTIQUITIES AND ART TREASURE ACT,0,0,0,0,0,0,0,6,6,0,0,0,0,6,6
JHARKHAND,2012,DOWRY PROHIBITION ACT,0,0,0,87,9,96,106,10,116,46,3,49,239,22,261
JHARKHAND,2012,FOREIGN EXCHANGE REGULATION ACT-1973,0,0,0,0,0,0,0,0,0,0,0,0,0,0,0
JHARKHAND,2012,PREVENTION OF CORRUPTION ACT-1988,0,0,0,8,0,8,10,0,10,0,0,0,18,0,18
JHARKHAND,2012,CONSER.OF FORGN.EXCH.&PREV. OF SMUG.ACT,0,0,0,0,0,0,0,0,0,0,0,0,0,0,0
JHARKHAND,2012,OTHER SLL OFFENCE,0,0,0,25,1,26,29,1,30,2,0,2,56,2,58
JHARKHAND,2012,TOTAL,0,0,0,854,28,882,943,40,983,205,6,211,2002,74,2076
KARNATAKA,2001,ARMS ACT,0,0,0,4,0,4,4,0,4,1,0,1,9,0,9
KARNATAKA,2001,N.D.P.S. ACT,0,0,0,49,0,49,74,0,74,0,0,0,123,0,123
KARNATAKA,2001,GAMBLING ACT,29,0,29,69,0,69,19,0,19,2,0,2,119,0,119
KARNATAKA,2001,EXCISE ACT,0,0,0,16,0,16,71,0,71,23,0,23,110,0,110
KARNATAKA,2001,PROHIBITION ACT,0,0,0,0,0,0,6,0,6,7,0,7,13,0,13
KARNATAKA,2001,EXPLOSIVE & EXPLOSIVE SUBST. ACT,0,0,0,0,0,0,2,0,2,0,0,0,2,0,2
KARNATAKA,2001,TERRORIST & DISRUPTIVE ACTIVITIES (TATA),0,0,0,0,0,0,0,0,0,0,0,0,0,0,0
KARNATAKA,2001,IMMORAL TRAFFIC (PREVENTION) ACT,3,9,12,7,11,18,5,9,14,0,0,0,15,29,44
KARNATAKA,2001,INDIAN RAILWAYS ACT,32,0,32,29,0,29,7,0,7,0,0,0,68,0,68
KARNATAKA,2001,REGISTRATION OF FOREIGNERS ACT,0,0,0,0,0,0,0,0,0,0,0,0,0,0,0
KARNATAKA,2001,PROTECTION OF CIVIL RIGHTS ACT,0,0,0,11,0,11,21,0,21,12,0,12,44,0,44
KARNATAKA,2001,SC/ST (PREVENTION OF ATROCITIES) ACT,0,0,0,17,0,17,9,1,10,0,0,0,26,1,27
KARNATAKA,2001,INDIAN PASSPORT ACT,0,0,0,0,0,0,0,0,0,0,0,0,0,0,0
KARNATAKA,2001,ESSENTIAL COMMODITIES ACT,0,0,0,22,0,22,52,0,52,27,0,27,101,0,101
KARNATAKA,2001,ANTIQUITIES AND ART TREASURE ACT,0,0,0,0,0,0,0,0,0,0,0,0,0,0,0
KARNATAKA,2001,DOWRY PROHIBITION ACT,11,0,11,32,0,32,72,5,77,22,2,24,137,7,144
KARNATAKA,2001,FOREIGN EXCHANGE REGULATION ACT-1973,0,0,0,0,0,0,0,0,0,0,0,0,0,0,0
KARNATAKA,2001,PREVENTION OF CORRUPTION ACT-1988,0,0,0,0,0,0,24,0,24,17,0,17,41,0,41
KARNATAKA,2001,CONSER.OF FORGN.EXCH.&PREV. OF SMUG.ACT,0,0,0,0,0,0,0,0,0,0,0,0,0,0,0
KARNATAKA,2001,OTHER SLL OFFENCE,26,1,27,196,3,199,262,5,267,71,1,72,555,10,565
KARNATAKA,2001,TOTAL,101,10,111,452,14,466,628,20,648,182,3,185,1363,47,1410
KARNATAKA,2002,ARMS ACT,0,0,0,4,0,4,7,0,7,3,0,3,14,0,14
KARNATAKA,2002,N.D.P.S. ACT,0,0,0,0,0,0,0,0,0,0,0,0,0,0,0
KARNATAKA,2002,GAMBLING ACT,32,0,32,72,0,72,27,0,27,7,0,7,138,0,138
KARNATAKA,2002,EXCISE ACT,0,0,0,12,0,12,153,0,153,41,0,41,206,0,206
KARNATAKA,2002,PROHIBITION ACT,0,0,0,0,0,0,5,0,5,17,0,17,22,0,22
KARNATAKA,2002,EXPLOSIVE & EXPLOSIVE SUBST. ACT,0,0,0,0,0,0,0,0,0,0,0,0,0,0,0
KARNATAKA,2002,TERRORIST & DISRUPTIVE ACTIVITIES (TATA),0,0,0,0,0,0,0,0,0,0,0,0,0,0,0
KARNATAKA,2002,IMMORAL TRAFFIC (PREVENTION) ACT,3,1,4,4,16,20,7,13,20,0,0,0,14,30,44
KARNATAKA,2002,INDIAN RAILWAYS ACT,28,0,28,26,0,26,12,0,12,0,0,0,66,0,66
KARNATAKA,2002,REGISTRATION OF FOREIGNERS ACT,0,0,0,0,0,0,0,0,0,0,0,0,0,0,0
KARNATAKA,2002,PROTECTION OF CIVIL RIGHTS ACT,0,0,0,8,0,8,27,0,27,26,0,26,61,0,61
KARNATAKA,2002,SC/ST (PREVENTION OF ATROCITIES) ACT,0,0,0,0,0,0,0,0,0,0,0,0,0,0,0
KARNATAKA,2002,INDIAN PASSPORT ACT,0,0,0,0,1,1,0,0,0,0,0,0,0,1,1
KARNATAKA,2002,ESSENTIAL COMMODITIES ACT,0,0,0,12,0,12,72,0,72,53,0,53,137,0,137
KARNATAKA,2002,ANTIQUITIES AND ART TREASURE ACT,0,0,0,0,0,0,0,0,0,0,0,0,0,0,0
KARNATAKA,2002,DOWRY PROHIBITION ACT,6,0,6,18,0,18,67,9,76,42,4,46,133,13,146
KARNATAKA,2002,FOREIGN EXCHANGE REGULATION ACT-1973,0,0,0,0,0,0,0,0,0,0,0,0,0,0,0
KARNATAKA,2002,PREVENTION OF CORRUPTION ACT-1988,0,0,0,0,0,0,22,0,22,24,0,24,46,0,46
KARNATAKA,2002,CONSER.OF FORGN.EXCH.&PREV. OF SMUG.ACT,0,0,0,0,0,0,4,0,4,0,0,0,4,0,4
KARNATAKA,2002,OTHER SLL OFFENCE,2,0,2,179,9,188,96,3,99,103,4,107,380,16,396
KARNATAKA,2002,TOTAL,71,1,72,335,26,361,499,25,524,316,8,324,1221,60,1281
KARNATAKA,2003,ARMS ACT,0,0,0,3,0,3,11,0,11,1,0,1,15,0,15
KARNATAKA,2003,N.D.P.S. ACT,0,0,0,44,2,46,57,2,59,0,0,0,101,4,105
KARNATAKA,2003,GAMBLING ACT,22,0,22,61,0,61,33,0,33,1,0,1,117,0,117
KARNATAKA,2003,EXCISE ACT,0,0,0,12,0,12,31,0,31,1,0,1,44,0,44
KARNATAKA,2003,PROHIBITION ACT,0,0,0,0,0,0,0,0,0,0,0,0,0,0,0
KARNATAKA,2003,EXPLOSIVE & EXPLOSIVE SUBST. ACT,0,0,0,0,0,0,0,0,0,0,0,0,0,0,0
KARNATAKA,2003,TERRORIST & DISRUPTIVE ACTIVITIES (TATA),0,0,0,0,0,0,0,0,0,0,0,0,0,0,0
KARNATAKA,2003,IMMORAL TRAFFIC (PREVENTION) ACT,3,0,3,3,17,20,8,14,22,0,0,0,14,31,45
KARNATAKA,2003,INDIAN RAILWAYS ACT,12,0,12,29,0,29,11,0,11,0,0,0,52,0,52
KARNATAKA,2003,REGISTRATION OF FOREIGNERS ACT,0,0,0,0,0,0,0,0,0,0,0,0,0,0,0
KARNATAKA,2003,PROTECTION OF CIVIL RIGHTS ACT,0,0,0,11,0,11,32,0,32,1,0,1,44,0,44
KARNATAKA,2003,SC/ST (PREVENTION OF ATROCITIES) ACT,0,0,0,0,0,0,0,0,0,0,0,0,0,0,0
KARNATAKA,2003,INDIAN PASSPORT ACT,0,0,0,0,0,0,0,0,0,0,0,0,0,0,0
KARNATAKA,2003,ESSENTIAL COMMODITIES ACT,0,0,0,0,0,0,0,0,0,0,0,0,0,0,0
KARNATAKA,2003,ANTIQUITIES AND ART TREASURE ACT,0,0,0,0,0,0,0,0,0,0,0,0,0,0,0
KARNATAKA,2003,DOWRY PROHIBITION ACT,6,0,6,24,0,24,36,8,44,8,3,11,74,11,85
KARNATAKA,2003,FOREIGN EXCHANGE REGULATION ACT-1973,0,0,0,0,0,0,0,0,0,0,0,0,0,0,0
KARNATAKA,2003,PREVENTION OF CORRUPTION ACT-1988,0,0,0,0,0,0,8,0,8,1,0,1,9,0,9
KARNATAKA,2003,CONSER.OF FORGN.EXCH.&PREV. OF SMUG.ACT,0,0,0,0,0,0,7,0,7,0,0,0,7,0,7
KARNATAKA,2003,OTHER SLL OFFENCE,3,0,3,145,30,175,21,2,23,2,0,2,171,32,203
KARNATAKA,2003,TOTAL,46,0,46,332,49,381,255,26,281,15,3,18,648,78,726
KARNATAKA,2004,ARMS ACT,0,0,0,2,0,2,0,0,0,0,0,0,2,0,2
KARNATAKA,2004,N.D.P.S. ACT,0,0,0,47,2,49,69,1,70,1,0,1,117,3,120
KARNATAKA,2004,GAMBLING ACT,29,0,29,67,1,68,37,0,37,2,0,2,135,1,136
KARNATAKA,2004,EXCISE ACT,0,0,0,14,0,14,29,0,29,2,0,2,45,0,45
KARNATAKA,2004,PROHIBITION ACT,0,0,0,0,0,0,0,0,0,0,0,0,0,0,0
KARNATAKA,2004,EXPLOSIVE & EXPLOSIVE SUBST. ACT,0,0,0,0,0,0,0,0,0,0,0,0,0,0,0
KARNATAKA,2004,TERRORIST & DISRUPTIVE ACTIVITIES (TATA),0,0,0,0,0,0,0,0,0,0,0,0,0,0,0
KARNATAKA,2004,IMMORAL TRAFFIC (PREVENTION) ACT,3,0,3,4,19,23,7,17,24,1,0,1,15,36,51
KARNATAKA,2004,INDIAN RAILWAYS ACT,2,0,2,31,0,31,13,0,13,0,0,0,46,0,46
KARNATAKA,2004,REGISTRATION OF FOREIGNERS ACT,0,0,0,0,0,0,0,0,0,0,0,0,0,0,0
KARNATAKA,2004,PROTECTION OF CIVIL RIGHTS ACT,0,0,0,13,0,13,37,0,37,1,0,1,51,0,51
KARNATAKA,2004,SC/ST (PREVENTION OF ATROCITIES) ACT,0,0,0,0,0,0,0,0,0,0,0,0,0,0,0
KARNATAKA,2004,INDIAN PASSPORT ACT,0,0,0,0,0,0,0,0,0,0,0,0,0,0,0
KARNATAKA,2004,ESSENTIAL COMMODITIES ACT,0,0,0,0,0,0,0,0,0,0,0,0,0,0,0
KARNATAKA,2004,ANTIQUITIES AND ART TREASURE ACT,0,0,0,0,0,0,0,0,0,0,0,0,0,0,0
KARNATAKA,2004,DOWRY PROHIBITION ACT,4,0,4,27,0,27,49,8,57,8,2,10,88,10,98
KARNATAKA,2004,FOREIGN EXCHANGE REGULATION ACT-1973,0,0,0,0,0,0,0,0,0,0,0,0,0,0,0
KARNATAKA,2004,PREVENTION OF CORRUPTION ACT-1988,0,0,0,0,0,0,0,0,0,0,0,0,0,0,0
KARNATAKA,2004,CONSER.OF FORGN.EXCH.&PREV. OF SMUG.ACT,0,0,0,11,0,11,0,0,0,0,0,0,11,0,11
KARNATAKA,2004,OTHER SLL OFFENCE,0,0,0,0,0,0,3,0,3,0,0,0,3,0,3
KARNATAKA,2004,TOTAL,38,0,38,216,22,238,244,26,270,15,2,17,513,50,563
KARNATAKA,2005,ARMS ACT,0,0,0,0,0,0,2,0,2,0,0,0,2,0,2
KARNATAKA,2005,N.D.P.S. ACT,0,0,0,58,5,63,79,3,82,2,0,2,139,8,147
KARNATAKA,2005,GAMBLING ACT,0,0,0,73,1,74,41,0,41,1,0,1,115,1,116
KARNATAKA,2005,EXCISE ACT,0,0,0,14,0,14,33,0,33,1,0,1,48,0,48
KARNATAKA,2005,PROHIBITION ACT,0,0,0,0,0,0,0,0,0,0,0,0,0,0,0
KARNATAKA,2005,EXPLOSIVE & EXPLOSIVE SUBST. ACT,0,0,0,0,0,0,0,0,0,0,0,0,0,0,0
KARNATAKA,2005,TERRORIST & DISRUPTIVE ACTIVITIES (TATA),0,0,0,0,0,0,0,0,0,0,0,0,0,0,0
KARNATAKA,2005,IMMORAL TRAFFIC (PREVENTION) ACT,0,0,0,7,21,28,6,19,25,1,0,1,14,40,54
KARNATAKA,2005,INDIAN RAILWAYS ACT,0,0,0,37,0,37,17,0,17,0,0,0,54,0,54
KARNATAKA,2005,REGISTRATION OF FOREIGNERS ACT,0,0,0,0,0,0,0,0,0,0,0,0,0,0,0
KARNATAKA,2005,PROTECTION OF CIVIL RIGHTS ACT,0,0,0,11,0,11,43,0,43,1,0,1,55,0,55
KARNATAKA,2005,SC/ST (PREVENTION OF ATROCITIES) ACT,0,0,0,0,0,0,0,0,0,0,0,0,0,0,0
KARNATAKA,2005,INDIAN PASSPORT ACT,0,0,0,0,0,0,0,0,0,0,0,0,0,0,0
KARNATAKA,2005,ESSENTIAL COMMODITIES ACT,0,0,0,0,0,0,0,0,0,0,0,0,0,0,0
KARNATAKA,2005,ANTIQUITIES AND ART TREASURE ACT,0,0,0,0,0,0,0,0,0,0,0,0,0,0,0
KARNATAKA,2005,DOWRY PROHIBITION ACT,0,0,0,36,0,36,53,9,62,8,3,11,97,12,109
KARNATAKA,2005,FOREIGN EXCHANGE REGULATION ACT-1973,0,0,0,0,0,0,0,0,0,0,0,0,0,0,0
KARNATAKA,2005,PREVENTION OF CORRUPTION ACT-1988,0,0,0,0,0,0,0,0,0,0,0,0,0,0,0
KARNATAKA,2005,CONSER.OF FORGN.EXCH.&PREV. OF SMUG.ACT,0,0,0,0,0,0,0,0,0,0,0,0,0,0,0
KARNATAKA,2005,OTHER SLL OFFENCE,0,0,0,0,0,0,2,0,2,0,0,0,2,0,2
KARNATAKA,2005,TOTAL,0,0,0,236,27,263,276,31,307,14,3,17,526,61,587
KARNATAKA,2006,ARMS ACT,0,0,0,0,0,0,0,0,0,0,0,0,0,0,0
KARNATAKA,2006,N.D.P.S. ACT,0,0,0,67,4,71,83,3,86,2,0,2,152,7,159
KARNATAKA,2006,GAMBLING ACT,0,0,0,78,2,80,41,0,41,1,0,1,120,2,122
KARNATAKA,2006,EXCISE ACT,0,0,0,13,0,13,37,0,37,2,0,2,52,0,52
KARNATAKA,2006,PROHIBITION ACT,0,0,0,0,0,0,0,0,0,0,0,0,0,0,0
KARNATAKA,2006,EXPLOSIVE & EXPLOSIVE SUBST. ACT,0,0,0,0,0,0,0,0,0,0,0,0,0,0,0
KARNATAKA,2006,TERRORIST & DISRUPTIVE ACTIVITIES (TATA),0,0,0,0,0,0,0,0,0,0,0,0,0,0,0
KARNATAKA,2006,IMMORAL TRAFFIC (PREVENTION) ACT,0,0,0,7,23,30,6,19,25,1,0,1,14,42,56
KARNATAKA,2006,INDIAN RAILWAYS ACT,0,0,0,33,0,33,17,0,17,0,0,0,50,0,50
KARNATAKA,2006,REGISTRATION OF FOREIGNERS ACT,0,0,0,0,0,0,0,0,0,0,0,0,0,0,0
KARNATAKA,2006,PROTECTION OF CIVIL RIGHTS ACT,0,0,0,9,0,9,51,0,51,1,0,1,61,0,61
KARNATAKA,2006,SC/ST (PREVENTION OF ATROCITIES) ACT,0,0,0,0,0,0,0,0,0,0,0,0,0,0,0
KARNATAKA,2006,INDIAN PASSPORT ACT,0,0,0,0,0,0,0,0,0,0,0,0,0,0,0
KARNATAKA,2006,ESSENTIAL COMMODITIES ACT,0,0,0,0,0,0,0,0,0,0,0,0,0,0,0
KARNATAKA,2006,ANTIQUITIES AND ART TREASURE ACT,0,0,0,0,0,0,0,0,0,0,0,0,0,0,0
KARNATAKA,2006,DOWRY PROHIBITION ACT,0,0,0,35,0,35,57,11,68,8,3,11,100,14,114
KARNATAKA,2006,FOREIGN EXCHANGE REGULATION ACT-1973,0,0,0,0,0,0,0,0,0,0,0,0,0,0,0
KARNATAKA,2006,PREVENTION OF CORRUPTION ACT-1988,0,0,0,0,0,0,0,0,0,0,0,0,0,0,0
KARNATAKA,2006,CONSER.OF FORGN.EXCH.&PREV. OF SMUG.ACT,0,0,0,0,0,0,0,0,0,0,0,0,0,0,0
KARNATAKA,2006,OTHER SLL OFFENCE,0,0,0,0,0,0,4,0,4,0,0,0,4,0,4
KARNATAKA,2006,TOTAL,0,0,0,242,29,271,296,33,329,15,3,18,553,65,618
KARNATAKA,2007,ARMS ACT,0,0,0,0,0,0,2,0,2,0,0,0,2,0,2
KARNATAKA,2007,N.D.P.S. ACT,0,0,0,61,4,65,94,2,96,2,0,2,157,6,163
KARNATAKA,2007,GAMBLING ACT,0,0,0,71,2,73,41,0,41,1,0,1,113,2,115
KARNATAKA,2007,EXCISE ACT,0,0,0,11,0,11,34,0,34,2,0,2,47,0,47
KARNATAKA,2007,PROHIBITION ACT,0,0,0,0,0,0,0,0,0,0,0,0,0,0,0
KARNATAKA,2007,EXPLOSIVE & EXPLOSIVE SUBST. ACT,0,0,0,0,0,0,0,0,0,0,0,0,0,0,0
KARNATAKA,2007,TERRORIST & DISRUPTIVE ACTIVITIES (TATA),0,0,0,0,0,0,0,0,0,0,0,0,0,0,0
KARNATAKA,2007,IMMORAL TRAFFIC (PREVENTION) ACT,0,0,0,7,24,31,5,25,30,2,0,2,14,49,63
KARNATAKA,2007,INDIAN RAILWAYS ACT,0,0,0,31,0,31,15,0,15,0,0,0,46,0,46
KARNATAKA,2007,REGISTRATION OF FOREIGNERS ACT,0,0,0,0,0,0,0,0,0,0,0,0,0,0,0
KARNATAKA,2007,PROTECTION OF CIVIL RIGHTS ACT,0,0,0,8,0,8,51,0,51,0,0,0,59,0,59
KARNATAKA,2007,SC/ST (PREVENTION OF ATROCITIES) ACT,0,0,0,0,0,0,0,0,0,0,0,0,0,0,0
KARNATAKA,2007,INDIAN PASSPORT ACT,0,0,0,0,0,0,0,0,0,0,0,0,0,0,0
KARNATAKA,2007,ESSENTIAL COMMODITIES ACT,0,0,0,0,0,0,0,0,0,0,0,0,0,0,0
KARNATAKA,2007,ANTIQUITIES AND ART TREASURE ACT,0,0,0,0,0,0,0,0,0,0,0,0,0,0,0
KARNATAKA,2007,DOWRY PROHIBITION ACT,0,0,0,27,0,27,61,13,74,9,3,12,97,16,113
KARNATAKA,2007,FOREIGN EXCHANGE REGULATION ACT-1973,0,0,0,0,0,0,0,0,0,0,0,0,0,0,0
KARNATAKA,2007,PREVENTION OF CORRUPTION ACT-1988,0,0,0,0,0,0,0,0,0,0,0,0,0,0,0
KARNATAKA,2007,CONSER.OF FORGN.EXCH.&PREV. OF SMUG.ACT,0,0,0,0,0,0,0,0,0,0,0,0,0,0,0
KARNATAKA,2007,OTHER SLL OFFENCE,0,0,0,0,0,0,7,0,7,0,0,0,7,0,7
KARNATAKA,2007,TOTAL,0,0,0,216,30,246,310,40,350,16,3,19,542,73,615
KARNATAKA,2008,ARMS ACT,0,0,0,0,0,0,2,0,2,0,0,0,2,0,2
KARNATAKA,2008,N.D.P.S. ACT,0,0,0,58,4,62,97,2,99,4,0,4,159,6,165
KARNATAKA,2008,GAMBLING ACT,0,0,0,74,2,76,42,0,42,1,0,1,117,2,119
KARNATAKA,2008,EXCISE ACT,0,0,0,13,0,13,34,0,34,2,0,2,49,0,49
KARNATAKA,2008,PROHIBITION ACT,0,0,0,0,0,0,0,0,0,0,0,0,0,0,0
KARNATAKA,2008,EXPLOSIVE & EXPLOSIVE SUBST. ACT,0,0,0,0,0,0,0,0,0,0,0,0,0,0,0
KARNATAKA,2008,TERRORIST & DISRUPTIVE ACTIVITIES (TATA),0,0,0,0,0,0,0,0,0,0,0,0,0,0,0
KARNATAKA,2008,IMMORAL TRAFFIC (PREVENTION) ACT,0,0,0,7,24,31,5,25,30,1,0,1,13,49,62
KARNATAKA,2008,INDIAN RAILWAYS ACT,0,0,0,31,0,31,15,0,15,0,0,0,46,0,46
KARNATAKA,2008,REGISTRATION OF FOREIGNERS ACT,0,0,0,0,0,0,0,0,0,0,0,0,0,0,0
KARNATAKA,2008,PROTECTION OF CIVIL RIGHTS ACT,0,0,0,8,0,8,51,0,51,1,0,1,60,0,60
KARNATAKA,2008,SC/ST (PREVENTION OF ATROCITIES) ACT,0,0,0,0,0,0,0,0,0,0,0,0,0,0,0
KARNATAKA,2008,INDIAN PASSPORT ACT,0,0,0,2,0,2,0,0,0,0,0,0,2,0,2
KARNATAKA,2008,ESSENTIAL COMMODITIES ACT,0,0,0,0,0,0,0,0,0,0,0,0,0,0,0
KARNATAKA,2008,ANTIQUITIES AND ART TREASURE ACT,0,0,0,0,0,0,0,0,0,0,0,0,0,0,0
KARNATAKA,2008,DOWRY PROHIBITION ACT,0,0,0,28,0,28,61,13,74,9,3,12,98,16,114
KARNATAKA,2008,FOREIGN EXCHANGE REGULATION ACT-1973,0,0,0,0,0,0,0,0,0,0,0,0,0,0,0
KARNATAKA,2008,PREVENTION OF CORRUPTION ACT-1988,0,0,0,0,0,0,0,0,0,0,0,0,0,0,0
KARNATAKA,2008,CONSER.OF FORGN.EXCH.&PREV. OF SMUG.ACT,0,0,0,0,0,0,0,0,0,0,0,0,0,0,0
KARNATAKA,2008,OTHER SLL OFFENCE,0,0,0,0,0,0,7,0,7,0,0,0,7,0,7
KARNATAKA,2008,TOTAL,0,0,0,221,30,251,314,40,354,18,3,21,553,73,626
KARNATAKA,2009,ARMS ACT,0,0,0,0,0,0,2,0,2,0,0,0,2,0,2
KARNATAKA,2009,N.D.P.S. ACT,0,0,0,56,4,60,87,2,89,2,0,2,145,6,151
KARNATAKA,2009,GAMBLING ACT,0,0,0,58,2,60,42,0,42,1,0,1,101,2,103
KARNATAKA,2009,EXCISE ACT,0,0,0,13,0,13,34,0,34,2,0,2,49,0,49
KARNATAKA,2009,PROHIBITION ACT,0,0,0,0,0,0,0,0,0,0,0,0,0,0,0
KARNATAKA,2009,EXPLOSIVE & EXPLOSIVE SUBST. ACT,0,0,0,0,0,0,20,0,20,0,0,0,20,0,20
KARNATAKA,2009,TERRORIST & DISRUPTIVE ACTIVITIES (TATA),0,0,0,10,0,10,5,0,5,0,0,0,15,0,15
KARNATAKA,2009,IMMORAL TRAFFIC (PREVENTION) ACT,0,0,0,7,27,34,5,26,31,1,0,1,13,53,66
KARNATAKA,2009,INDIAN RAILWAYS ACT,0,0,0,21,0,21,10,0,10,0,0,0,31,0,31
KARNATAKA,2009,REGISTRATION OF FOREIGNERS ACT,0,0,0,0,0,0,0,0,0,0,0,0,0,0,0
KARNATAKA,2009,PROTECTION OF CIVIL RIGHTS ACT,0,0,0,8,0,8,31,0,31,1,0,1,40,0,40
KARNATAKA,2009,SC/ST (PREVENTION OF ATROCITIES) ACT,0,0,0,0,0,0,0,0,0,0,0,0,0,0,0
KARNATAKA,2009,INDIAN PASSPORT ACT,0,0,0,2,0,2,0,0,0,0,0,0,2,0,2
KARNATAKA,2009,ESSENTIAL COMMODITIES ACT,0,0,0,0,0,0,0,0,0,0,0,0,0,0,0
KARNATAKA,2009,ANTIQUITIES AND ART TREASURE ACT,0,0,0,0,0,0,0,0,0,0,0,0,0,0,0
KARNATAKA,2009,DOWRY PROHIBITION ACT,0,0,0,26,0,26,61,13,74,9,3,12,96,16,112
KARNATAKA,2009,FOREIGN EXCHANGE REGULATION ACT-1973,0,0,0,0,0,0,0,0,0,0,0,0,0,0,0
KARNATAKA,2009,PREVENTION OF CORRUPTION ACT-1988,0,0,0,0,0,0,0,0,0,0,0,0,0,0,0
KARNATAKA,2009,CONSER.OF FORGN.EXCH.&PREV. OF SMUG.ACT,0,0,0,0,0,0,0,0,0,0,0,0,0,0,0
KARNATAKA,2009,OTHER SLL OFFENCE,0,0,0,0,0,0,7,0,7,0,0,0,7,0,7
KARNATAKA,2009,TOTAL,0,0,0,201,33,234,304,41,345,16,3,19,521,77,598
KARNATAKA,2010,ARMS ACT,0,0,0,0,0,0,2,0,2,0,0,0,2,0,2
KARNATAKA,2010,N.D.P.S. ACT,0,0,0,61,2,63,101,2,103,2,0,2,164,4,168
KARNATAKA,2010,GAMBLING ACT,0,0,0,56,2,58,42,0,42,1,0,1,99,2,101
KARNATAKA,2010,EXCISE ACT,0,0,0,11,0,11,32,0,32,2,0,2,45,0,45
KARNATAKA,2010,PROHIBITION ACT,0,0,0,0,0,0,0,0,0,0,0,0,0,0,0
KARNATAKA,2010,EXPLOSIVE & EXPLOSIVE SUBST. ACT,0,0,0,0,0,0,20,0,20,0,0,0,20,0,20
KARNATAKA,2010,TERRORIST & DISRUPTIVE ACTIVITIES (TATA),0,0,0,11,0,11,5,0,5,0,0,0,16,0,16
KARNATAKA,2010,IMMORAL TRAFFIC (PREVENTION) ACT,0,0,0,9,24,33,5,21,26,1,0,1,15,45,60
KARNATAKA,2010,INDIAN RAILWAYS ACT,0,0,0,31,0,31,10,0,10,0,0,0,41,0,41
KARNATAKA,2010,REGISTRATION OF FOREIGNERS ACT,0,0,0,0,0,0,0,0,0,0,0,0,0,0,0
KARNATAKA,2010,PROTECTION OF CIVIL RIGHTS ACT,0,0,0,8,0,8,31,0,31,1,0,1,40,0,40
KARNATAKA,2010,SC/ST (PREVENTION OF ATROCITIES) ACT,0,0,0,0,0,0,0,0,0,0,0,0,0,0,0
KARNATAKA,2010,INDIAN PASSPORT ACT,0,0,0,2,0,2,0,0,0,0,0,0,2,0,2
KARNATAKA,2010,ESSENTIAL COMMODITIES ACT,0,0,0,0,0,0,0,0,0,0,0,0,0,0,0
KARNATAKA,2010,ANTIQUITIES AND ART TREASURE ACT,0,0,0,0,0,0,0,0,0,0,0,0,0,0,0
KARNATAKA,2010,DOWRY PROHIBITION ACT,0,0,0,31,0,31,61,12,73,9,2,11,101,14,115
KARNATAKA,2010,FOREIGN EXCHANGE REGULATION ACT-1973,0,0,0,0,0,0,0,0,0,0,0,0,0,0,0
KARNATAKA,2010,PREVENTION OF CORRUPTION ACT-1988,0,0,0,0,0,0,5,0,5,0,0,0,5,0,5
KARNATAKA,2010,CONSER.OF FORGN.EXCH.&PREV. OF SMUG.ACT,0,0,0,0,0,0,0,0,0,0,0,0,0,0,0
KARNATAKA,2010,OTHER SLL OFFENCE,0,0,0,0,0,0,2,0,2,0,0,0,2,0,2
KARNATAKA,2010,TOTAL,0,0,0,220,28,248,316,35,351,16,2,18,552,65,617
KARNATAKA,2011,ARMS ACT,0,0,0,0,0,0,2,0,2,0,0,0,2,0,2
KARNATAKA,2011,N.D.P.S. ACT,0,0,0,66,2,68,99,2,101,3,0,3,168,4,172
KARNATAKA,2011,GAMBLING ACT,0,0,0,51,2,53,42,0,42,1,0,1,94,2,96
KARNATAKA,2011,EXCISE ACT,0,0,0,17,0,17,32,0,32,2,0,2,51,0,51
KARNATAKA,2011,PROHIBITION ACT,0,0,0,0,0,0,0,0,0,0,0,0,0,0,0
KARNATAKA,2011,EXPLOSIVE & EXPLOSIVE SUBST. ACT,0,0,0,0,0,0,20,0,20,0,0,0,20,0,20
KARNATAKA,2011,TERRORIST & DISRUPTIVE ACTIVITIES (TATA),0,0,0,14,0,14,5,0,5,0,0,0,19,0,19
KARNATAKA,2011,IMMORAL TRAFFIC (PREVENTION) ACT,0,0,0,11,24,35,5,21,26,1,0,1,17,45,62
KARNATAKA,2011,INDIAN RAILWAYS ACT,0,0,0,37,0,37,10,0,10,0,0,0,47,0,47
KARNATAKA,2011,REGISTRATION OF FOREIGNERS ACT,0,0,0,0,0,0,0,0,0,0,0,0,0,0,0
KARNATAKA,2011,PROTECTION OF CIVIL RIGHTS ACT,0,0,0,8,0,8,31,0,31,1,0,1,40,0,40
KARNATAKA,2011,SC/ST (PREVENTION OF ATROCITIES) ACT,0,0,0,0,0,0,0,0,0,0,0,0,0,0,0
KARNATAKA,2011,INDIAN PASSPORT ACT,0,0,0,14,0,14,16,0,16,0,0,0,30,0,30
KARNATAKA,2011,ESSENTIAL COMMODITIES ACT,0,0,0,0,0,0,0,0,0,0,0,0,0,0,0
KARNATAKA,2011,ANTIQUITIES AND ART TREASURE ACT,0,0,0,0,0,0,0,0,0,0,0,0,0,0,0
KARNATAKA,2011,DOWRY PROHIBITION ACT,0,0,0,37,0,37,59,12,71,11,2,13,107,14,121
KARNATAKA,2011,FOREIGN EXCHANGE REGULATION ACT-1973,0,0,0,0,0,0,0,0,0,0,0,0,0,0,0
KARNATAKA,2011,PREVENTION OF CORRUPTION ACT-1988,0,0,0,2,0,2,11,0,11,4,0,4,17,0,17
KARNATAKA,2011,CONSER.OF FORGN.EXCH.&PREV. OF SMUG.ACT,0,0,0,0,0,0,0,0,0,0,0,0,0,0,0
KARNATAKA,2011,OTHER SLL OFFENCE,0,0,0,0,0,0,0,0,0,0,0,0,0,0,0
KARNATAKA,2011,TOTAL,0,0,0,257,28,285,332,35,367,23,2,25,612,65,677
KARNATAKA,2012,ARMS ACT,0,0,0,7,0,7,15,0,15,2,0,2,24,0,24
KARNATAKA,2012,N.D.P.S. ACT,0,0,0,51,2,53,46,3,49,2,0,2,99,5,104
KARNATAKA,2012,GAMBLING ACT,0,0,0,43,1,44,37,0,37,1,0,1,81,1,82
KARNATAKA,2012,EXCISE ACT,0,0,0,37,0,37,49,0,49,0,0,0,86,0,86
KARNATAKA,2012,PROHIBITION ACT,0,0,0,0,0,0,3,0,3,0,0,0,3,0,3
KARNATAKA,2012,EXPLOSIVE & EXPLOSIVE SUBST. ACT,0,0,0,0,0,0,19,0,19,0,0,0,19,0,19
KARNATAKA,2012,TERRORIST & DISRUPTIVE ACTIVITIES (TATA),0,0,0,11,0,11,9,0,9,0,0,0,20,0,20
KARNATAKA,2012,IMMORAL TRAFFIC (PREVENTION) ACT,0,0,0,16,12,28,11,17,28,2,0,2,29,29,58
KARNATAKA,2012,INDIAN RAILWAYS ACT,0,0,0,36,0,36,11,2,13,1,0,1,48,2,50
KARNATAKA,2012,REGISTRATION OF FOREIGNERS ACT,0,0,0,7,1,8,13,2,15,0,0,0,20,3,23
KARNATAKA,2012,PROTECTION OF CIVIL RIGHTS ACT,0,0,0,7,0,7,16,0,16,0,0,0,23,0,23
KARNATAKA,2012,SC/ST (PREVENTION OF ATROCITIES) ACT,0,0,0,3,0,3,7,0,7,1,0,1,11,0,11
KARNATAKA,2012,INDIAN PASSPORT ACT,0,0,0,3,0,3,9,0,9,0,0,0,12,0,12
KARNATAKA,2012,ESSENTIAL COMMODITIES ACT,0,0,0,0,0,0,5,0,5,0,0,0,5,0,5
KARNATAKA,2012,ANTIQUITIES AND ART TREASURE ACT,0,0,0,0,0,0,2,0,2,0,0,0,2,0,2
KARNATAKA,2012,DOWRY PROHIBITION ACT,0,0,0,32,4,36,51,18,69,7,2,9,90,24,114
KARNATAKA,2012,FOREIGN EXCHANGE REGULATION ACT-1973,0,0,0,1,0,1,4,0,4,0,0,0,5,0,5
KARNATAKA,2012,PREVENTION OF CORRUPTION ACT-1988,0,0,0,0,0,0,9,0,9,0,0,0,9,0,9
KARNATAKA,2012,CONSER.OF FORGN.EXCH.&PREV. OF SMUG.ACT,0,0,0,0,0,0,0,0,0,0,0,0,0,0,0
KARNATAKA,2012,OTHER SLL OFFENCE,0,0,0,0,0,0,3,0,3,1,0,1,4,0,4
KARNATAKA,2012,TOTAL,0,0,0,254,20,274,319,42,361,17,2,19,590,64,654
KERALA,2001,ARMS ACT,0,0,0,2,0,2,18,0,18,12,0,12,32,0,32
KERALA,2001,N.D.P.S. ACT,0,0,0,20,6,26,96,0,96,52,1,53,168,7,175
KERALA,2001,GAMBLING ACT,0,0,0,0,0,0,0,0,0,0,0,0,0,0,0
KERALA,2001,EXCISE ACT,0,0,0,222,11,233,240,3,243,108,1,109,570,15,585
KERALA,2001,PROHIBITION ACT,0,0,0,28,0,28,16,0,16,3,0,3,47,0,47
KERALA,2001,EXPLOSIVE & EXPLOSIVE SUBST. ACT,0,0,0,0,0,0,0,0,0,0,0,0,0,0,0
KERALA,2001,TERRORIST & DISRUPTIVE ACTIVITIES (TATA),0,0,0,0,0,0,0,0,0,0,0,0,0,0,0
KERALA,2001,IMMORAL TRAFFIC (PREVENTION) ACT,0,0,0,129,8,137,156,0,156,22,0,22,307,8,315
KERALA,2001,INDIAN RAILWAYS ACT,0,0,0,12,0,12,10,0,10,2,0,2,24,0,24
KERALA,2001,REGISTRATION OF FOREIGNERS ACT,0,0,0,0,0,0,0,0,0,0,0,0,0,0,0
KERALA,2001,PROTECTION OF CIVIL RIGHTS ACT,0,0,0,0,0,0,0,0,0,0,0,0,0,0,0
KERALA,2001,SC/ST (PREVENTION OF ATROCITIES) ACT,0,0,0,0,0,0,0,0,0,0,0,0,0,0,0
KERALA,2001,INDIAN PASSPORT ACT,0,0,0,2,0,2,3,0,3,1,0,1,6,0,6
KERALA,2001,ESSENTIAL COMMODITIES ACT,0,0,0,2,0,2,0,0,0,1,0,1,3,0,3
KERALA,2001,ANTIQUITIES AND ART TREASURE ACT,0,0,0,0,0,0,0,0,0,0,0,0,0,0,0
KERALA,2001,DOWRY PROHIBITION ACT,0,0,0,8,5,13,5,0,5,3,0,3,16,5,21
KERALA,2001,FOREIGN EXCHANGE REGULATION ACT-1973,0,0,0,0,0,0,0,0,0,0,0,0,0,0,0
KERALA,2001,PREVENTION OF CORRUPTION ACT-1988,0,0,0,0,0,0,0,0,0,0,0,0,0,0,0
KERALA,2001,CONSER.OF FORGN.EXCH.&PREV. OF SMUG.ACT,0,0,0,0,0,0,0,0,0,0,0,0,0,0,0
KERALA,2001,OTHER SLL OFFENCE,0,0,0,79,0,79,91,0,91,7,0,7,177,0,177
KERALA,2001,TOTAL,0,0,0,504,30,534,635,3,638,211,2,213,1350,35,1385
KERALA,2002,ARMS ACT,0,0,0,12,0,12,18,0,18,13,0,13,43,0,43
KERALA,2002,N.D.P.S. ACT,0,0,0,107,0,107,52,0,52,17,0,17,176,0,176
KERALA,2002,GAMBLING ACT,0,0,0,25,0,25,23,0,23,15,0,15,63,0,63
KERALA,2002,EXCISE ACT,0,0,0,262,5,267,383,19,402,122,8,130,767,32,799
KERALA,2002,PROHIBITION ACT,0,0,0,0,0,0,21,0,21,0,0,0,21,0,21
KERALA,2002,EXPLOSIVE & EXPLOSIVE SUBST. ACT,0,0,0,19,0,19,0,0,0,0,0,0,19,0,19
KERALA,2002,TERRORIST & DISRUPTIVE ACTIVITIES (TATA),0,0,0,0,0,0,0,0,0,0,0,0,0,0,0
KERALA,2002,IMMORAL TRAFFIC (PREVENTION) ACT,0,0,0,32,15,47,71,2,73,2,0,2,105,17,122
KERALA,2002,INDIAN RAILWAYS ACT,0,0,0,16,0,16,5,0,5,0,0,0,21,0,21
KERALA,2002,REGISTRATION OF FOREIGNERS ACT,0,0,0,0,0,0,0,0,0,0,0,0,0,0,0
KERALA,2002,PROTECTION OF CIVIL RIGHTS ACT,0,0,0,0,0,0,0,0,0,0,0,0,0,0,0
KERALA,2002,SC/ST (PREVENTION OF ATROCITIES) ACT,0,0,0,0,0,0,0,0,0,0,0,0,0,0,0
KERALA,2002,INDIAN PASSPORT ACT,0,0,0,13,0,13,13,0,13,1,0,1,27,0,27
KERALA,2002,ESSENTIAL COMMODITIES ACT,0,0,0,0,0,0,0,0,0,0,0,0,0,0,0
KERALA,2002,ANTIQUITIES AND ART TREASURE ACT,0,0,0,0,0,0,0,0,0,0,0,0,0,0,0
KERALA,2002,DOWRY PROHIBITION ACT,0,0,0,27,0,27,22,0,22,2,0,2,51,0,51
KERALA,2002,FOREIGN EXCHANGE REGULATION ACT-1973,0,0,0,3,0,3,2,0,2,0,0,0,5,0,5
KERALA,2002,PREVENTION OF CORRUPTION ACT-1988,0,0,0,1,0,1,0,0,0,0,0,0,1,0,1
KERALA,2002,CONSER.OF FORGN.EXCH.&PREV. OF SMUG.ACT,0,0,0,1,0,1,3,0,3,0,0,0,4,0,4
KERALA,2002,OTHER SLL OFFENCE,0,0,0,79,0,79,35,0,35,4,0,4,118,0,118
KERALA,2002,TOTAL,0,0,0,597,20,617,648,21,669,176,8,184,1421,49,1470
KERALA,2003,ARMS ACT,0,0,0,14,0,14,16,0,16,13,0,13,43,0,43
KERALA,2003,N.D.P.S. ACT,0,0,0,207,0,207,102,0,102,42,0,42,351,0,351
KERALA,2003,GAMBLING ACT,0,0,0,25,0,25,23,0,23,15,0,15,63,0,63
KERALA,2003,EXCISE ACT,0,0,0,463,7,470,459,17,476,192,8,200,1114,32,1146
KERALA,2003,PROHIBITION ACT,0,0,0,0,0,0,21,0,21,0,0,0,21,0,21
KERALA,2003,EXPLOSIVE & EXPLOSIVE SUBST. ACT,0,0,0,19,0,19,0,0,0,0,0,0,19,0,19
KERALA,2003,TERRORIST & DISRUPTIVE ACTIVITIES (TATA),0,0,0,0,0,0,0,0,0,0,0,0,0,0,0
KERALA,2003,IMMORAL TRAFFIC (PREVENTION) ACT,0,0,0,37,15,52,66,2,68,2,0,2,105,17,122
KERALA,2003,INDIAN RAILWAYS ACT,0,0,0,18,0,18,3,0,3,0,0,0,21,0,21
KERALA,2003,REGISTRATION OF FOREIGNERS ACT,0,0,0,0,0,0,0,0,0,0,0,0,0,0,0
KERALA,2003,PROTECTION OF CIVIL RIGHTS ACT,0,0,0,0,0,0,0,0,0,0,0,0,0,0,0
KERALA,2003,SC/ST (PREVENTION OF ATROCITIES) ACT,0,0,0,0,0,0,0,0,0,0,0,0,0,0,0
KERALA,2003,INDIAN PASSPORT ACT,0,0,0,15,0,15,11,0,11,1,0,1,27,0,27
KERALA,2003,ESSENTIAL COMMODITIES ACT,0,0,0,0,0,0,0,0,0,0,0,0,0,0,0
KERALA,2003,ANTIQUITIES AND ART TREASURE ACT,0,0,0,0,0,0,0,0,0,0,0,0,0,0,0
KERALA,2003,DOWRY PROHIBITION ACT,0,0,0,29,0,29,20,0,20,2,0,2,51,0,51
KERALA,2003,FOREIGN EXCHANGE REGULATION ACT-1973,0,0,0,4,0,4,1,0,1,0,0,0,5,0,5
KERALA,2003,PREVENTION OF CORRUPTION ACT-1988,0,0,0,1,0,1,0,0,0,0,0,0,1,0,1
KERALA,2003,CONSER.OF FORGN.EXCH.&PREV. OF SMUG.ACT,0,0,0,1,0,1,3,0,3,0,0,0,4,0,4
KERALA,2003,OTHER SLL OFFENCE,0,0,0,84,0,84,30,0,30,4,0,4,118,0,118
KERALA,2003,TOTAL,0,0,0,917,22,939,755,19,774,271,8,279,1943,49,1992
KERALA,2004,ARMS ACT,0,0,0,11,0,11,160,0,160,110,0,110,281,0,281
KERALA,2004,N.D.P.S. ACT,0,0,0,26,0,26,102,5,107,31,2,33,159,7,166
KERALA,2004,GAMBLING ACT,0,0,0,0,0,0,2,0,2,0,0,0,2,0,2
KERALA,2004,EXCISE ACT,0,0,0,359,0,359,400,11,411,89,7,96,848,18,866
KERALA,2004,PROHIBITION ACT,0,0,0,8,0,8,0,0,0,0,0,0,8,0,8
KERALA,2004,EXPLOSIVE & EXPLOSIVE SUBST. ACT,0,0,0,18,0,18,16,0,16,0,0,0,34,0,34
KERALA,2004,TERRORIST & DISRUPTIVE ACTIVITIES (TATA),0,0,0,0,0,0,0,0,0,0,0,0,0,0,0
KERALA,2004,IMMORAL TRAFFIC (PREVENTION) ACT,0,0,0,52,17,69,82,30,112,48,4,52,182,51,233
KERALA,2004,INDIAN RAILWAYS ACT,0,0,0,2,0,2,15,0,15,0,0,0,17,0,17
KERALA,2004,REGISTRATION OF FOREIGNERS ACT,0,0,0,0,0,0,0,0,0,0,0,0,0,0,0
KERALA,2004,PROTECTION OF CIVIL RIGHTS ACT,0,0,0,0,0,0,0,0,0,0,0,0,0,0,0
KERALA,2004,SC/ST (PREVENTION OF ATROCITIES) ACT,0,0,0,0,0,0,0,0,0,0,0,0,0,0,0
KERALA,2004,INDIAN PASSPORT ACT,0,0,0,0,0,0,0,0,0,0,0,0,0,0,0
KERALA,2004,ESSENTIAL COMMODITIES ACT,0,0,0,0,0,0,0,0,0,0,0,0,0,0,0
KERALA,2004,ANTIQUITIES AND ART TREASURE ACT,0,0,0,0,0,0,0,0,0,0,0,0,0,0,0
KERALA,2004,DOWRY PROHIBITION ACT,0,0,0,0,0,0,0,0,0,0,0,0,0,0,0
KERALA,2004,FOREIGN EXCHANGE REGULATION ACT-1973,0,0,0,0,0,0,0,0,0,0,0,0,0,0,0
KERALA,2004,PREVENTION OF CORRUPTION ACT-1988,0,0,0,0,0,0,0,0,0,0,0,0,0,0,0
KERALA,2004,CONSER.OF FORGN.EXCH.&PREV. OF SMUG.ACT,0,0,0,0,0,0,0,0,0,0,0,0,0,0,0
KERALA,2004,OTHER SLL OFFENCE,0,0,0,0,0,0,0,0,0,0,0,0,0,0,0
KERALA,2004,TOTAL,0,0,0,476,17,493,777,46,823,278,13,291,1531,76,1607
KERALA,2005,ARMS ACT,0,0,0,8,0,8,160,0,160,120,0,120,288,0,288
KERALA,2005,N.D.P.S. ACT,0,0,0,32,8,40,116,0,116,51,4,55,199,12,211
KERALA,2005,GAMBLING ACT,0,0,0,0,0,0,0,0,0,0,0,0,0,0,0
KERALA,2005,EXCISE ACT,0,0,0,654,66,720,563,0,563,255,6,261,1472,72,1544
KERALA,2005,PROHIBITION ACT,0,0,0,18,0,18,0,0,0,0,0,0,18,0,18
KERALA,2005,EXPLOSIVE & EXPLOSIVE SUBST. ACT,0,0,0,8,0,8,16,0,16,0,0,0,24,0,24
KERALA,2005,TERRORIST & DISRUPTIVE ACTIVITIES (TATA),0,0,0,0,0,0,0,0,0,0,0,0,0,0,0
KERALA,2005,IMMORAL TRAFFIC (PREVENTION) ACT,0,0,0,102,0,102,48,0,48,42,0,42,192,0,192
KERALA,2005,INDIAN RAILWAYS ACT,0,0,0,0,0,0,0,0,0,0,0,0,0,0,0
KERALA,2005,REGISTRATION OF FOREIGNERS ACT,0,0,0,0,0,0,0,0,0,0,0,0,0,0,0
KERALA,2005,PROTECTION OF CIVIL RIGHTS ACT,0,0,0,0,0,0,0,0,0,0,0,0,0,0,0
KERALA,2005,SC/ST (PREVENTION OF ATROCITIES) ACT,0,0,0,0,0,0,0,0,0,0,0,0,0,0,0
KERALA,2005,INDIAN PASSPORT ACT,0,0,0,0,0,0,0,0,0,0,0,0,0,0,0
KERALA,2005,ESSENTIAL COMMODITIES ACT,0,0,0,0,0,0,0,0,0,0,0,0,0,0,0
KERALA,2005,ANTIQUITIES AND ART TREASURE ACT,0,0,0,0,0,0,0,0,0,0,0,0,0,0,0
KERALA,2005,DOWRY PROHIBITION ACT,0,0,0,0,0,0,0,0,0,0,0,0,0,0,0
KERALA,2005,FOREIGN EXCHANGE REGULATION ACT-1973,0,0,0,0,0,0,0,0,0,0,0,0,0,0,0
KERALA,2005,PREVENTION OF CORRUPTION ACT-1988,0,0,0,0,0,0,0,0,0,0,0,0,0,0,0
KERALA,2005,CONSER.OF FORGN.EXCH.&PREV. OF SMUG.ACT,0,0,0,0,0,0,0,0,0,0,0,0,0,0,0
KERALA,2005,OTHER SLL OFFENCE,0,0,0,0,0,0,0,0,0,0,0,0,0,0,0
KERALA,2005,TOTAL,0,0,0,822,74,896,903,0,903,468,10,478,2193,84,2277
KERALA,2006,ARMS ACT,0,0,0,27,0,27,18,0,18,6,0,6,51,0,51
KERALA,2006,N.D.P.S. ACT,0,0,0,35,0,35,50,3,53,16,0,16,101,3,104
KERALA,2006,GAMBLING ACT,0,0,0,3,0,3,1,0,1,0,0,0,4,0,4
KERALA,2006,EXCISE ACT,0,0,0,292,4,296,219,21,240,119,8,127,630,33,663
KERALA,2006,PROHIBITION ACT,0,0,0,0,0,0,0,0,0,0,0,0,0,0,0
KERALA,2006,EXPLOSIVE & EXPLOSIVE SUBST. ACT,0,0,0,9,0,9,8,0,8,0,0,0,17,0,17
KERALA,2006,TERRORIST & DISRUPTIVE ACTIVITIES (TATA),0,0,0,0,0,0,0,0,0,0,0,0,0,0,0
KERALA,2006,IMMORAL TRAFFIC (PREVENTION) ACT,0,0,0,7,6,13,4,5,9,0,0,0,11,11,22
KERALA,2006,INDIAN RAILWAYS ACT,0,0,0,20,0,20,21,1,22,4,0,4,45,1,46
KERALA,2006,REGISTRATION OF FOREIGNERS ACT,0,0,0,0,0,0,0,0,0,0,0,0,0,0,0
KERALA,2006,PROTECTION OF CIVIL RIGHTS ACT,0,0,0,2,0,2,0,0,0,0,0,0,2,0,2
KERALA,2006,SC/ST (PREVENTION OF ATROCITIES) ACT,0,0,0,1,0,1,4,0,4,0,0,0,5,0,5
KERALA,2006,INDIAN PASSPORT ACT,0,0,0,0,0,0,0,0,0,0,0,0,0,0,0
KERALA,2006,ESSENTIAL COMMODITIES ACT,0,0,0,0,0,0,6,0,6,0,0,0,6,0,6
KERALA,2006,ANTIQUITIES AND ART TREASURE ACT,0,0,0,0,0,0,0,0,0,0,0,0,0,0,0
KERALA,2006,DOWRY PROHIBITION ACT,0,0,0,3,0,3,0,0,0,1,0,1,4,0,4
KERALA,2006,FOREIGN EXCHANGE REGULATION ACT-1973,0,0,0,0,0,0,0,0,0,0,0,0,0,0,0
KERALA,2006,PREVENTION OF CORRUPTION ACT-1988,0,0,0,0,0,0,6,0,6,0,0,0,6,0,6
KERALA,2006,CONSER.OF FORGN.EXCH.&PREV. OF SMUG.ACT,0,0,0,0,0,0,0,0,0,0,0,0,0,0,0
KERALA,2006,OTHER SLL OFFENCE,0,0,0,38,2,40,36,4,40,9,0,9,83,6,89
KERALA,2006,TOTAL,0,0,0,437,12,449,373,34,407,155,8,163,965,54,1019
KERALA,2007,ARMS ACT,0,0,0,35,0,35,20,0,20,8,0,8,63,0,63
KERALA,2007,N.D.P.S. ACT,0,0,0,42,0,42,60,3,63,18,0,18,120,3,123
KERALA,2007,GAMBLING ACT,0,0,0,2,0,2,8,0,8,2,0,2,12,0,12
KERALA,2007,EXCISE ACT,0,0,0,225,4,229,263,21,284,129,4,133,617,29,646
KERALA,2007,PROHIBITION ACT,0,0,0,0,0,0,0,0,0,0,0,0,0,0,0
KERALA,2007,EXPLOSIVE & EXPLOSIVE SUBST. ACT,0,0,0,9,0,9,25,0,25,5,0,5,39,0,39
KERALA,2007,TERRORIST & DISRUPTIVE ACTIVITIES (TATA),0,0,0,0,0,0,0,0,0,0,0,0,0,0,0
KERALA,2007,IMMORAL TRAFFIC (PREVENTION) ACT,0,0,0,8,1,9,6,7,13,0,0,0,14,8,22
KERALA,2007,INDIAN RAILWAYS ACT,0,0,0,10,0,10,25,0,25,3,0,3,38,0,38
KERALA,2007,REGISTRATION OF FOREIGNERS ACT,0,0,0,0,0,0,0,0,0,0,0,0,0,0,0
KERALA,2007,PROTECTION OF CIVIL RIGHTS ACT,0,0,0,3,0,3,2,0,2,0,0,0,5,0,5
KERALA,2007,SC/ST (PREVENTION OF ATROCITIES) ACT,0,0,0,0,0,0,0,0,0,0,0,0,0,0,0
KERALA,2007,INDIAN PASSPORT ACT,0,0,0,0,0,0,0,0,0,0,0,0,0,0,0
KERALA,2007,ESSENTIAL COMMODITIES ACT,0,0,0,0,0,0,0,0,0,0,0,0,0,0,0
KERALA,2007,ANTIQUITIES AND ART TREASURE ACT,0,0,0,0,0,0,0,0,0,0,0,0,0,0,0
KERALA,2007,DOWRY PROHIBITION ACT,0,0,0,0,0,0,0,0,0,0,0,0,0,0,0
KERALA,2007,FOREIGN EXCHANGE REGULATION ACT-1973,0,0,0,0,0,0,0,0,0,0,0,0,0,0,0
KERALA,2007,PREVENTION OF CORRUPTION ACT-1988,0,0,0,2,0,2,7,0,7,3,0,3,12,0,12
KERALA,2007,CONSER.OF FORGN.EXCH.&PREV. OF SMUG.ACT,0,0,0,0,0,0,5,0,5,0,0,0,5,0,5
KERALA,2007,OTHER SLL OFFENCE,0,0,0,55,1,56,78,0,78,53,1,54,186,2,188
KERALA,2007,TOTAL,0,0,0,391,6,397,499,31,530,221,5,226,1111,42,1153
KERALA,2008,ARMS ACT,0,0,0,85,0,85,85,0,85,8,0,8,178,0,178
KERALA,2008,N.D.P.S. ACT,0,0,0,42,0,42,60,3,63,18,0,18,120,3,123
KERALA,2008,GAMBLING ACT,0,0,0,2,0,2,8,0,8,2,0,2,12,0,12
KERALA,2008,EXCISE ACT,0,0,0,225,4,229,273,25,298,159,4,163,657,33,690
KERALA,2008,PROHIBITION ACT,0,0,0,0,0,0,0,0,0,0,0,0,0,0,0
KERALA,2008,EXPLOSIVE & EXPLOSIVE SUBST. ACT,0,0,0,9,0,9,25,0,25,5,0,5,39,0,39
KERALA,2008,TERRORIST & DISRUPTIVE ACTIVITIES (TATA),0,0,0,0,0,0,0,0,0,0,0,0,0,0,0
KERALA,2008,IMMORAL TRAFFIC (PREVENTION) ACT,0,0,0,8,1,9,6,7,13,0,0,0,14,8,22
KERALA,2008,INDIAN RAILWAYS ACT,0,0,0,10,0,10,30,0,30,3,0,3,43,0,43
KERALA,2008,REGISTRATION OF FOREIGNERS ACT,0,0,0,0,0,0,0,0,0,0,0,0,0,0,0
KERALA,2008,PROTECTION OF CIVIL RIGHTS ACT,0,0,0,3,0,3,2,0,2,0,0,0,5,0,5
KERALA,2008,SC/ST (PREVENTION OF ATROCITIES) ACT,0,0,0,0,0,0,0,0,0,0,0,0,0,0,0
KERALA,2008,INDIAN PASSPORT ACT,0,0,0,0,0,0,0,0,0,0,0,0,0,0,0
KERALA,2008,ESSENTIAL COMMODITIES ACT,0,0,0,0,0,0,0,0,0,0,0,0,0,0,0
KERALA,2008,ANTIQUITIES AND ART TREASURE ACT,0,0,0,0,0,0,0,0,0,0,0,0,0,0,0
KERALA,2008,DOWRY PROHIBITION ACT,0,0,0,0,0,0,0,0,0,0,0,0,0,0,0
KERALA,2008,FOREIGN EXCHANGE REGULATION ACT-1973,0,0,0,0,0,0,0,0,0,0,0,0,0,0,0
KERALA,2008,PREVENTION OF CORRUPTION ACT-1988,0,0,0,2,0,2,7,0,7,3,0,3,12,0,12
KERALA,2008,CONSER.OF FORGN.EXCH.&PREV. OF SMUG.ACT,0,0,0,0,0,0,12,0,12,0,0,0,12,0,12
KERALA,2008,OTHER SLL OFFENCE,0,0,0,44,1,45,140,0,140,61,1,62,245,2,247
KERALA,2008,TOTAL,0,0,0,430,6,436,648,35,683,259,5,264,1337,46,1383
KERALA,2009,ARMS ACT,0,0,0,53,0,53,20,0,20,3,0,3,76,0,76
KERALA,2009,N.D.P.S. ACT,0,0,0,18,0,18,49,1,50,15,2,17,82,3,85
KERALA,2009,GAMBLING ACT,0,0,0,0,0,0,4,0,4,2,0,2,6,0,6
KERALA,2009,EXCISE ACT,0,0,0,253,7,260,252,14,266,66,4,70,571,25,596
KERALA,2009,PROHIBITION ACT,0,0,0,0,0,0,5,1,6,0,0,0,5,1,6
KERALA,2009,EXPLOSIVE & EXPLOSIVE SUBST. ACT,0,0,0,18,0,18,21,0,21,5,0,5,44,0,44
KERALA,2009,TERRORIST & DISRUPTIVE ACTIVITIES (TATA),0,0,0,0,0,0,1,0,1,0,0,0,1,0,1
KERALA,2009,IMMORAL TRAFFIC (PREVENTION) ACT,0,0,0,6,3,9,9,8,17,4,0,4,19,11,30
KERALA,2009,INDIAN RAILWAYS ACT,0,0,0,19,1,20,19,0,19,8,0,8,46,1,47
KERALA,2009,REGISTRATION OF FOREIGNERS ACT,0,0,0,0,0,0,0,0,0,0,0,0,0,0,0
KERALA,2009,PROTECTION OF CIVIL RIGHTS ACT,0,0,0,0,0,0,0,0,0,0,0,0,0,0,0
KERALA,2009,SC/ST (PREVENTION OF ATROCITIES) ACT,0,0,0,2,0,2,1,0,1,0,0,0,3,0,3
KERALA,2009,INDIAN PASSPORT ACT,0,0,0,6,0,6,7,0,7,0,0,0,13,0,13
KERALA,2009,ESSENTIAL COMMODITIES ACT,0,0,0,0,0,0,0,0,0,0,0,0,0,0,0
KERALA,2009,ANTIQUITIES AND ART TREASURE ACT,0,0,0,0,0,0,2,0,2,0,0,0,2,0,2
KERALA,2009,DOWRY PROHIBITION ACT,0,0,0,13,0,13,9,0,9,2,0,2,24,0,24
KERALA,2009,FOREIGN EXCHANGE REGULATION ACT-1973,0,0,0,0,0,0,0,0,0,0,0,0,0,0,0
KERALA,2009,PREVENTION OF CORRUPTION ACT-1988,0,0,0,0,0,0,2,0,2,0,0,0,2,0,2
KERALA,2009,CONSER.OF FORGN.EXCH.&PREV. OF SMUG.ACT,0,0,0,0,0,0,0,0,0,0,0,0,0,0,0
KERALA,2009,OTHER SLL OFFENCE,0,0,0,146,0,146,205,8,213,65,0,65,416,8,424
KERALA,2009,TOTAL,0,0,0,534,11,545,606,32,638,170,6,176,1310,49,1359
KERALA,2010,ARMS ACT,0,0,0,53,0,53,27,0,27,0,0,0,80,0,80
KERALA,2010,N.D.P.S. ACT,0,0,0,18,0,18,85,2,87,16,0,16,119,2,121
KERALA,2010,GAMBLING ACT,0,0,0,0,0,0,3,0,3,0,0,0,3,0,3
KERALA,2010,EXCISE ACT,2,0,2,253,7,260,248,7,255,73,26,99,576,40,616
KERALA,2010,PROHIBITION ACT,0,0,0,0,0,0,7,0,7,0,0,0,7,0,7
KERALA,2010,EXPLOSIVE & EXPLOSIVE SUBST. ACT,0,0,0,18,0,18,26,0,26,0,0,0,44,0,44
KERALA,2010,TERRORIST & DISRUPTIVE ACTIVITIES (TATA),0,0,0,0,0,0,0,0,0,0,0,0,0,0,0
KERALA,2010,IMMORAL TRAFFIC (PREVENTION) ACT,0,0,0,6,3,9,10,0,10,1,0,1,17,3,20
KERALA,2010,INDIAN RAILWAYS ACT,0,0,0,19,1,20,21,0,21,0,0,0,40,1,41
KERALA,2010,REGISTRATION OF FOREIGNERS ACT,0,0,0,0,0,0,0,0,0,0,0,0,0,0,0
KERALA,2010,PROTECTION OF CIVIL RIGHTS ACT,0,0,0,0,0,0,0,0,0,0,0,0,0,0,0
KERALA,2010,SC/ST (PREVENTION OF ATROCITIES) ACT,0,0,0,2,0,2,2,0,2,0,0,0,4,0,4
KERALA,2010,INDIAN PASSPORT ACT,0,0,0,6,0,6,9,0,9,0,0,0,15,0,15
KERALA,2010,ESSENTIAL COMMODITIES ACT,0,0,0,0,0,0,2,0,2,0,0,0,2,0,2
KERALA,2010,ANTIQUITIES AND ART TREASURE ACT,0,0,0,0,0,0,9,0,9,0,0,0,9,0,9
KERALA,2010,DOWRY PROHIBITION ACT,0,0,0,0,0,0,0,0,0,0,0,0,0,0,0
KERALA,2010,FOREIGN EXCHANGE REGULATION ACT-1973,0,0,0,13,0,13,0,0,0,0,0,0,13,0,13
KERALA,2010,PREVENTION OF CORRUPTION ACT-1988,0,0,0,0,0,0,3,0,3,0,0,0,3,0,3
KERALA,2010,CONSER.OF FORGN.EXCH.&PREV. OF SMUG.ACT,0,0,0,0,0,0,5,0,5,0,0,0,5,0,5
KERALA,2010,OTHER SLL OFFENCE,0,0,0,146,4,150,185,15,200,8,0,8,339,19,358
KERALA,2010,TOTAL,2,0,2,534,15,549,642,24,666,98,26,124,1276,65,1341
KERALA,2011,ARMS ACT,0,0,0,53,0,53,27,0,27,0,0,0,80,0,80
KERALA,2011,N.D.P.S. ACT,0,0,0,28,0,28,75,2,77,21,0,21,124,2,126
KERALA,2011,GAMBLING ACT,0,0,0,0,0,0,3,0,3,0,0,0,3,0,3
KERALA,2011,EXCISE ACT,2,0,2,303,7,310,238,5,243,84,13,97,627,25,652
KERALA,2011,PROHIBITION ACT,0,0,0,0,0,0,7,0,7,0,0,0,7,0,7
KERALA,2011,EXPLOSIVE & EXPLOSIVE SUBST. ACT,0,0,0,18,0,18,21,0,21,0,0,0,39,0,39
KERALA,2011,TERRORIST & DISRUPTIVE ACTIVITIES (TATA),0,0,0,0,0,0,0,0,0,0,0,0,0,0,0
KERALA,2011,IMMORAL TRAFFIC (PREVENTION) ACT,0,0,0,6,3,9,10,0,10,1,0,1,17,3,20
KERALA,2011,INDIAN RAILWAYS ACT,0,0,0,19,1,20,21,0,21,0,0,0,40,1,41
KERALA,2011,REGISTRATION OF FOREIGNERS ACT,0,0,0,0,0,0,0,0,0,0,0,0,0,0,0
KERALA,2011,PROTECTION OF CIVIL RIGHTS ACT,0,0,0,0,0,0,0,0,0,0,0,0,0,0,0
KERALA,2011,SC/ST (PREVENTION OF ATROCITIES) ACT,0,0,0,2,0,2,2,0,2,0,0,0,4,0,4
KERALA,2011,INDIAN PASSPORT ACT,0,0,0,6,0,6,9,0,9,3,0,3,18,0,18
KERALA,2011,ESSENTIAL COMMODITIES ACT,0,0,0,0,0,0,2,0,2,0,0,0,2,0,2
KERALA,2011,ANTIQUITIES AND ART TREASURE ACT,0,0,0,0,0,0,7,0,7,0,0,0,7,0,7
KERALA,2011,DOWRY PROHIBITION ACT,0,0,0,0,0,0,0,0,0,0,0,0,0,0,0
KERALA,2011,FOREIGN EXCHANGE REGULATION ACT-1973,0,0,0,13,0,13,0,0,0,0,0,0,13,0,13
KERALA,2011,PREVENTION OF CORRUPTION ACT-1988,0,0,0,0,0,0,3,0,3,0,0,0,3,0,3
KERALA,2011,CONSER.OF FORGN.EXCH.&PREV. OF SMUG.ACT,0,0,0,0,0,0,5,0,5,0,0,0,5,0,5
KERALA,2011,OTHER SLL OFFENCE,0,0,0,166,3,169,193,16,209,16,0,16,375,19,394
KERALA,2011,TOTAL,2,0,2,614,14,628,623,23,646,125,13,138,1364,50,1414
KERALA,2012,ARMS ACT,0,0,0,54,0,54,28,0,28,0,0,0,82,0,82
KERALA,2012,N.D.P.S. ACT,0,0,0,0,0,0,4,0,4,0,0,0,4,0,4
KERALA,2012,GAMBLING ACT,0,0,0,0,0,0,4,0,4,0,0,0,4,0,4
KERALA,2012,EXCISE ACT,4,0,4,305,9,314,83,9,92,95,6,101,487,24,511
KERALA,2012,PROHIBITION ACT,0,0,0,0,0,0,8,0,8,0,0,0,8,0,8
KERALA,2012,EXPLOSIVE & EXPLOSIVE SUBST. ACT,0,0,0,19,0,19,22,0,22,0,0,0,41,0,41
KERALA,2012,TERRORIST & DISRUPTIVE ACTIVITIES (TATA),0,0,0,0,0,0,0,0,0,0,0,0,0,0,0
KERALA,2012,IMMORAL TRAFFIC (PREVENTION) ACT,0,0,0,7,4,11,11,0,11,2,0,2,20,4,24
KERALA,2012,INDIAN RAILWAYS ACT,0,0,0,21,4,25,22,0,22,0,0,0,43,4,47
KERALA,2012,REGISTRATION OF FOREIGNERS ACT,0,0,0,0,0,0,0,0,0,0,0,0,0,0,0
KERALA,2012,PROTECTION OF CIVIL RIGHTS ACT,0,0,0,0,0,0,0,0,0,0,0,0,0,0,0
KERALA,2012,SC/ST (PREVENTION OF ATROCITIES) ACT,0,0,0,3,0,3,3,0,3,7,0,7,13,0,13
KERALA,2012,INDIAN PASSPORT ACT,0,0,0,21,2,23,22,0,22,0,0,0,43,2,45
KERALA,2012,ESSENTIAL COMMODITIES ACT,0,0,0,0,0,0,3,0,3,0,0,0,3,0,3
KERALA,2012,ANTIQUITIES AND ART TREASURE ACT,0,0,0,0,0,0,8,0,8,0,0,0,8,0,8
KERALA,2012,DOWRY PROHIBITION ACT,0,0,0,0,0,0,0,0,0,0,0,0,0,0,0
KERALA,2012,FOREIGN EXCHANGE REGULATION ACT-1973,0,0,0,14,0,14,0,0,0,0,0,0,14,0,14
KERALA,2012,PREVENTION OF CORRUPTION ACT-1988,0,0,0,0,0,0,4,0,4,0,0,0,4,0,4
KERALA,2012,CONSER.OF FORGN.EXCH.&PREV. OF SMUG.ACT,0,0,0,0,0,0,6,0,6,0,0,0,6,0,6
KERALA,2012,OTHER SLL OFFENCE,0,0,0,167,5,172,262,6,268,17,0,17,446,11,457
KERALA,2012,TOTAL,4,0,4,611,24,635,490,15,505,121,6,127,1226,45,1271
MADHYA PRADESH,2001,ARMS ACT,10,0,10,272,1,273,142,0,142,11,0,11,435,1,436
MADHYA PRADESH,2001,N.D.P.S. ACT,7,0,7,414,17,431,443,23,466,270,10,280,1134,50,1184
MADHYA PRADESH,2001,GAMBLING ACT,0,0,0,23,0,23,22,3,25,12,1,13,57,4,61
MADHYA PRADESH,2001,EXCISE ACT,1,0,1,100,0,100,56,1,57,11,0,11,168,1,169
MADHYA PRADESH,2001,PROHIBITION ACT,0,0,0,22,0,22,12,0,12,2,0,2,36,0,36
MADHYA PRADESH,2001,EXPLOSIVE & EXPLOSIVE SUBST. ACT,0,0,0,17,0,17,19,0,19,1,0,1,37,0,37
MADHYA PRADESH,2001,TERRORIST & DISRUPTIVE ACTIVITIES (TATA),0,0,0,0,0,0,0,0,0,0,0,0,0,0,0
MADHYA PRADESH,2001,IMMORAL TRAFFIC (PREVENTION) ACT,0,0,0,0,0,0,0,0,0,0,0,0,0,0,0
MADHYA PRADESH,2001,INDIAN RAILWAYS ACT,49,0,49,173,0,173,81,0,81,8,0,8,311,0,311
MADHYA PRADESH,2001,REGISTRATION OF FOREIGNERS ACT,0,0,0,0,0,0,0,0,0,0,0,0,0,0,0
MADHYA PRADESH,2001,PROTECTION OF CIVIL RIGHTS ACT,0,0,0,0,0,0,0,0,0,0,0,0,0,0,0
MADHYA PRADESH,2001,SC/ST (PREVENTION OF ATROCITIES) ACT,0,0,0,9,0,9,5,0,5,2,0,2,16,0,16
MADHYA PRADESH,2001,INDIAN PASSPORT ACT,0,0,0,0,0,0,0,0,0,0,0,0,0,0,0
MADHYA PRADESH,2001,ESSENTIAL COMMODITIES ACT,0,0,0,0,0,0,0,0,0,0,0,0,0,0,0
MADHYA PRADESH,2001,ANTIQUITIES AND ART TREASURE ACT,0,0,0,0,0,0,0,0,0,0,0,0,0,0,0
MADHYA PRADESH,2001,DOWRY PROHIBITION ACT,0,0,0,61,2,63,38,7,45,19,1,20,118,10,128
MADHYA PRADESH,2001,FOREIGN EXCHANGE REGULATION ACT-1973,0,0,0,0,0,0,0,0,0,0,0,0,0,0,0
MADHYA PRADESH,2001,PREVENTION OF CORRUPTION ACT-1988,0,0,0,0,2,2,3,0,3,1,0,1,4,2,6
MADHYA PRADESH,2001,CONSER.OF FORGN.EXCH.&PREV. OF SMUG.ACT,0,0,0,0,0,0,0,0,0,0,0,0,0,0,0
MADHYA PRADESH,2001,OTHER SLL OFFENCE,4,0,4,179,2,181,244,10,254,71,15,86,498,27,525
MADHYA PRADESH,2001,TOTAL,71,0,71,1270,24,1294,1065,44,1109,408,27,435,2814,95,2909
MADHYA PRADESH,2002,ARMS ACT,21,0,21,336,3,339,247,2,249,47,0,47,651,5,656
MADHYA PRADESH,2002,N.D.P.S. ACT,6,0,6,413,12,425,548,23,571,109,4,113,1076,39,1115
MADHYA PRADESH,2002,GAMBLING ACT,0,0,0,33,0,33,40,0,40,10,0,10,83,0,83
MADHYA PRADESH,2002,EXCISE ACT,2,0,2,135,3,138,128,4,132,25,0,25,290,7,297
MADHYA PRADESH,2002,PROHIBITION ACT,0,0,0,0,0,0,0,0,0,0,0,0,0,0,0
MADHYA PRADESH,2002,EXPLOSIVE & EXPLOSIVE SUBST. ACT,0,0,0,10,0,10,6,0,6,8,0,8,24,0,24
MADHYA PRADESH,2002,TERRORIST & DISRUPTIVE ACTIVITIES (TATA),0,0,0,0,0,0,0,0,0,0,0,0,0,0,0
MADHYA PRADESH,2002,IMMORAL TRAFFIC (PREVENTION) ACT,0,0,0,0,0,0,0,0,0,0,0,0,0,0,0
MADHYA PRADESH,2002,INDIAN RAILWAYS ACT,10,0,10,44,0,44,20,0,20,8,0,8,82,0,82
MADHYA PRADESH,2002,REGISTRATION OF FOREIGNERS ACT,0,0,0,0,0,0,0,0,0,0,0,0,0,0,0
MADHYA PRADESH,2002,PROTECTION OF CIVIL RIGHTS ACT,0,0,0,2,0,2,0,0,0,0,0,0,2,0,2
MADHYA PRADESH,2002,SC/ST (PREVENTION OF ATROCITIES) ACT,0,0,0,15,0,15,20,0,20,8,0,8,43,0,43
MADHYA PRADESH,2002,INDIAN PASSPORT ACT,0,0,0,0,0,0,0,0,0,0,0,0,0,0,0
MADHYA PRADESH,2002,ESSENTIAL COMMODITIES ACT,0,0,0,0,0,0,0,0,0,0,0,0,0,0,0
MADHYA PRADESH,2002,ANTIQUITIES AND ART TREASURE ACT,0,0,0,0,0,0,0,0,0,0,0,0,0,0,0
MADHYA PRADESH,2002,DOWRY PROHIBITION ACT,3,0,3,73,1,74,41,10,51,26,1,27,143,12,155
MADHYA PRADESH,2002,FOREIGN EXCHANGE REGULATION ACT-1973,0,0,0,0,0,0,0,0,0,0,0,0,0,0,0
MADHYA PRADESH,2002,PREVENTION OF CORRUPTION ACT-1988,0,0,0,0,0,0,0,0,0,0,0,0,0,0,0
MADHYA PRADESH,2002,CONSER.OF FORGN.EXCH.&PREV. OF SMUG.ACT,0,0,0,0,0,0,0,0,0,0,0,0,0,0,0
MADHYA PRADESH,2002,OTHER SLL OFFENCE,3,0,3,97,3,100,121,1,122,29,0,29,250,4,254
MADHYA PRADESH,2002,TOTAL,45,0,45,1158,22,1180,1171,40,1211,270,5,275,2644,67,2711
MADHYA PRADESH,2003,ARMS ACT,0,0,0,335,0,335,278,2,280,51,0,51,664,2,666
MADHYA PRADESH,2003,N.D.P.S. ACT,0,0,0,328,16,344,276,28,304,52,0,52,656,44,700
MADHYA PRADESH,2003,GAMBLING ACT,0,0,0,24,0,24,29,0,29,0,0,0,53,0,53
MADHYA PRADESH,2003,EXCISE ACT,0,0,0,131,14,145,120,10,130,39,0,39,290,24,314
MADHYA PRADESH,2003,PROHIBITION ACT,0,0,0,5,0,5,2,0,2,0,0,0,7,0,7
MADHYA PRADESH,2003,EXPLOSIVE & EXPLOSIVE SUBST. ACT,0,0,0,8,0,8,0,0,0,0,0,0,8,0,8
MADHYA PRADESH,2003,TERRORIST & DISRUPTIVE ACTIVITIES (TATA),0,0,0,0,0,0,0,0,0,0,0,0,0,0,0
MADHYA PRADESH,2003,IMMORAL TRAFFIC (PREVENTION) ACT,0,0,0,0,0,0,0,0,0,0,0,0,0,0,0
MADHYA PRADESH,2003,INDIAN RAILWAYS ACT,52,0,52,21,0,21,16,1,17,6,0,6,95,1,96
MADHYA PRADESH,2003,REGISTRATION OF FOREIGNERS ACT,0,0,0,0,0,0,0,0,0,0,0,0,0,0,0
MADHYA PRADESH,2003,PROTECTION OF CIVIL RIGHTS ACT,0,0,0,0,0,0,0,0,0,0,0,0,0,0,0
MADHYA PRADESH,2003,SC/ST (PREVENTION OF ATROCITIES) ACT,0,0,0,37,0,37,20,0,20,15,0,15,72,0,72
MADHYA PRADESH,2003,INDIAN PASSPORT ACT,0,0,0,0,0,0,0,0,0,0,0,0,0,0,0
MADHYA PRADESH,2003,ESSENTIAL COMMODITIES ACT,0,0,0,0,0,0,0,0,0,0,0,0,0,0,0
MADHYA PRADESH,2003,ANTIQUITIES AND ART TREASURE ACT,0,0,0,0,0,0,0,0,0,0,0,0,0,0,0
MADHYA PRADESH,2003,DOWRY PROHIBITION ACT,0,0,0,15,10,25,8,6,14,3,2,5,26,18,44
MADHYA PRADESH,2003,FOREIGN EXCHANGE REGULATION ACT-1973,0,0,0,0,0,0,0,0,0,0,0,0,0,0,0
MADHYA PRADESH,2003,PREVENTION OF CORRUPTION ACT-1988,0,0,0,0,0,0,0,0,0,0,0,0,0,0,0
MADHYA PRADESH,2003,CONSER.OF FORGN.EXCH.&PREV. OF SMUG.ACT,0,0,0,0,0,0,0,0,0,0,0,0,0,0,0
MADHYA PRADESH,2003,OTHER SLL OFFENCE,0,0,0,103,3,106,107,1,108,36,2,38,246,6,252
MADHYA PRADESH,2003,TOTAL,52,0,52,1007,43,1050,856,48,904,202,4,206,2117,95,2212
MADHYA PRADESH,2004,ARMS ACT,0,0,0,293,0,293,377,1,378,32,0,32,702,1,703
MADHYA PRADESH,2004,N.D.P.S. ACT,0,0,0,266,16,282,607,31,638,57,10,67,930,57,987
MADHYA PRADESH,2004,GAMBLING ACT,0,0,0,53,0,53,58,4,62,4,0,4,115,4,119
MADHYA PRADESH,2004,EXCISE ACT,0,0,0,229,11,240,131,3,134,40,0,40,400,14,414
MADHYA PRADESH,2004,PROHIBITION ACT,0,0,0,0,0,0,1,0,1,0,0,0,1,0,1
MADHYA PRADESH,2004,EXPLOSIVE & EXPLOSIVE SUBST. ACT,0,0,0,43,0,43,19,0,19,0,0,0,62,0,62
MADHYA PRADESH,2004,TERRORIST & DISRUPTIVE ACTIVITIES (TATA),0,0,0,0,0,0,0,0,0,0,0,0,0,0,0
MADHYA PRADESH,2004,IMMORAL TRAFFIC (PREVENTION) ACT,0,0,0,0,0,0,0,0,0,0,0,0,0,0,0
MADHYA PRADESH,2004,INDIAN RAILWAYS ACT,0,0,0,123,0,123,124,0,124,21,0,21,268,0,268
MADHYA PRADESH,2004,REGISTRATION OF FOREIGNERS ACT,0,0,0,0,0,0,1,0,1,0,0,0,1,0,1
MADHYA PRADESH,2004,PROTECTION OF CIVIL RIGHTS ACT,0,0,0,1,0,1,0,0,0,0,0,0,1,0,1
MADHYA PRADESH,2004,SC/ST (PREVENTION OF ATROCITIES) ACT,0,0,0,17,1,18,73,5,78,11,0,11,101,6,107
MADHYA PRADESH,2004,INDIAN PASSPORT ACT,0,0,0,0,0,0,0,0,0,0,0,0,0,0,0
MADHYA PRADESH,2004,ESSENTIAL COMMODITIES ACT,0,0,0,0,0,0,2,0,2,0,0,0,2,0,2
MADHYA PRADESH,2004,ANTIQUITIES AND ART TREASURE ACT,0,0,0,1,0,1,0,0,0,0,0,0,1,0,1
MADHYA PRADESH,2004,DOWRY PROHIBITION ACT,0,0,0,13,0,13,24,3,27,13,2,15,50,5,55
MADHYA PRADESH,2004,FOREIGN EXCHANGE REGULATION ACT-1973,0,0,0,0,0,0,0,0,0,0,0,0,0,0,0
MADHYA PRADESH,2004,PREVENTION OF CORRUPTION ACT-1988,0,0,0,0,0,0,0,0,0,0,0,0,0,0,0
MADHYA PRADESH,2004,CONSER.OF FORGN.EXCH.&PREV. OF SMUG.ACT,0,0,0,0,0,0,0,0,0,0,0,0,0,0,0
MADHYA PRADESH,2004,OTHER SLL OFFENCE,0,0,0,171,3,174,169,6,175,29,3,32,369,12,381
MADHYA PRADESH,2004,TOTAL,0,0,0,1210,31,1241,1586,53,1639,207,15,222,3003,99,3102
MADHYA PRADESH,2005,ARMS ACT,0,0,0,444,2,446,281,0,281,16,0,16,741,2,743
MADHYA PRADESH,2005,N.D.P.S. ACT,0,0,0,413,19,432,379,28,407,64,5,69,856,52,908
MADHYA PRADESH,2005,GAMBLING ACT,0,0,0,82,1,83,42,1,43,10,0,10,134,2,136
MADHYA PRADESH,2005,EXCISE ACT,0,0,0,138,6,144,125,3,128,34,0,34,297,9,306
MADHYA PRADESH,2005,PROHIBITION ACT,0,0,0,0,0,0,0,0,0,0,0,0,0,0,0
MADHYA PRADESH,2005,EXPLOSIVE & EXPLOSIVE SUBST. ACT,0,0,0,21,0,21,9,0,9,1,0,1,31,0,31
MADHYA PRADESH,2005,TERRORIST & DISRUPTIVE ACTIVITIES (TATA),0,0,0,0,0,0,0,0,0,0,0,0,0,0,0
MADHYA PRADESH,2005,IMMORAL TRAFFIC (PREVENTION) ACT,0,0,0,2,0,2,2,0,2,0,0,0,4,0,4
MADHYA PRADESH,2005,INDIAN RAILWAYS ACT,0,0,0,138,0,138,45,0,45,30,0,30,213,0,213
MADHYA PRADESH,2005,REGISTRATION OF FOREIGNERS ACT,0,0,0,9,0,9,0,0,0,0,0,0,9,0,9
MADHYA PRADESH,2005,PROTECTION OF CIVIL RIGHTS ACT,0,0,0,13,0,13,3,0,3,0,0,0,16,0,16
MADHYA PRADESH,2005,SC/ST (PREVENTION OF ATROCITIES) ACT,0,0,0,79,3,82,49,2,51,9,1,10,137,6,143
MADHYA PRADESH,2005,INDIAN PASSPORT ACT,0,0,0,1,0,1,0,0,0,0,0,0,1,0,1
MADHYA PRADESH,2005,ESSENTIAL COMMODITIES ACT,0,0,0,9,0,9,0,0,0,1,0,1,10,0,10
MADHYA PRADESH,2005,ANTIQUITIES AND ART TREASURE ACT,0,0,0,0,0,0,0,0,0,0,0,0,0,0,0
MADHYA PRADESH,2005,DOWRY PROHIBITION ACT,0,0,0,23,0,23,14,2,16,11,1,12,48,3,51
MADHYA PRADESH,2005,FOREIGN EXCHANGE REGULATION ACT-1973,0,0,0,0,0,0,0,0,0,0,0,0,0,0,0
MADHYA PRADESH,2005,PREVENTION OF CORRUPTION ACT-1988,0,0,0,7,0,7,6,0,6,10,0,10,23,0,23
MADHYA PRADESH,2005,CONSER.OF FORGN.EXCH.&PREV. OF SMUG.ACT,0,0,0,0,0,0,0,0,0,0,0,0,0,0,0
MADHYA PRADESH,2005,OTHER SLL OFFENCE,0,0,0,339,11,350,217,9,226,79,2,81,635,22,657
MADHYA PRADESH,2005,TOTAL,0,0,0,1718,42,1760,1172,45,1217,265,9,274,3155,96,3251
MADHYA PRADESH,2006,ARMS ACT,0,0,0,410,2,412,255,2,257,23,0,23,688,4,692
MADHYA PRADESH,2006,N.D.P.S. ACT,0,0,0,511,26,537,457,13,470,91,11,102,1059,50,1109
MADHYA PRADESH,2006,GAMBLING ACT,0,0,0,31,0,31,28,0,28,5,0,5,64,0,64
MADHYA PRADESH,2006,EXCISE ACT,0,0,0,131,5,136,71,3,74,22,0,22,224,8,232
MADHYA PRADESH,2006,PROHIBITION ACT,0,0,0,10,0,10,0,0,0,0,0,0,10,0,10
MADHYA PRADESH,2006,EXPLOSIVE & EXPLOSIVE SUBST. ACT,0,0,0,10,0,10,4,0,4,0,0,0,14,0,14
MADHYA PRADESH,2006,TERRORIST & DISRUPTIVE ACTIVITIES (TATA),0,0,0,0,0,0,0,0,0,0,0,0,0,0,0
MADHYA PRADESH,2006,IMMORAL TRAFFIC (PREVENTION) ACT,0,0,0,0,0,0,0,0,0,0,0,0,0,0,0
MADHYA PRADESH,2006,INDIAN RAILWAYS ACT,0,0,0,93,2,95,40,1,41,13,0,13,146,3,149
MADHYA PRADESH,2006,REGISTRATION OF FOREIGNERS ACT,0,0,0,4,0,4,1,0,1,0,0,0,5,0,5
MADHYA PRADESH,2006,PROTECTION OF CIVIL RIGHTS ACT,0,0,0,8,0,8,1,0,1,0,0,0,9,0,9
MADHYA PRADESH,2006,SC/ST (PREVENTION OF ATROCITIES) ACT,0,0,0,68,1,69,57,0,57,14,0,14,139,1,140
MADHYA PRADESH,2006,INDIAN PASSPORT ACT,0,0,0,9,0,9,3,0,3,0,0,0,12,0,12
MADHYA PRADESH,2006,ESSENTIAL COMMODITIES ACT,0,0,0,7,0,7,1,0,1,0,0,0,8,0,8
MADHYA PRADESH,2006,ANTIQUITIES AND ART TREASURE ACT,0,0,0,0,0,0,1,0,1,0,0,0,1,0,1
MADHYA PRADESH,2006,DOWRY PROHIBITION ACT,0,0,0,15,0,15,15,1,16,7,1,8,37,2,39
MADHYA PRADESH,2006,FOREIGN EXCHANGE REGULATION ACT-1973,0,0,0,8,1,9,5,2,7,3,2,5,16,5,21
MADHYA PRADESH,2006,PREVENTION OF CORRUPTION ACT-1988,0,0,0,8,0,8,15,2,17,6,0,6,29,2,31
MADHYA PRADESH,2006,CONSER.OF FORGN.EXCH.&PREV. OF SMUG.ACT,0,0,0,0,0,0,0,0,0,0,0,0,0,0,0
MADHYA PRADESH,2006,OTHER SLL OFFENCE,0,0,0,550,4,554,435,0,435,70,0,70,1055,4,1059
MADHYA PRADESH,2006,TOTAL,0,0,0,1873,41,1914,1389,24,1413,254,14,268,3516,79,3595
MADHYA PRADESH,2007,ARMS ACT,0,0,0,403,0,403,286,0,286,28,0,28,717,0,717
MADHYA PRADESH,2007,N.D.P.S. ACT,0,0,0,466,19,485,480,17,497,85,5,90,1031,41,1072
MADHYA PRADESH,2007,GAMBLING ACT,0,0,0,41,1,42,49,1,50,17,0,17,107,2,109
MADHYA PRADESH,2007,EXCISE ACT,0,0,0,119,10,129,93,3,96,19,0,19,231,13,244
MADHYA PRADESH,2007,PROHIBITION ACT,0,0,0,0,0,0,0,0,0,0,0,0,0,0,0
MADHYA PRADESH,2007,EXPLOSIVE & EXPLOSIVE SUBST. ACT,0,0,0,13,0,13,12,1,13,0,0,0,25,1,26
MADHYA PRADESH,2007,TERRORIST & DISRUPTIVE ACTIVITIES (TATA),0,0,0,0,0,0,0,0,0,0,0,0,0,0,0
MADHYA PRADESH,2007,IMMORAL TRAFFIC (PREVENTION) ACT,0,0,0,3,0,3,0,0,0,1,0,1,4,0,4
MADHYA PRADESH,2007,INDIAN RAILWAYS ACT,0,0,0,92,2,94,81,1,82,30,0,30,203,3,206
MADHYA PRADESH,2007,REGISTRATION OF FOREIGNERS ACT,0,0,0,3,0,3,8,0,8,2,0,2,13,0,13
MADHYA PRADESH,2007,PROTECTION OF CIVIL RIGHTS ACT,0,0,0,4,0,4,3,0,3,0,0,0,7,0,7
MADHYA PRADESH,2007,SC/ST (PREVENTION OF ATROCITIES) ACT,0,0,0,150,0,150,99,0,99,24,0,24,273,0,273
MADHYA PRADESH,2007,INDIAN PASSPORT ACT,0,0,0,12,0,12,31,0,31,9,0,9,52,0,52
MADHYA PRADESH,2007,ESSENTIAL COMMODITIES ACT,0,0,0,0,0,0,10,0,10,1,0,1,11,0,11
MADHYA PRADESH,2007,ANTIQUITIES AND ART TREASURE ACT,0,0,0,0,0,0,0,0,0,2,0,2,2,0,2
MADHYA PRADESH,2007,DOWRY PROHIBITION ACT,0,0,0,12,2,14,21,4,25,11,1,12,44,7,51
MADHYA PRADESH,2007,FOREIGN EXCHANGE REGULATION ACT-1973,0,0,0,0,0,0,0,0,0,0,0,0,0,0,0
MADHYA PRADESH,2007,PREVENTION OF CORRUPTION ACT-1988,0,0,0,4,0,4,15,1,16,4,0,4,23,1,24
MADHYA PRADESH,2007,CONSER.OF FORGN.EXCH.&PREV. OF SMUG.ACT,0,0,0,0,0,0,0,0,0,0,0,0,0,0,0
MADHYA PRADESH,2007,OTHER SLL OFFENCE,0,0,0,313,6,319,499,9,508,108,6,114,920,21,941
MADHYA PRADESH,2007,TOTAL,0,0,0,1635,40,1675,1687,37,1724,341,12,353,3663,89,3752
MADHYA PRADESH,2008,ARMS ACT,0,0,0,467,0,467,316,0,316,32,0,32,815,0,815
MADHYA PRADESH,2008,N.D.P.S. ACT,0,0,0,569,16,585,384,15,399,60,2,62,1013,33,1046
MADHYA PRADESH,2008,GAMBLING ACT,0,0,0,43,0,43,31,0,31,5,0,5,79,0,79
MADHYA PRADESH,2008,EXCISE ACT,0,0,0,165,3,168,85,6,91,24,0,24,274,9,283
MADHYA PRADESH,2008,PROHIBITION ACT,0,0,0,0,0,0,0,0,0,0,0,0,0,0,0
MADHYA PRADESH,2008,EXPLOSIVE & EXPLOSIVE SUBST. ACT,0,0,0,11,0,11,22,2,24,0,0,0,33,2,35
MADHYA PRADESH,2008,TERRORIST & DISRUPTIVE ACTIVITIES (TATA),0,0,0,0,0,0,0,0,0,0,0,0,0,0,0
MADHYA PRADESH,2008,IMMORAL TRAFFIC (PREVENTION) ACT,0,0,0,9,0,9,8,0,8,0,0,0,17,0,17
MADHYA PRADESH,2008,INDIAN RAILWAYS ACT,0,0,0,108,6,114,77,1,78,12,0,12,197,7,204
MADHYA PRADESH,2008,REGISTRATION OF FOREIGNERS ACT,0,0,0,9,0,9,5,0,5,0,0,0,14,0,14
MADHYA PRADESH,2008,PROTECTION OF CIVIL RIGHTS ACT,0,0,0,7,0,7,11,0,11,0,0,0,18,0,18
MADHYA PRADESH,2008,SC/ST (PREVENTION OF ATROCITIES) ACT,0,0,0,126,0,126,84,0,84,19,0,19,229,0,229
MADHYA PRADESH,2008,INDIAN PASSPORT ACT,0,0,0,0,0,0,9,0,9,0,0,0,9,0,9
MADHYA PRADESH,2008,ESSENTIAL COMMODITIES ACT,0,0,0,0,0,0,3,0,3,0,0,0,3,0,3
MADHYA PRADESH,2008,ANTIQUITIES AND ART TREASURE ACT,0,0,0,0,0,0,0,0,0,0,0,0,0,0,0
MADHYA PRADESH,2008,DOWRY PROHIBITION ACT,0,0,0,23,2,25,21,2,23,3,0,3,47,4,51
MADHYA PRADESH,2008,FOREIGN EXCHANGE REGULATION ACT-1973,0,0,0,0,0,0,0,0,0,0,0,0,0,0,0
MADHYA PRADESH,2008,PREVENTION OF CORRUPTION ACT-1988,0,0,0,8,0,8,4,0,4,0,0,0,12,0,12
MADHYA PRADESH,2008,CONSER.OF FORGN.EXCH.&PREV. OF SMUG.ACT,0,0,0,0,0,0,0,0,0,0,0,0,0,0,0
MADHYA PRADESH,2008,OTHER SLL OFFENCE,0,0,0,527,5,532,368,21,389,94,1,95,989,27,1016
MADHYA PRADESH,2008,TOTAL,0,0,0,2072,32,2104,1428,47,1475,249,3,252,3749,82,3831
MADHYA PRADESH,2009,ARMS ACT,0,0,0,400,0,400,346,0,346,23,0,23,769,0,769
MADHYA PRADESH,2009,N.D.P.S. ACT,0,0,0,376,15,391,367,21,388,88,4,92,831,40,871
MADHYA PRADESH,2009,GAMBLING ACT,0,0,0,41,0,41,33,0,33,5,0,5,79,0,79
MADHYA PRADESH,2009,EXCISE ACT,0,0,0,147,3,150,132,6,138,25,4,29,304,13,317
MADHYA PRADESH,2009,PROHIBITION ACT,0,0,0,3,0,3,4,0,4,0,0,0,7,0,7
MADHYA PRADESH,2009,EXPLOSIVE & EXPLOSIVE SUBST. ACT,0,0,0,9,0,9,11,0,11,0,0,0,20,0,20
MADHYA PRADESH,2009,TERRORIST & DISRUPTIVE ACTIVITIES (TATA),0,0,0,0,0,0,0,0,0,0,0,0,0,0,0
MADHYA PRADESH,2009,IMMORAL TRAFFIC (PREVENTION) ACT,0,0,0,9,0,9,11,0,11,0,0,0,20,0,20
MADHYA PRADESH,2009,INDIAN RAILWAYS ACT,0,0,0,98,5,103,68,3,71,12,1,13,178,9,187
MADHYA PRADESH,2009,REGISTRATION OF FOREIGNERS ACT,0,0,0,9,0,9,4,0,4,0,0,0,13,0,13
MADHYA PRADESH,2009,PROTECTION OF CIVIL RIGHTS ACT,0,0,0,7,0,7,6,0,6,0,0,0,13,0,13
MADHYA PRADESH,2009,SC/ST (PREVENTION OF ATROCITIES) ACT,0,0,0,100,0,100,77,1,78,17,1,18,194,2,196
MADHYA PRADESH,2009,INDIAN PASSPORT ACT,0,0,0,0,0,0,9,0,9,0,0,0,9,0,9
MADHYA PRADESH,2009,ESSENTIAL COMMODITIES ACT,0,0,0,1,0,1,4,0,4,2,0,2,7,0,7
MADHYA PRADESH,2009,ANTIQUITIES AND ART TREASURE ACT,0,0,0,1,0,1,3,0,3,1,0,1,5,0,5
MADHYA PRADESH,2009,DOWRY PROHIBITION ACT,0,0,0,26,1,27,16,3,19,8,0,8,50,4,54
MADHYA PRADESH,2009,FOREIGN EXCHANGE REGULATION ACT-1973,0,0,0,0,0,0,0,0,0,0,0,0,0,0,0
MADHYA PRADESH,2009,PREVENTION OF CORRUPTION ACT-1988,0,0,0,10,0,10,11,1,12,1,0,1,22,1,23
MADHYA PRADESH,2009,CONSER.OF FORGN.EXCH.&PREV. OF SMUG.ACT,0,0,0,0,0,0,0,0,0,0,0,0,0,0,0
MADHYA PRADESH,2009,OTHER SLL OFFENCE,0,0,0,539,16,555,365,16,381,66,4,70,970,36,1006
MADHYA PRADESH,2009,TOTAL,0,0,0,1776,40,1816,1467,51,1518,248,14,262,3491,105,3596
MADHYA PRADESH,2010,ARMS ACT,0,0,0,322,0,322,269,0,269,27,0,27,618,0,618
MADHYA PRADESH,2010,N.D.P.S. ACT,0,0,0,589,12,601,358,24,382,126,10,136,1073,46,1119
MADHYA PRADESH,2010,GAMBLING ACT,0,0,0,44,0,44,35,1,36,13,0,13,92,1,93
MADHYA PRADESH,2010,EXCISE ACT,0,0,0,160,7,167,112,6,118,24,3,27,296,16,312
MADHYA PRADESH,2010,PROHIBITION ACT,0,0,0,0,0,0,1,0,1,0,0,0,1,0,1
MADHYA PRADESH,2010,EXPLOSIVE & EXPLOSIVE SUBST. ACT,0,0,0,10,0,10,10,0,10,0,0,0,20,0,20
MADHYA PRADESH,2010,TERRORIST & DISRUPTIVE ACTIVITIES (TATA),0,0,0,0,0,0,0,0,0,0,0,0,0,0,0
MADHYA PRADESH,2010,IMMORAL TRAFFIC (PREVENTION) ACT,0,0,0,0,0,0,3,0,3,0,0,0,3,0,3
MADHYA PRADESH,2010,INDIAN RAILWAYS ACT,0,0,0,76,5,81,78,4,82,14,1,15,168,10,178
MADHYA PRADESH,2010,REGISTRATION OF FOREIGNERS ACT,0,0,0,0,0,0,0,0,0,0,0,0,0,0,0
MADHYA PRADESH,2010,PROTECTION OF CIVIL RIGHTS ACT,0,0,0,9,0,9,2,0,2,0,0,0,11,0,11
MADHYA PRADESH,2010,SC/ST (PREVENTION OF ATROCITIES) ACT,0,0,0,100,0,100,58,0,58,14,0,14,172,0,172
MADHYA PRADESH,2010,INDIAN PASSPORT ACT,0,0,0,8,0,8,8,0,8,2,0,2,18,0,18
MADHYA PRADESH,2010,ESSENTIAL COMMODITIES ACT,0,0,0,1,0,1,4,0,4,3,0,3,8,0,8
MADHYA PRADESH,2010,ANTIQUITIES AND ART TREASURE ACT,0,0,0,1,0,1,3,0,3,1,0,1,5,0,5
MADHYA PRADESH,2010,DOWRY PROHIBITION ACT,0,0,0,51,1,52,9,1,10,6,0,6,66,2,68
MADHYA PRADESH,2010,FOREIGN EXCHANGE REGULATION ACT-1973,0,0,0,0,0,0,0,0,0,0,0,0,0,0,0
MADHYA PRADESH,2010,PREVENTION OF CORRUPTION ACT-1988,0,0,0,14,0,14,8,0,8,2,0,2,24,0,24
MADHYA PRADESH,2010,CONSER.OF FORGN.EXCH.&PREV. OF SMUG.ACT,0,0,0,0,0,0,0,0,0,0,0,0,0,0,0
MADHYA PRADESH,2010,OTHER SLL OFFENCE,0,0,0,409,19,428,168,12,180,71,2,73,648,33,681
MADHYA PRADESH,2010,TOTAL,0,0,0,1794,44,1838,1126,48,1174,303,16,319,3223,108,3331
MADHYA PRADESH,2011,ARMS ACT,0,0,0,320,0,320,245,0,245,18,0,18,583,0,583
MADHYA PRADESH,2011,N.D.P.S. ACT,0,0,0,341,9,350,324,13,337,74,0,74,739,22,761
MADHYA PRADESH,2011,GAMBLING ACT,0,0,0,14,0,14,19,0,19,5,0,5,38,0,38
MADHYA PRADESH,2011,EXCISE ACT,0,0,0,147,6,153,105,4,109,23,0,23,275,10,285
MADHYA PRADESH,2011,PROHIBITION ACT,0,0,0,0,0,0,4,0,4,0,0,0,4,0,4
MADHYA PRADESH,2011,EXPLOSIVE & EXPLOSIVE SUBST. ACT,0,0,0,58,0,58,33,0,33,3,0,3,94,0,94
MADHYA PRADESH,2011,TERRORIST & DISRUPTIVE ACTIVITIES (TATA),0,0,0,0,0,0,0,0,0,0,0,0,0,0,0
MADHYA PRADESH,2011,IMMORAL TRAFFIC (PREVENTION) ACT,0,0,0,0,0,0,4,0,4,0,0,0,4,0,4
MADHYA PRADESH,2011,INDIAN RAILWAYS ACT,0,0,0,40,0,40,29,0,29,10,0,10,79,0,79
MADHYA PRADESH,2011,REGISTRATION OF FOREIGNERS ACT,0,0,0,0,0,0,0,0,0,0,0,0,0,0,0
MADHYA PRADESH,2011,PROTECTION OF CIVIL RIGHTS ACT,0,0,0,0,0,0,0,0,0,0,0,0,0,0,0
MADHYA PRADESH,2011,SC/ST (PREVENTION OF ATROCITIES) ACT,0,0,0,37,0,37,50,5,55,12,1,13,99,6,105
MADHYA PRADESH,2011,INDIAN PASSPORT ACT,0,0,0,9,0,9,8,0,8,0,0,0,17,0,17
MADHYA PRADESH,2011,ESSENTIAL COMMODITIES ACT,0,0,0,55,0,55,16,0,16,7,0,7,78,0,78
MADHYA PRADESH,2011,ANTIQUITIES AND ART TREASURE ACT,0,0,0,10,0,10,9,0,9,1,0,1,20,0,20
MADHYA PRADESH,2011,DOWRY PROHIBITION ACT,0,0,0,10,5,15,16,0,16,4,0,4,30,5,35
MADHYA PRADESH,2011,FOREIGN EXCHANGE REGULATION ACT-1973,0,0,0,68,1,69,39,0,39,3,0,3,110,1,111
MADHYA PRADESH,2011,PREVENTION OF CORRUPTION ACT-1988,0,0,0,1,0,1,9,0,9,4,0,4,14,0,14
MADHYA PRADESH,2011,CONSER.OF FORGN.EXCH.&PREV. OF SMUG.ACT,0,0,0,0,0,0,9,0,9,0,0,0,9,0,9
MADHYA PRADESH,2011,OTHER SLL OFFENCE,0,0,0,186,24,210,108,14,122,21,2,23,315,40,355
MADHYA PRADESH,2011,TOTAL,0,0,0,1296,45,1341,1027,36,1063,185,3,188,2508,84,2592
MADHYA PRADESH,2012,ARMS ACT,0,0,0,358,0,358,204,1,205,17,0,17,579,1,580
MADHYA PRADESH,2012,N.D.P.S. ACT,0,0,0,431,11,442,379,11,390,82,2,84,892,24,916
MADHYA PRADESH,2012,GAMBLING ACT,0,0,0,17,0,17,29,0,29,5,0,5,51,0,51
MADHYA PRADESH,2012,EXCISE ACT,0,0,0,216,4,220,125,6,131,20,1,21,361,11,372
MADHYA PRADESH,2012,PROHIBITION ACT,0,0,0,2,0,2,4,0,4,0,0,0,6,0,6
MADHYA PRADESH,2012,EXPLOSIVE & EXPLOSIVE SUBST. ACT,0,0,0,16,0,16,10,0,10,3,0,3,29,0,29
MADHYA PRADESH,2012,TERRORIST & DISRUPTIVE ACTIVITIES (TATA),0,0,0,0,0,0,0,0,0,0,0,0,0,0,0
MADHYA PRADESH,2012,IMMORAL TRAFFIC (PREVENTION) ACT,0,0,0,2,0,2,4,0,4,0,0,0,6,0,6
MADHYA PRADESH,2012,INDIAN RAILWAYS ACT,0,0,0,43,0,43,24,0,24,11,0,11,78,0,78
MADHYA PRADESH,2012,REGISTRATION OF FOREIGNERS ACT,0,0,0,0,0,0,2,0,2,0,0,0,2,0,2
MADHYA PRADESH,2012,PROTECTION OF CIVIL RIGHTS ACT,0,0,0,0,0,0,0,0,0,0,0,0,0,0,0
MADHYA PRADESH,2012,SC/ST (PREVENTION OF ATROCITIES) ACT,0,0,0,27,0,27,36,4,40,11,1,12,74,5,79
MADHYA PRADESH,2012,INDIAN PASSPORT ACT,0,0,0,0,0,0,0,0,0,0,0,0,0,0,0
MADHYA PRADESH,2012,ESSENTIAL COMMODITIES ACT,0,0,0,1,0,1,7,0,7,3,0,3,11,0,11
MADHYA PRADESH,2012,ANTIQUITIES AND ART TREASURE ACT,0,0,0,1,0,1,6,0,6,1,0,1,8,0,8
MADHYA PRADESH,2012,DOWRY PROHIBITION ACT,0,0,0,5,0,5,5,0,5,1,0,1,11,0,11
MADHYA PRADESH,2012,FOREIGN EXCHANGE REGULATION ACT-1973,0,0,0,0,0,0,0,0,0,0,0,0,0,0,0
MADHYA PRADESH,2012,PREVENTION OF CORRUPTION ACT-1988,0,0,0,1,0,1,5,0,5,1,0,1,7,0,7
MADHYA PRADESH,2012,CONSER.OF FORGN.EXCH.&PREV. OF SMUG.ACT,0,0,0,0,0,0,0,0,0,0,0,0,0,0,0
MADHYA PRADESH,2012,OTHER SLL OFFENCE,0,0,0,123,12,135,114,11,125,21,1,22,258,24,282
MADHYA PRADESH,2012,TOTAL,0,0,0,1243,27,1270,954,33,987,176,5,181,2373,65,2438
MAHARASHTRA,2001,ARMS ACT,0,0,0,44,0,44,42,0,42,13,0,13,99,0,99
MAHARASHTRA,2001,N.D.P.S. ACT,0,0,0,163,9,172,262,18,280,21,4,25,446,31,477
MAHARASHTRA,2001,GAMBLING ACT,0,0,0,105,0,105,100,0,100,27,0,27,232,0,232
MAHARASHTRA,2001,EXCISE ACT,0,0,0,4,0,4,5,0,5,9,0,9,18,0,18
MAHARASHTRA,2001,PROHIBITION ACT,0,0,0,207,5,212,231,3,234,39,1,40,477,9,486
MAHARASHTRA,2001,EXPLOSIVE & EXPLOSIVE SUBST. ACT,0,0,0,6,0,6,64,3,67,18,1,19,88,4,92
MAHARASHTRA,2001,TERRORIST & DISRUPTIVE ACTIVITIES (TATA),0,0,0,0,0,0,0,0,0,0,0,0,0,0,0
MAHARASHTRA,2001,IMMORAL TRAFFIC (PREVENTION) ACT,0,0,0,34,0,34,61,0,61,0,0,0,95,0,95
MAHARASHTRA,2001,INDIAN RAILWAYS ACT,4,0,4,77,5,82,153,4,157,7,0,7,241,9,250
MAHARASHTRA,2001,REGISTRATION OF FOREIGNERS ACT,0,0,0,0,0,0,0,0,0,0,0,0,0,0,0
MAHARASHTRA,2001,PROTECTION OF CIVIL RIGHTS ACT,2,0,2,13,0,13,8,0,8,0,0,0,23,0,23
MAHARASHTRA,2001,SC/ST (PREVENTION OF ATROCITIES) ACT,0,0,0,0,0,0,0,0,0,0,0,0,0,0,0
MAHARASHTRA,2001,INDIAN PASSPORT ACT,0,0,0,3,0,3,0,0,0,0,0,0,3,0,3
MAHARASHTRA,2001,ESSENTIAL COMMODITIES ACT,0,0,0,0,0,0,0,0,0,0,0,0,0,0,0
MAHARASHTRA,2001,ANTIQUITIES AND ART TREASURE ACT,0,0,0,0,0,0,0,0,0,0,0,0,0,0,0
MAHARASHTRA,2001,DOWRY PROHIBITION ACT,0,0,0,76,16,92,119,28,147,25,5,30,220,49,269
MAHARASHTRA,2001,FOREIGN EXCHANGE REGULATION ACT-1973,0,0,0,0,0,0,0,0,0,0,0,0,0,0,0
MAHARASHTRA,2001,PREVENTION OF CORRUPTION ACT-1988,0,0,0,9,0,9,6,0,6,1,0,1,16,0,16
MAHARASHTRA,2001,CONSER.OF FORGN.EXCH.&PREV. OF SMUG.ACT,0,0,0,0,0,0,0,0,0,0,0,0,0,0,0
MAHARASHTRA,2001,OTHER SLL OFFENCE,0,0,0,697,28,725,738,39,777,33,21,54,1468,88,1556
MAHARASHTRA,2001,TOTAL,6,0,6,1438,63,1501,1789,95,1884,193,32,225,3426,190,3616
MAHARASHTRA,2002,ARMS ACT,0,0,0,30,0,30,58,2,60,6,0,6,94,2,96
MAHARASHTRA,2002,N.D.P.S. ACT,0,0,0,149,18,167,259,15,274,31,1,32,439,34,473
MAHARASHTRA,2002,GAMBLING ACT,0,0,0,33,0,33,19,0,19,2,0,2,54,0,54
MAHARASHTRA,2002,EXCISE ACT,0,0,0,28,1,29,52,1,53,11,0,11,91,2,93
MAHARASHTRA,2002,PROHIBITION ACT,0,0,0,96,0,96,133,3,136,30,0,30,259,3,262
MAHARASHTRA,2002,EXPLOSIVE & EXPLOSIVE SUBST. ACT,0,0,0,3,0,3,3,0,3,0,0,0,6,0,6
MAHARASHTRA,2002,TERRORIST & DISRUPTIVE ACTIVITIES (TATA),0,0,0,14,0,14,28,4,32,18,2,20,60,6,66
MAHARASHTRA,2002,IMMORAL TRAFFIC (PREVENTION) ACT,0,0,0,0,0,0,0,0,0,0,0,0,0,0,0
MAHARASHTRA,2002,INDIAN RAILWAYS ACT,0,0,0,105,3,108,78,4,82,35,3,38,218,10,228
MAHARASHTRA,2002,REGISTRATION OF FOREIGNERS ACT,0,0,0,3,0,3,8,0,8,2,0,2,13,0,13
MAHARASHTRA,2002,PROTECTION OF CIVIL RIGHTS ACT,0,0,0,0,0,0,0,0,0,0,0,0,0,0,0
MAHARASHTRA,2002,SC/ST (PREVENTION OF ATROCITIES) ACT,0,0,0,0,0,0,0,0,0,0,0,0,0,0,0
MAHARASHTRA,2002,INDIAN PASSPORT ACT,0,0,0,0,0,0,1,0,1,1,0,1,2,0,2
MAHARASHTRA,2002,ESSENTIAL COMMODITIES ACT,0,0,0,2,0,2,9,0,9,2,0,2,13,0,13
MAHARASHTRA,2002,ANTIQUITIES AND ART TREASURE ACT,0,0,0,0,0,0,0,0,0,0,0,0,0,0,0
MAHARASHTRA,2002,DOWRY PROHIBITION ACT,0,0,0,22,7,29,13,4,17,4,2,6,39,13,52
MAHARASHTRA,2002,FOREIGN EXCHANGE REGULATION ACT-1973,0,0,0,1,0,1,5,0,5,1,0,1,7,0,7
MAHARASHTRA,2002,PREVENTION OF CORRUPTION ACT-1988,0,0,0,0,0,0,0,0,0,0,0,0,0,0,0
MAHARASHTRA,2002,CONSER.OF FORGN.EXCH.&PREV. OF SMUG.ACT,0,0,0,0,0,0,34,0,34,0,0,0,34,0,34
MAHARASHTRA,2002,OTHER SLL OFFENCE,0,0,0,603,29,632,564,18,582,83,4,87,1250,51,1301
MAHARASHTRA,2002,TOTAL,0,0,0,1089,58,1147,1264,51,1315,226,12,238,2579,121,2700
MAHARASHTRA,2003,ARMS ACT,0,0,0,77,0,77,89,0,89,22,0,22,188,0,188
MAHARASHTRA,2003,N.D.P.S. ACT,0,0,0,53,9,62,311,31,342,6,2,8,370,42,412
MAHARASHTRA,2003,GAMBLING ACT,0,0,0,45,0,45,36,0,36,4,0,4,85,0,85
MAHARASHTRA,2003,EXCISE ACT,0,0,0,2,0,2,14,0,14,0,0,0,16,0,16
MAHARASHTRA,2003,PROHIBITION ACT,0,0,0,133,29,162,174,32,206,40,7,47,347,68,415
MAHARASHTRA,2003,EXPLOSIVE & EXPLOSIVE SUBST. ACT,0,0,0,4,0,4,14,0,14,0,0,0,18,0,18
MAHARASHTRA,2003,TERRORIST & DISRUPTIVE ACTIVITIES (TATA),0,0,0,4,1,5,66,0,66,0,0,0,70,1,71
MAHARASHTRA,2003,IMMORAL TRAFFIC (PREVENTION) ACT,0,0,0,0,0,0,0,0,0,0,0,0,0,0,0
MAHARASHTRA,2003,INDIAN RAILWAYS ACT,0,0,0,175,16,191,247,9,256,14,5,19,436,30,466
MAHARASHTRA,2003,REGISTRATION OF FOREIGNERS ACT,0,0,0,0,0,0,0,0,0,0,0,0,0,0,0
MAHARASHTRA,2003,PROTECTION OF CIVIL RIGHTS ACT,0,0,0,1,0,1,0,0,0,0,0,0,1,0,1
MAHARASHTRA,2003,SC/ST (PREVENTION OF ATROCITIES) ACT,0,0,0,9,0,9,28,0,28,0,0,0,37,0,37
MAHARASHTRA,2003,INDIAN PASSPORT ACT,0,0,0,18,0,18,35,0,35,2,0,2,55,0,55
MAHARASHTRA,2003,ESSENTIAL COMMODITIES ACT,0,0,0,5,0,5,13,0,13,0,0,0,18,0,18
MAHARASHTRA,2003,ANTIQUITIES AND ART TREASURE ACT,0,0,0,0,0,0,0,0,0,0,0,0,0,0,0
MAHARASHTRA,2003,DOWRY PROHIBITION ACT,0,0,0,24,0,24,15,1,16,6,0,6,45,1,46
MAHARASHTRA,2003,FOREIGN EXCHANGE REGULATION ACT-1973,0,0,0,0,0,0,0,0,0,0,0,0,0,0,0
MAHARASHTRA,2003,PREVENTION OF CORRUPTION ACT-1988,0,0,0,2,0,2,3,0,3,0,0,0,5,0,5
MAHARASHTRA,2003,CONSER.OF FORGN.EXCH.&PREV. OF SMUG.ACT,0,0,0,0,0,0,0,0,0,0,0,0,0,0,0
MAHARASHTRA,2003,OTHER SLL OFFENCE,0,0,0,993,66,1059,2225,112,2337,734,15,749,3952,193,4145
MAHARASHTRA,2003,TOTAL,0,0,0,1545,121,1666,3270,185,3455,828,29,857,5643,335,5978
MAHARASHTRA,2004,ARMS ACT,0,0,0,63,0,63,67,0,67,10,0,10,140,0,140
MAHARASHTRA,2004,N.D.P.S. ACT,0,0,0,370,8,378,344,10,354,43,3,46,757,21,778
MAHARASHTRA,2004,GAMBLING ACT,0,0,0,43,0,43,90,0,90,21,0,21,154,0,154
MAHARASHTRA,2004,EXCISE ACT,0,0,0,0,0,0,2,0,2,0,0,0,2,0,2
MAHARASHTRA,2004,PROHIBITION ACT,0,0,0,142,1,143,151,1,152,53,0,53,346,2,348
MAHARASHTRA,2004,EXPLOSIVE & EXPLOSIVE SUBST. ACT,0,0,0,1,0,1,0,0,0,0,0,0,1,0,1
MAHARASHTRA,2004,TERRORIST & DISRUPTIVE ACTIVITIES (TATA),0,0,0,3,2,5,48,2,50,15,0,15,66,4,70
MAHARASHTRA,2004,IMMORAL TRAFFIC (PREVENTION) ACT,0,0,0,7,0,7,5,0,5,3,0,3,15,0,15
MAHARASHTRA,2004,INDIAN RAILWAYS ACT,0,0,0,214,11,225,129,7,136,57,5,62,400,23,423
MAHARASHTRA,2004,REGISTRATION OF FOREIGNERS ACT,0,0,0,1,0,1,0,0,0,0,0,0,1,0,1
MAHARASHTRA,2004,PROTECTION OF CIVIL RIGHTS ACT,0,0,0,0,0,0,0,0,0,0,0,0,0,0,0
MAHARASHTRA,2004,SC/ST (PREVENTION OF ATROCITIES) ACT,0,0,0,1,0,1,7,0,7,0,0,0,8,0,8
MAHARASHTRA,2004,INDIAN PASSPORT ACT,0,0,0,34,68,102,21,15,36,9,15,24,64,98,162
MAHARASHTRA,2004,ESSENTIAL COMMODITIES ACT,0,0,0,0,0,0,14,0,14,1,0,1,15,0,15
MAHARASHTRA,2004,ANTIQUITIES AND ART TREASURE ACT,0,0,0,0,0,0,0,0,0,0,0,0,0,0,0
MAHARASHTRA,2004,DOWRY PROHIBITION ACT,0,0,0,28,0,28,40,9,49,4,1,5,72,10,82
MAHARASHTRA,2004,FOREIGN EXCHANGE REGULATION ACT-1973,0,0,0,0,0,0,0,0,0,0,0,0,0,0,0
MAHARASHTRA,2004,PREVENTION OF CORRUPTION ACT-1988,0,0,0,0,0,0,4,0,4,0,0,0,4,0,4
MAHARASHTRA,2004,CONSER.OF FORGN.EXCH.&PREV. OF SMUG.ACT,0,0,0,0,0,0,0,0,0,0,0,0,0,0,0
MAHARASHTRA,2004,OTHER SLL OFFENCE,0,0,0,802,17,819,788,147,935,371,10,381,1961,174,2135
MAHARASHTRA,2004,TOTAL,0,0,0,1709,107,1816,1710,191,1901,587,34,621,4006,332,4338
MAHARASHTRA,2005,ARMS ACT,0,0,0,11,0,11,9,0,9,0,0,0,20,0,20
MAHARASHTRA,2005,N.D.P.S. ACT,0,0,0,131,24,155,577,56,633,47,2,49,755,82,837
MAHARASHTRA,2005,GAMBLING ACT,0,0,0,48,0,48,83,0,83,11,0,11,142,0,142
MAHARASHTRA,2005,EXCISE ACT,0,0,0,2,0,2,10,0,10,0,0,0,12,0,12
MAHARASHTRA,2005,PROHIBITION ACT,0,0,0,97,3,100,183,1,184,42,0,42,322,4,326
MAHARASHTRA,2005,EXPLOSIVE & EXPLOSIVE SUBST. ACT,0,0,0,4,0,4,7,0,7,0,0,0,11,0,11
MAHARASHTRA,2005,TERRORIST & DISRUPTIVE ACTIVITIES (TATA),0,0,0,4,4,8,42,2,44,2,0,2,48,6,54
MAHARASHTRA,2005,IMMORAL TRAFFIC (PREVENTION) ACT,0,0,0,2,0,2,4,0,4,0,0,0,6,0,6
MAHARASHTRA,2005,INDIAN RAILWAYS ACT,0,0,0,158,0,158,237,0,237,49,0,49,444,0,444
MAHARASHTRA,2005,REGISTRATION OF FOREIGNERS ACT,0,0,0,1,1,2,0,2,2,0,0,0,1,3,4
MAHARASHTRA,2005,PROTECTION OF CIVIL RIGHTS ACT,0,0,0,0,0,0,0,0,0,0,0,0,0,0,0
MAHARASHTRA,2005,SC/ST (PREVENTION OF ATROCITIES) ACT,0,0,0,2,0,2,4,0,4,0,0,0,6,0,6
MAHARASHTRA,2005,INDIAN PASSPORT ACT,0,0,0,106,87,193,94,48,142,3,1,4,203,136,339
MAHARASHTRA,2005,ESSENTIAL COMMODITIES ACT,0,0,0,0,0,0,5,0,5,0,0,0,5,0,5
MAHARASHTRA,2005,ANTIQUITIES AND ART TREASURE ACT,0,0,0,0,0,0,0,0,0,0,0,0,0,0,0
MAHARASHTRA,2005,DOWRY PROHIBITION ACT,0,0,0,9,1,10,24,0,24,0,0,0,33,1,34
MAHARASHTRA,2005,FOREIGN EXCHANGE REGULATION ACT-1973,0,0,0,0,0,0,0,0,0,0,0,0,0,0,0
MAHARASHTRA,2005,PREVENTION OF CORRUPTION ACT-1988,0,0,0,1,0,1,6,0,6,1,0,1,8,0,8
MAHARASHTRA,2005,CONSER.OF FORGN.EXCH.&PREV. OF SMUG.ACT,0,0,0,0,0,0,0,0,0,0,0,0,0,0,0
MAHARASHTRA,2005,OTHER SLL OFFENCE,0,0,0,1049,56,1105,1265,55,1320,559,13,572,2873,124,2997
MAHARASHTRA,2005,TOTAL,0,0,0,1625,176,1801,2550,164,2714,714,16,730,4889,356,5245
MAHARASHTRA,2006,ARMS ACT,0,0,0,14,0,14,22,0,22,5,0,5,41,0,41
MAHARASHTRA,2006,N.D.P.S. ACT,0,0,0,220,48,268,639,64,703,43,8,51,902,120,1022
MAHARASHTRA,2006,GAMBLING ACT,0,0,0,23,0,23,20,0,20,5,0,5,48,0,48
MAHARASHTRA,2006,EXCISE ACT,0,0,0,1,0,1,2,0,2,0,0,0,3,0,3
MAHARASHTRA,2006,PROHIBITION ACT,0,0,0,116,2,118,196,8,204,54,0,54,366,10,376
MAHARASHTRA,2006,EXPLOSIVE & EXPLOSIVE SUBST. ACT,0,0,0,0,0,0,0,0,0,0,0,0,0,0,0
MAHARASHTRA,2006,TERRORIST & DISRUPTIVE ACTIVITIES (TATA),0,0,0,3,2,5,170,4,174,2,0,2,175,6,181
MAHARASHTRA,2006,IMMORAL TRAFFIC (PREVENTION) ACT,0,0,0,0,0,0,0,0,0,0,0,0,0,0,0
MAHARASHTRA,2006,INDIAN RAILWAYS ACT,0,0,0,198,7,205,143,10,153,75,0,75,416,17,433
MAHARASHTRA,2006,REGISTRATION OF FOREIGNERS ACT,0,0,0,0,0,0,0,0,0,0,0,0,0,0,0
MAHARASHTRA,2006,PROTECTION OF CIVIL RIGHTS ACT,0,0,0,0,0,0,0,0,0,0,0,0,0,0,0
MAHARASHTRA,2006,SC/ST (PREVENTION OF ATROCITIES) ACT,0,0,0,7,0,7,10,1,11,1,0,1,18,1,19
MAHARASHTRA,2006,INDIAN PASSPORT ACT,0,0,0,161,134,295,141,94,235,19,7,26,321,235,556
MAHARASHTRA,2006,ESSENTIAL COMMODITIES ACT,0,0,0,0,0,0,0,0,0,0,0,0,0,0,0
MAHARASHTRA,2006,ANTIQUITIES AND ART TREASURE ACT,0,0,0,0,0,0,0,0,0,0,0,0,0,0,0
MAHARASHTRA,2006,DOWRY PROHIBITION ACT,0,0,0,26,5,31,40,2,42,8,2,10,74,9,83
MAHARASHTRA,2006,FOREIGN EXCHANGE REGULATION ACT-1973,0,0,0,0,0,0,0,0,0,0,0,0,0,0,0
MAHARASHTRA,2006,PREVENTION OF CORRUPTION ACT-1988,0,0,0,0,0,0,0,0,0,0,0,0,0,0,0
MAHARASHTRA,2006,CONSER.OF FORGN.EXCH.&PREV. OF SMUG.ACT,0,0,0,0,0,0,0,0,0,0,0,0,0,0,0
MAHARASHTRA,2006,OTHER SLL OFFENCE,0,0,0,898,54,952,1075,33,1108,395,16,411,2368,103,2471
MAHARASHTRA,2006,TOTAL,0,0,0,1667,252,1919,2458,216,2674,607,33,640,4732,501,5233
MAHARASHTRA,2007,ARMS ACT,0,0,0,7,0,7,11,0,11,3,0,3,21,0,21
MAHARASHTRA,2007,N.D.P.S. ACT,0,0,0,331,36,367,345,33,378,11,16,27,687,85,772
MAHARASHTRA,2007,GAMBLING ACT,0,0,0,2,0,2,6,0,6,5,0,5,13,0,13
MAHARASHTRA,2007,EXCISE ACT,0,0,0,0,0,0,0,0,0,0,0,0,0,0,0
MAHARASHTRA,2007,PROHIBITION ACT,0,0,0,101,3,104,169,6,175,43,1,44,313,10,323
MAHARASHTRA,2007,EXPLOSIVE & EXPLOSIVE SUBST. ACT,0,0,0,6,0,6,2,0,2,1,0,1,9,0,9
MAHARASHTRA,2007,TERRORIST & DISRUPTIVE ACTIVITIES (TATA),0,0,0,1,0,1,12,1,13,1,0,1,14,1,15
MAHARASHTRA,2007,IMMORAL TRAFFIC (PREVENTION) ACT,0,0,0,0,12,12,0,6,6,0,1,1,0,19,19
MAHARASHTRA,2007,INDIAN RAILWAYS ACT,0,0,0,181,0,181,170,0,170,29,0,29,380,0,380
MAHARASHTRA,2007,REGISTRATION OF FOREIGNERS ACT,0,0,0,0,0,0,0,0,0,0,0,0,0,0,0
MAHARASHTRA,2007,PROTECTION OF CIVIL RIGHTS ACT,0,0,0,0,0,0,0,0,0,0,0,0,0,0,0
MAHARASHTRA,2007,SC/ST (PREVENTION OF ATROCITIES) ACT,0,0,0,0,0,0,5,0,5,1,0,1,6,0,6
MAHARASHTRA,2007,INDIAN PASSPORT ACT,0,0,0,27,92,119,97,20,117,2,3,5,126,115,241
MAHARASHTRA,2007,ESSENTIAL COMMODITIES ACT,0,0,0,0,0,0,0,0,0,0,0,0,0,0,0
MAHARASHTRA,2007,ANTIQUITIES AND ART TREASURE ACT,0,0,0,0,0,0,0,0,0,0,0,0,0,0,0
MAHARASHTRA,2007,DOWRY PROHIBITION ACT,0,0,0,9,0,9,3,0,3,5,0,5,17,0,17
MAHARASHTRA,2007,FOREIGN EXCHANGE REGULATION ACT-1973,0,0,0,1,0,1,0,0,0,0,0,0,1,0,1
MAHARASHTRA,2007,PREVENTION OF CORRUPTION ACT-1988,0,0,0,1,0,1,1,0,1,0,0,0,2,0,2
MAHARASHTRA,2007,CONSER.OF FORGN.EXCH.&PREV. OF SMUG.ACT,0,0,0,1,0,1,2,2,4,0,0,0,3,2,5
MAHARASHTRA,2007,OTHER SLL OFFENCE,0,0,0,918,81,999,1142,63,1205,229,22,251,2289,166,2455
MAHARASHTRA,2007,TOTAL,0,0,0,1586,224,1810,1965,131,2096,330,43,373,3881,398,4279
MAHARASHTRA,2008,ARMS ACT,0,0,0,11,0,11,6,0,6,1,0,1,18,0,18
MAHARASHTRA,2008,N.D.P.S. ACT,0,0,0,204,19,223,182,20,202,81,7,88,467,46,513
MAHARASHTRA,2008,GAMBLING ACT,0,0,0,14,0,14,15,0,15,0,0,0,29,0,29
MAHARASHTRA,2008,EXCISE ACT,0,0,0,0,0,0,0,0,0,0,0,0,0,0,0
MAHARASHTRA,2008,PROHIBITION ACT,0,0,0,126,5,131,136,4,140,42,2,44,304,11,315
MAHARASHTRA,2008,EXPLOSIVE & EXPLOSIVE SUBST. ACT,0,0,0,2,0,2,2,0,2,2,0,2,6,0,6
MAHARASHTRA,2008,TERRORIST & DISRUPTIVE ACTIVITIES (TATA),0,0,0,1,0,1,5,1,6,0,0,0,6,1,7
MAHARASHTRA,2008,IMMORAL TRAFFIC (PREVENTION) ACT,0,0,0,0,2,2,0,4,4,0,0,0,0,6,6
MAHARASHTRA,2008,INDIAN RAILWAYS ACT,0,0,0,236,3,239,130,4,134,24,0,24,390,7,397
MAHARASHTRA,2008,REGISTRATION OF FOREIGNERS ACT,0,0,0,0,0,0,0,0,0,1,0,1,1,0,1
MAHARASHTRA,2008,PROTECTION OF CIVIL RIGHTS ACT,0,0,0,0,0,0,0,0,0,0,0,0,0,0,0
MAHARASHTRA,2008,SC/ST (PREVENTION OF ATROCITIES) ACT,0,0,0,0,0,0,1,0,1,0,0,0,1,0,1
MAHARASHTRA,2008,INDIAN PASSPORT ACT,0,0,0,78,62,140,68,55,123,13,10,23,159,127,286
MAHARASHTRA,2008,ESSENTIAL COMMODITIES ACT,0,0,0,1,0,1,1,0,1,0,0,0,2,0,2
MAHARASHTRA,2008,ANTIQUITIES AND ART TREASURE ACT,0,0,0,8,0,8,5,0,5,5,0,5,18,0,18
MAHARASHTRA,2008,DOWRY PROHIBITION ACT,0,0,0,0,0,0,2,0,2,0,0,0,2,0,2
MAHARASHTRA,2008,FOREIGN EXCHANGE REGULATION ACT-1973,0,0,0,6,0,6,1,0,1,0,0,0,7,0,7
MAHARASHTRA,2008,PREVENTION OF CORRUPTION ACT-1988,0,0,0,0,0,0,1,0,1,0,0,0,1,0,1
MAHARASHTRA,2008,CONSER.OF FORGN.EXCH.&PREV. OF SMUG.ACT,0,0,0,0,0,0,2,0,2,0,0,0,2,0,2
MAHARASHTRA,2008,OTHER SLL OFFENCE,0,0,0,1002,60,1062,954,64,1018,352,13,365,2308,137,2445
MAHARASHTRA,2008,TOTAL,0,0,0,1689,151,1840,1511,152,1663,521,32,553,3721,335,4056
MAHARASHTRA,2009,ARMS ACT,0,0,0,17,0,17,31,0,31,0,0,0,48,0,48
MAHARASHTRA,2009,N.D.P.S. ACT,0,0,0,269,14,283,200,12,212,94,2,96,563,28,591
MAHARASHTRA,2009,GAMBLING ACT,0,0,0,9,0,9,4,0,4,0,0,0,13,0,13
MAHARASHTRA,2009,EXCISE ACT,0,0,0,0,0,0,0,0,0,0,0,0,0,0,0
MAHARASHTRA,2009,PROHIBITION ACT,0,0,0,81,5,86,85,8,93,30,1,31,196,14,210
MAHARASHTRA,2009,EXPLOSIVE & EXPLOSIVE SUBST. ACT,0,0,0,15,0,15,0,0,0,0,0,0,15,0,15
MAHARASHTRA,2009,TERRORIST & DISRUPTIVE ACTIVITIES (TATA),0,0,0,6,0,6,15,0,15,0,0,0,21,0,21
MAHARASHTRA,2009,IMMORAL TRAFFIC (PREVENTION) ACT,0,0,0,13,4,17,0,3,3,0,1,1,13,8,21
MAHARASHTRA,2009,INDIAN RAILWAYS ACT,0,0,0,158,3,161,122,2,124,35,0,35,315,5,320
MAHARASHTRA,2009,REGISTRATION OF FOREIGNERS ACT,0,0,0,0,0,0,0,0,0,0,0,0,0,0,0
MAHARASHTRA,2009,PROTECTION OF CIVIL RIGHTS ACT,0,0,0,0,0,0,0,0,0,0,0,0,0,0,0
MAHARASHTRA,2009,SC/ST (PREVENTION OF ATROCITIES) ACT,0,0,0,0,0,0,13,0,13,2,0,2,15,0,15
MAHARASHTRA,2009,INDIAN PASSPORT ACT,0,0,0,93,106,199,104,73,177,6,15,21,203,194,397
MAHARASHTRA,2009,ESSENTIAL COMMODITIES ACT,0,0,0,15,0,15,7,0,7,0,0,0,22,0,22
MAHARASHTRA,2009,ANTIQUITIES AND ART TREASURE ACT,0,0,0,0,0,0,0,0,0,0,0,0,0,0,0
MAHARASHTRA,2009,DOWRY PROHIBITION ACT,0,0,0,0,0,0,0,0,0,0,0,0,0,0,0
MAHARASHTRA,2009,FOREIGN EXCHANGE REGULATION ACT-1973,0,0,0,0,0,0,0,0,0,2,0,2,2,0,2
MAHARASHTRA,2009,PREVENTION OF CORRUPTION ACT-1988,0,0,0,0,0,0,6,0,6,1,0,1,7,0,7
MAHARASHTRA,2009,CONSER.OF FORGN.EXCH.&PREV. OF SMUG.ACT,0,0,0,19,0,19,1,0,1,0,0,0,20,0,20
MAHARASHTRA,2009,OTHER SLL OFFENCE,0,0,0,580,28,608,874,46,920,341,22,363,1795,96,1891
MAHARASHTRA,2009,TOTAL,0,0,0,1275,160,1435,1462,144,1606,511,41,552,3248,345,3593
MAHARASHTRA,2010,ARMS ACT,0,0,0,4,0,4,13,0,13,0,0,0,17,0,17
MAHARASHTRA,2010,N.D.P.S. ACT,0,0,0,117,6,123,151,14,165,85,2,87,353,22,375
MAHARASHTRA,2010,GAMBLING ACT,0,0,0,0,0,0,0,0,0,3,0,3,3,0,3
MAHARASHTRA,2010,EXCISE ACT,0,0,0,0,0,0,0,0,0,0,0,0,0,0,0
MAHARASHTRA,2010,PROHIBITION ACT,0,0,0,82,0,82,188,9,197,51,0,51,321,9,330
MAHARASHTRA,2010,EXPLOSIVE & EXPLOSIVE SUBST. ACT,0,0,0,4,0,4,3,0,3,0,0,0,7,0,7
MAHARASHTRA,2010,TERRORIST & DISRUPTIVE ACTIVITIES (TATA),0,0,0,3,0,3,11,0,11,0,0,0,14,0,14
MAHARASHTRA,2010,IMMORAL TRAFFIC (PREVENTION) ACT,0,0,0,0,0,0,0,1,1,0,0,0,0,1,1
MAHARASHTRA,2010,INDIAN RAILWAYS ACT,0,0,0,140,2,142,110,6,116,39,0,39,289,8,297
MAHARASHTRA,2010,REGISTRATION OF FOREIGNERS ACT,0,0,0,0,0,0,0,0,0,0,0,0,0,0,0
MAHARASHTRA,2010,PROTECTION OF CIVIL RIGHTS ACT,0,0,0,0,0,0,0,0,0,0,0,0,0,0,0
MAHARASHTRA,2010,SC/ST (PREVENTION OF ATROCITIES) ACT,0,0,0,0,0,0,1,0,1,0,0,0,1,0,1
MAHARASHTRA,2010,INDIAN PASSPORT ACT,0,0,0,40,58,98,39,31,70,9,0,9,88,89,177
MAHARASHTRA,2010,ESSENTIAL COMMODITIES ACT,0,0,0,2,0,2,7,0,7,2,0,2,11,0,11
MAHARASHTRA,2010,ANTIQUITIES AND ART TREASURE ACT,0,0,0,17,0,17,25,0,25,1,0,1,43,0,43
MAHARASHTRA,2010,DOWRY PROHIBITION ACT,0,0,0,0,0,0,0,0,0,0,0,0,0,0,0
MAHARASHTRA,2010,FOREIGN EXCHANGE REGULATION ACT-1973,0,0,0,0,0,0,0,0,0,0,0,0,0,0,0
MAHARASHTRA,2010,PREVENTION OF CORRUPTION ACT-1988,0,0,0,0,0,0,0,0,0,0,0,0,0,0,0
MAHARASHTRA,2010,CONSER.OF FORGN.EXCH.&PREV. OF SMUG.ACT,0,0,0,0,0,0,0,0,0,0,0,0,0,0,0
MAHARASHTRA,2010,OTHER SLL OFFENCE,0,0,0,608,29,637,652,34,686,155,18,173,1415,81,1496
MAHARASHTRA,2010,TOTAL,0,0,0,1017,95,1112,1200,95,1295,345,20,365,2562,210,2772
MAHARASHTRA,2011,ARMS ACT,0,0,0,18,1,19,18,1,19,6,0,6,42,2,44
MAHARASHTRA,2011,N.D.P.S. ACT,0,0,0,158,1,159,170,10,180,40,0,40,368,11,379
MAHARASHTRA,2011,GAMBLING ACT,0,0,0,15,0,15,6,0,6,0,0,0,21,0,21
MAHARASHTRA,2011,EXCISE ACT,0,0,0,0,0,0,0,0,0,0,0,0,0,0,0
MAHARASHTRA,2011,PROHIBITION ACT,0,0,0,100,4,104,97,4,101,13,0,13,210,8,218
MAHARASHTRA,2011,EXPLOSIVE & EXPLOSIVE SUBST. ACT,0,0,0,0,0,0,2,0,2,0,0,0,2,0,2
MAHARASHTRA,2011,TERRORIST & DISRUPTIVE ACTIVITIES (TATA),0,0,0,0,0,0,2,0,2,2,0,2,4,0,4
MAHARASHTRA,2011,IMMORAL TRAFFIC (PREVENTION) ACT,0,0,0,5,12,17,12,16,28,0,0,0,17,28,45
MAHARASHTRA,2011,INDIAN RAILWAYS ACT,0,0,0,78,6,84,84,0,84,0,0,0,162,6,168
MAHARASHTRA,2011,REGISTRATION OF FOREIGNERS ACT,0,0,0,5,0,5,2,0,2,0,0,0,7,0,7
MAHARASHTRA,2011,PROTECTION OF CIVIL RIGHTS ACT,0,0,0,0,0,0,0,0,0,0,0,0,0,0,0
MAHARASHTRA,2011,SC/ST (PREVENTION OF ATROCITIES) ACT,0,0,0,3,0,3,0,0,0,0,0,0,3,0,3
MAHARASHTRA,2011,INDIAN PASSPORT ACT,0,0,0,68,97,165,126,47,173,5,0,5,199,144,343
MAHARASHTRA,2011,ESSENTIAL COMMODITIES ACT,0,0,0,0,0,0,0,0,0,0,0,0,0,0,0
MAHARASHTRA,2011,ANTIQUITIES AND ART TREASURE ACT,0,0,0,0,0,0,0,0,0,0,0,0,0,0,0
MAHARASHTRA,2011,DOWRY PROHIBITION ACT,0,0,0,0,0,0,2,0,2,0,0,0,2,0,2
MAHARASHTRA,2011,FOREIGN EXCHANGE REGULATION ACT-1973,0,0,0,0,0,0,0,0,0,0,0,0,0,0,0
MAHARASHTRA,2011,PREVENTION OF CORRUPTION ACT-1988,0,0,0,0,0,0,3,0,3,0,0,0,3,0,3
MAHARASHTRA,2011,CONSER.OF FORGN.EXCH.&PREV. OF SMUG.ACT,0,0,0,0,0,0,0,0,0,0,0,0,0,0,0
MAHARASHTRA,2011,OTHER SLL OFFENCE,0,0,0,431,11,442,401,45,446,262,8,270,1094,64,1158
MAHARASHTRA,2011,TOTAL,0,0,0,881,132,1013,925,123,1048,328,8,336,2134,263,2397
MAHARASHTRA,2012,ARMS ACT,0,0,0,17,0,17,34,0,34,0,0,0,51,0,51
MAHARASHTRA,2012,N.D.P.S. ACT,0,0,0,209,5,214,195,7,202,33,0,33,437,12,449
MAHARASHTRA,2012,GAMBLING ACT,0,0,0,4,0,4,11,0,11,0,0,0,15,0,15
MAHARASHTRA,2012,EXCISE ACT,0,0,0,0,0,0,1,0,1,0,0,0,1,0,1
MAHARASHTRA,2012,PROHIBITION ACT,0,0,0,74,0,74,106,2,108,33,1,34,213,3,216
MAHARASHTRA,2012,EXPLOSIVE & EXPLOSIVE SUBST. ACT,0,0,0,7,0,7,5,2,7,0,1,1,12,3,15
MAHARASHTRA,2012,TERRORIST & DISRUPTIVE ACTIVITIES (TATA),0,0,0,0,0,0,8,0,8,0,0,0,8,0,8
MAHARASHTRA,2012,IMMORAL TRAFFIC (PREVENTION) ACT,0,0,0,8,7,15,4,14,18,0,0,0,12,21,33
MAHARASHTRA,2012,INDIAN RAILWAYS ACT,0,0,0,50,0,50,36,0,36,14,0,14,100,0,100
MAHARASHTRA,2012,REGISTRATION OF FOREIGNERS ACT,0,0,0,5,0,5,9,0,9,0,0,0,14,0,14
MAHARASHTRA,2012,PROTECTION OF CIVIL RIGHTS ACT,0,0,0,0,0,0,0,0,0,0,0,0,0,0,0
MAHARASHTRA,2012,SC/ST (PREVENTION OF ATROCITIES) ACT,0,0,0,23,1,24,10,0,10,1,0,1,34,1,35
MAHARASHTRA,2012,INDIAN PASSPORT ACT,0,0,0,131,60,191,134,108,242,6,14,20,271,182,453
MAHARASHTRA,2012,ESSENTIAL COMMODITIES ACT,0,0,0,1,0,1,0,0,0,0,0,0,1,0,1
MAHARASHTRA,2012,ANTIQUITIES AND ART TREASURE ACT,0,0,0,2,1,3,4,1,5,0,0,0,6,2,8
MAHARASHTRA,2012,DOWRY PROHIBITION ACT,0,0,0,32,0,32,7,0,7,0,0,0,39,0,39
MAHARASHTRA,2012,FOREIGN EXCHANGE REGULATION ACT-1973,0,0,0,0,0,0,0,0,0,0,0,0,0,0,0
MAHARASHTRA,2012,PREVENTION OF CORRUPTION ACT-1988,0,0,0,10,0,10,18,0,18,0,0,0,28,0,28
MAHARASHTRA,2012,CONSER.OF FORGN.EXCH.&PREV. OF SMUG.ACT,0,0,0,0,0,0,31,10,41,0,0,0,31,10,41
MAHARASHTRA,2012,OTHER SLL OFFENCE,0,0,0,302,11,313,589,25,614,138,2,140,1029,38,1067
MAHARASHTRA,2012,TOTAL,0,0,0,875,85,960,1202,169,1371,225,18,243,2302,272,2574
MANIPUR,2001,ARMS ACT,0,0,0,72,1,73,3,0,3,0,0,0,75,1,76
MANIPUR,2001,N.D.P.S. ACT,0,0,0,33,2,35,27,5,32,5,1,6,65,8,73
MANIPUR,2001,GAMBLING ACT,0,0,0,0,0,0,0,0,0,0,0,0,0,0,0
MANIPUR,2001,EXCISE ACT,0,0,0,0,0,0,0,0,0,0,0,0,0,0,0
MANIPUR,2001,PROHIBITION ACT,0,0,0,0,0,0,0,0,0,0,0,0,0,0,0
MANIPUR,2001,EXPLOSIVE & EXPLOSIVE SUBST. ACT,0,0,0,8,0,8,1,0,1,0,0,0,9,0,9
MANIPUR,2001,TERRORIST & DISRUPTIVE ACTIVITIES (TATA),0,0,0,0,0,0,0,0,0,0,0,0,0,0,0
MANIPUR,2001,IMMORAL TRAFFIC (PREVENTION) ACT,0,0,0,0,0,0,0,0,0,0,0,0,0,0,0
MANIPUR,2001,INDIAN RAILWAYS ACT,0,0,0,0,0,0,0,0,0,0,0,0,0,0,0
MANIPUR,2001,REGISTRATION OF FOREIGNERS ACT,0,0,0,3,0,3,2,0,2,0,0,0,5,0,5
MANIPUR,2001,PROTECTION OF CIVIL RIGHTS ACT,0,0,0,0,0,0,0,0,0,0,0,0,0,0,0
MANIPUR,2001,SC/ST (PREVENTION OF ATROCITIES) ACT,0,0,0,0,0,0,0,0,0,0,0,0,0,0,0
MANIPUR,2001,INDIAN PASSPORT ACT,0,0,0,0,0,0,0,0,0,0,0,0,0,0,0
MANIPUR,2001,ESSENTIAL COMMODITIES ACT,0,0,0,0,0,0,0,0,0,0,0,0,0,0,0
MANIPUR,2001,ANTIQUITIES AND ART TREASURE ACT,0,0,0,0,0,0,0,0,0,0,0,0,0,0,0
MANIPUR,2001,DOWRY PROHIBITION ACT,0,0,0,0,0,0,0,0,0,0,0,0,0,0,0
MANIPUR,2001,FOREIGN EXCHANGE REGULATION ACT-1973,0,0,0,0,0,0,0,0,0,0,0,0,0,0,0
MANIPUR,2001,PREVENTION OF CORRUPTION ACT-1988,0,0,0,0,0,0,0,0,0,0,0,0,0,0,0
MANIPUR,2001,CONSER.OF FORGN.EXCH.&PREV. OF SMUG.ACT,0,0,0,0,0,0,0,0,0,0,0,0,0,0,0
MANIPUR,2001,OTHER SLL OFFENCE,0,0,0,28,2,30,7,0,7,0,0,0,35,2,37
MANIPUR,2001,TOTAL,0,0,0,144,5,149,40,5,45,5,1,6,189,11,200
MANIPUR,2002,ARMS ACT,0,0,0,22,0,22,9,0,9,0,0,0,31,0,31
MANIPUR,2002,N.D.P.S. ACT,1,0,1,27,1,28,25,3,28,4,1,5,57,5,62
MANIPUR,2002,GAMBLING ACT,0,0,0,0,0,0,0,0,0,0,0,0,0,0,0
MANIPUR,2002,EXCISE ACT,0,0,0,0,0,0,0,0,0,0,0,0,0,0,0
MANIPUR,2002,PROHIBITION ACT,0,0,0,0,0,0,0,0,0,0,0,0,0,0,0
MANIPUR,2002,EXPLOSIVE & EXPLOSIVE SUBST. ACT,0,0,0,2,0,2,0,0,0,0,0,0,2,0,2
MANIPUR,2002,TERRORIST & DISRUPTIVE ACTIVITIES (TATA),0,0,0,0,0,0,0,0,0,0,0,0,0,0,0
MANIPUR,2002,IMMORAL TRAFFIC (PREVENTION) ACT,0,0,0,0,0,0,0,0,0,0,0,0,0,0,0
MANIPUR,2002,INDIAN RAILWAYS ACT,0,0,0,0,0,0,0,0,0,0,0,0,0,0,0
MANIPUR,2002,REGISTRATION OF FOREIGNERS ACT,0,0,0,0,0,0,0,0,0,0,0,0,0,0,0
MANIPUR,2002,PROTECTION OF CIVIL RIGHTS ACT,0,0,0,0,0,0,0,0,0,0,0,0,0,0,0
MANIPUR,2002,SC/ST (PREVENTION OF ATROCITIES) ACT,0,0,0,0,0,0,0,0,0,0,0,0,0,0,0
MANIPUR,2002,INDIAN PASSPORT ACT,0,0,0,0,0,0,0,0,0,0,0,0,0,0,0
MANIPUR,2002,ESSENTIAL COMMODITIES ACT,0,0,0,0,0,0,0,0,0,0,0,0,0,0,0
MANIPUR,2002,ANTIQUITIES AND ART TREASURE ACT,0,0,0,0,0,0,0,0,0,0,0,0,0,0,0
MANIPUR,2002,DOWRY PROHIBITION ACT,0,0,0,0,0,0,0,0,0,0,0,0,0,0,0
MANIPUR,2002,FOREIGN EXCHANGE REGULATION ACT-1973,0,0,0,0,0,0,0,0,0,0,0,0,0,0,0
MANIPUR,2002,PREVENTION OF CORRUPTION ACT-1988,0,0,0,0,0,0,1,0,1,0,0,0,1,0,1
MANIPUR,2002,CONSER.OF FORGN.EXCH.&PREV. OF SMUG.ACT,0,0,0,0,0,0,0,0,0,0,0,0,0,0,0
MANIPUR,2002,OTHER SLL OFFENCE,1,0,1,15,6,21,4,1,5,0,0,0,20,7,27
MANIPUR,2002,TOTAL,2,0,2,66,7,73,39,4,43,4,1,5,111,12,123
MANIPUR,2003,ARMS ACT,0,0,0,33,0,33,7,0,7,0,0,0,40,0,40
MANIPUR,2003,N.D.P.S. ACT,0,0,0,27,0,27,34,6,40,2,4,6,63,10,73
MANIPUR,2003,GAMBLING ACT,0,0,0,0,0,0,0,0,0,0,0,0,0,0,0
MANIPUR,2003,EXCISE ACT,0,0,0,0,0,0,0,0,0,0,0,0,0,0,0
MANIPUR,2003,PROHIBITION ACT,0,0,0,0,0,0,0,0,0,0,0,0,0,0,0
MANIPUR,2003,EXPLOSIVE & EXPLOSIVE SUBST. ACT,0,0,0,0,0,0,0,0,0,0,0,0,0,0,0
MANIPUR,2003,TERRORIST & DISRUPTIVE ACTIVITIES (TATA),0,0,0,0,0,0,0,0,0,0,0,0,0,0,0
MANIPUR,2003,IMMORAL TRAFFIC (PREVENTION) ACT,0,0,0,0,0,0,0,0,0,0,0,0,0,0,0
MANIPUR,2003,INDIAN RAILWAYS ACT,0,0,0,0,0,0,0,0,0,0,0,0,0,0,0
MANIPUR,2003,REGISTRATION OF FOREIGNERS ACT,0,0,0,2,0,2,3,0,3,1,0,1,6,0,6
MANIPUR,2003,PROTECTION OF CIVIL RIGHTS ACT,0,0,0,0,0,0,0,0,0,0,0,0,0,0,0
MANIPUR,2003,SC/ST (PREVENTION OF ATROCITIES) ACT,0,0,0,0,0,0,0,0,0,0,0,0,0,0,0
MANIPUR,2003,INDIAN PASSPORT ACT,0,0,0,0,0,0,0,0,0,0,0,0,0,0,0
MANIPUR,2003,ESSENTIAL COMMODITIES ACT,0,0,0,0,0,0,0,0,0,0,0,0,0,0,0
MANIPUR,2003,ANTIQUITIES AND ART TREASURE ACT,0,0,0,0,0,0,0,0,0,0,0,0,0,0,0
MANIPUR,2003,DOWRY PROHIBITION ACT,0,0,0,0,0,0,0,0,0,0,0,0,0,0,0
MANIPUR,2003,FOREIGN EXCHANGE REGULATION ACT-1973,0,0,0,0,0,0,0,0,0,0,0,0,0,0,0
MANIPUR,2003,PREVENTION OF CORRUPTION ACT-1988,0,0,0,0,0,0,0,0,0,0,0,0,0,0,0
MANIPUR,2003,CONSER.OF FORGN.EXCH.&PREV. OF SMUG.ACT,0,0,0,0,0,0,0,0,0,0,0,0,0,0,0
MANIPUR,2003,OTHER SLL OFFENCE,0,0,0,6,0,6,2,0,2,1,0,1,9,0,9
MANIPUR,2003,TOTAL,0,0,0,68,0,68,46,6,52,4,4,8,118,10,128
MANIPUR,2004,ARMS ACT,1,2,3,44,2,46,10,0,10,1,0,1,56,4,60
MANIPUR,2004,N.D.P.S. ACT,3,0,3,21,2,23,21,5,26,0,2,2,45,9,54
MANIPUR,2004,GAMBLING ACT,0,0,0,0,0,0,0,0,0,0,0,0,0,0,0
MANIPUR,2004,EXCISE ACT,0,0,0,0,0,0,0,0,0,0,0,0,0,0,0
MANIPUR,2004,PROHIBITION ACT,0,0,0,0,0,0,0,0,0,0,0,0,0,0,0
MANIPUR,2004,EXPLOSIVE & EXPLOSIVE SUBST. ACT,0,0,0,2,0,2,0,0,0,0,0,0,2,0,2
MANIPUR,2004,TERRORIST & DISRUPTIVE ACTIVITIES (TATA),0,0,0,0,0,0,0,0,0,0,0,0,0,0,0
MANIPUR,2004,IMMORAL TRAFFIC (PREVENTION) ACT,0,0,0,0,0,0,0,0,0,0,0,0,0,0,0
MANIPUR,2004,INDIAN RAILWAYS ACT,0,0,0,0,0,0,0,0,0,0,0,0,0,0,0
MANIPUR,2004,REGISTRATION OF FOREIGNERS ACT,0,0,0,2,0,2,2,0,2,1,0,1,5,0,5
MANIPUR,2004,PROTECTION OF CIVIL RIGHTS ACT,0,0,0,0,0,0,0,0,0,0,0,0,0,0,0
MANIPUR,2004,SC/ST (PREVENTION OF ATROCITIES) ACT,0,0,0,0,0,0,0,0,0,0,0,0,0,0,0
MANIPUR,2004,INDIAN PASSPORT ACT,0,0,0,0,0,0,0,0,0,0,0,0,0,0,0
MANIPUR,2004,ESSENTIAL COMMODITIES ACT,0,0,0,0,0,0,0,0,0,0,0,0,0,0,0
MANIPUR,2004,ANTIQUITIES AND ART TREASURE ACT,0,0,0,0,0,0,0,0,0,0,0,0,0,0,0
MANIPUR,2004,DOWRY PROHIBITION ACT,0,0,0,0,0,0,0,0,0,0,0,0,0,0,0
MANIPUR,2004,FOREIGN EXCHANGE REGULATION ACT-1973,0,0,0,0,0,0,0,0,0,0,0,0,0,0,0
MANIPUR,2004,PREVENTION OF CORRUPTION ACT-1988,0,0,0,0,0,0,0,0,0,0,0,0,0,0,0
MANIPUR,2004,CONSER.OF FORGN.EXCH.&PREV. OF SMUG.ACT,0,0,0,0,0,0,0,0,0,0,0,0,0,0,0
MANIPUR,2004,OTHER SLL OFFENCE,0,0,0,0,0,0,1,0,1,0,0,0,1,0,1
MANIPUR,2004,TOTAL,4,2,6,69,4,73,34,5,39,2,2,4,109,13,122
MANIPUR,2005,ARMS ACT,1,0,1,63,0,63,14,0,14,0,0,0,78,0,78
MANIPUR,2005,N.D.P.S. ACT,0,0,0,11,0,11,11,1,12,0,0,0,22,1,23
MANIPUR,2005,GAMBLING ACT,0,0,0,0,0,0,0,0,0,0,0,0,0,0,0
MANIPUR,2005,EXCISE ACT,0,0,0,0,0,0,0,0,0,0,0,0,0,0,0
MANIPUR,2005,PROHIBITION ACT,0,0,0,0,0,0,0,0,0,0,0,0,0,0,0
MANIPUR,2005,EXPLOSIVE & EXPLOSIVE SUBST. ACT,0,0,0,4,0,4,0,0,0,0,0,0,4,0,4
MANIPUR,2005,TERRORIST & DISRUPTIVE ACTIVITIES (TATA),0,0,0,0,0,0,0,0,0,0,0,0,0,0,0
MANIPUR,2005,IMMORAL TRAFFIC (PREVENTION) ACT,0,0,0,0,0,0,0,0,0,0,0,0,0,0,0
MANIPUR,2005,INDIAN RAILWAYS ACT,0,0,0,0,0,0,0,0,0,0,0,0,0,0,0
MANIPUR,2005,REGISTRATION OF FOREIGNERS ACT,0,0,0,0,0,0,0,0,0,0,0,0,0,0,0
MANIPUR,2005,PROTECTION OF CIVIL RIGHTS ACT,0,0,0,0,0,0,0,0,0,0,0,0,0,0,0
MANIPUR,2005,SC/ST (PREVENTION OF ATROCITIES) ACT,0,0,0,0,0,0,0,0,0,0,0,0,0,0,0
MANIPUR,2005,INDIAN PASSPORT ACT,0,0,0,0,0,0,0,0,0,0,0,0,0,0,0
MANIPUR,2005,ESSENTIAL COMMODITIES ACT,0,0,0,0,0,0,0,0,0,0,0,0,0,0,0
MANIPUR,2005,ANTIQUITIES AND ART TREASURE ACT,0,0,0,0,0,0,0,0,0,0,0,0,0,0,0
MANIPUR,2005,DOWRY PROHIBITION ACT,0,0,0,0,0,0,0,0,0,0,0,0,0,0,0
MANIPUR,2005,FOREIGN EXCHANGE REGULATION ACT-1973,0,0,0,0,0,0,0,0,0,0,0,0,0,0,0
MANIPUR,2005,PREVENTION OF CORRUPTION ACT-1988,0,0,0,0,0,0,0,0,0,1,0,1,1,0,1
MANIPUR,2005,CONSER.OF FORGN.EXCH.&PREV. OF SMUG.ACT,0,0,0,0,0,0,0,0,0,0,0,0,0,0,0
MANIPUR,2005,OTHER SLL OFFENCE,0,0,0,0,0,0,0,0,0,2,0,2,2,0,2
MANIPUR,2005,TOTAL,1,0,1,78,0,78,25,1,26,3,0,3,107,1,108
MANIPUR,2006,ARMS ACT,0,0,0,37,0,37,7,0,7,0,0,0,44,0,44
MANIPUR,2006,N.D.P.S. ACT,0,0,0,15,0,15,10,1,11,0,0,0,25,1,26
MANIPUR,2006,GAMBLING ACT,0,0,0,0,0,0,0,0,0,0,0,0,0,0,0
MANIPUR,2006,EXCISE ACT,0,0,0,0,0,0,0,0,0,0,0,0,0,0,0
MANIPUR,2006,PROHIBITION ACT,0,0,0,0,0,0,0,0,0,0,0,0,0,0,0
MANIPUR,2006,EXPLOSIVE & EXPLOSIVE SUBST. ACT,0,0,0,7,0,7,2,0,2,0,0,0,9,0,9
MANIPUR,2006,TERRORIST & DISRUPTIVE ACTIVITIES (TATA),0,0,0,27,1,28,10,0,10,1,0,1,38,1,39
MANIPUR,2006,IMMORAL TRAFFIC (PREVENTION) ACT,0,0,0,0,0,0,0,0,0,0,0,0,0,0,0
MANIPUR,2006,INDIAN RAILWAYS ACT,0,0,0,0,0,0,0,0,0,0,0,0,0,0,0
MANIPUR,2006,REGISTRATION OF FOREIGNERS ACT,0,0,0,0,0,0,0,0,0,1,0,1,1,0,1
MANIPUR,2006,PROTECTION OF CIVIL RIGHTS ACT,0,0,0,0,0,0,0,0,0,0,0,0,0,0,0
MANIPUR,2006,SC/ST (PREVENTION OF ATROCITIES) ACT,0,0,0,0,0,0,0,0,0,0,0,0,0,0,0
MANIPUR,2006,INDIAN PASSPORT ACT,0,0,0,0,0,0,0,0,0,0,0,0,0,0,0
MANIPUR,2006,ESSENTIAL COMMODITIES ACT,0,0,0,0,0,0,0,0,0,0,0,0,0,0,0
MANIPUR,2006,ANTIQUITIES AND ART TREASURE ACT,0,0,0,0,0,0,0,0,0,0,0,0,0,0,0
MANIPUR,2006,DOWRY PROHIBITION ACT,0,0,0,0,0,0,0,0,0,0,0,0,0,0,0
MANIPUR,2006,FOREIGN EXCHANGE REGULATION ACT-1973,0,0,0,0,0,0,0,0,0,0,0,0,0,0,0
MANIPUR,2006,PREVENTION OF CORRUPTION ACT-1988,0,0,0,0,0,0,0,0,0,0,0,0,0,0,0
MANIPUR,2006,CONSER.OF FORGN.EXCH.&PREV. OF SMUG.ACT,0,0,0,0,0,0,0,0,0,0,0,0,0,0,0
MANIPUR,2006,OTHER SLL OFFENCE,0,0,0,0,0,0,1,0,1,0,0,0,1,0,1
MANIPUR,2006,TOTAL,0,0,0,86,1,87,30,1,31,2,0,2,118,2,120
MANIPUR,2007,ARMS ACT,0,0,0,26,0,26,3,0,3,0,0,0,29,0,29
MANIPUR,2007,N.D.P.S. ACT,0,0,0,7,0,7,11,1,12,0,0,0,18,1,19
MANIPUR,2007,GAMBLING ACT,0,0,0,0,0,0,0,0,0,0,0,0,0,0,0
MANIPUR,2007,EXCISE ACT,0,0,0,0,0,0,0,0,0,0,0,0,0,0,0
MANIPUR,2007,PROHIBITION ACT,0,0,0,0,0,0,0,0,0,0,0,0,0,0,0
MANIPUR,2007,EXPLOSIVE & EXPLOSIVE SUBST. ACT,0,0,0,2,0,2,1,0,1,0,0,0,3,0,3
MANIPUR,2007,TERRORIST & DISRUPTIVE ACTIVITIES (TATA),0,0,0,0,0,0,0,0,0,0,0,0,0,0,0
MANIPUR,2007,IMMORAL TRAFFIC (PREVENTION) ACT,0,0,0,0,0,0,0,0,0,0,0,0,0,0,0
MANIPUR,2007,INDIAN RAILWAYS ACT,0,0,0,0,0,0,0,0,0,0,0,0,0,0,0
MANIPUR,2007,REGISTRATION OF FOREIGNERS ACT,0,0,0,0,0,0,1,0,1,0,0,0,1,0,1
MANIPUR,2007,PROTECTION OF CIVIL RIGHTS ACT,0,0,0,0,0,0,0,0,0,0,0,0,0,0,0
MANIPUR,2007,SC/ST (PREVENTION OF ATROCITIES) ACT,0,0,0,0,0,0,0,0,0,0,0,0,0,0,0
MANIPUR,2007,INDIAN PASSPORT ACT,0,0,0,0,0,0,0,0,0,0,0,0,0,0,0
MANIPUR,2007,ESSENTIAL COMMODITIES ACT,0,0,0,0,0,0,0,0,0,0,0,0,0,0,0
MANIPUR,2007,ANTIQUITIES AND ART TREASURE ACT,0,0,0,0,0,0,0,0,0,0,0,0,0,0,0
MANIPUR,2007,DOWRY PROHIBITION ACT,0,0,0,0,0,0,0,0,0,0,0,0,0,0,0
MANIPUR,2007,FOREIGN EXCHANGE REGULATION ACT-1973,0,0,0,0,0,0,0,0,0,0,0,0,0,0,0
MANIPUR,2007,PREVENTION OF CORRUPTION ACT-1988,0,0,0,0,0,0,0,0,0,1,0,1,1,0,1
MANIPUR,2007,CONSER.OF FORGN.EXCH.&PREV. OF SMUG.ACT,0,0,0,0,0,0,0,0,0,0,0,0,0,0,0
MANIPUR,2007,OTHER SLL OFFENCE,0,0,0,31,0,31,6,0,6,0,0,0,37,0,37
MANIPUR,2007,TOTAL,0,0,0,66,0,66,22,1,23,1,0,1,89,1,90
MANIPUR,2008,ARMS ACT,0,0,0,29,1,30,15,1,16,0,0,0,44,2,46
MANIPUR,2008,N.D.P.S. ACT,0,0,0,5,1,6,6,2,8,1,2,3,12,5,17
MANIPUR,2008,GAMBLING ACT,0,0,0,0,0,0,0,0,0,0,0,0,0,0,0
MANIPUR,2008,EXCISE ACT,0,0,0,0,0,0,0,0,0,0,0,0,0,0,0
MANIPUR,2008,PROHIBITION ACT,0,0,0,0,0,0,0,0,0,0,0,0,0,0,0
MANIPUR,2008,EXPLOSIVE & EXPLOSIVE SUBST. ACT,0,0,0,12,0,12,6,0,6,0,0,0,18,0,18
MANIPUR,2008,TERRORIST & DISRUPTIVE ACTIVITIES (TATA),0,0,0,0,0,0,0,0,0,0,0,0,0,0,0
MANIPUR,2008,IMMORAL TRAFFIC (PREVENTION) ACT,0,0,0,0,0,0,0,0,0,0,0,0,0,0,0
MANIPUR,2008,INDIAN RAILWAYS ACT,0,0,0,0,0,0,0,0,0,0,0,0,0,0,0
MANIPUR,2008,REGISTRATION OF FOREIGNERS ACT,0,0,0,3,0,3,1,0,1,1,0,1,5,0,5
MANIPUR,2008,PROTECTION OF CIVIL RIGHTS ACT,0,0,0,0,0,0,0,0,0,0,0,0,0,0,0
MANIPUR,2008,SC/ST (PREVENTION OF ATROCITIES) ACT,0,0,0,0,0,0,0,0,0,0,0,0,0,0,0
MANIPUR,2008,INDIAN PASSPORT ACT,0,0,0,0,0,0,0,0,0,0,0,0,0,0,0
MANIPUR,2008,ESSENTIAL COMMODITIES ACT,0,0,0,0,0,0,0,0,0,0,0,0,0,0,0
MANIPUR,2008,ANTIQUITIES AND ART TREASURE ACT,0,0,0,0,0,0,0,0,0,0,0,0,0,0,0
MANIPUR,2008,DOWRY PROHIBITION ACT,0,0,0,0,0,0,0,0,0,0,0,0,0,0,0
MANIPUR,2008,FOREIGN EXCHANGE REGULATION ACT-1973,0,0,0,0,0,0,0,0,0,0,0,0,0,0,0
MANIPUR,2008,PREVENTION OF CORRUPTION ACT-1988,0,0,0,0,0,0,0,0,0,0,0,0,0,0,0
MANIPUR,2008,CONSER.OF FORGN.EXCH.&PREV. OF SMUG.ACT,0,0,0,0,0,0,0,0,0,0,0,0,0,0,0
MANIPUR,2008,OTHER SLL OFFENCE,0,0,0,0,0,0,0,0,0,0,0,0,0,0,0
MANIPUR,2008,TOTAL,0,0,0,49,2,51,28,3,31,2,2,4,79,7,86
MANIPUR,2009,ARMS ACT,0,0,0,41,4,45,29,2,31,1,0,1,71,6,77
MANIPUR,2009,N.D.P.S. ACT,0,0,0,8,0,8,9,1,10,1,0,1,18,1,19
MANIPUR,2009,GAMBLING ACT,0,0,0,0,0,0,0,0,0,0,0,0,0,0,0
MANIPUR,2009,EXCISE ACT,0,0,0,0,0,0,0,0,0,0,0,0,0,0,0
MANIPUR,2009,PROHIBITION ACT,0,0,0,0,0,0,0,0,0,0,0,0,0,0,0
MANIPUR,2009,EXPLOSIVE & EXPLOSIVE SUBST. ACT,0,0,0,3,0,3,2,0,2,0,0,0,5,0,5
MANIPUR,2009,TERRORIST & DISRUPTIVE ACTIVITIES (TATA),0,0,0,0,0,0,0,0,0,0,0,0,0,0,0
MANIPUR,2009,IMMORAL TRAFFIC (PREVENTION) ACT,0,0,0,0,0,0,0,0,0,0,0,0,0,0,0
MANIPUR,2009,INDIAN RAILWAYS ACT,0,0,0,0,0,0,0,0,0,0,0,0,0,0,0
MANIPUR,2009,REGISTRATION OF FOREIGNERS ACT,0,0,0,7,2,9,5,3,8,0,0,0,12,5,17
MANIPUR,2009,PROTECTION OF CIVIL RIGHTS ACT,0,0,0,0,0,0,0,0,0,0,0,0,0,0,0
MANIPUR,2009,SC/ST (PREVENTION OF ATROCITIES) ACT,0,0,0,0,0,0,0,0,0,0,0,0,0,0,0
MANIPUR,2009,INDIAN PASSPORT ACT,0,0,0,0,0,0,0,0,0,0,0,0,0,0,0
MANIPUR,2009,ESSENTIAL COMMODITIES ACT,0,0,0,0,0,0,0,0,0,0,0,0,0,0,0
MANIPUR,2009,ANTIQUITIES AND ART TREASURE ACT,0,0,0,0,0,0,0,0,0,0,0,0,0,0,0
MANIPUR,2009,DOWRY PROHIBITION ACT,0,0,0,0,0,0,0,0,0,0,0,0,0,0,0
MANIPUR,2009,FOREIGN EXCHANGE REGULATION ACT-1973,0,0,0,0,0,0,0,0,0,0,0,0,0,0,0
MANIPUR,2009,PREVENTION OF CORRUPTION ACT-1988,0,0,0,0,0,0,0,0,0,0,0,0,0,0,0
MANIPUR,2009,CONSER.OF FORGN.EXCH.&PREV. OF SMUG.ACT,0,0,0,0,0,0,0,0,0,0,0,0,0,0,0
MANIPUR,2009,OTHER SLL OFFENCE,0,0,0,0,0,0,0,1,1,0,6,6,0,7,7
MANIPUR,2009,TOTAL,0,0,0,59,6,65,45,7,52,2,6,8,106,19,125
MANIPUR,2010,ARMS ACT,0,0,0,75,2,77,43,4,47,1,0,1,119,6,125
MANIPUR,2010,N.D.P.S. ACT,0,0,0,0,0,0,0,0,0,0,0,0,0,0,0
MANIPUR,2010,GAMBLING ACT,0,0,0,0,0,0,0,0,0,0,0,0,0,0,0
MANIPUR,2010,EXCISE ACT,0,0,0,0,0,0,0,0,0,0,0,0,0,0,0
MANIPUR,2010,PROHIBITION ACT,0,0,0,0,0,0,0,0,0,0,0,0,0,0,0
MANIPUR,2010,EXPLOSIVE & EXPLOSIVE SUBST. ACT,0,0,0,1,0,1,0,0,0,0,0,0,1,0,1
MANIPUR,2010,TERRORIST & DISRUPTIVE ACTIVITIES (TATA),0,0,0,0,0,0,0,0,0,0,0,0,0,0,0
MANIPUR,2010,IMMORAL TRAFFIC (PREVENTION) ACT,0,0,0,0,0,0,0,0,0,0,0,0,0,0,0
MANIPUR,2010,INDIAN RAILWAYS ACT,0,0,0,0,0,0,0,0,0,0,0,0,0,0,0
MANIPUR,2010,REGISTRATION OF FOREIGNERS ACT,0,0,0,8,0,8,2,0,2,0,0,0,10,0,10
MANIPUR,2010,PROTECTION OF CIVIL RIGHTS ACT,0,0,0,0,0,0,0,0,0,0,0,0,0,0,0
MANIPUR,2010,SC/ST (PREVENTION OF ATROCITIES) ACT,0,0,0,0,0,0,0,0,0,0,0,0,0,0,0
MANIPUR,2010,INDIAN PASSPORT ACT,0,0,0,0,0,0,0,0,0,0,0,0,0,0,0
MANIPUR,2010,ESSENTIAL COMMODITIES ACT,0,0,0,0,0,0,0,0,0,0,0,0,0,0,0
MANIPUR,2010,ANTIQUITIES AND ART TREASURE ACT,0,0,0,0,0,0,0,0,0,0,0,0,0,0,0
MANIPUR,2010,DOWRY PROHIBITION ACT,0,0,0,0,0,0,0,0,0,0,0,0,0,0,0
MANIPUR,2010,FOREIGN EXCHANGE REGULATION ACT-1973,0,0,0,0,0,0,0,0,0,0,0,0,0,0,0
MANIPUR,2010,PREVENTION OF CORRUPTION ACT-1988,0,0,0,0,0,0,0,0,0,0,0,0,0,0,0
MANIPUR,2010,CONSER.OF FORGN.EXCH.&PREV. OF SMUG.ACT,0,0,0,0,0,0,0,0,0,0,0,0,0,0,0
MANIPUR,2010,OTHER SLL OFFENCE,0,0,0,0,0,0,0,0,0,0,0,0,0,0,0
MANIPUR,2010,TOTAL,0,0,0,84,2,86,45,4,49,1,0,1,130,6,136
MANIPUR,2011,ARMS ACT,0,0,0,47,1,48,36,3,39,3,0,3,86,4,90
MANIPUR,2011,N.D.P.S. ACT,0,0,0,7,0,7,13,4,17,1,1,2,21,5,26
MANIPUR,2011,GAMBLING ACT,0,0,0,0,0,0,0,0,0,0,0,0,0,0,0
MANIPUR,2011,EXCISE ACT,0,0,0,4,0,4,6,0,6,2,0,2,12,0,12
MANIPUR,2011,PROHIBITION ACT,0,0,0,0,0,0,0,0,0,0,0,0,0,0,0
MANIPUR,2011,EXPLOSIVE & EXPLOSIVE SUBST. ACT,0,0,0,0,3,3,0,1,1,0,0,0,0,4,4
MANIPUR,2011,TERRORIST & DISRUPTIVE ACTIVITIES (TATA),0,0,0,0,0,0,0,0,0,0,0,0,0,0,0
MANIPUR,2011,IMMORAL TRAFFIC (PREVENTION) ACT,0,0,0,0,0,0,0,0,0,0,0,0,0,0,0
MANIPUR,2011,INDIAN RAILWAYS ACT,0,0,0,0,0,0,0,0,0,0,0,0,0,0,0
MANIPUR,2011,REGISTRATION OF FOREIGNERS ACT,0,0,0,13,0,13,5,0,5,0,0,0,18,0,18
MANIPUR,2011,PROTECTION OF CIVIL RIGHTS ACT,0,0,0,0,0,0,0,0,0,0,0,0,0,0,0
MANIPUR,2011,SC/ST (PREVENTION OF ATROCITIES) ACT,0,0,0,0,0,0,0,0,0,0,0,0,0,0,0
MANIPUR,2011,INDIAN PASSPORT ACT,0,0,0,0,0,0,0,0,0,0,0,0,0,0,0
MANIPUR,2011,ESSENTIAL COMMODITIES ACT,0,0,0,0,0,0,0,0,0,0,0,0,0,0,0
MANIPUR,2011,ANTIQUITIES AND ART TREASURE ACT,0,0,0,0,0,0,0,0,0,0,0,0,0,0,0
MANIPUR,2011,DOWRY PROHIBITION ACT,0,0,0,0,0,0,0,0,0,0,0,0,0,0,0
MANIPUR,2011,FOREIGN EXCHANGE REGULATION ACT-1973,0,0,0,0,0,0,0,0,0,0,0,0,0,0,0
MANIPUR,2011,PREVENTION OF CORRUPTION ACT-1988,0,0,0,0,0,0,0,0,0,0,0,0,0,0,0
MANIPUR,2011,CONSER.OF FORGN.EXCH.&PREV. OF SMUG.ACT,0,0,0,0,0,0,0,0,0,0,0,0,0,0,0
MANIPUR,2011,OTHER SLL OFFENCE,0,0,0,20,0,20,16,0,16,0,0,0,36,0,36
MANIPUR,2011,TOTAL,0,0,0,91,4,95,76,8,84,6,1,7,173,13,186
MANIPUR,2012,ARMS ACT,0,0,0,55,0,55,44,8,52,4,0,4,103,8,111
MANIPUR,2012,N.D.P.S. ACT,0,0,0,0,0,0,0,0,0,0,0,0,0,0,0
MANIPUR,2012,GAMBLING ACT,0,0,0,0,0,0,0,0,0,0,0,0,0,0,0
MANIPUR,2012,EXCISE ACT,0,0,0,0,0,0,0,0,0,0,0,0,0,0,0
MANIPUR,2012,PROHIBITION ACT,0,0,0,0,0,0,0,0,0,0,0,0,0,0,0
MANIPUR,2012,EXPLOSIVE & EXPLOSIVE SUBST. ACT,0,0,0,14,2,16,18,0,18,0,0,0,32,2,34
MANIPUR,2012,TERRORIST & DISRUPTIVE ACTIVITIES (TATA),0,0,0,0,0,0,0,0,0,0,0,0,0,0,0
MANIPUR,2012,IMMORAL TRAFFIC (PREVENTION) ACT,0,0,0,0,0,0,0,0,0,0,0,0,0,0,0
MANIPUR,2012,INDIAN RAILWAYS ACT,0,0,0,0,0,0,0,0,0,0,0,0,0,0,0
MANIPUR,2012,REGISTRATION OF FOREIGNERS ACT,0,0,0,18,2,20,10,0,10,1,0,1,29,2,31
MANIPUR,2012,PROTECTION OF CIVIL RIGHTS ACT,0,0,0,0,0,0,0,0,0,0,0,0,0,0,0
MANIPUR,2012,SC/ST (PREVENTION OF ATROCITIES) ACT,0,0,0,0,0,0,0,0,0,0,0,0,0,0,0
MANIPUR,2012,INDIAN PASSPORT ACT,0,0,0,0,0,0,0,0,0,0,0,0,0,0,0
MANIPUR,2012,ESSENTIAL COMMODITIES ACT,0,0,0,0,0,0,0,0,0,0,0,0,0,0,0
MANIPUR,2012,ANTIQUITIES AND ART TREASURE ACT,0,0,0,0,0,0,0,0,0,0,0,0,0,0,0
MANIPUR,2012,DOWRY PROHIBITION ACT,0,0,0,0,0,0,0,0,0,0,0,0,0,0,0
MANIPUR,2012,FOREIGN EXCHANGE REGULATION ACT-1973,0,0,0,0,0,0,0,0,0,0,0,0,0,0,0
MANIPUR,2012,PREVENTION OF CORRUPTION ACT-1988,0,0,0,0,0,0,0,0,0,0,0,0,0,0,0
MANIPUR,2012,CONSER.OF FORGN.EXCH.&PREV. OF SMUG.ACT,0,0,0,0,0,0,0,0,0,1,0,1,1,0,1
MANIPUR,2012,OTHER SLL OFFENCE,0,0,0,16,0,16,11,2,13,1,0,1,28,2,30
MANIPUR,2012,TOTAL,0,0,0,103,4,107,83,10,93,7,0,7,193,14,207
MEGHALAYA,2001,ARMS ACT,0,0,0,21,0,21,8,0,8,0,0,0,29,0,29
MEGHALAYA,2001,N.D.P.S. ACT,0,0,0,8,0,8,8,4,12,0,0,0,16,4,20
MEGHALAYA,2001,GAMBLING ACT,0,0,0,0,0,0,1,0,1,0,0,0,1,0,1
MEGHALAYA,2001,EXCISE ACT,0,0,0,0,0,0,0,0,0,0,0,0,0,0,0
MEGHALAYA,2001,PROHIBITION ACT,0,0,0,0,0,0,0,0,0,0,0,0,0,0,0
MEGHALAYA,2001,EXPLOSIVE & EXPLOSIVE SUBST. ACT,0,0,0,1,0,1,0,0,0,0,0,0,1,0,1
MEGHALAYA,2001,TERRORIST & DISRUPTIVE ACTIVITIES (TATA),0,0,0,1,0,1,0,0,0,0,0,0,1,0,1
MEGHALAYA,2001,IMMORAL TRAFFIC (PREVENTION) ACT,0,0,0,0,0,0,0,0,0,0,0,0,0,0,0
MEGHALAYA,2001,INDIAN RAILWAYS ACT,0,0,0,0,0,0,0,0,0,0,0,0,0,0,0
MEGHALAYA,2001,REGISTRATION OF FOREIGNERS ACT,0,0,0,0,0,0,0,0,0,0,0,0,0,0,0
MEGHALAYA,2001,PROTECTION OF CIVIL RIGHTS ACT,0,0,0,0,0,0,0,0,0,0,0,0,0,0,0
MEGHALAYA,2001,SC/ST (PREVENTION OF ATROCITIES) ACT,0,0,0,0,0,0,0,0,0,0,0,0,0,0,0
MEGHALAYA,2001,INDIAN PASSPORT ACT,0,0,0,7,0,7,4,0,4,2,0,2,13,0,13
MEGHALAYA,2001,ESSENTIAL COMMODITIES ACT,0,0,0,0,0,0,0,0,0,0,0,0,0,0,0
MEGHALAYA,2001,ANTIQUITIES AND ART TREASURE ACT,0,0,0,0,0,0,0,0,0,0,0,0,0,0,0
MEGHALAYA,2001,DOWRY PROHIBITION ACT,0,0,0,0,0,0,0,0,0,0,0,0,0,0,0
MEGHALAYA,2001,FOREIGN EXCHANGE REGULATION ACT-1973,0,0,0,0,0,0,0,0,0,0,0,0,0,0,0
MEGHALAYA,2001,PREVENTION OF CORRUPTION ACT-1988,0,0,0,0,0,0,0,0,0,0,0,0,0,0,0
MEGHALAYA,2001,CONSER.OF FORGN.EXCH.&PREV. OF SMUG.ACT,0,0,0,0,0,0,0,0,0,0,0,0,0,0,0
MEGHALAYA,2001,OTHER SLL OFFENCE,0,0,0,0,0,0,0,0,0,0,0,0,0,0,0
MEGHALAYA,2001,TOTAL,0,0,0,38,0,38,21,4,25,2,0,2,61,4,65
MEGHALAYA,2002,ARMS ACT,0,0,0,49,0,49,22,0,22,0,0,0,71,0,71
MEGHALAYA,2002,N.D.P.S. ACT,0,0,0,10,0,10,18,5,23,0,0,0,28,5,33
MEGHALAYA,2002,GAMBLING ACT,0,0,0,0,0,0,0,0,0,0,0,0,0,0,0
MEGHALAYA,2002,EXCISE ACT,0,0,0,0,0,0,0,0,0,0,0,0,0,0,0
MEGHALAYA,2002,PROHIBITION ACT,0,0,0,0,0,0,0,0,0,0,0,0,0,0,0
MEGHALAYA,2002,EXPLOSIVE & EXPLOSIVE SUBST. ACT,0,0,0,4,0,4,2,0,2,0,0,0,6,0,6
MEGHALAYA,2002,TERRORIST & DISRUPTIVE ACTIVITIES (TATA),0,0,0,10,0,10,1,0,1,0,0,0,11,0,11
MEGHALAYA,2002,IMMORAL TRAFFIC (PREVENTION) ACT,0,0,0,0,0,0,0,3,3,0,0,0,0,3,3
MEGHALAYA,2002,INDIAN RAILWAYS ACT,0,0,0,0,0,0,0,0,0,0,0,0,0,0,0
MEGHALAYA,2002,REGISTRATION OF FOREIGNERS ACT,0,0,0,0,0,0,0,0,0,0,0,0,0,0,0
MEGHALAYA,2002,PROTECTION OF CIVIL RIGHTS ACT,0,0,0,0,0,0,0,0,0,0,0,0,0,0,0
MEGHALAYA,2002,SC/ST (PREVENTION OF ATROCITIES) ACT,0,0,0,0,0,0,0,0,0,0,0,0,0,0,0
MEGHALAYA,2002,INDIAN PASSPORT ACT,0,0,0,21,0,21,11,0,11,0,0,0,32,0,32
MEGHALAYA,2002,ESSENTIAL COMMODITIES ACT,0,0,0,0,0,0,0,0,0,0,0,0,0,0,0
MEGHALAYA,2002,ANTIQUITIES AND ART TREASURE ACT,0,0,0,0,0,0,0,0,0,0,0,0,0,0,0
MEGHALAYA,2002,DOWRY PROHIBITION ACT,0,0,0,0,0,0,0,0,0,0,0,0,0,0,0
MEGHALAYA,2002,FOREIGN EXCHANGE REGULATION ACT-1973,0,0,0,0,0,0,0,0,0,0,0,0,0,0,0
MEGHALAYA,2002,PREVENTION OF CORRUPTION ACT-1988,0,0,0,0,0,0,0,0,0,0,0,0,0,0,0
MEGHALAYA,2002,CONSER.OF FORGN.EXCH.&PREV. OF SMUG.ACT,0,0,0,0,0,0,0,0,0,0,0,0,0,0,0
MEGHALAYA,2002,OTHER SLL OFFENCE,0,0,0,0,0,0,0,0,0,18,0,18,18,0,18
MEGHALAYA,2002,TOTAL,0,0,0,94,0,94,54,8,62,18,0,18,166,8,174
MEGHALAYA,2003,ARMS ACT,0,0,0,12,0,12,18,0,18,0,0,0,30,0,30
MEGHALAYA,2003,N.D.P.S. ACT,0,0,0,7,1,8,9,0,9,1,0,1,17,1,18
MEGHALAYA,2003,GAMBLING ACT,0,0,0,0,0,0,0,0,0,0,0,0,0,0,0
MEGHALAYA,2003,EXCISE ACT,0,0,0,0,0,0,1,0,1,0,0,0,1,0,1
MEGHALAYA,2003,PROHIBITION ACT,0,0,0,0,0,0,0,0,0,0,0,0,0,0,0
MEGHALAYA,2003,EXPLOSIVE & EXPLOSIVE SUBST. ACT,0,0,0,0,0,0,1,0,1,0,0,0,1,0,1
MEGHALAYA,2003,TERRORIST & DISRUPTIVE ACTIVITIES (TATA),0,0,0,7,0,7,0,0,0,0,0,0,7,0,7
MEGHALAYA,2003,IMMORAL TRAFFIC (PREVENTION) ACT,0,0,0,0,4,4,0,0,0,0,0,0,0,4,4
MEGHALAYA,2003,INDIAN RAILWAYS ACT,0,0,0,0,0,0,0,0,0,0,0,0,0,0,0
MEGHALAYA,2003,REGISTRATION OF FOREIGNERS ACT,0,0,0,0,0,0,0,0,0,0,0,0,0,0,0
MEGHALAYA,2003,PROTECTION OF CIVIL RIGHTS ACT,0,0,0,0,0,0,0,0,0,0,0,0,0,0,0
MEGHALAYA,2003,SC/ST (PREVENTION OF ATROCITIES) ACT,0,0,0,0,0,0,0,0,0,0,0,0,0,0,0
MEGHALAYA,2003,INDIAN PASSPORT ACT,0,0,0,4,0,4,3,0,3,0,0,0,7,0,7
MEGHALAYA,2003,ESSENTIAL COMMODITIES ACT,0,0,0,0,0,0,0,0,0,0,0,0,0,0,0
MEGHALAYA,2003,ANTIQUITIES AND ART TREASURE ACT,0,0,0,0,0,0,0,0,0,0,0,0,0,0,0
MEGHALAYA,2003,DOWRY PROHIBITION ACT,0,0,0,0,0,0,0,0,0,0,0,0,0,0,0
MEGHALAYA,2003,FOREIGN EXCHANGE REGULATION ACT-1973,0,0,0,0,0,0,0,0,0,0,0,0,0,0,0
MEGHALAYA,2003,PREVENTION OF CORRUPTION ACT-1988,0,0,0,0,0,0,0,0,0,0,0,0,0,0,0
MEGHALAYA,2003,CONSER.OF FORGN.EXCH.&PREV. OF SMUG.ACT,0,0,0,0,0,0,0,0,0,0,0,0,0,0,0
MEGHALAYA,2003,OTHER SLL OFFENCE,0,0,0,8,0,8,14,1,15,0,0,0,22,1,23
MEGHALAYA,2003,TOTAL,0,0,0,38,5,43,46,1,47,1,0,1,85,6,91
MEGHALAYA,2004,ARMS ACT,0,0,0,0,0,0,25,0,25,8,0,8,33,0,33
MEGHALAYA,2004,N.D.P.S. ACT,0,0,0,2,2,4,8,7,15,0,0,0,10,9,19
MEGHALAYA,2004,GAMBLING ACT,0,0,0,0,0,0,0,0,0,0,0,0,0,0,0
MEGHALAYA,2004,EXCISE ACT,0,0,0,0,0,0,0,0,0,0,0,0,0,0,0
MEGHALAYA,2004,PROHIBITION ACT,0,0,0,0,0,0,0,0,0,0,0,0,0,0,0
MEGHALAYA,2004,EXPLOSIVE & EXPLOSIVE SUBST. ACT,0,0,0,6,0,6,5,0,5,0,0,0,11,0,11
MEGHALAYA,2004,TERRORIST & DISRUPTIVE ACTIVITIES (TATA),0,0,0,0,0,0,0,0,0,0,0,0,0,0,0
MEGHALAYA,2004,IMMORAL TRAFFIC (PREVENTION) ACT,0,0,0,0,0,0,0,0,0,0,0,0,0,0,0
MEGHALAYA,2004,INDIAN RAILWAYS ACT,0,0,0,0,0,0,0,0,0,0,0,0,0,0,0
MEGHALAYA,2004,REGISTRATION OF FOREIGNERS ACT,0,0,0,0,0,0,0,0,0,0,0,0,0,0,0
MEGHALAYA,2004,PROTECTION OF CIVIL RIGHTS ACT,0,0,0,0,0,0,0,0,0,0,0,0,0,0,0
MEGHALAYA,2004,SC/ST (PREVENTION OF ATROCITIES) ACT,0,0,0,0,0,0,0,0,0,0,0,0,0,0,0
MEGHALAYA,2004,INDIAN PASSPORT ACT,0,0,0,6,0,6,9,0,9,4,0,4,19,0,19
MEGHALAYA,2004,ESSENTIAL COMMODITIES ACT,0,0,0,0,0,0,0,0,0,0,0,0,0,0,0
MEGHALAYA,2004,ANTIQUITIES AND ART TREASURE ACT,0,0,0,0,0,0,0,0,0,0,0,0,0,0,0
MEGHALAYA,2004,DOWRY PROHIBITION ACT,0,0,0,0,0,0,0,0,0,0,0,0,0,0,0
MEGHALAYA,2004,FOREIGN EXCHANGE REGULATION ACT-1973,0,0,0,0,0,0,0,0,0,0,0,0,0,0,0
MEGHALAYA,2004,PREVENTION OF CORRUPTION ACT-1988,0,0,0,0,0,0,0,0,0,0,0,0,0,0,0
MEGHALAYA,2004,CONSER.OF FORGN.EXCH.&PREV. OF SMUG.ACT,0,0,0,0,0,0,0,0,0,0,0,0,0,0,0
MEGHALAYA,2004,OTHER SLL OFFENCE,0,0,0,0,0,0,0,0,0,0,0,0,0,0,0
MEGHALAYA,2004,TOTAL,0,0,0,14,2,16,47,7,54,12,0,12,73,9,82
MEGHALAYA,2005,ARMS ACT,0,0,0,21,0,21,28,0,28,5,0,5,54,0,54
MEGHALAYA,2005,N.D.P.S. ACT,0,0,0,14,0,14,13,0,13,0,0,0,27,0,27
MEGHALAYA,2005,GAMBLING ACT,0,0,0,7,0,7,1,0,1,4,0,4,12,0,12
MEGHALAYA,2005,EXCISE ACT,0,0,0,0,0,0,0,0,0,0,0,0,0,0,0
MEGHALAYA,2005,PROHIBITION ACT,0,0,0,0,0,0,0,0,0,0,0,0,0,0,0
MEGHALAYA,2005,EXPLOSIVE & EXPLOSIVE SUBST. ACT,0,0,0,0,0,0,0,0,0,0,0,0,0,0,0
MEGHALAYA,2005,TERRORIST & DISRUPTIVE ACTIVITIES (TATA),0,0,0,0,0,0,0,0,0,0,0,0,0,0,0
MEGHALAYA,2005,IMMORAL TRAFFIC (PREVENTION) ACT,0,0,0,0,0,0,0,0,0,0,0,0,0,0,0
MEGHALAYA,2005,INDIAN RAILWAYS ACT,0,0,0,0,0,0,0,0,0,0,0,0,0,0,0
MEGHALAYA,2005,REGISTRATION OF FOREIGNERS ACT,0,0,0,0,0,0,0,0,0,0,0,0,0,0,0
MEGHALAYA,2005,PROTECTION OF CIVIL RIGHTS ACT,0,0,0,0,0,0,0,0,0,0,0,0,0,0,0
MEGHALAYA,2005,SC/ST (PREVENTION OF ATROCITIES) ACT,0,0,0,0,0,0,0,0,0,0,0,0,0,0,0
MEGHALAYA,2005,INDIAN PASSPORT ACT,0,0,0,9,0,9,0,0,0,0,0,0,9,0,9
MEGHALAYA,2005,ESSENTIAL COMMODITIES ACT,0,0,0,0,0,0,0,0,0,0,0,0,0,0,0
MEGHALAYA,2005,ANTIQUITIES AND ART TREASURE ACT,0,0,0,0,0,0,0,0,0,0,0,0,0,0,0
MEGHALAYA,2005,DOWRY PROHIBITION ACT,0,0,0,0,0,0,0,0,0,0,0,0,0,0,0
MEGHALAYA,2005,FOREIGN EXCHANGE REGULATION ACT-1973,0,0,0,0,0,0,0,0,0,0,0,0,0,0,0
MEGHALAYA,2005,PREVENTION OF CORRUPTION ACT-1988,0,0,0,0,0,0,0,0,0,0,0,0,0,0,0
MEGHALAYA,2005,CONSER.OF FORGN.EXCH.&PREV. OF SMUG.ACT,0,0,0,0,0,0,0,0,0,0,0,0,0,0,0
MEGHALAYA,2005,OTHER SLL OFFENCE,0,0,0,9,0,9,0,0,0,0,0,0,9,0,9
MEGHALAYA,2005,TOTAL,0,0,0,60,0,60,42,0,42,9,0,9,111,0,111
MEGHALAYA,2006,ARMS ACT,0,0,0,10,0,10,28,0,28,4,0,4,42,0,42
MEGHALAYA,2006,N.D.P.S. ACT,0,0,0,3,0,3,19,2,21,0,0,0,22,2,24
MEGHALAYA,2006,GAMBLING ACT,0,0,0,0,0,0,0,0,0,0,0,0,0,0,0
MEGHALAYA,2006,EXCISE ACT,0,0,0,0,0,0,8,0,8,0,0,0,8,0,8
MEGHALAYA,2006,PROHIBITION ACT,0,0,0,0,0,0,0,0,0,0,0,0,0,0,0
MEGHALAYA,2006,EXPLOSIVE & EXPLOSIVE SUBST. ACT,0,0,0,0,0,0,16,0,16,0,0,0,16,0,16
MEGHALAYA,2006,TERRORIST & DISRUPTIVE ACTIVITIES (TATA),0,0,0,0,0,0,0,0,0,0,0,0,0,0,0
MEGHALAYA,2006,IMMORAL TRAFFIC (PREVENTION) ACT,0,0,0,2,0,2,4,0,4,0,0,0,6,0,6
MEGHALAYA,2006,INDIAN RAILWAYS ACT,0,0,0,0,0,0,0,0,0,0,0,0,0,0,0
MEGHALAYA,2006,REGISTRATION OF FOREIGNERS ACT,0,0,0,0,0,0,0,0,0,0,0,0,0,0,0
MEGHALAYA,2006,PROTECTION OF CIVIL RIGHTS ACT,0,0,0,0,0,0,0,0,0,0,0,0,0,0,0
MEGHALAYA,2006,SC/ST (PREVENTION OF ATROCITIES) ACT,0,0,0,0,0,0,0,0,0,0,0,0,0,0,0
MEGHALAYA,2006,INDIAN PASSPORT ACT,0,0,0,0,0,0,0,0,0,0,0,0,0,0,0
MEGHALAYA,2006,ESSENTIAL COMMODITIES ACT,0,0,0,0,0,0,0,0,0,0,0,0,0,0,0
MEGHALAYA,2006,ANTIQUITIES AND ART TREASURE ACT,0,0,0,0,0,0,0,0,0,0,0,0,0,0,0
MEGHALAYA,2006,DOWRY PROHIBITION ACT,0,0,0,0,0,0,0,0,0,0,0,0,0,0,0
MEGHALAYA,2006,FOREIGN EXCHANGE REGULATION ACT-1973,0,0,0,0,0,0,0,0,0,0,0,0,0,0,0
MEGHALAYA,2006,PREVENTION OF CORRUPTION ACT-1988,0,0,0,0,0,0,0,0,0,0,0,0,0,0,0
MEGHALAYA,2006,CONSER.OF FORGN.EXCH.&PREV. OF SMUG.ACT,0,0,0,0,0,0,0,0,0,0,0,0,0,0,0
MEGHALAYA,2006,OTHER SLL OFFENCE,0,0,0,0,0,0,10,0,10,0,0,0,10,0,10
MEGHALAYA,2006,TOTAL,0,0,0,15,0,15,85,2,87,4,0,4,104,2,106
MEGHALAYA,2007,ARMS ACT,0,0,0,14,0,14,17,0,17,0,0,0,31,0,31
MEGHALAYA,2007,N.D.P.S. ACT,0,0,0,7,1,8,5,2,7,0,0,0,12,3,15
MEGHALAYA,2007,GAMBLING ACT,0,0,0,0,0,0,0,0,0,0,0,0,0,0,0
MEGHALAYA,2007,EXCISE ACT,0,0,0,0,0,0,0,0,0,0,0,0,0,0,0
MEGHALAYA,2007,PROHIBITION ACT,0,0,0,0,0,0,0,0,0,0,0,0,0,0,0
MEGHALAYA,2007,EXPLOSIVE & EXPLOSIVE SUBST. ACT,0,0,0,8,0,8,5,0,5,0,0,0,13,0,13
MEGHALAYA,2007,TERRORIST & DISRUPTIVE ACTIVITIES (TATA),0,0,0,0,0,0,0,0,0,0,0,0,0,0,0
MEGHALAYA,2007,IMMORAL TRAFFIC (PREVENTION) ACT,0,0,0,0,0,0,0,0,0,0,0,0,0,0,0
MEGHALAYA,2007,INDIAN RAILWAYS ACT,0,0,0,0,0,0,0,0,0,0,0,0,0,0,0
MEGHALAYA,2007,REGISTRATION OF FOREIGNERS ACT,0,0,0,2,0,2,4,0,4,0,0,0,6,0,6
MEGHALAYA,2007,PROTECTION OF CIVIL RIGHTS ACT,0,0,0,0,0,0,0,0,0,0,0,0,0,0,0
MEGHALAYA,2007,SC/ST (PREVENTION OF ATROCITIES) ACT,0,0,0,0,0,0,0,0,0,0,0,0,0,0,0
MEGHALAYA,2007,INDIAN PASSPORT ACT,0,0,0,1,0,1,16,0,16,0,0,0,17,0,17
MEGHALAYA,2007,ESSENTIAL COMMODITIES ACT,0,0,0,0,0,0,0,0,0,0,0,0,0,0,0
MEGHALAYA,2007,ANTIQUITIES AND ART TREASURE ACT,0,0,0,0,0,0,0,0,0,0,0,0,0,0,0
MEGHALAYA,2007,DOWRY PROHIBITION ACT,0,0,0,0,0,0,0,0,0,0,0,0,0,0,0
MEGHALAYA,2007,FOREIGN EXCHANGE REGULATION ACT-1973,0,0,0,0,0,0,0,0,0,0,0,0,0,0,0
MEGHALAYA,2007,PREVENTION OF CORRUPTION ACT-1988,0,0,0,0,0,0,0,0,0,0,0,0,0,0,0
MEGHALAYA,2007,CONSER.OF FORGN.EXCH.&PREV. OF SMUG.ACT,0,0,0,0,0,0,0,0,0,0,0,0,0,0,0
MEGHALAYA,2007,OTHER SLL OFFENCE,0,0,0,4,0,4,10,0,10,0,0,0,14,0,14
MEGHALAYA,2007,TOTAL,0,0,0,36,1,37,57,2,59,0,0,0,93,3,96
MEGHALAYA,2008,ARMS ACT,0,0,0,16,0,16,6,0,6,0,0,0,22,0,22
MEGHALAYA,2008,N.D.P.S. ACT,0,0,0,5,0,5,11,0,11,0,0,0,16,0,16
MEGHALAYA,2008,GAMBLING ACT,0,0,0,0,0,0,0,0,0,0,0,0,0,0,0
MEGHALAYA,2008,EXCISE ACT,0,0,0,0,0,0,2,0,2,0,0,0,2,0,2
MEGHALAYA,2008,PROHIBITION ACT,0,0,0,0,0,0,0,0,0,0,0,0,0,0,0
MEGHALAYA,2008,EXPLOSIVE & EXPLOSIVE SUBST. ACT,0,0,0,10,0,10,3,0,3,0,0,0,13,0,13
MEGHALAYA,2008,TERRORIST & DISRUPTIVE ACTIVITIES (TATA),0,0,0,0,0,0,0,0,0,0,0,0,0,0,0
MEGHALAYA,2008,IMMORAL TRAFFIC (PREVENTION) ACT,0,0,0,0,0,0,0,1,1,0,0,0,0,1,1
MEGHALAYA,2008,INDIAN RAILWAYS ACT,0,0,0,0,0,0,0,0,0,0,0,0,0,0,0
MEGHALAYA,2008,REGISTRATION OF FOREIGNERS ACT,0,0,0,7,0,7,1,0,1,0,0,0,8,0,8
MEGHALAYA,2008,PROTECTION OF CIVIL RIGHTS ACT,0,0,0,0,0,0,0,0,0,0,0,0,0,0,0
MEGHALAYA,2008,SC/ST (PREVENTION OF ATROCITIES) ACT,0,0,0,0,0,0,0,0,0,0,0,0,0,0,0
MEGHALAYA,2008,INDIAN PASSPORT ACT,0,0,0,4,0,4,2,0,2,0,0,0,6,0,6
MEGHALAYA,2008,ESSENTIAL COMMODITIES ACT,0,0,0,0,0,0,0,0,0,0,0,0,0,0,0
MEGHALAYA,2008,ANTIQUITIES AND ART TREASURE ACT,0,0,0,0,0,0,0,0,0,0,0,0,0,0,0
MEGHALAYA,2008,DOWRY PROHIBITION ACT,0,0,0,0,0,0,0,0,0,0,0,0,0,0,0
MEGHALAYA,2008,FOREIGN EXCHANGE REGULATION ACT-1973,0,0,0,0,0,0,0,0,0,0,0,0,0,0,0
MEGHALAYA,2008,PREVENTION OF CORRUPTION ACT-1988,0,0,0,0,0,0,0,0,0,0,0,0,0,0,0
MEGHALAYA,2008,CONSER.OF FORGN.EXCH.&PREV. OF SMUG.ACT,0,0,0,0,0,0,0,0,0,0,0,0,0,0,0
MEGHALAYA,2008,OTHER SLL OFFENCE,0,0,0,0,0,0,0,0,0,0,0,0,0,0,0
MEGHALAYA,2008,TOTAL,0,0,0,42,0,42,25,1,26,0,0,0,67,1,68
MEGHALAYA,2009,ARMS ACT,0,0,0,16,0,16,6,0,6,2,0,2,24,0,24
MEGHALAYA,2009,N.D.P.S. ACT,0,0,0,5,0,5,5,0,5,0,0,0,10,0,10
MEGHALAYA,2009,GAMBLING ACT,0,0,0,0,0,0,0,0,0,0,0,0,0,0,0
MEGHALAYA,2009,EXCISE ACT,0,0,0,0,0,0,0,0,0,0,0,0,0,0,0
MEGHALAYA,2009,PROHIBITION ACT,0,0,0,0,0,0,0,0,0,0,0,0,0,0,0
MEGHALAYA,2009,EXPLOSIVE & EXPLOSIVE SUBST. ACT,0,0,0,2,0,2,5,0,5,0,0,0,7,0,7
MEGHALAYA,2009,TERRORIST & DISRUPTIVE ACTIVITIES (TATA),0,0,0,0,0,0,0,0,0,0,0,0,0,0,0
MEGHALAYA,2009,IMMORAL TRAFFIC (PREVENTION) ACT,0,0,0,0,0,0,0,0,0,0,0,0,0,0,0
MEGHALAYA,2009,INDIAN RAILWAYS ACT,0,0,0,0,0,0,0,0,0,0,0,0,0,0,0
MEGHALAYA,2009,REGISTRATION OF FOREIGNERS ACT,0,0,0,0,0,0,0,0,0,0,0,0,0,0,0
MEGHALAYA,2009,PROTECTION OF CIVIL RIGHTS ACT,0,0,0,0,0,0,0,0,0,0,0,0,0,0,0
MEGHALAYA,2009,SC/ST (PREVENTION OF ATROCITIES) ACT,0,0,0,0,0,0,0,0,0,0,0,0,0,0,0
MEGHALAYA,2009,INDIAN PASSPORT ACT,0,0,0,1,0,1,0,0,0,0,0,0,1,0,1
MEGHALAYA,2009,ESSENTIAL COMMODITIES ACT,0,0,0,0,0,0,0,0,0,0,0,0,0,0,0
MEGHALAYA,2009,ANTIQUITIES AND ART TREASURE ACT,0,0,0,0,0,0,0,0,0,0,0,0,0,0,0
MEGHALAYA,2009,DOWRY PROHIBITION ACT,0,0,0,0,0,0,0,0,0,0,0,0,0,0,0
MEGHALAYA,2009,FOREIGN EXCHANGE REGULATION ACT-1973,0,0,0,0,0,0,0,0,0,0,0,0,0,0,0
MEGHALAYA,2009,PREVENTION OF CORRUPTION ACT-1988,0,0,0,0,0,0,0,0,0,0,0,0,0,0,0
MEGHALAYA,2009,CONSER.OF FORGN.EXCH.&PREV. OF SMUG.ACT,0,0,0,0,0,0,0,0,0,0,0,0,0,0,0
MEGHALAYA,2009,OTHER SLL OFFENCE,0,0,0,0,0,0,0,0,0,0,0,0,0,0,0
MEGHALAYA,2009,TOTAL,0,0,0,24,0,24,16,0,16,2,0,2,42,0,42
MEGHALAYA,2010,ARMS ACT,0,0,0,20,0,20,3,0,3,0,0,0,23,0,23
MEGHALAYA,2010,N.D.P.S. ACT,0,0,0,4,0,4,5,0,5,0,0,0,9,0,9
MEGHALAYA,2010,GAMBLING ACT,0,0,0,0,0,0,0,0,0,0,0,0,0,0,0
MEGHALAYA,2010,EXCISE ACT,0,0,0,0,0,0,0,0,0,0,0,0,0,0,0
MEGHALAYA,2010,PROHIBITION ACT,0,0,0,0,0,0,0,0,0,0,0,0,0,0,0
MEGHALAYA,2010,EXPLOSIVE & EXPLOSIVE SUBST. ACT,0,0,0,0,0,0,0,0,0,0,0,0,0,0,0
MEGHALAYA,2010,TERRORIST & DISRUPTIVE ACTIVITIES (TATA),0,0,0,0,0,0,0,0,0,0,0,0,0,0,0
MEGHALAYA,2010,IMMORAL TRAFFIC (PREVENTION) ACT,0,0,0,6,0,6,3,0,3,0,0,0,9,0,9
MEGHALAYA,2010,INDIAN RAILWAYS ACT,0,0,0,0,0,0,0,0,0,0,0,0,0,0,0
MEGHALAYA,2010,REGISTRATION OF FOREIGNERS ACT,0,0,0,2,0,2,0,0,0,0,0,0,2,0,2
MEGHALAYA,2010,PROTECTION OF CIVIL RIGHTS ACT,0,0,0,0,0,0,0,0,0,0,0,0,0,0,0
MEGHALAYA,2010,SC/ST (PREVENTION OF ATROCITIES) ACT,0,0,0,0,0,0,0,0,0,0,0,0,0,0,0
MEGHALAYA,2010,INDIAN PASSPORT ACT,0,0,0,1,0,1,0,0,0,0,0,0,1,0,1
MEGHALAYA,2010,ESSENTIAL COMMODITIES ACT,0,0,0,0,0,0,0,0,0,0,0,0,0,0,0
MEGHALAYA,2010,ANTIQUITIES AND ART TREASURE ACT,0,0,0,0,0,0,0,0,0,0,0,0,0,0,0
MEGHALAYA,2010,DOWRY PROHIBITION ACT,0,0,0,0,0,0,0,0,0,0,0,0,0,0,0
MEGHALAYA,2010,FOREIGN EXCHANGE REGULATION ACT-1973,0,0,0,0,0,0,0,0,0,0,0,0,0,0,0
MEGHALAYA,2010,PREVENTION OF CORRUPTION ACT-1988,0,0,0,0,0,0,0,0,0,0,0,0,0,0,0
MEGHALAYA,2010,CONSER.OF FORGN.EXCH.&PREV. OF SMUG.ACT,0,0,0,0,0,0,0,0,0,0,0,0,0,0,0
MEGHALAYA,2010,OTHER SLL OFFENCE,0,0,0,0,0,0,0,0,0,0,0,0,0,0,0
MEGHALAYA,2010,TOTAL,0,0,0,33,0,33,11,0,11,0,0,0,44,0,44
MEGHALAYA,2011,ARMS ACT,0,0,0,20,0,20,1,0,1,0,0,0,21,0,21
MEGHALAYA,2011,N.D.P.S. ACT,0,0,0,3,2,5,3,0,3,0,0,0,6,2,8
MEGHALAYA,2011,GAMBLING ACT,0,0,0,0,0,0,0,0,0,0,0,0,0,0,0
MEGHALAYA,2011,EXCISE ACT,0,0,0,0,0,0,0,0,0,0,0,0,0,0,0
MEGHALAYA,2011,PROHIBITION ACT,0,0,0,0,0,0,0,0,0,0,0,0,0,0,0
MEGHALAYA,2011,EXPLOSIVE & EXPLOSIVE SUBST. ACT,0,0,0,0,0,0,0,0,0,0,0,0,0,0,0
MEGHALAYA,2011,TERRORIST & DISRUPTIVE ACTIVITIES (TATA),0,0,0,0,0,0,0,0,0,0,0,0,0,0,0
MEGHALAYA,2011,IMMORAL TRAFFIC (PREVENTION) ACT,0,0,0,0,4,4,0,0,0,0,0,0,0,4,4
MEGHALAYA,2011,INDIAN RAILWAYS ACT,0,0,0,0,0,0,0,0,0,0,0,0,0,0,0
MEGHALAYA,2011,REGISTRATION OF FOREIGNERS ACT,0,0,0,0,0,0,0,0,0,0,0,0,0,0,0
MEGHALAYA,2011,PROTECTION OF CIVIL RIGHTS ACT,0,0,0,0,0,0,0,0,0,0,0,0,0,0,0
MEGHALAYA,2011,SC/ST (PREVENTION OF ATROCITIES) ACT,0,0,0,0,0,0,0,0,0,0,0,0,0,0,0
MEGHALAYA,2011,INDIAN PASSPORT ACT,0,0,0,15,0,15,4,0,4,0,0,0,19,0,19
MEGHALAYA,2011,ESSENTIAL COMMODITIES ACT,0,0,0,0,0,0,0,0,0,0,0,0,0,0,0
MEGHALAYA,2011,ANTIQUITIES AND ART TREASURE ACT,0,0,0,0,0,0,0,0,0,0,0,0,0,0,0
MEGHALAYA,2011,DOWRY PROHIBITION ACT,0,0,0,0,0,0,0,0,0,0,0,0,0,0,0
MEGHALAYA,2011,FOREIGN EXCHANGE REGULATION ACT-1973,0,0,0,0,0,0,0,0,0,0,0,0,0,0,0
MEGHALAYA,2011,PREVENTION OF CORRUPTION ACT-1988,0,0,0,0,0,0,0,0,0,0,0,0,0,0,0
MEGHALAYA,2011,CONSER.OF FORGN.EXCH.&PREV. OF SMUG.ACT,0,0,0,0,0,0,0,0,0,0,0,0,0,0,0
MEGHALAYA,2011,OTHER SLL OFFENCE,0,0,0,0,0,0,0,0,0,0,0,0,0,0,0
MEGHALAYA,2011,TOTAL,0,0,0,38,6,44,8,0,8,0,0,0,46,6,52
MEGHALAYA,2012,ARMS ACT,0,0,0,27,0,27,5,0,5,2,0,2,34,0,34
MEGHALAYA,2012,N.D.P.S. ACT,0,0,0,10,2,12,2,0,2,0,0,0,12,2,14
MEGHALAYA,2012,GAMBLING ACT,0,0,0,0,0,0,0,0,0,0,0,0,0,0,0
MEGHALAYA,2012,EXCISE ACT,0,0,0,0,0,0,0,0,0,0,0,0,0,0,0
MEGHALAYA,2012,PROHIBITION ACT,0,0,0,0,0,0,0,0,0,0,0,0,0,0,0
MEGHALAYA,2012,EXPLOSIVE & EXPLOSIVE SUBST. ACT,0,0,0,20,0,20,5,0,5,1,0,1,26,0,26
MEGHALAYA,2012,TERRORIST & DISRUPTIVE ACTIVITIES (TATA),0,0,0,0,0,0,0,0,0,0,0,0,0,0,0
MEGHALAYA,2012,IMMORAL TRAFFIC (PREVENTION) ACT,0,0,0,0,2,2,0,0,0,0,0,0,0,2,2
MEGHALAYA,2012,INDIAN RAILWAYS ACT,0,0,0,0,0,0,0,0,0,0,0,0,0,0,0
MEGHALAYA,2012,REGISTRATION OF FOREIGNERS ACT,0,0,0,0,0,0,0,0,0,0,0,0,0,0,0
MEGHALAYA,2012,PROTECTION OF CIVIL RIGHTS ACT,0,0,0,0,0,0,0,0,0,0,0,0,0,0,0
MEGHALAYA,2012,SC/ST (PREVENTION OF ATROCITIES) ACT,0,0,0,0,0,0,0,0,0,0,0,0,0,0,0
MEGHALAYA,2012,INDIAN PASSPORT ACT,0,0,0,24,0,24,9,1,10,1,0,1,34,1,35
MEGHALAYA,2012,ESSENTIAL COMMODITIES ACT,0,0,0,0,0,0,0,0,0,0,0,0,0,0,0
MEGHALAYA,2012,ANTIQUITIES AND ART TREASURE ACT,0,0,0,0,0,0,0,0,0,0,0,0,0,0,0
MEGHALAYA,2012,DOWRY PROHIBITION ACT,0,0,0,0,0,0,0,0,0,0,0,0,0,0,0
MEGHALAYA,2012,FOREIGN EXCHANGE REGULATION ACT-1973,0,0,0,0,0,0,0,0,0,0,0,0,0,0,0
MEGHALAYA,2012,PREVENTION OF CORRUPTION ACT-1988,0,0,0,0,0,0,0,0,0,0,0,0,0,0,0
MEGHALAYA,2012,CONSER.OF FORGN.EXCH.&PREV. OF SMUG.ACT,0,0,0,0,0,0,0,0,0,0,0,0,0,0,0
MEGHALAYA,2012,OTHER SLL OFFENCE,0,0,0,6,0,6,0,0,0,0,0,0,6,0,6
MEGHALAYA,2012,TOTAL,0,0,0,87,4,91,21,1,22,4,0,4,112,5,117
MIZORAM,2001,ARMS ACT,0,0,0,3,0,3,2,0,2,0,0,0,5,0,5
MIZORAM,2001,N.D.P.S. ACT,7,0,7,21,1,22,4,1,5,0,0,0,32,2,34
MIZORAM,2001,GAMBLING ACT,0,0,0,0,0,0,0,0,0,0,0,0,0,0,0
MIZORAM,2001,EXCISE ACT,0,0,0,0,0,0,0,0,0,0,0,0,0,0,0
MIZORAM,2001,PROHIBITION ACT,13,0,13,87,26,113,68,7,75,0,0,0,168,33,201
MIZORAM,2001,EXPLOSIVE & EXPLOSIVE SUBST. ACT,0,0,0,0,0,0,0,0,0,0,0,0,0,0,0
MIZORAM,2001,TERRORIST & DISRUPTIVE ACTIVITIES (TATA),0,0,0,0,0,0,0,0,0,0,0,0,0,0,0
MIZORAM,2001,IMMORAL TRAFFIC (PREVENTION) ACT,0,0,0,0,0,0,0,0,0,0,0,0,0,0,0
MIZORAM,2001,INDIAN RAILWAYS ACT,0,0,0,0,0,0,0,0,0,0,0,0,0,0,0
MIZORAM,2001,REGISTRATION OF FOREIGNERS ACT,0,0,0,0,0,0,0,0,0,0,0,0,0,0,0
MIZORAM,2001,PROTECTION OF CIVIL RIGHTS ACT,0,0,0,0,0,0,0,0,0,0,0,0,0,0,0
MIZORAM,2001,SC/ST (PREVENTION OF ATROCITIES) ACT,0,0,0,0,0,0,0,0,0,0,0,0,0,0,0
MIZORAM,2001,INDIAN PASSPORT ACT,0,0,0,0,0,0,0,0,0,0,0,0,0,0,0
MIZORAM,2001,ESSENTIAL COMMODITIES ACT,0,0,0,0,0,0,0,0,0,0,0,0,0,0,0
MIZORAM,2001,ANTIQUITIES AND ART TREASURE ACT,0,0,0,0,0,0,0,0,0,0,0,0,0,0,0
MIZORAM,2001,DOWRY PROHIBITION ACT,0,0,0,0,0,0,0,0,0,0,0,0,0,0,0
MIZORAM,2001,FOREIGN EXCHANGE REGULATION ACT-1973,0,0,0,0,0,0,0,0,0,0,0,0,0,0,0
MIZORAM,2001,PREVENTION OF CORRUPTION ACT-1988,0,0,0,0,0,0,0,0,0,0,0,0,0,0,0
MIZORAM,2001,CONSER.OF FORGN.EXCH.&PREV. OF SMUG.ACT,0,0,0,0,0,0,0,0,0,0,0,0,0,0,0
MIZORAM,2001,OTHER SLL OFFENCE,14,0,14,101,3,104,57,1,58,0,0,0,172,4,176
MIZORAM,2001,TOTAL,34,0,34,212,30,242,131,9,140,0,0,0,377,39,416
MIZORAM,2002,ARMS ACT,0,0,0,2,0,2,0,0,0,0,0,0,2,0,2
MIZORAM,2002,N.D.P.S. ACT,0,0,0,5,5,10,10,5,15,5,0,5,20,10,30
MIZORAM,2002,GAMBLING ACT,0,0,0,0,0,0,0,0,0,0,0,0,0,0,0
MIZORAM,2002,EXCISE ACT,8,0,8,30,5,35,17,7,24,5,5,10,60,17,77
MIZORAM,2002,PROHIBITION ACT,0,0,0,40,0,40,50,5,55,0,0,0,90,5,95
MIZORAM,2002,EXPLOSIVE & EXPLOSIVE SUBST. ACT,0,0,0,0,0,0,0,0,0,0,0,0,0,0,0
MIZORAM,2002,TERRORIST & DISRUPTIVE ACTIVITIES (TATA),0,0,0,0,0,0,0,0,0,0,0,0,0,0,0
MIZORAM,2002,IMMORAL TRAFFIC (PREVENTION) ACT,0,0,0,0,0,0,0,0,0,0,0,0,0,0,0
MIZORAM,2002,INDIAN RAILWAYS ACT,0,0,0,0,0,0,0,0,0,0,0,0,0,0,0
MIZORAM,2002,REGISTRATION OF FOREIGNERS ACT,0,0,0,0,0,0,0,0,0,0,0,0,0,0,0
MIZORAM,2002,PROTECTION OF CIVIL RIGHTS ACT,0,0,0,0,0,0,0,0,0,0,0,0,0,0,0
MIZORAM,2002,SC/ST (PREVENTION OF ATROCITIES) ACT,0,0,0,0,0,0,0,0,0,0,0,0,0,0,0
MIZORAM,2002,INDIAN PASSPORT ACT,0,0,0,0,0,0,0,0,0,0,0,0,0,0,0
MIZORAM,2002,ESSENTIAL COMMODITIES ACT,0,0,0,0,0,0,0,0,0,0,0,0,0,0,0
MIZORAM,2002,ANTIQUITIES AND ART TREASURE ACT,0,0,0,0,0,0,0,0,0,0,0,0,0,0,0
MIZORAM,2002,DOWRY PROHIBITION ACT,0,0,0,0,0,0,0,0,0,0,0,0,0,0,0
MIZORAM,2002,FOREIGN EXCHANGE REGULATION ACT-1973,0,0,0,0,0,0,0,0,0,0,0,0,0,0,0
MIZORAM,2002,PREVENTION OF CORRUPTION ACT-1988,0,0,0,0,0,0,0,0,0,0,0,0,0,0,0
MIZORAM,2002,CONSER.OF FORGN.EXCH.&PREV. OF SMUG.ACT,0,0,0,0,0,0,0,0,0,0,0,0,0,0,0
MIZORAM,2002,OTHER SLL OFFENCE,0,0,0,0,0,0,0,0,0,0,0,0,0,0,0
MIZORAM,2002,TOTAL,8,0,8,77,10,87,77,17,94,10,5,15,172,32,204
MIZORAM,2003,ARMS ACT,0,0,0,3,0,3,0,0,0,0,0,0,3,0,3
MIZORAM,2003,N.D.P.S. ACT,7,0,7,15,2,17,10,0,10,0,0,0,32,2,34
MIZORAM,2003,GAMBLING ACT,0,0,0,0,0,0,0,0,0,0,0,0,0,0,0
MIZORAM,2003,EXCISE ACT,0,0,0,20,0,20,0,0,0,0,0,0,20,0,20
MIZORAM,2003,PROHIBITION ACT,20,0,20,79,20,99,32,10,42,4,0,4,135,30,165
MIZORAM,2003,EXPLOSIVE & EXPLOSIVE SUBST. ACT,0,0,0,0,0,0,0,0,0,0,0,0,0,0,0
MIZORAM,2003,TERRORIST & DISRUPTIVE ACTIVITIES (TATA),0,0,0,0,0,0,0,0,0,0,0,0,0,0,0
MIZORAM,2003,IMMORAL TRAFFIC (PREVENTION) ACT,0,0,0,0,0,0,0,0,0,0,0,0,0,0,0
MIZORAM,2003,INDIAN RAILWAYS ACT,0,0,0,0,0,0,0,0,0,0,0,0,0,0,0
MIZORAM,2003,REGISTRATION OF FOREIGNERS ACT,0,0,0,0,0,0,0,0,0,0,0,0,0,0,0
MIZORAM,2003,PROTECTION OF CIVIL RIGHTS ACT,0,0,0,0,0,0,0,0,0,0,0,0,0,0,0
MIZORAM,2003,SC/ST (PREVENTION OF ATROCITIES) ACT,0,0,0,0,0,0,0,0,0,0,0,0,0,0,0
MIZORAM,2003,INDIAN PASSPORT ACT,0,0,0,0,0,0,0,0,0,0,0,0,0,0,0
MIZORAM,2003,ESSENTIAL COMMODITIES ACT,0,0,0,0,0,0,0,0,0,0,0,0,0,0,0
MIZORAM,2003,ANTIQUITIES AND ART TREASURE ACT,0,0,0,0,0,0,0,0,0,0,0,0,0,0,0
MIZORAM,2003,DOWRY PROHIBITION ACT,0,0,0,0,0,0,0,0,0,0,0,0,0,0,0
MIZORAM,2003,FOREIGN EXCHANGE REGULATION ACT-1973,0,0,0,0,0,0,0,0,0,0,0,0,0,0,0
MIZORAM,2003,PREVENTION OF CORRUPTION ACT-1988,0,0,0,0,0,0,0,0,0,0,0,0,0,0,0
MIZORAM,2003,CONSER.OF FORGN.EXCH.&PREV. OF SMUG.ACT,0,0,0,0,0,0,0,0,0,0,0,0,0,0,0
MIZORAM,2003,OTHER SLL OFFENCE,7,0,7,20,5,25,18,9,27,0,0,0,45,14,59
MIZORAM,2003,TOTAL,34,0,34,137,27,164,60,19,79,4,0,4,235,46,281
MIZORAM,2004,ARMS ACT,0,0,0,3,0,3,3,0,3,0,0,0,6,0,6
MIZORAM,2004,N.D.P.S. ACT,0,0,0,91,18,109,14,12,26,0,0,0,105,30,135
MIZORAM,2004,GAMBLING ACT,0,0,0,0,0,0,0,0,0,0,0,0,0,0,0
MIZORAM,2004,EXCISE ACT,0,0,0,0,0,0,0,0,0,0,0,0,0,0,0
MIZORAM,2004,PROHIBITION ACT,0,0,0,45,13,58,48,11,59,0,0,0,93,24,117
MIZORAM,2004,EXPLOSIVE & EXPLOSIVE SUBST. ACT,0,0,0,0,0,0,0,0,0,0,0,0,0,0,0
MIZORAM,2004,TERRORIST & DISRUPTIVE ACTIVITIES (TATA),0,0,0,0,0,0,0,0,0,0,0,0,0,0,0
MIZORAM,2004,IMMORAL TRAFFIC (PREVENTION) ACT,0,0,0,0,0,0,0,0,0,0,0,0,0,0,0
MIZORAM,2004,INDIAN RAILWAYS ACT,0,0,0,0,0,0,0,0,0,0,0,0,0,0,0
MIZORAM,2004,REGISTRATION OF FOREIGNERS ACT,0,0,0,0,0,0,0,0,0,0,0,0,0,0,0
MIZORAM,2004,PROTECTION OF CIVIL RIGHTS ACT,0,0,0,0,0,0,0,0,0,0,0,0,0,0,0
MIZORAM,2004,SC/ST (PREVENTION OF ATROCITIES) ACT,0,0,0,0,0,0,0,0,0,0,0,0,0,0,0
MIZORAM,2004,INDIAN PASSPORT ACT,0,0,0,0,0,0,0,0,0,0,0,0,0,0,0
MIZORAM,2004,ESSENTIAL COMMODITIES ACT,0,0,0,0,0,0,0,0,0,0,0,0,0,0,0
MIZORAM,2004,ANTIQUITIES AND ART TREASURE ACT,0,0,0,0,0,0,0,0,0,0,0,0,0,0,0
MIZORAM,2004,DOWRY PROHIBITION ACT,0,0,0,0,0,0,0,0,0,0,0,0,0,0,0
MIZORAM,2004,FOREIGN EXCHANGE REGULATION ACT-1973,0,0,0,0,0,0,0,0,0,0,0,0,0,0,0
MIZORAM,2004,PREVENTION OF CORRUPTION ACT-1988,0,0,0,0,0,0,0,0,0,0,0,0,0,0,0
MIZORAM,2004,CONSER.OF FORGN.EXCH.&PREV. OF SMUG.ACT,0,0,0,0,0,0,0,0,0,0,0,0,0,0,0
MIZORAM,2004,OTHER SLL OFFENCE,0,7,7,10,0,10,18,12,30,5,0,5,33,19,52
MIZORAM,2004,TOTAL,0,7,7,149,31,180,83,35,118,5,0,5,237,73,310
MIZORAM,2005,ARMS ACT,0,0,0,4,0,4,4,0,4,0,0,0,8,0,8
MIZORAM,2005,N.D.P.S. ACT,0,0,0,80,15,95,8,0,8,0,0,0,88,15,103
MIZORAM,2005,GAMBLING ACT,0,0,0,0,0,0,0,0,0,0,0,0,0,0,0
MIZORAM,2005,EXCISE ACT,0,0,0,20,8,28,8,0,8,0,0,0,28,8,36
MIZORAM,2005,PROHIBITION ACT,0,0,0,40,7,47,101,22,123,0,0,0,141,29,170
MIZORAM,2005,EXPLOSIVE & EXPLOSIVE SUBST. ACT,0,0,0,0,0,0,0,0,0,0,0,0,0,0,0
MIZORAM,2005,TERRORIST & DISRUPTIVE ACTIVITIES (TATA),0,0,0,0,0,0,0,0,0,0,0,0,0,0,0
MIZORAM,2005,IMMORAL TRAFFIC (PREVENTION) ACT,0,0,0,0,0,0,0,0,0,0,0,0,0,0,0
MIZORAM,2005,INDIAN RAILWAYS ACT,0,0,0,0,0,0,0,0,0,0,0,0,0,0,0
MIZORAM,2005,REGISTRATION OF FOREIGNERS ACT,0,0,0,0,0,0,0,0,0,0,0,0,0,0,0
MIZORAM,2005,PROTECTION OF CIVIL RIGHTS ACT,0,0,0,0,0,0,0,0,0,0,0,0,0,0,0
MIZORAM,2005,SC/ST (PREVENTION OF ATROCITIES) ACT,0,0,0,0,0,0,0,0,0,0,0,0,0,0,0
MIZORAM,2005,INDIAN PASSPORT ACT,0,0,0,0,0,0,0,0,0,0,0,0,0,0,0
MIZORAM,2005,ESSENTIAL COMMODITIES ACT,0,0,0,0,0,0,0,0,0,0,0,0,0,0,0
MIZORAM,2005,ANTIQUITIES AND ART TREASURE ACT,0,0,0,0,0,0,0,0,0,0,0,0,0,0,0
MIZORAM,2005,DOWRY PROHIBITION ACT,0,0,0,0,0,0,0,0,0,0,0,0,0,0,0
MIZORAM,2005,FOREIGN EXCHANGE REGULATION ACT-1973,0,0,0,0,0,0,0,0,0,0,0,0,0,0,0
MIZORAM,2005,PREVENTION OF CORRUPTION ACT-1988,0,0,0,0,0,0,0,0,0,0,0,0,0,0,0
MIZORAM,2005,CONSER.OF FORGN.EXCH.&PREV. OF SMUG.ACT,0,0,0,0,0,0,0,0,0,0,0,0,0,0,0
MIZORAM,2005,OTHER SLL OFFENCE,0,0,0,4,0,4,12,0,12,0,0,0,16,0,16
MIZORAM,2005,TOTAL,0,0,0,148,30,178,133,22,155,0,0,0,281,52,333
MIZORAM,2006,ARMS ACT,0,0,0,2,0,2,5,0,5,0,0,0,7,0,7
MIZORAM,2006,N.D.P.S. ACT,0,0,0,28,6,34,37,5,42,1,0,1,66,11,77
MIZORAM,2006,GAMBLING ACT,0,0,0,4,2,6,2,0,2,0,0,0,6,2,8
MIZORAM,2006,EXCISE ACT,0,0,0,8,3,11,5,2,7,0,0,0,13,5,18
MIZORAM,2006,PROHIBITION ACT,0,0,0,56,6,62,61,25,86,4,0,4,121,31,152
MIZORAM,2006,EXPLOSIVE & EXPLOSIVE SUBST. ACT,0,0,0,0,0,0,0,0,0,0,0,0,0,0,0
MIZORAM,2006,TERRORIST & DISRUPTIVE ACTIVITIES (TATA),0,0,0,0,0,0,0,0,0,0,0,0,0,0,0
MIZORAM,2006,IMMORAL TRAFFIC (PREVENTION) ACT,0,0,0,0,0,0,0,0,0,0,0,0,0,0,0
MIZORAM,2006,INDIAN RAILWAYS ACT,0,0,0,0,0,0,0,0,0,0,0,0,0,0,0
MIZORAM,2006,REGISTRATION OF FOREIGNERS ACT,0,0,0,0,0,0,0,0,0,0,0,0,0,0,0
MIZORAM,2006,PROTECTION OF CIVIL RIGHTS ACT,0,0,0,0,0,0,0,0,0,0,0,0,0,0,0
MIZORAM,2006,SC/ST (PREVENTION OF ATROCITIES) ACT,0,0,0,0,0,0,0,0,0,0,0,0,0,0,0
MIZORAM,2006,INDIAN PASSPORT ACT,0,0,0,0,0,0,0,0,0,0,0,0,0,0,0
MIZORAM,2006,ESSENTIAL COMMODITIES ACT,0,0,0,2,0,2,6,0,6,0,0,0,8,0,8
MIZORAM,2006,ANTIQUITIES AND ART TREASURE ACT,0,0,0,0,0,0,0,0,0,0,0,0,0,0,0
MIZORAM,2006,DOWRY PROHIBITION ACT,0,0,0,0,0,0,0,0,0,0,0,0,0,0,0
MIZORAM,2006,FOREIGN EXCHANGE REGULATION ACT-1973,0,0,0,0,0,0,0,0,0,0,0,0,0,0,0
MIZORAM,2006,PREVENTION OF CORRUPTION ACT-1988,0,0,0,0,0,0,0,0,0,0,0,0,0,0,0
MIZORAM,2006,CONSER.OF FORGN.EXCH.&PREV. OF SMUG.ACT,0,0,0,0,0,0,0,0,0,0,0,0,0,0,0
MIZORAM,2006,OTHER SLL OFFENCE,0,0,0,2,0,2,4,0,4,0,0,0,6,0,6
MIZORAM,2006,TOTAL,0,0,0,102,17,119,120,32,152,5,0,5,227,49,276
MIZORAM,2007,ARMS ACT,0,0,0,5,0,5,1,0,1,0,0,0,6,0,6
MIZORAM,2007,N.D.P.S. ACT,0,0,0,12,5,17,14,11,25,1,0,1,27,16,43
MIZORAM,2007,GAMBLING ACT,0,0,0,0,0,0,0,0,0,0,0,0,0,0,0
MIZORAM,2007,EXCISE ACT,0,0,0,19,0,19,10,0,10,0,0,0,29,0,29
MIZORAM,2007,PROHIBITION ACT,0,0,0,83,20,103,65,31,96,5,0,5,153,51,204
MIZORAM,2007,EXPLOSIVE & EXPLOSIVE SUBST. ACT,0,0,0,0,0,0,0,0,0,0,0,0,0,0,0
MIZORAM,2007,TERRORIST & DISRUPTIVE ACTIVITIES (TATA),0,0,0,0,0,0,0,0,0,0,0,0,0,0,0
MIZORAM,2007,IMMORAL TRAFFIC (PREVENTION) ACT,0,0,0,0,0,0,0,0,0,0,0,0,0,0,0
MIZORAM,2007,INDIAN RAILWAYS ACT,0,0,0,0,0,0,0,0,0,0,0,0,0,0,0
MIZORAM,2007,REGISTRATION OF FOREIGNERS ACT,0,0,0,0,0,0,0,0,0,0,0,0,0,0,0
MIZORAM,2007,PROTECTION OF CIVIL RIGHTS ACT,0,0,0,0,0,0,0,0,0,0,0,0,0,0,0
MIZORAM,2007,SC/ST (PREVENTION OF ATROCITIES) ACT,0,0,0,0,0,0,0,0,0,0,0,0,0,0,0
MIZORAM,2007,INDIAN PASSPORT ACT,0,0,0,0,0,0,0,0,0,0,0,0,0,0,0
MIZORAM,2007,ESSENTIAL COMMODITIES ACT,0,0,0,0,0,0,0,0,0,0,0,0,0,0,0
MIZORAM,2007,ANTIQUITIES AND ART TREASURE ACT,0,0,0,0,0,0,0,0,0,0,0,0,0,0,0
MIZORAM,2007,DOWRY PROHIBITION ACT,0,0,0,0,0,0,0,0,0,0,0,0,0,0,0
MIZORAM,2007,FOREIGN EXCHANGE REGULATION ACT-1973,0,0,0,0,0,0,0,0,0,0,0,0,0,0,0
MIZORAM,2007,PREVENTION OF CORRUPTION ACT-1988,0,0,0,0,0,0,0,0,0,0,0,0,0,0,0
MIZORAM,2007,CONSER.OF FORGN.EXCH.&PREV. OF SMUG.ACT,0,0,0,0,0,0,0,0,0,0,0,0,0,0,0
MIZORAM,2007,OTHER SLL OFFENCE,0,0,0,5,0,5,4,0,4,0,0,0,9,0,9
MIZORAM,2007,TOTAL,0,0,0,124,25,149,94,42,136,6,0,6,224,67,291
MIZORAM,2008,ARMS ACT,0,0,0,6,0,6,4,0,4,0,0,0,10,0,10
MIZORAM,2008,N.D.P.S. ACT,0,0,0,28,2,30,13,2,15,0,0,0,41,4,45
MIZORAM,2008,GAMBLING ACT,0,0,0,0,0,0,0,0,0,0,0,0,0,0,0
MIZORAM,2008,EXCISE ACT,0,0,0,5,1,6,0,0,0,0,0,0,5,1,6
MIZORAM,2008,PROHIBITION ACT,0,0,0,35,20,55,41,10,51,17,3,20,93,33,126
MIZORAM,2008,EXPLOSIVE & EXPLOSIVE SUBST. ACT,0,0,0,0,0,0,0,0,0,0,0,0,0,0,0
MIZORAM,2008,TERRORIST & DISRUPTIVE ACTIVITIES (TATA),0,0,0,0,0,0,0,0,0,0,0,0,0,0,0
MIZORAM,2008,IMMORAL TRAFFIC (PREVENTION) ACT,0,0,0,0,0,0,0,0,0,0,0,0,0,0,0
MIZORAM,2008,INDIAN RAILWAYS ACT,0,0,0,0,0,0,0,0,0,0,0,0,0,0,0
MIZORAM,2008,REGISTRATION OF FOREIGNERS ACT,0,0,0,0,0,0,0,0,0,0,0,0,0,0,0
MIZORAM,2008,PROTECTION OF CIVIL RIGHTS ACT,0,0,0,0,0,0,0,0,0,0,0,0,0,0,0
MIZORAM,2008,SC/ST (PREVENTION OF ATROCITIES) ACT,0,0,0,0,0,0,0,0,0,0,0,0,0,0,0
MIZORAM,2008,INDIAN PASSPORT ACT,0,0,0,0,0,0,0,0,0,0,0,0,0,0,0
MIZORAM,2008,ESSENTIAL COMMODITIES ACT,0,0,0,0,0,0,0,0,0,0,0,0,0,0,0
MIZORAM,2008,ANTIQUITIES AND ART TREASURE ACT,0,0,0,0,0,0,0,0,0,0,0,0,0,0,0
MIZORAM,2008,DOWRY PROHIBITION ACT,0,0,0,0,0,0,0,0,0,0,0,0,0,0,0
MIZORAM,2008,FOREIGN EXCHANGE REGULATION ACT-1973,0,0,0,0,0,0,0,0,0,0,0,0,0,0,0
MIZORAM,2008,PREVENTION OF CORRUPTION ACT-1988,0,0,0,0,0,0,0,0,0,0,0,0,0,0,0
MIZORAM,2008,CONSER.OF FORGN.EXCH.&PREV. OF SMUG.ACT,0,0,0,0,0,0,0,0,0,0,0,0,0,0,0
MIZORAM,2008,OTHER SLL OFFENCE,0,0,0,4,0,4,0,0,0,0,0,0,4,0,4
MIZORAM,2008,TOTAL,0,0,0,78,23,101,58,12,70,17,3,20,153,38,191
MIZORAM,2009,ARMS ACT,0,0,0,3,0,3,2,0,2,0,0,0,5,0,5
MIZORAM,2009,N.D.P.S. ACT,0,0,0,21,7,28,11,2,13,1,0,1,33,9,42
MIZORAM,2009,GAMBLING ACT,0,0,0,0,0,0,0,0,0,0,0,0,0,0,0
MIZORAM,2009,EXCISE ACT,0,0,0,1,0,1,0,0,0,0,0,0,1,0,1
MIZORAM,2009,PROHIBITION ACT,0,0,0,59,17,76,52,16,68,10,0,10,121,33,154
MIZORAM,2009,EXPLOSIVE & EXPLOSIVE SUBST. ACT,0,0,0,0,0,0,0,0,0,0,0,0,0,0,0
MIZORAM,2009,TERRORIST & DISRUPTIVE ACTIVITIES (TATA),0,0,0,0,0,0,0,0,0,0,0,0,0,0,0
MIZORAM,2009,IMMORAL TRAFFIC (PREVENTION) ACT,0,0,0,0,0,0,0,0,0,0,0,0,0,0,0
MIZORAM,2009,INDIAN RAILWAYS ACT,0,0,0,0,0,0,0,0,0,0,0,0,0,0,0
MIZORAM,2009,REGISTRATION OF FOREIGNERS ACT,0,0,0,1,0,1,0,0,0,0,0,0,1,0,1
MIZORAM,2009,PROTECTION OF CIVIL RIGHTS ACT,0,0,0,0,0,0,0,0,0,0,0,0,0,0,0
MIZORAM,2009,SC/ST (PREVENTION OF ATROCITIES) ACT,0,0,0,0,0,0,0,0,0,0,0,0,0,0,0
MIZORAM,2009,INDIAN PASSPORT ACT,0,0,0,0,0,0,0,0,0,0,0,0,0,0,0
MIZORAM,2009,ESSENTIAL COMMODITIES ACT,0,0,0,0,0,0,0,0,0,0,0,0,0,0,0
MIZORAM,2009,ANTIQUITIES AND ART TREASURE ACT,0,0,0,0,0,0,0,0,0,0,0,0,0,0,0
MIZORAM,2009,DOWRY PROHIBITION ACT,0,0,0,0,0,0,0,0,0,0,0,0,0,0,0
MIZORAM,2009,FOREIGN EXCHANGE REGULATION ACT-1973,0,0,0,0,0,0,0,0,0,0,0,0,0,0,0
MIZORAM,2009,PREVENTION OF CORRUPTION ACT-1988,0,0,0,0,0,0,0,0,0,0,0,0,0,0,0
MIZORAM,2009,CONSER.OF FORGN.EXCH.&PREV. OF SMUG.ACT,0,0,0,0,0,0,0,0,0,0,0,0,0,0,0
MIZORAM,2009,OTHER SLL OFFENCE,0,0,0,10,0,10,6,0,6,0,0,0,16,0,16
MIZORAM,2009,TOTAL,0,0,0,95,24,119,71,18,89,11,0,11,177,42,219
MIZORAM,2010,ARMS ACT,0,0,0,0,0,0,2,0,2,0,0,0,2,0,2
MIZORAM,2010,N.D.P.S. ACT,0,0,0,27,4,31,23,5,28,0,0,0,50,9,59
MIZORAM,2010,GAMBLING ACT,0,0,0,0,0,0,0,0,0,0,0,0,0,0,0
MIZORAM,2010,EXCISE ACT,0,0,0,2,0,2,1,0,1,0,0,0,3,0,3
MIZORAM,2010,PROHIBITION ACT,0,0,0,56,8,64,49,17,66,0,3,3,105,28,133
MIZORAM,2010,EXPLOSIVE & EXPLOSIVE SUBST. ACT,0,0,0,0,0,0,0,0,0,0,0,0,0,0,0
MIZORAM,2010,TERRORIST & DISRUPTIVE ACTIVITIES (TATA),0,0,0,0,0,0,0,0,0,0,0,0,0,0,0
MIZORAM,2010,IMMORAL TRAFFIC (PREVENTION) ACT,0,0,0,0,0,0,0,0,0,0,0,0,0,0,0
MIZORAM,2010,INDIAN RAILWAYS ACT,0,0,0,0,0,0,0,0,0,0,0,0,0,0,0
MIZORAM,2010,REGISTRATION OF FOREIGNERS ACT,0,0,0,12,0,12,1,0,1,0,0,0,13,0,13
MIZORAM,2010,PROTECTION OF CIVIL RIGHTS ACT,0,0,0,0,0,0,0,0,0,0,0,0,0,0,0
MIZORAM,2010,SC/ST (PREVENTION OF ATROCITIES) ACT,0,0,0,0,0,0,0,0,0,0,0,0,0,0,0
MIZORAM,2010,INDIAN PASSPORT ACT,0,0,0,0,0,0,0,0,0,0,0,0,0,0,0
MIZORAM,2010,ESSENTIAL COMMODITIES ACT,0,0,0,0,0,0,0,0,0,0,0,0,0,0,0
MIZORAM,2010,ANTIQUITIES AND ART TREASURE ACT,0,0,0,0,0,0,0,0,0,0,0,0,0,0,0
MIZORAM,2010,DOWRY PROHIBITION ACT,0,0,0,0,0,0,0,0,0,0,0,0,0,0,0
MIZORAM,2010,FOREIGN EXCHANGE REGULATION ACT-1973,0,0,0,0,0,0,0,0,0,0,0,0,0,0,0
MIZORAM,2010,PREVENTION OF CORRUPTION ACT-1988,0,0,0,0,0,0,0,0,0,0,0,0,0,0,0
MIZORAM,2010,CONSER.OF FORGN.EXCH.&PREV. OF SMUG.ACT,0,0,0,0,0,0,0,0,0,0,0,0,0,0,0
MIZORAM,2010,OTHER SLL OFFENCE,0,0,0,6,10,16,47,0,47,6,2,8,59,12,71
MIZORAM,2010,TOTAL,0,0,0,103,22,125,123,22,145,6,5,11,232,49,281
MIZORAM,2011,ARMS ACT,0,0,0,2,0,2,3,0,3,0,0,0,5,0,5
MIZORAM,2011,N.D.P.S. ACT,0,0,0,32,7,39,16,8,24,0,0,0,48,15,63
MIZORAM,2011,GAMBLING ACT,0,0,0,0,0,0,0,0,0,0,0,0,0,0,0
MIZORAM,2011,EXCISE ACT,0,0,0,0,0,0,0,0,0,0,0,0,0,0,0
MIZORAM,2011,PROHIBITION ACT,0,0,0,89,15,104,28,10,38,2,4,6,119,29,148
MIZORAM,2011,EXPLOSIVE & EXPLOSIVE SUBST. ACT,0,0,0,0,0,0,0,0,0,0,0,0,0,0,0
MIZORAM,2011,TERRORIST & DISRUPTIVE ACTIVITIES (TATA),0,0,0,0,0,0,0,0,0,0,0,0,0,0,0
MIZORAM,2011,IMMORAL TRAFFIC (PREVENTION) ACT,0,0,0,0,0,0,0,0,0,0,0,0,0,0,0
MIZORAM,2011,INDIAN RAILWAYS ACT,0,0,0,0,0,0,0,0,0,0,0,0,0,0,0
MIZORAM,2011,REGISTRATION OF FOREIGNERS ACT,0,0,0,0,0,0,0,0,0,0,0,0,0,0,0
MIZORAM,2011,PROTECTION OF CIVIL RIGHTS ACT,0,0,0,0,0,0,0,0,0,0,0,0,0,0,0
MIZORAM,2011,SC/ST (PREVENTION OF ATROCITIES) ACT,0,0,0,0,0,0,0,0,0,0,0,0,0,0,0
MIZORAM,2011,INDIAN PASSPORT ACT,0,0,0,0,0,0,0,0,0,0,0,0,0,0,0
MIZORAM,2011,ESSENTIAL COMMODITIES ACT,0,0,0,0,0,0,0,0,0,0,0,0,0,0,0
MIZORAM,2011,ANTIQUITIES AND ART TREASURE ACT,0,0,0,0,0,0,0,0,0,0,0,0,0,0,0
MIZORAM,2011,DOWRY PROHIBITION ACT,0,0,0,0,0,0,0,0,0,0,0,0,0,0,0
MIZORAM,2011,FOREIGN EXCHANGE REGULATION ACT-1973,0,0,0,0,0,0,0,0,0,0,0,0,0,0,0
MIZORAM,2011,PREVENTION OF CORRUPTION ACT-1988,0,0,0,0,0,0,0,0,0,0,0,0,0,0,0
MIZORAM,2011,CONSER.OF FORGN.EXCH.&PREV. OF SMUG.ACT,0,0,0,0,0,0,0,0,0,0,0,0,0,0,0
MIZORAM,2011,OTHER SLL OFFENCE,0,0,0,18,1,19,10,1,11,0,0,0,28,2,30
MIZORAM,2011,TOTAL,0,0,0,141,23,164,57,19,76,2,4,6,200,46,246
MIZORAM,2012,ARMS ACT,0,0,0,5,0,5,4,0,4,1,0,1,10,0,10
MIZORAM,2012,N.D.P.S. ACT,0,0,0,57,15,72,36,9,45,0,0,0,93,24,117
MIZORAM,2012,GAMBLING ACT,0,0,0,0,0,0,0,0,0,0,0,0,0,0,0
MIZORAM,2012,EXCISE ACT,0,0,0,0,0,0,0,0,0,0,0,0,0,0,0
MIZORAM,2012,PROHIBITION ACT,0,0,0,28,6,34,71,10,81,15,2,17,114,18,132
MIZORAM,2012,EXPLOSIVE & EXPLOSIVE SUBST. ACT,0,0,0,0,0,0,0,0,0,0,0,0,0,0,0
MIZORAM,2012,TERRORIST & DISRUPTIVE ACTIVITIES (TATA),0,0,0,0,0,0,0,0,0,0,0,0,0,0,0
MIZORAM,2012,IMMORAL TRAFFIC (PREVENTION) ACT,0,0,0,0,0,0,0,0,0,0,0,0,0,0,0
MIZORAM,2012,INDIAN RAILWAYS ACT,0,0,0,0,0,0,0,0,0,0,0,0,0,0,0
MIZORAM,2012,REGISTRATION OF FOREIGNERS ACT,0,0,0,0,0,0,0,0,0,0,0,0,0,0,0
MIZORAM,2012,PROTECTION OF CIVIL RIGHTS ACT,0,0,0,0,0,0,0,0,0,0,0,0,0,0,0
MIZORAM,2012,SC/ST (PREVENTION OF ATROCITIES) ACT,0,0,0,0,0,0,0,0,0,0,0,0,0,0,0
MIZORAM,2012,INDIAN PASSPORT ACT,0,0,0,0,0,0,0,0,0,0,0,0,0,0,0
MIZORAM,2012,ESSENTIAL COMMODITIES ACT,0,0,0,0,0,0,0,0,0,0,0,0,0,0,0
MIZORAM,2012,ANTIQUITIES AND ART TREASURE ACT,0,0,0,0,0,0,0,0,0,0,0,0,0,0,0
MIZORAM,2012,DOWRY PROHIBITION ACT,0,0,0,0,0,0,0,0,0,0,0,0,0,0,0
MIZORAM,2012,FOREIGN EXCHANGE REGULATION ACT-1973,0,0,0,0,0,0,0,0,0,0,0,0,0,0,0
MIZORAM,2012,PREVENTION OF CORRUPTION ACT-1988,0,0,0,0,0,0,0,0,0,0,0,0,0,0,0
MIZORAM,2012,CONSER.OF FORGN.EXCH.&PREV. OF SMUG.ACT,0,0,0,0,0,0,0,0,0,0,0,0,0,0,0
MIZORAM,2012,OTHER SLL OFFENCE,0,0,0,6,0,6,7,1,8,0,0,0,13,1,14
MIZORAM,2012,TOTAL,0,0,0,96,21,117,118,20,138,16,2,18,230,43,273
NAGALAND,2001,ARMS ACT,0,0,0,12,0,12,38,2,40,56,0,56,106,2,108
NAGALAND,2001,N.D.P.S. ACT,0,0,0,5,1,6,21,2,23,2,1,3,28,4,32
NAGALAND,2001,GAMBLING ACT,0,0,0,7,0,7,17,0,17,0,0,0,24,0,24
NAGALAND,2001,EXCISE ACT,0,0,0,16,4,20,41,4,45,10,0,10,67,8,75
NAGALAND,2001,PROHIBITION ACT,0,0,0,3,0,3,22,0,22,3,0,3,28,0,28
NAGALAND,2001,EXPLOSIVE & EXPLOSIVE SUBST. ACT,0,0,0,10,0,10,13,0,13,0,0,0,23,0,23
NAGALAND,2001,TERRORIST & DISRUPTIVE ACTIVITIES (TATA),0,0,0,0,0,0,0,0,0,0,0,0,0,0,0
NAGALAND,2001,IMMORAL TRAFFIC (PREVENTION) ACT,0,0,0,1,0,1,7,0,7,0,0,0,8,0,8
NAGALAND,2001,INDIAN RAILWAYS ACT,0,0,0,1,0,1,5,0,5,0,0,0,6,0,6
NAGALAND,2001,REGISTRATION OF FOREIGNERS ACT,0,0,0,0,0,0,0,0,0,0,0,0,0,0,0
NAGALAND,2001,PROTECTION OF CIVIL RIGHTS ACT,0,0,0,0,0,0,0,0,0,0,0,0,0,0,0
NAGALAND,2001,SC/ST (PREVENTION OF ATROCITIES) ACT,0,0,0,1,0,1,0,0,0,0,0,0,1,0,1
NAGALAND,2001,INDIAN PASSPORT ACT,0,0,0,0,0,0,0,0,0,0,0,0,0,0,0
NAGALAND,2001,ESSENTIAL COMMODITIES ACT,0,0,0,0,0,0,0,0,0,0,0,0,0,0,0
NAGALAND,2001,ANTIQUITIES AND ART TREASURE ACT,0,0,0,0,0,0,0,0,0,0,0,0,0,0,0
NAGALAND,2001,DOWRY PROHIBITION ACT,0,0,0,0,0,0,0,0,0,0,0,0,0,0,0
NAGALAND,2001,FOREIGN EXCHANGE REGULATION ACT-1973,0,0,0,0,0,0,0,0,0,0,0,0,0,0,0
NAGALAND,2001,PREVENTION OF CORRUPTION ACT-1988,0,0,0,0,0,0,0,0,0,0,0,0,0,0,0
NAGALAND,2001,CONSER.OF FORGN.EXCH.&PREV. OF SMUG.ACT,0,0,0,0,0,0,0,0,0,0,0,0,0,0,0
NAGALAND,2001,OTHER SLL OFFENCE,0,0,0,0,0,0,0,0,0,0,0,0,0,0,0
NAGALAND,2001,TOTAL,0,0,0,56,5,61,164,8,172,71,1,72,291,14,305
NAGALAND,2002,ARMS ACT,0,0,0,9,0,9,18,2,20,17,0,17,44,2,46
NAGALAND,2002,N.D.P.S. ACT,0,0,0,11,1,12,25,0,25,1,0,1,37,1,38
NAGALAND,2002,GAMBLING ACT,0,0,0,10,0,10,22,0,22,0,0,0,32,0,32
NAGALAND,2002,EXCISE ACT,0,0,0,12,3,15,41,0,41,10,0,10,63,3,66
NAGALAND,2002,PROHIBITION ACT,0,0,0,0,0,0,0,0,0,0,0,0,0,0,0
NAGALAND,2002,EXPLOSIVE & EXPLOSIVE SUBST. ACT,0,0,0,11,0,11,12,0,12,0,0,0,23,0,23
NAGALAND,2002,TERRORIST & DISRUPTIVE ACTIVITIES (TATA),0,0,0,0,0,0,0,0,0,0,0,0,0,0,0
NAGALAND,2002,IMMORAL TRAFFIC (PREVENTION) ACT,0,0,0,0,0,0,4,0,4,0,0,0,4,0,4
NAGALAND,2002,INDIAN RAILWAYS ACT,0,0,0,0,0,0,0,0,0,0,0,0,0,0,0
NAGALAND,2002,REGISTRATION OF FOREIGNERS ACT,0,0,0,1,0,1,7,0,7,0,0,0,8,0,8
NAGALAND,2002,PROTECTION OF CIVIL RIGHTS ACT,0,0,0,0,0,0,0,0,0,0,0,0,0,0,0
NAGALAND,2002,SC/ST (PREVENTION OF ATROCITIES) ACT,0,0,0,0,0,0,0,0,0,0,0,0,0,0,0
NAGALAND,2002,INDIAN PASSPORT ACT,0,0,0,0,0,0,0,0,0,0,0,0,0,0,0
NAGALAND,2002,ESSENTIAL COMMODITIES ACT,0,0,0,0,0,0,0,0,0,0,0,0,0,0,0
NAGALAND,2002,ANTIQUITIES AND ART TREASURE ACT,0,0,0,0,0,0,0,0,0,0,0,0,0,0,0
NAGALAND,2002,DOWRY PROHIBITION ACT,0,0,0,0,0,0,0,0,0,0,0,0,0,0,0
NAGALAND,2002,FOREIGN EXCHANGE REGULATION ACT-1973,0,0,0,0,0,0,0,0,0,0,0,0,0,0,0
NAGALAND,2002,PREVENTION OF CORRUPTION ACT-1988,0,0,0,1,0,1,1,0,1,0,0,0,2,0,2
NAGALAND,2002,CONSER.OF FORGN.EXCH.&PREV. OF SMUG.ACT,0,0,0,0,0,0,0,0,0,0,0,0,0,0,0
NAGALAND,2002,OTHER SLL OFFENCE,0,0,0,0,0,0,0,0,0,0,0,0,0,0,0
NAGALAND,2002,TOTAL,0,0,0,55,4,59,130,2,132,28,0,28,213,6,219
NAGALAND,2003,ARMS ACT,0,0,0,9,0,9,10,0,10,2,0,2,21,0,21
NAGALAND,2003,N.D.P.S. ACT,1,0,1,9,1,10,6,0,6,0,0,0,16,1,17
NAGALAND,2003,GAMBLING ACT,0,0,0,9,0,9,0,0,0,0,0,0,9,0,9
NAGALAND,2003,EXCISE ACT,0,0,0,27,3,30,15,1,16,0,0,0,42,4,46
NAGALAND,2003,PROHIBITION ACT,0,0,0,0,0,0,0,0,0,0,0,0,0,0,0
NAGALAND,2003,EXPLOSIVE & EXPLOSIVE SUBST. ACT,0,0,0,21,0,21,5,0,5,0,0,0,26,0,26
NAGALAND,2003,TERRORIST & DISRUPTIVE ACTIVITIES (TATA),0,0,0,0,0,0,0,0,0,0,0,0,0,0,0
NAGALAND,2003,IMMORAL TRAFFIC (PREVENTION) ACT,0,0,0,0,0,0,0,0,0,0,0,0,0,0,0
NAGALAND,2003,INDIAN RAILWAYS ACT,0,0,0,7,0,7,2,0,2,0,0,0,9,0,9
NAGALAND,2003,REGISTRATION OF FOREIGNERS ACT,0,0,0,0,0,0,0,0,0,0,0,0,0,0,0
NAGALAND,2003,PROTECTION OF CIVIL RIGHTS ACT,0,0,0,0,0,0,0,0,0,0,0,0,0,0,0
NAGALAND,2003,SC/ST (PREVENTION OF ATROCITIES) ACT,0,0,0,0,0,0,0,0,0,0,0,0,0,0,0
NAGALAND,2003,INDIAN PASSPORT ACT,0,0,0,0,0,0,0,0,0,0,0,0,0,0,0
NAGALAND,2003,ESSENTIAL COMMODITIES ACT,0,0,0,0,0,0,0,0,0,0,0,0,0,0,0
NAGALAND,2003,ANTIQUITIES AND ART TREASURE ACT,0,0,0,0,0,0,0,0,0,0,0,0,0,0,0
NAGALAND,2003,DOWRY PROHIBITION ACT,0,0,0,0,0,0,0,0,0,0,0,0,0,0,0
NAGALAND,2003,FOREIGN EXCHANGE REGULATION ACT-1973,0,0,0,0,0,0,0,0,0,0,0,0,0,0,0
NAGALAND,2003,PREVENTION OF CORRUPTION ACT-1988,0,0,0,0,0,0,0,0,0,0,0,0,0,0,0
NAGALAND,2003,CONSER.OF FORGN.EXCH.&PREV. OF SMUG.ACT,0,0,0,0,0,0,0,0,0,0,0,0,0,0,0
NAGALAND,2003,OTHER SLL OFFENCE,0,0,0,0,0,0,0,0,0,0,0,0,0,0,0
NAGALAND,2003,TOTAL,1,0,1,82,4,86,38,1,39,2,0,2,123,5,128
NAGALAND,2004,ARMS ACT,0,0,0,9,1,10,17,0,17,8,0,8,34,1,35
NAGALAND,2004,N.D.P.S. ACT,1,0,1,6,0,6,14,0,14,4,0,4,25,0,25
NAGALAND,2004,GAMBLING ACT,0,0,0,0,0,0,0,0,0,0,0,0,0,0,0
NAGALAND,2004,EXCISE ACT,0,0,0,5,2,7,30,3,33,7,0,7,42,5,47
NAGALAND,2004,PROHIBITION ACT,0,0,0,0,0,0,0,0,0,0,0,0,0,0,0
NAGALAND,2004,EXPLOSIVE & EXPLOSIVE SUBST. ACT,0,0,0,0,0,0,0,0,0,0,0,0,0,0,0
NAGALAND,2004,TERRORIST & DISRUPTIVE ACTIVITIES (TATA),0,0,0,0,0,0,0,0,0,0,0,0,0,0,0
NAGALAND,2004,IMMORAL TRAFFIC (PREVENTION) ACT,0,0,0,0,0,0,0,0,0,0,0,0,0,0,0
NAGALAND,2004,INDIAN RAILWAYS ACT,0,0,0,2,0,2,5,0,5,2,0,2,9,0,9
NAGALAND,2004,REGISTRATION OF FOREIGNERS ACT,0,0,0,0,0,0,0,0,0,0,0,0,0,0,0
NAGALAND,2004,PROTECTION OF CIVIL RIGHTS ACT,0,0,0,0,0,0,0,0,0,0,0,0,0,0,0
NAGALAND,2004,SC/ST (PREVENTION OF ATROCITIES) ACT,0,0,0,0,0,0,0,0,0,0,0,0,0,0,0
NAGALAND,2004,INDIAN PASSPORT ACT,0,0,0,0,0,0,0,0,0,0,0,0,0,0,0
NAGALAND,2004,ESSENTIAL COMMODITIES ACT,0,0,0,0,0,0,0,0,0,0,0,0,0,0,0
NAGALAND,2004,ANTIQUITIES AND ART TREASURE ACT,0,0,0,0,0,0,0,0,0,0,0,0,0,0,0
NAGALAND,2004,DOWRY PROHIBITION ACT,0,0,0,0,0,0,0,0,0,0,0,0,0,0,0
NAGALAND,2004,FOREIGN EXCHANGE REGULATION ACT-1973,0,0,0,0,0,0,0,0,0,0,0,0,0,0,0
NAGALAND,2004,PREVENTION OF CORRUPTION ACT-1988,0,0,0,0,0,0,0,0,0,0,0,0,0,0,0
NAGALAND,2004,CONSER.OF FORGN.EXCH.&PREV. OF SMUG.ACT,0,0,0,0,0,0,0,0,0,0,0,0,0,0,0
NAGALAND,2004,OTHER SLL OFFENCE,0,0,0,0,0,0,0,0,0,0,0,0,0,0,0
NAGALAND,2004,TOTAL,1,0,1,22,3,25,66,3,69,21,0,21,110,6,116
NAGALAND,2005,ARMS ACT,0,0,0,3,0,3,17,2,19,8,0,8,28,2,30
NAGALAND,2005,N.D.P.S. ACT,7,0,7,9,2,11,10,0,10,0,0,0,26,2,28
NAGALAND,2005,GAMBLING ACT,0,0,0,0,0,0,0,0,0,0,0,0,0,0,0
NAGALAND,2005,EXCISE ACT,0,0,0,7,0,7,0,0,0,0,0,0,7,0,7
NAGALAND,2005,PROHIBITION ACT,0,0,0,0,0,0,0,0,0,0,0,0,0,0,0
NAGALAND,2005,EXPLOSIVE & EXPLOSIVE SUBST. ACT,0,0,0,3,0,3,0,0,0,0,0,0,3,0,3
NAGALAND,2005,TERRORIST & DISRUPTIVE ACTIVITIES (TATA),0,0,0,0,0,0,0,0,0,0,0,0,0,0,0
NAGALAND,2005,IMMORAL TRAFFIC (PREVENTION) ACT,0,0,0,0,0,0,0,0,0,0,0,0,0,0,0
NAGALAND,2005,INDIAN RAILWAYS ACT,0,0,0,0,0,0,0,0,0,0,0,0,0,0,0
NAGALAND,2005,REGISTRATION OF FOREIGNERS ACT,0,0,0,0,0,0,0,0,0,0,0,0,0,0,0
NAGALAND,2005,PROTECTION OF CIVIL RIGHTS ACT,0,0,0,0,0,0,0,0,0,0,0,0,0,0,0
NAGALAND,2005,SC/ST (PREVENTION OF ATROCITIES) ACT,0,0,0,0,0,0,0,0,0,0,0,0,0,0,0
NAGALAND,2005,INDIAN PASSPORT ACT,0,0,0,0,0,0,0,0,0,0,0,0,0,0,0
NAGALAND,2005,ESSENTIAL COMMODITIES ACT,0,0,0,0,0,0,0,0,0,0,0,0,0,0,0
NAGALAND,2005,ANTIQUITIES AND ART TREASURE ACT,0,0,0,0,0,0,0,0,0,0,0,0,0,0,0
NAGALAND,2005,DOWRY PROHIBITION ACT,0,0,0,0,0,0,0,0,0,0,0,0,0,0,0
NAGALAND,2005,FOREIGN EXCHANGE REGULATION ACT-1973,0,0,0,0,0,0,0,0,0,0,0,0,0,0,0
NAGALAND,2005,PREVENTION OF CORRUPTION ACT-1988,0,0,0,0,0,0,0,0,0,0,0,0,0,0,0
NAGALAND,2005,CONSER.OF FORGN.EXCH.&PREV. OF SMUG.ACT,0,0,0,0,0,0,0,0,0,0,0,0,0,0,0
NAGALAND,2005,OTHER SLL OFFENCE,0,0,0,0,0,0,0,0,0,0,0,0,0,0,0
NAGALAND,2005,TOTAL,7,0,7,22,2,24,27,2,29,8,0,8,64,4,68
NAGALAND,2006,ARMS ACT,0,0,0,28,2,30,27,1,28,21,0,21,76,3,79
NAGALAND,2006,N.D.P.S. ACT,2,0,2,13,1,14,71,0,71,4,0,4,90,1,91
NAGALAND,2006,GAMBLING ACT,0,0,0,0,0,0,0,0,0,0,0,0,0,0,0
NAGALAND,2006,EXCISE ACT,3,0,3,16,4,20,60,4,64,5,0,5,84,8,92
NAGALAND,2006,PROHIBITION ACT,0,0,0,0,0,0,0,0,0,0,0,0,0,0,0
NAGALAND,2006,EXPLOSIVE & EXPLOSIVE SUBST. ACT,0,0,0,0,0,0,25,0,25,0,0,0,25,0,25
NAGALAND,2006,TERRORIST & DISRUPTIVE ACTIVITIES (TATA),0,0,0,0,0,0,0,0,0,0,0,0,0,0,0
NAGALAND,2006,IMMORAL TRAFFIC (PREVENTION) ACT,0,0,0,0,0,0,0,0,0,0,0,0,0,0,0
NAGALAND,2006,INDIAN RAILWAYS ACT,0,0,0,0,0,0,0,0,0,0,0,0,0,0,0
NAGALAND,2006,REGISTRATION OF FOREIGNERS ACT,0,0,0,0,0,0,0,0,0,0,0,0,0,0,0
NAGALAND,2006,PROTECTION OF CIVIL RIGHTS ACT,0,0,0,0,0,0,0,0,0,0,0,0,0,0,0
NAGALAND,2006,SC/ST (PREVENTION OF ATROCITIES) ACT,0,0,0,0,0,0,0,0,0,0,0,0,0,0,0
NAGALAND,2006,INDIAN PASSPORT ACT,0,0,0,0,0,0,0,0,0,0,0,0,0,0,0
NAGALAND,2006,ESSENTIAL COMMODITIES ACT,0,0,0,0,0,0,0,0,0,0,0,0,0,0,0
NAGALAND,2006,ANTIQUITIES AND ART TREASURE ACT,0,0,0,0,0,0,0,0,0,0,0,0,0,0,0
NAGALAND,2006,DOWRY PROHIBITION ACT,0,0,0,0,0,0,0,0,0,0,0,0,0,0,0
NAGALAND,2006,FOREIGN EXCHANGE REGULATION ACT-1973,0,0,0,0,0,0,0,0,0,0,0,0,0,0,0
NAGALAND,2006,PREVENTION OF CORRUPTION ACT-1988,0,0,0,0,0,0,0,0,0,0,0,0,0,0,0
NAGALAND,2006,CONSER.OF FORGN.EXCH.&PREV. OF SMUG.ACT,0,0,0,0,0,0,0,0,0,0,0,0,0,0,0
NAGALAND,2006,OTHER SLL OFFENCE,0,0,0,0,0,0,0,0,0,0,0,0,0,0,0
NAGALAND,2006,TOTAL,5,0,5,57,7,64,183,5,188,30,0,30,275,12,287
NAGALAND,2007,ARMS ACT,4,0,4,17,0,17,23,3,26,6,0,6,50,3,53
NAGALAND,2007,N.D.P.S. ACT,2,0,2,14,1,15,20,3,23,0,0,0,36,4,40
NAGALAND,2007,GAMBLING ACT,0,0,0,0,0,0,0,0,0,0,0,0,0,0,0
NAGALAND,2007,EXCISE ACT,0,0,0,20,2,22,13,1,14,5,0,5,38,3,41
NAGALAND,2007,PROHIBITION ACT,0,0,0,0,0,0,0,0,0,0,0,0,0,0,0
NAGALAND,2007,EXPLOSIVE & EXPLOSIVE SUBST. ACT,0,0,0,2,0,2,10,0,10,0,0,0,12,0,12
NAGALAND,2007,TERRORIST & DISRUPTIVE ACTIVITIES (TATA),0,0,0,0,0,0,0,0,0,0,0,0,0,0,0
NAGALAND,2007,IMMORAL TRAFFIC (PREVENTION) ACT,0,0,0,0,0,0,0,0,0,0,0,0,0,0,0
NAGALAND,2007,INDIAN RAILWAYS ACT,0,0,0,0,0,0,4,0,4,0,0,0,4,0,4
NAGALAND,2007,REGISTRATION OF FOREIGNERS ACT,0,0,0,0,0,0,0,0,0,0,0,0,0,0,0
NAGALAND,2007,PROTECTION OF CIVIL RIGHTS ACT,0,0,0,0,0,0,0,0,0,0,0,0,0,0,0
NAGALAND,2007,SC/ST (PREVENTION OF ATROCITIES) ACT,0,0,0,0,0,0,0,0,0,0,0,0,0,0,0
NAGALAND,2007,INDIAN PASSPORT ACT,0,0,0,0,0,0,0,0,0,0,0,0,0,0,0
NAGALAND,2007,ESSENTIAL COMMODITIES ACT,0,0,0,0,0,0,0,0,0,0,0,0,0,0,0
NAGALAND,2007,ANTIQUITIES AND ART TREASURE ACT,0,0,0,0,0,0,0,0,0,0,0,0,0,0,0
NAGALAND,2007,DOWRY PROHIBITION ACT,0,0,0,0,0,0,0,0,0,0,0,0,0,0,0
NAGALAND,2007,FOREIGN EXCHANGE REGULATION ACT-1973,0,0,0,0,0,0,0,0,0,0,0,0,0,0,0
NAGALAND,2007,PREVENTION OF CORRUPTION ACT-1988,0,0,0,0,0,0,0,0,0,0,0,0,0,0,0
NAGALAND,2007,CONSER.OF FORGN.EXCH.&PREV. OF SMUG.ACT,0,0,0,0,0,0,0,0,0,0,0,0,0,0,0
NAGALAND,2007,OTHER SLL OFFENCE,0,0,0,0,0,0,0,0,0,0,0,0,0,0,0
NAGALAND,2007,TOTAL,6,0,6,53,3,56,70,7,77,11,0,11,140,10,150
NAGALAND,2008,ARMS ACT,0,0,0,11,0,11,17,3,20,9,0,9,37,3,40
NAGALAND,2008,N.D.P.S. ACT,0,0,0,17,2,19,22,3,25,0,0,0,39,5,44
NAGALAND,2008,GAMBLING ACT,0,0,0,0,0,0,0,0,0,0,0,0,0,0,0
NAGALAND,2008,EXCISE ACT,0,0,0,7,0,7,22,0,22,0,0,0,29,0,29
NAGALAND,2008,PROHIBITION ACT,0,0,0,0,0,0,0,0,0,0,0,0,0,0,0
NAGALAND,2008,EXPLOSIVE & EXPLOSIVE SUBST. ACT,0,0,0,0,0,0,0,0,0,0,0,0,0,0,0
NAGALAND,2008,TERRORIST & DISRUPTIVE ACTIVITIES (TATA),0,0,0,0,0,0,0,0,0,0,0,0,0,0,0
NAGALAND,2008,IMMORAL TRAFFIC (PREVENTION) ACT,0,0,0,0,0,0,0,0,0,0,0,0,0,0,0
NAGALAND,2008,INDIAN RAILWAYS ACT,0,0,0,0,0,0,0,0,0,0,0,0,0,0,0
NAGALAND,2008,REGISTRATION OF FOREIGNERS ACT,0,0,0,0,0,0,0,0,0,0,0,0,0,0,0
NAGALAND,2008,PROTECTION OF CIVIL RIGHTS ACT,0,0,0,0,0,0,0,0,0,0,0,0,0,0,0
NAGALAND,2008,SC/ST (PREVENTION OF ATROCITIES) ACT,0,0,0,0,0,0,0,0,0,0,0,0,0,0,0
NAGALAND,2008,INDIAN PASSPORT ACT,0,0,0,0,0,0,0,0,0,0,0,0,0,0,0
NAGALAND,2008,ESSENTIAL COMMODITIES ACT,0,0,0,0,0,0,0,0,0,0,0,0,0,0,0
NAGALAND,2008,ANTIQUITIES AND ART TREASURE ACT,0,0,0,0,0,0,0,0,0,0,0,0,0,0,0
NAGALAND,2008,DOWRY PROHIBITION ACT,0,0,0,0,0,0,0,0,0,0,0,0,0,0,0
NAGALAND,2008,FOREIGN EXCHANGE REGULATION ACT-1973,0,0,0,0,0,0,0,0,0,0,0,0,0,0,0
NAGALAND,2008,PREVENTION OF CORRUPTION ACT-1988,0,0,0,0,0,0,0,0,0,0,0,0,0,0,0
NAGALAND,2008,CONSER.OF FORGN.EXCH.&PREV. OF SMUG.ACT,0,0,0,0,0,0,0,0,0,0,0,0,0,0,0
NAGALAND,2008,OTHER SLL OFFENCE,0,0,0,0,0,0,0,0,0,0,0,0,0,0,0
NAGALAND,2008,TOTAL,0,0,0,35,2,37,61,6,67,9,0,9,105,8,113
NAGALAND,2009,ARMS ACT,0,0,0,10,0,10,7,0,7,2,0,2,19,0,19
NAGALAND,2009,N.D.P.S. ACT,0,0,0,22,3,25,20,0,20,4,0,4,46,3,49
NAGALAND,2009,GAMBLING ACT,0,0,0,0,0,0,0,0,0,0,0,0,0,0,0
NAGALAND,2009,EXCISE ACT,0,0,0,1,0,1,6,0,6,0,0,0,7,0,7
NAGALAND,2009,PROHIBITION ACT,0,0,0,5,0,5,10,0,10,1,0,1,16,0,16
NAGALAND,2009,EXPLOSIVE & EXPLOSIVE SUBST. ACT,0,0,0,0,0,0,0,0,0,0,0,0,0,0,0
NAGALAND,2009,TERRORIST & DISRUPTIVE ACTIVITIES (TATA),0,0,0,0,0,0,0,0,0,0,0,0,0,0,0
NAGALAND,2009,IMMORAL TRAFFIC (PREVENTION) ACT,0,0,0,0,0,0,0,0,0,0,0,0,0,0,0
NAGALAND,2009,INDIAN RAILWAYS ACT,0,0,0,0,0,0,0,0,0,0,0,0,0,0,0
NAGALAND,2009,REGISTRATION OF FOREIGNERS ACT,0,0,0,0,0,0,0,0,0,0,0,0,0,0,0
NAGALAND,2009,PROTECTION OF CIVIL RIGHTS ACT,0,0,0,0,0,0,0,0,0,0,0,0,0,0,0
NAGALAND,2009,SC/ST (PREVENTION OF ATROCITIES) ACT,0,0,0,0,0,0,0,0,0,0,0,0,0,0,0
NAGALAND,2009,INDIAN PASSPORT ACT,0,0,0,0,0,0,0,0,0,0,0,0,0,0,0
NAGALAND,2009,ESSENTIAL COMMODITIES ACT,0,0,0,0,0,0,0,0,0,0,0,0,0,0,0
NAGALAND,2009,ANTIQUITIES AND ART TREASURE ACT,0,0,0,0,0,0,0,0,0,0,0,0,0,0,0
NAGALAND,2009,DOWRY PROHIBITION ACT,0,0,0,0,0,0,0,0,0,0,0,0,0,0,0
NAGALAND,2009,FOREIGN EXCHANGE REGULATION ACT-1973,0,0,0,0,0,0,0,0,0,0,0,0,0,0,0
NAGALAND,2009,PREVENTION OF CORRUPTION ACT-1988,0,0,0,0,0,0,0,0,0,0,0,0,0,0,0
NAGALAND,2009,CONSER.OF FORGN.EXCH.&PREV. OF SMUG.ACT,0,0,0,0,0,0,0,0,0,0,0,0,0,0,0
NAGALAND,2009,OTHER SLL OFFENCE,0,0,0,0,0,0,0,0,0,0,0,0,0,0,0
NAGALAND,2009,TOTAL,0,0,0,38,3,41,43,0,43,7,0,7,88,3,91
NAGALAND,2010,ARMS ACT,0,0,0,5,0,5,10,0,10,7,0,7,22,0,22
NAGALAND,2010,N.D.P.S. ACT,0,0,0,9,0,9,15,0,15,5,0,5,29,0,29
NAGALAND,2010,GAMBLING ACT,0,0,0,0,0,0,0,0,0,0,0,0,0,0,0
NAGALAND,2010,EXCISE ACT,0,0,0,6,4,10,8,4,12,9,0,9,23,8,31
NAGALAND,2010,PROHIBITION ACT,0,0,0,5,3,8,10,0,10,6,0,6,21,3,24
NAGALAND,2010,EXPLOSIVE & EXPLOSIVE SUBST. ACT,0,0,0,0,0,0,0,0,0,2,0,2,2,0,2
NAGALAND,2010,TERRORIST & DISRUPTIVE ACTIVITIES (TATA),0,0,0,0,0,0,0,0,0,0,0,0,0,0,0
NAGALAND,2010,IMMORAL TRAFFIC (PREVENTION) ACT,0,0,0,0,0,0,4,2,6,0,0,0,4,2,6
NAGALAND,2010,INDIAN RAILWAYS ACT,0,0,0,0,0,0,0,0,0,0,0,0,0,0,0
NAGALAND,2010,REGISTRATION OF FOREIGNERS ACT,0,0,0,0,0,0,0,0,0,0,0,0,0,0,0
NAGALAND,2010,PROTECTION OF CIVIL RIGHTS ACT,0,0,0,0,0,0,0,0,0,0,0,0,0,0,0
NAGALAND,2010,SC/ST (PREVENTION OF ATROCITIES) ACT,0,0,0,0,0,0,0,0,0,0,0,0,0,0,0
NAGALAND,2010,INDIAN PASSPORT ACT,0,0,0,0,0,0,0,0,0,0,0,0,0,0,0
NAGALAND,2010,ESSENTIAL COMMODITIES ACT,0,0,0,0,0,0,0,0,0,0,0,0,0,0,0
NAGALAND,2010,ANTIQUITIES AND ART TREASURE ACT,0,0,0,0,0,0,0,0,0,0,0,0,0,0,0
NAGALAND,2010,DOWRY PROHIBITION ACT,0,0,0,0,0,0,0,0,0,0,0,0,0,0,0
NAGALAND,2010,FOREIGN EXCHANGE REGULATION ACT-1973,0,0,0,0,0,0,0,0,0,0,0,0,0,0,0
NAGALAND,2010,PREVENTION OF CORRUPTION ACT-1988,0,0,0,0,0,0,0,0,0,0,0,0,0,0,0
NAGALAND,2010,CONSER.OF FORGN.EXCH.&PREV. OF SMUG.ACT,0,0,0,0,0,0,0,0,0,0,0,0,0,0,0
NAGALAND,2010,OTHER SLL OFFENCE,0,0,0,0,0,0,0,0,0,4,0,4,4,0,4
NAGALAND,2010,TOTAL,0,0,0,25,7,32,47,6,53,33,0,33,105,13,118
NAGALAND,2011,ARMS ACT,0,0,0,6,0,6,8,0,8,0,0,0,14,0,14
NAGALAND,2011,N.D.P.S. ACT,0,0,0,4,0,4,3,0,3,1,0,1,8,0,8
NAGALAND,2011,GAMBLING ACT,0,0,0,0,0,0,0,0,0,0,0,0,0,0,0
NAGALAND,2011,EXCISE ACT,0,0,0,0,0,0,0,0,0,0,0,0,0,0,0
NAGALAND,2011,PROHIBITION ACT,0,0,0,0,0,0,0,0,0,0,0,0,0,0,0
NAGALAND,2011,EXPLOSIVE & EXPLOSIVE SUBST. ACT,0,0,0,2,0,2,0,0,0,0,0,0,2,0,2
NAGALAND,2011,TERRORIST & DISRUPTIVE ACTIVITIES (TATA),0,0,0,0,0,0,0,0,0,0,0,0,0,0,0
NAGALAND,2011,IMMORAL TRAFFIC (PREVENTION) ACT,0,0,0,0,0,0,0,0,0,0,0,0,0,0,0
NAGALAND,2011,INDIAN RAILWAYS ACT,0,0,0,0,0,0,0,0,0,0,0,0,0,0,0
NAGALAND,2011,REGISTRATION OF FOREIGNERS ACT,0,0,0,0,0,0,0,0,0,0,0,0,0,0,0
NAGALAND,2011,PROTECTION OF CIVIL RIGHTS ACT,0,0,0,0,0,0,0,0,0,0,0,0,0,0,0
NAGALAND,2011,SC/ST (PREVENTION OF ATROCITIES) ACT,0,0,0,0,0,0,0,0,0,0,0,0,0,0,0
NAGALAND,2011,INDIAN PASSPORT ACT,0,0,0,0,0,0,0,0,0,0,0,0,0,0,0
NAGALAND,2011,ESSENTIAL COMMODITIES ACT,0,0,0,0,0,0,0,0,0,0,0,0,0,0,0
NAGALAND,2011,ANTIQUITIES AND ART TREASURE ACT,0,0,0,0,0,0,0,0,0,0,0,0,0,0,0
NAGALAND,2011,DOWRY PROHIBITION ACT,0,0,0,0,0,0,0,0,0,0,0,0,0,0,0
NAGALAND,2011,FOREIGN EXCHANGE REGULATION ACT-1973,0,0,0,0,0,0,0,0,0,0,0,0,0,0,0
NAGALAND,2011,PREVENTION OF CORRUPTION ACT-1988,0,0,0,0,0,0,0,0,0,0,0,0,0,0,0
NAGALAND,2011,CONSER.OF FORGN.EXCH.&PREV. OF SMUG.ACT,0,0,0,0,0,0,0,0,0,0,0,0,0,0,0
NAGALAND,2011,OTHER SLL OFFENCE,0,0,0,1,0,1,1,0,1,0,0,0,2,0,2
NAGALAND,2011,TOTAL,0,0,0,13,0,13,12,0,12,1,0,1,26,0,26
NAGALAND,2012,ARMS ACT,0,0,0,3,0,3,1,0,1,0,0,0,4,0,4
NAGALAND,2012,N.D.P.S. ACT,0,0,0,9,0,9,2,0,2,0,0,0,11,0,11
NAGALAND,2012,GAMBLING ACT,0,0,0,0,0,0,0,0,0,0,0,0,0,0,0
NAGALAND,2012,EXCISE ACT,0,0,0,0,0,0,0,0,0,0,0,0,0,0,0
NAGALAND,2012,PROHIBITION ACT,0,0,0,2,0,2,0,0,0,0,0,0,2,0,2
NAGALAND,2012,EXPLOSIVE & EXPLOSIVE SUBST. ACT,0,0,0,0,0,0,0,0,0,0,0,0,0,0,0
NAGALAND,2012,TERRORIST & DISRUPTIVE ACTIVITIES (TATA),0,0,0,0,0,0,0,0,0,0,0,0,0,0,0
NAGALAND,2012,IMMORAL TRAFFIC (PREVENTION) ACT,0,0,0,0,0,0,0,0,0,0,0,0,0,0,0
NAGALAND,2012,INDIAN RAILWAYS ACT,0,0,0,0,0,0,0,0,0,0,0,0,0,0,0
NAGALAND,2012,REGISTRATION OF FOREIGNERS ACT,0,0,0,0,0,0,0,0,0,0,0,0,0,0,0
NAGALAND,2012,PROTECTION OF CIVIL RIGHTS ACT,0,0,0,0,0,0,0,0,0,0,0,0,0,0,0
NAGALAND,2012,SC/ST (PREVENTION OF ATROCITIES) ACT,0,0,0,0,0,0,0,0,0,0,0,0,0,0,0
NAGALAND,2012,INDIAN PASSPORT ACT,0,0,0,0,0,0,0,0,0,0,0,0,0,0,0
NAGALAND,2012,ESSENTIAL COMMODITIES ACT,0,0,0,0,0,0,0,0,0,0,0,0,0,0,0
NAGALAND,2012,ANTIQUITIES AND ART TREASURE ACT,0,0,0,0,0,0,0,0,0,0,0,0,0,0,0
NAGALAND,2012,DOWRY PROHIBITION ACT,0,0,0,0,0,0,0,0,0,0,0,0,0,0,0
NAGALAND,2012,FOREIGN EXCHANGE REGULATION ACT-1973,0,0,0,0,0,0,0,0,0,0,0,0,0,0,0
NAGALAND,2012,PREVENTION OF CORRUPTION ACT-1988,0,0,0,0,0,0,0,0,0,0,0,0,0,0,0
NAGALAND,2012,CONSER.OF FORGN.EXCH.&PREV. OF SMUG.ACT,0,0,0,0,0,0,0,0,0,0,0,0,0,0,0
NAGALAND,2012,OTHER SLL OFFENCE,0,0,0,2,0,2,0,0,0,0,0,0,2,0,2
NAGALAND,2012,TOTAL,0,0,0,16,0,16,3,0,3,0,0,0,19,0,19
ORISSA,2001,ARMS ACT,0,0,0,85,1,86,46,0,46,7,0,7,138,1,139
ORISSA,2001,N.D.P.S. ACT,0,0,0,105,4,109,128,7,135,16,1,17,249,12,261
ORISSA,2001,GAMBLING ACT,0,0,0,3,0,3,0,0,0,0,0,0,3,0,3
ORISSA,2001,EXCISE ACT,0,0,0,227,0,227,251,0,251,44,4,48,522,4,526
ORISSA,2001,PROHIBITION ACT,0,0,0,7,0,7,0,0,0,0,0,0,7,0,7
ORISSA,2001,EXPLOSIVE & EXPLOSIVE SUBST. ACT,0,0,0,4,0,4,5,0,5,0,0,0,9,0,9
ORISSA,2001,TERRORIST & DISRUPTIVE ACTIVITIES (TATA),0,0,0,0,0,0,0,0,0,0,0,0,0,0,0
ORISSA,2001,IMMORAL TRAFFIC (PREVENTION) ACT,0,0,0,5,0,5,0,0,0,0,0,0,5,0,5
ORISSA,2001,INDIAN RAILWAYS ACT,0,0,0,42,0,42,29,0,29,1,0,1,72,0,72
ORISSA,2001,REGISTRATION OF FOREIGNERS ACT,0,0,0,1,0,1,2,0,2,1,0,1,4,0,4
ORISSA,2001,PROTECTION OF CIVIL RIGHTS ACT,0,0,0,0,0,0,0,0,0,0,0,0,0,0,0
ORISSA,2001,SC/ST (PREVENTION OF ATROCITIES) ACT,0,0,0,0,0,0,3,0,3,0,0,0,3,0,3
ORISSA,2001,INDIAN PASSPORT ACT,0,0,0,42,0,42,35,0,35,7,0,7,84,0,84
ORISSA,2001,ESSENTIAL COMMODITIES ACT,0,0,0,3,0,3,3,0,3,0,0,0,6,0,6
ORISSA,2001,ANTIQUITIES AND ART TREASURE ACT,0,0,0,0,0,0,3,0,3,0,0,0,3,0,3
ORISSA,2001,DOWRY PROHIBITION ACT,0,0,0,34,7,41,48,6,54,10,6,16,92,19,111
ORISSA,2001,FOREIGN EXCHANGE REGULATION ACT-1973,0,0,0,0,0,0,0,0,0,0,0,0,0,0,0
ORISSA,2001,PREVENTION OF CORRUPTION ACT-1988,0,0,0,5,0,5,2,0,2,0,0,0,7,0,7
ORISSA,2001,CONSER.OF FORGN.EXCH.&PREV. OF SMUG.ACT,0,0,0,4,0,4,0,0,0,0,0,0,4,0,4
ORISSA,2001,OTHER SLL OFFENCE,7,0,7,306,8,314,191,5,196,261,0,261,765,13,778
ORISSA,2001,TOTAL,7,0,7,873,20,893,746,18,764,347,11,358,1973,49,2022
ORISSA,2002,ARMS ACT,0,0,0,63,0,63,81,3,84,67,0,67,211,3,214
ORISSA,2002,N.D.P.S. ACT,0,0,0,51,0,51,145,1,146,14,0,14,210,1,211
ORISSA,2002,GAMBLING ACT,0,0,0,0,0,0,0,0,0,0,0,0,0,0,0
ORISSA,2002,EXCISE ACT,0,0,0,161,2,163,219,8,227,53,3,56,433,13,446
ORISSA,2002,PROHIBITION ACT,0,0,0,0,0,0,0,0,0,0,0,0,0,0,0
ORISSA,2002,EXPLOSIVE & EXPLOSIVE SUBST. ACT,0,0,0,3,0,3,2,0,2,1,0,1,6,0,6
ORISSA,2002,TERRORIST & DISRUPTIVE ACTIVITIES (TATA),0,0,0,0,0,0,0,0,0,0,0,0,0,0,0
ORISSA,2002,IMMORAL TRAFFIC (PREVENTION) ACT,0,0,0,0,0,0,0,0,0,0,0,0,0,0,0
ORISSA,2002,INDIAN RAILWAYS ACT,0,0,0,34,3,37,39,7,46,34,2,36,107,12,119
ORISSA,2002,REGISTRATION OF FOREIGNERS ACT,0,0,0,0,0,0,0,0,0,0,0,0,0,0,0
ORISSA,2002,PROTECTION OF CIVIL RIGHTS ACT,0,0,0,0,0,0,0,0,0,0,0,0,0,0,0
ORISSA,2002,SC/ST (PREVENTION OF ATROCITIES) ACT,0,0,0,0,0,0,12,0,12,2,0,2,14,0,14
ORISSA,2002,INDIAN PASSPORT ACT,0,0,0,24,1,25,31,0,31,33,0,33,88,1,89
ORISSA,2002,ESSENTIAL COMMODITIES ACT,0,0,0,3,0,3,0,0,0,3,0,3,6,0,6
ORISSA,2002,ANTIQUITIES AND ART TREASURE ACT,0,0,0,0,0,0,0,0,0,0,0,0,0,0,0
ORISSA,2002,DOWRY PROHIBITION ACT,0,0,0,42,5,47,61,3,64,17,0,17,120,8,128
ORISSA,2002,FOREIGN EXCHANGE REGULATION ACT-1973,0,0,0,7,0,7,6,0,6,2,0,2,15,0,15
ORISSA,2002,PREVENTION OF CORRUPTION ACT-1988,0,0,0,0,0,0,0,0,0,0,0,0,0,0,0
ORISSA,2002,CONSER.OF FORGN.EXCH.&PREV. OF SMUG.ACT,0,0,0,3,0,3,12,0,12,0,0,0,15,0,15
ORISSA,2002,OTHER SLL OFFENCE,0,0,0,175,0,175,245,10,255,172,2,174,592,12,604
ORISSA,2002,TOTAL,0,0,0,566,11,577,853,32,885,398,7,405,1817,50,1867
ORISSA,2003,ARMS ACT,0,0,0,14,3,17,93,2,95,39,0,39,146,5,151
ORISSA,2003,N.D.P.S. ACT,0,0,0,12,0,12,111,0,111,41,0,41,164,0,164
ORISSA,2003,GAMBLING ACT,0,0,0,0,0,0,0,0,0,0,0,0,0,0,0
ORISSA,2003,EXCISE ACT,0,0,0,54,0,54,103,2,105,42,0,42,199,2,201
ORISSA,2003,PROHIBITION ACT,0,0,0,0,0,0,0,0,0,0,0,0,0,0,0
ORISSA,2003,EXPLOSIVE & EXPLOSIVE SUBST. ACT,0,0,0,4,0,4,6,0,6,2,0,2,12,0,12
ORISSA,2003,TERRORIST & DISRUPTIVE ACTIVITIES (TATA),0,0,0,0,0,0,0,0,0,0,0,0,0,0,0
ORISSA,2003,IMMORAL TRAFFIC (PREVENTION) ACT,0,0,0,0,0,0,0,0,0,0,0,0,0,0,0
ORISSA,2003,INDIAN RAILWAYS ACT,0,0,0,32,7,39,81,0,81,34,0,34,147,7,154
ORISSA,2003,REGISTRATION OF FOREIGNERS ACT,0,0,0,0,0,0,0,0,0,0,0,0,0,0,0
ORISSA,2003,PROTECTION OF CIVIL RIGHTS ACT,0,0,0,0,0,0,0,0,0,0,0,0,0,0,0
ORISSA,2003,SC/ST (PREVENTION OF ATROCITIES) ACT,0,0,0,24,0,24,38,0,38,12,0,12,74,0,74
ORISSA,2003,INDIAN PASSPORT ACT,0,0,0,0,0,0,0,0,0,2,0,2,2,0,2
ORISSA,2003,ESSENTIAL COMMODITIES ACT,0,0,0,0,0,0,0,0,0,0,0,0,0,0,0
ORISSA,2003,ANTIQUITIES AND ART TREASURE ACT,0,0,0,0,0,0,0,0,0,0,0,0,0,0,0
ORISSA,2003,DOWRY PROHIBITION ACT,0,0,0,31,6,37,53,10,63,24,0,24,108,16,124
ORISSA,2003,FOREIGN EXCHANGE REGULATION ACT-1973,0,0,0,0,0,0,0,0,0,0,0,0,0,0,0
ORISSA,2003,PREVENTION OF CORRUPTION ACT-1988,0,0,0,0,0,0,0,0,0,0,0,0,0,0,0
ORISSA,2003,CONSER.OF FORGN.EXCH.&PREV. OF SMUG.ACT,0,0,0,0,0,0,0,0,0,0,0,0,0,0,0
ORISSA,2003,OTHER SLL OFFENCE,0,0,0,0,0,0,27,3,30,23,0,23,50,3,53
ORISSA,2003,TOTAL,0,0,0,171,16,187,512,17,529,219,0,219,902,33,935
ORISSA,2004,ARMS ACT,0,0,0,46,0,46,37,12,49,2,0,2,85,12,97
ORISSA,2004,N.D.P.S. ACT,0,0,0,86,4,90,85,6,91,15,1,16,186,11,197
ORISSA,2004,GAMBLING ACT,0,0,0,0,0,0,0,0,0,0,0,0,0,0,0
ORISSA,2004,EXCISE ACT,0,0,0,82,1,83,60,0,60,25,1,26,167,2,169
ORISSA,2004,PROHIBITION ACT,0,0,0,0,0,0,0,0,0,0,0,0,0,0,0
ORISSA,2004,EXPLOSIVE & EXPLOSIVE SUBST. ACT,0,0,0,10,0,10,2,2,4,0,0,0,12,2,14
ORISSA,2004,TERRORIST & DISRUPTIVE ACTIVITIES (TATA),0,0,0,0,0,0,0,0,0,0,0,0,0,0,0
ORISSA,2004,IMMORAL TRAFFIC (PREVENTION) ACT,0,0,0,5,0,5,3,3,6,0,0,0,8,3,11
ORISSA,2004,INDIAN RAILWAYS ACT,0,0,0,31,0,31,24,0,24,1,0,1,56,0,56
ORISSA,2004,REGISTRATION OF FOREIGNERS ACT,0,0,0,0,0,0,0,0,0,0,0,0,0,0,0
ORISSA,2004,PROTECTION OF CIVIL RIGHTS ACT,0,0,0,0,0,0,0,0,0,0,0,0,0,0,0
ORISSA,2004,SC/ST (PREVENTION OF ATROCITIES) ACT,0,0,0,15,0,15,12,2,14,1,0,1,28,2,30
ORISSA,2004,INDIAN PASSPORT ACT,0,0,0,0,0,0,0,0,0,0,0,0,0,0,0
ORISSA,2004,ESSENTIAL COMMODITIES ACT,0,0,0,1,0,1,4,0,4,0,0,0,5,0,5
ORISSA,2004,ANTIQUITIES AND ART TREASURE ACT,0,0,0,0,0,0,0,0,0,0,0,0,0,0,0
ORISSA,2004,DOWRY PROHIBITION ACT,0,0,0,32,3,35,22,2,24,0,0,0,54,5,59
ORISSA,2004,FOREIGN EXCHANGE REGULATION ACT-1973,0,0,0,0,0,0,0,0,0,0,0,0,0,0,0
ORISSA,2004,PREVENTION OF CORRUPTION ACT-1988,0,0,0,4,0,4,2,1,3,1,0,1,7,1,8
ORISSA,2004,CONSER.OF FORGN.EXCH.&PREV. OF SMUG.ACT,0,0,0,0,0,0,0,0,0,0,0,0,0,0,0
ORISSA,2004,OTHER SLL OFFENCE,0,0,0,64,0,64,50,11,61,0,0,0,114,11,125
ORISSA,2004,TOTAL,0,0,0,376,8,384,301,39,340,45,2,47,722,49,771
ORISSA,2005,ARMS ACT,0,0,0,19,0,19,34,3,37,8,6,14,61,9,70
ORISSA,2005,N.D.P.S. ACT,0,0,0,104,4,108,102,4,106,11,0,11,217,8,225
ORISSA,2005,GAMBLING ACT,0,0,0,7,0,7,9,0,9,5,0,5,21,0,21
ORISSA,2005,EXCISE ACT,0,0,0,68,1,69,113,9,122,17,1,18,198,11,209
ORISSA,2005,PROHIBITION ACT,0,0,0,0,0,0,2,0,2,0,0,0,2,0,2
ORISSA,2005,EXPLOSIVE & EXPLOSIVE SUBST. ACT,0,0,0,5,0,5,0,0,0,0,0,0,5,0,5
ORISSA,2005,TERRORIST & DISRUPTIVE ACTIVITIES (TATA),0,0,0,0,0,0,0,0,0,0,0,0,0,0,0
ORISSA,2005,IMMORAL TRAFFIC (PREVENTION) ACT,0,0,0,1,0,1,0,0,0,0,0,0,1,0,1
ORISSA,2005,INDIAN RAILWAYS ACT,0,0,0,47,0,47,22,0,22,0,0,0,69,0,69
ORISSA,2005,REGISTRATION OF FOREIGNERS ACT,0,0,0,0,0,0,0,0,0,0,0,0,0,0,0
ORISSA,2005,PROTECTION OF CIVIL RIGHTS ACT,0,0,0,2,0,2,8,0,8,0,0,0,10,0,10
ORISSA,2005,SC/ST (PREVENTION OF ATROCITIES) ACT,0,0,0,7,0,7,26,2,28,0,0,0,33,2,35
ORISSA,2005,INDIAN PASSPORT ACT,0,0,0,0,0,0,0,0,0,0,0,0,0,0,0
ORISSA,2005,ESSENTIAL COMMODITIES ACT,0,0,0,19,0,19,7,0,7,1,0,1,27,0,27
ORISSA,2005,ANTIQUITIES AND ART TREASURE ACT,0,0,0,4,0,4,2,0,2,0,0,0,6,0,6
ORISSA,2005,DOWRY PROHIBITION ACT,0,0,0,35,3,38,15,3,18,26,3,29,76,9,85
ORISSA,2005,FOREIGN EXCHANGE REGULATION ACT-1973,0,0,0,0,0,0,0,0,0,0,0,0,0,0,0
ORISSA,2005,PREVENTION OF CORRUPTION ACT-1988,0,0,0,9,0,9,3,0,3,0,0,0,12,0,12
ORISSA,2005,CONSER.OF FORGN.EXCH.&PREV. OF SMUG.ACT,0,0,0,0,0,0,0,0,0,0,0,0,0,0,0
ORISSA,2005,OTHER SLL OFFENCE,0,0,0,66,0,66,18,0,18,6,0,6,90,0,90
ORISSA,2005,TOTAL,0,0,0,393,8,401,361,21,382,74,10,84,828,39,867
ORISSA,2006,ARMS ACT,0,0,0,29,0,29,52,0,52,14,0,14,95,0,95
ORISSA,2006,N.D.P.S. ACT,0,0,0,123,1,124,101,7,108,13,0,13,237,8,245
ORISSA,2006,GAMBLING ACT,0,0,0,5,0,5,2,0,2,0,0,0,7,0,7
ORISSA,2006,EXCISE ACT,0,0,0,76,1,77,137,8,145,12,0,12,225,9,234
ORISSA,2006,PROHIBITION ACT,0,0,0,3,0,3,8,0,8,0,0,0,11,0,11
ORISSA,2006,EXPLOSIVE & EXPLOSIVE SUBST. ACT,0,0,0,23,0,23,12,0,12,0,0,0,35,0,35
ORISSA,2006,TERRORIST & DISRUPTIVE ACTIVITIES (TATA),0,0,0,0,0,0,0,0,0,0,0,0,0,0,0
ORISSA,2006,IMMORAL TRAFFIC (PREVENTION) ACT,0,0,0,3,0,3,1,0,1,0,0,0,4,0,4
ORISSA,2006,INDIAN RAILWAYS ACT,0,0,0,48,0,48,21,0,21,0,0,0,69,0,69
ORISSA,2006,REGISTRATION OF FOREIGNERS ACT,0,0,0,0,0,0,0,0,0,0,0,0,0,0,0
ORISSA,2006,PROTECTION OF CIVIL RIGHTS ACT,0,0,0,2,0,2,2,0,2,0,0,0,4,0,4
ORISSA,2006,SC/ST (PREVENTION OF ATROCITIES) ACT,0,0,0,9,0,9,35,3,38,1,0,1,45,3,48
ORISSA,2006,INDIAN PASSPORT ACT,0,0,0,0,0,0,0,0,0,0,0,0,0,0,0
ORISSA,2006,ESSENTIAL COMMODITIES ACT,0,0,0,31,0,31,8,0,8,1,0,1,40,0,40
ORISSA,2006,ANTIQUITIES AND ART TREASURE ACT,0,0,0,3,0,3,2,0,2,0,0,0,5,0,5
ORISSA,2006,DOWRY PROHIBITION ACT,0,0,0,52,1,53,27,0,27,4,0,4,83,1,84
ORISSA,2006,FOREIGN EXCHANGE REGULATION ACT-1973,0,0,0,0,0,0,0,0,0,0,0,0,0,0,0
ORISSA,2006,PREVENTION OF CORRUPTION ACT-1988,0,0,0,5,0,5,22,0,22,3,0,3,30,0,30
ORISSA,2006,CONSER.OF FORGN.EXCH.&PREV. OF SMUG.ACT,0,0,0,0,0,0,0,0,0,0,0,0,0,0,0
ORISSA,2006,OTHER SLL OFFENCE,0,0,0,73,5,78,38,2,40,0,5,5,111,12,123
ORISSA,2006,TOTAL,0,0,0,485,8,493,468,20,488,48,5,53,1001,33,1034
ORISSA,2007,ARMS ACT,0,0,0,32,0,32,46,0,46,16,0,16,94,0,94
ORISSA,2007,N.D.P.S. ACT,0,0,0,141,1,142,102,7,109,15,0,15,258,8,266
ORISSA,2007,GAMBLING ACT,0,0,0,6,0,6,2,0,2,0,0,0,8,0,8
ORISSA,2007,EXCISE ACT,0,0,0,82,1,83,126,8,134,14,0,14,222,9,231
ORISSA,2007,PROHIBITION ACT,0,0,0,3,0,3,8,0,8,0,0,0,11,0,11
ORISSA,2007,EXPLOSIVE & EXPLOSIVE SUBST. ACT,0,0,0,28,0,28,18,1,19,2,0,2,48,1,49
ORISSA,2007,TERRORIST & DISRUPTIVE ACTIVITIES (TATA),0,0,0,0,0,0,0,0,0,0,0,0,0,0,0
ORISSA,2007,IMMORAL TRAFFIC (PREVENTION) ACT,0,0,0,3,0,3,1,0,1,0,0,0,4,0,4
ORISSA,2007,INDIAN RAILWAYS ACT,0,0,0,52,0,52,31,0,31,0,0,0,83,0,83
ORISSA,2007,REGISTRATION OF FOREIGNERS ACT,0,0,0,0,0,0,0,0,0,0,0,0,0,0,0
ORISSA,2007,PROTECTION OF CIVIL RIGHTS ACT,0,0,0,2,0,2,2,0,2,0,0,0,4,0,4
ORISSA,2007,SC/ST (PREVENTION OF ATROCITIES) ACT,0,0,0,12,0,12,34,3,37,1,0,1,47,3,50
ORISSA,2007,INDIAN PASSPORT ACT,0,0,0,0,0,0,0,0,0,0,0,0,0,0,0
ORISSA,2007,ESSENTIAL COMMODITIES ACT,0,0,0,30,0,30,6,0,6,1,0,1,37,0,37
ORISSA,2007,ANTIQUITIES AND ART TREASURE ACT,0,0,0,3,0,3,2,0,2,0,0,0,5,0,5
ORISSA,2007,DOWRY PROHIBITION ACT,0,0,0,82,1,83,27,4,31,4,0,4,113,5,118
ORISSA,2007,FOREIGN EXCHANGE REGULATION ACT-1973,0,0,0,0,0,0,0,0,0,0,0,0,0,0,0
ORISSA,2007,PREVENTION OF CORRUPTION ACT-1988,0,0,0,5,0,5,12,0,12,3,0,3,20,0,20
ORISSA,2007,CONSER.OF FORGN.EXCH.&PREV. OF SMUG.ACT,0,0,0,0,0,0,0,0,0,0,0,0,0,0,0
ORISSA,2007,OTHER SLL OFFENCE,0,0,0,85,5,90,26,3,29,0,3,3,111,11,122
ORISSA,2007,TOTAL,0,0,0,566,8,574,443,26,469,56,3,59,1065,37,1102
ORISSA,2008,ARMS ACT,0,0,0,30,0,30,46,0,46,2,0,2,78,0,78
ORISSA,2008,N.D.P.S. ACT,0,0,0,121,1,122,102,2,104,1,0,1,224,3,227
ORISSA,2008,GAMBLING ACT,0,0,0,1,0,1,2,0,2,0,0,0,3,0,3
ORISSA,2008,EXCISE ACT,0,0,0,75,1,76,126,3,129,0,0,0,201,4,205
ORISSA,2008,PROHIBITION ACT,0,0,0,2,0,2,8,0,8,0,0,0,10,0,10
ORISSA,2008,EXPLOSIVE & EXPLOSIVE SUBST. ACT,0,0,0,20,0,20,18,0,18,0,0,0,38,0,38
ORISSA,2008,TERRORIST & DISRUPTIVE ACTIVITIES (TATA),0,0,0,0,0,0,0,0,0,0,0,0,0,0,0
ORISSA,2008,IMMORAL TRAFFIC (PREVENTION) ACT,0,0,0,1,0,1,1,0,1,0,0,0,2,0,2
ORISSA,2008,INDIAN RAILWAYS ACT,0,0,0,32,0,32,28,0,28,0,0,0,60,0,60
ORISSA,2008,REGISTRATION OF FOREIGNERS ACT,0,0,0,0,0,0,0,0,0,0,0,0,0,0,0
ORISSA,2008,PROTECTION OF CIVIL RIGHTS ACT,0,0,0,2,0,2,2,0,2,0,0,0,4,0,4
ORISSA,2008,SC/ST (PREVENTION OF ATROCITIES) ACT,0,0,0,10,0,10,21,3,24,0,0,0,31,3,34
ORISSA,2008,INDIAN PASSPORT ACT,0,0,0,0,0,0,0,0,0,0,0,0,0,0,0
ORISSA,2008,ESSENTIAL COMMODITIES ACT,0,0,0,24,0,24,3,0,3,0,0,0,27,0,27
ORISSA,2008,ANTIQUITIES AND ART TREASURE ACT,0,0,0,3,0,3,1,0,1,0,0,0,4,0,4
ORISSA,2008,DOWRY PROHIBITION ACT,0,0,0,61,0,61,25,1,26,1,0,1,87,1,88
ORISSA,2008,FOREIGN EXCHANGE REGULATION ACT-1973,0,0,0,0,0,0,0,0,0,0,0,0,0,0,0
ORISSA,2008,PREVENTION OF CORRUPTION ACT-1988,0,0,0,2,0,2,8,0,8,0,0,0,10,0,10
ORISSA,2008,CONSER.OF FORGN.EXCH.&PREV. OF SMUG.ACT,0,0,0,0,0,0,0,0,0,0,0,0,0,0,0
ORISSA,2008,OTHER SLL OFFENCE,0,0,0,52,1,53,23,1,24,0,0,0,75,2,77
ORISSA,2008,TOTAL,0,0,0,436,3,439,414,10,424,4,0,4,854,13,867
ORISSA,2009,ARMS ACT,0,0,0,28,0,28,46,0,46,3,0,3,77,0,77
ORISSA,2009,N.D.P.S. ACT,0,0,0,115,0,115,102,1,103,1,0,1,218,1,219
ORISSA,2009,GAMBLING ACT,0,0,0,0,0,0,2,0,2,0,0,0,2,0,2
ORISSA,2009,EXCISE ACT,0,0,0,62,1,63,126,1,127,0,0,0,188,2,190
ORISSA,2009,PROHIBITION ACT,0,0,0,0,0,0,8,0,8,0,0,0,8,0,8
ORISSA,2009,EXPLOSIVE & EXPLOSIVE SUBST. ACT,0,0,0,12,0,12,18,0,18,0,0,0,30,0,30
ORISSA,2009,TERRORIST & DISRUPTIVE ACTIVITIES (TATA),0,0,0,0,0,0,0,0,0,0,0,0,0,0,0
ORISSA,2009,IMMORAL TRAFFIC (PREVENTION) ACT,0,0,0,0,0,0,1,0,1,0,0,0,1,0,1
ORISSA,2009,INDIAN RAILWAYS ACT,0,0,0,15,0,15,28,0,28,0,0,0,43,0,43
ORISSA,2009,REGISTRATION OF FOREIGNERS ACT,0,0,0,0,0,0,0,0,0,0,0,0,0,0,0
ORISSA,2009,PROTECTION OF CIVIL RIGHTS ACT,0,0,0,2,0,2,2,0,2,0,0,0,4,0,4
ORISSA,2009,SC/ST (PREVENTION OF ATROCITIES) ACT,0,0,0,8,0,8,21,3,24,0,0,0,29,3,32
ORISSA,2009,INDIAN PASSPORT ACT,0,0,0,0,0,0,0,0,0,0,0,0,0,0,0
ORISSA,2009,ESSENTIAL COMMODITIES ACT,0,0,0,8,0,8,3,0,3,0,0,0,11,0,11
ORISSA,2009,ANTIQUITIES AND ART TREASURE ACT,0,0,0,3,0,3,1,0,1,0,0,0,4,0,4
ORISSA,2009,DOWRY PROHIBITION ACT,0,0,0,45,0,45,25,1,26,1,0,1,71,1,72
ORISSA,2009,FOREIGN EXCHANGE REGULATION ACT-1973,0,0,0,0,0,0,0,0,0,0,0,0,0,0,0
ORISSA,2009,PREVENTION OF CORRUPTION ACT-1988,0,0,0,0,0,0,3,0,3,0,0,0,3,0,3
ORISSA,2009,CONSER.OF FORGN.EXCH.&PREV. OF SMUG.ACT,0,0,0,0,0,0,0,0,0,0,0,0,0,0,0
ORISSA,2009,OTHER SLL OFFENCE,0,0,0,45,1,46,33,1,34,1,0,1,79,2,81
ORISSA,2009,TOTAL,0,0,0,343,2,345,419,7,426,6,0,6,768,9,777
ORISSA,2010,ARMS ACT,0,0,0,27,0,27,43,0,43,3,0,3,73,0,73
ORISSA,2010,N.D.P.S. ACT,0,0,0,113,0,113,91,1,92,1,0,1,205,1,206
ORISSA,2010,GAMBLING ACT,0,0,0,0,0,0,0,0,0,0,0,0,0,0,0
ORISSA,2010,EXCISE ACT,0,0,0,60,1,61,113,1,114,0,0,0,173,2,175
ORISSA,2010,PROHIBITION ACT,0,0,0,0,0,0,2,0,2,0,0,0,2,0,2
ORISSA,2010,EXPLOSIVE & EXPLOSIVE SUBST. ACT,0,0,0,12,0,12,10,0,10,0,0,0,22,0,22
ORISSA,2010,TERRORIST & DISRUPTIVE ACTIVITIES (TATA),0,0,0,0,0,0,0,0,0,0,0,0,0,0,0
ORISSA,2010,IMMORAL TRAFFIC (PREVENTION) ACT,0,0,0,0,0,0,1,0,1,0,0,0,1,0,1
ORISSA,2010,INDIAN RAILWAYS ACT,0,0,0,13,0,13,23,0,23,0,0,0,36,0,36
ORISSA,2010,REGISTRATION OF FOREIGNERS ACT,0,0,0,0,0,0,0,0,0,0,0,0,0,0,0
ORISSA,2010,PROTECTION OF CIVIL RIGHTS ACT,0,0,0,2,0,2,1,0,1,0,0,0,3,0,3
ORISSA,2010,SC/ST (PREVENTION OF ATROCITIES) ACT,0,0,0,6,0,6,17,3,20,0,0,0,23,3,26
ORISSA,2010,INDIAN PASSPORT ACT,0,0,0,0,0,0,0,0,0,0,0,0,0,0,0
ORISSA,2010,ESSENTIAL COMMODITIES ACT,0,0,0,3,0,3,1,0,1,0,0,0,4,0,4
ORISSA,2010,ANTIQUITIES AND ART TREASURE ACT,0,0,0,1,0,1,1,0,1,0,0,0,2,0,2
ORISSA,2010,DOWRY PROHIBITION ACT,0,0,0,23,0,23,19,1,20,1,0,1,43,1,44
ORISSA,2010,FOREIGN EXCHANGE REGULATION ACT-1973,0,0,0,0,0,0,0,0,0,0,0,0,0,0,0
ORISSA,2010,PREVENTION OF CORRUPTION ACT-1988,0,0,0,0,0,0,3,0,3,0,0,0,3,0,3
ORISSA,2010,CONSER.OF FORGN.EXCH.&PREV. OF SMUG.ACT,0,0,0,0,0,0,0,0,0,0,0,0,0,0,0
ORISSA,2010,OTHER SLL OFFENCE,0,0,0,32,1,33,27,1,28,1,0,1,60,2,62
ORISSA,2010,TOTAL,0,0,0,292,2,294,352,7,359,6,0,6,650,9,659
ORISSA,2011,ARMS ACT,0,0,0,27,0,27,43,0,43,3,0,3,73,0,73
ORISSA,2011,N.D.P.S. ACT,0,0,0,115,0,115,93,0,93,2,0,2,210,0,210
ORISSA,2011,GAMBLING ACT,0,0,0,0,0,0,0,0,0,0,0,0,0,0,0
ORISSA,2011,EXCISE ACT,0,0,0,67,1,68,117,1,118,0,0,0,184,2,186
ORISSA,2011,PROHIBITION ACT,0,0,0,0,0,0,2,0,2,0,0,0,2,0,2
ORISSA,2011,EXPLOSIVE & EXPLOSIVE SUBST. ACT,0,0,0,17,0,17,10,0,10,0,0,0,27,0,27
ORISSA,2011,TERRORIST & DISRUPTIVE ACTIVITIES (TATA),0,0,0,0,0,0,0,0,0,0,0,0,0,0,0
ORISSA,2011,IMMORAL TRAFFIC (PREVENTION) ACT,0,0,0,0,0,0,1,0,1,0,0,0,1,0,1
ORISSA,2011,INDIAN RAILWAYS ACT,0,0,0,13,0,13,23,0,23,0,0,0,36,0,36
ORISSA,2011,REGISTRATION OF FOREIGNERS ACT,0,0,0,0,0,0,0,0,0,0,0,0,0,0,0
ORISSA,2011,PROTECTION OF CIVIL RIGHTS ACT,0,0,0,6,0,6,1,0,1,0,0,0,7,0,7
ORISSA,2011,SC/ST (PREVENTION OF ATROCITIES) ACT,0,0,0,6,0,6,17,3,20,0,0,0,23,3,26
ORISSA,2011,INDIAN PASSPORT ACT,0,0,0,0,0,0,0,0,0,0,0,0,0,0,0
ORISSA,2011,ESSENTIAL COMMODITIES ACT,0,0,0,3,0,3,1,0,1,0,0,0,4,0,4
ORISSA,2011,ANTIQUITIES AND ART TREASURE ACT,0,0,0,1,0,1,1,0,1,0,0,0,2,0,2
ORISSA,2011,DOWRY PROHIBITION ACT,0,0,0,23,0,23,19,1,20,1,0,1,43,1,44
ORISSA,2011,FOREIGN EXCHANGE REGULATION ACT-1973,0,0,0,0,0,0,0,0,0,0,0,0,0,0,0
ORISSA,2011,PREVENTION OF CORRUPTION ACT-1988,0,0,0,0,0,0,0,0,0,0,0,0,0,0,0
ORISSA,2011,CONSER.OF FORGN.EXCH.&PREV. OF SMUG.ACT,0,0,0,0,0,0,0,0,0,0,0,0,0,0,0
ORISSA,2011,OTHER SLL OFFENCE,0,0,0,35,2,37,25,3,28,1,0,1,61,5,66
ORISSA,2011,TOTAL,0,0,0,313,3,316,353,8,361,7,0,7,673,11,684
ORISSA,2012,ARMS ACT,0,0,0,37,0,37,53,0,53,3,0,3,93,0,93
ORISSA,2012,N.D.P.S. ACT,0,0,0,105,0,105,83,0,83,2,0,2,190,0,190
ORISSA,2012,GAMBLING ACT,0,0,0,0,0,0,0,0,0,0,0,0,0,0,0
ORISSA,2012,EXCISE ACT,0,0,0,57,1,58,70,1,71,0,0,0,127,2,129
ORISSA,2012,PROHIBITION ACT,0,0,0,0,0,0,12,0,12,0,0,0,12,0,12
ORISSA,2012,EXPLOSIVE & EXPLOSIVE SUBST. ACT,0,0,0,27,0,27,15,0,15,0,0,0,42,0,42
ORISSA,2012,TERRORIST & DISRUPTIVE ACTIVITIES (TATA),0,0,0,0,0,0,0,0,0,0,0,0,0,0,0
ORISSA,2012,IMMORAL TRAFFIC (PREVENTION) ACT,0,0,0,0,0,0,1,0,1,0,0,0,1,0,1
ORISSA,2012,INDIAN RAILWAYS ACT,0,0,0,10,0,10,18,0,18,0,0,0,28,0,28
ORISSA,2012,REGISTRATION OF FOREIGNERS ACT,0,0,0,0,0,0,0,0,0,0,0,0,0,0,0
ORISSA,2012,PROTECTION OF CIVIL RIGHTS ACT,0,0,0,9,0,9,1,0,1,0,0,0,10,0,10
ORISSA,2012,SC/ST (PREVENTION OF ATROCITIES) ACT,0,0,0,6,0,6,14,3,17,0,0,0,20,3,23
ORISSA,2012,INDIAN PASSPORT ACT,0,0,0,0,0,0,0,0,0,0,0,0,0,0,0
ORISSA,2012,ESSENTIAL COMMODITIES ACT,0,0,0,3,0,3,1,0,1,0,0,0,4,0,4
ORISSA,2012,ANTIQUITIES AND ART TREASURE ACT,0,0,0,1,0,1,1,0,1,0,0,0,2,0,2
ORISSA,2012,DOWRY PROHIBITION ACT,0,0,0,28,0,28,24,1,25,1,0,1,53,1,54
ORISSA,2012,FOREIGN EXCHANGE REGULATION ACT-1973,0,0,0,0,0,0,0,0,0,0,0,0,0,0,0
ORISSA,2012,PREVENTION OF CORRUPTION ACT-1988,0,0,0,0,0,0,0,0,0,0,0,0,0,0,0
ORISSA,2012,CONSER.OF FORGN.EXCH.&PREV. OF SMUG.ACT,0,0,0,0,0,0,0,0,0,0,0,0,0,0,0
ORISSA,2012,OTHER SLL OFFENCE,0,0,0,30,1,31,23,3,26,1,0,1,54,4,58
ORISSA,2012,TOTAL,0,0,0,313,2,315,316,8,324,7,0,7,636,10,646
PUNJAB,2001,ARMS ACT,0,0,0,153,28,181,185,5,190,45,15,60,383,48,431
PUNJAB,2001,N.D.P.S. ACT,0,0,0,31,16,47,56,4,60,7,7,14,94,27,121
PUNJAB,2001,GAMBLING ACT,0,0,0,21,0,21,15,0,15,0,0,0,36,0,36
PUNJAB,2001,EXCISE ACT,0,0,0,173,23,196,147,0,147,16,12,28,336,35,371
PUNJAB,2001,PROHIBITION ACT,0,0,0,44,0,44,30,0,30,0,0,0,74,0,74
PUNJAB,2001,EXPLOSIVE & EXPLOSIVE SUBST. ACT,0,0,0,110,0,110,58,0,58,18,0,18,186,0,186
PUNJAB,2001,TERRORIST & DISRUPTIVE ACTIVITIES (TATA),0,0,0,22,11,33,34,0,34,0,0,0,56,11,67
PUNJAB,2001,IMMORAL TRAFFIC (PREVENTION) ACT,0,0,0,24,0,24,28,0,28,6,0,6,58,0,58
PUNJAB,2001,INDIAN RAILWAYS ACT,0,0,0,33,0,33,45,0,45,0,0,0,78,0,78
PUNJAB,2001,REGISTRATION OF FOREIGNERS ACT,0,0,0,0,0,0,0,0,0,0,0,0,0,0,0
PUNJAB,2001,PROTECTION OF CIVIL RIGHTS ACT,0,0,0,18,0,18,17,0,17,0,0,0,35,0,35
PUNJAB,2001,SC/ST (PREVENTION OF ATROCITIES) ACT,0,0,0,0,0,0,0,0,0,0,0,0,0,0,0
PUNJAB,2001,INDIAN PASSPORT ACT,0,0,0,14,6,20,10,0,10,0,0,0,24,6,30
PUNJAB,2001,ESSENTIAL COMMODITIES ACT,0,0,0,50,12,62,75,0,75,38,16,54,163,28,191
PUNJAB,2001,ANTIQUITIES AND ART TREASURE ACT,0,0,0,32,0,32,8,8,16,14,0,14,54,8,62
PUNJAB,2001,DOWRY PROHIBITION ACT,0,0,0,4,0,4,24,0,24,0,0,0,28,0,28
PUNJAB,2001,FOREIGN EXCHANGE REGULATION ACT-1973,0,0,0,24,0,24,8,0,8,20,0,20,52,0,52
PUNJAB,2001,PREVENTION OF CORRUPTION ACT-1988,0,0,0,14,0,14,10,0,10,0,0,0,24,0,24
PUNJAB,2001,CONSER.OF FORGN.EXCH.&PREV. OF SMUG.ACT,0,0,0,13,0,13,0,0,0,0,0,0,13,0,13
PUNJAB,2001,OTHER SLL OFFENCE,0,0,0,0,0,0,16,0,16,0,0,0,16,0,16
PUNJAB,2001,TOTAL,0,0,0,780,96,876,766,17,783,164,50,214,1710,163,1873
PUNJAB,2002,ARMS ACT,0,0,0,269,0,269,7,0,7,14,0,14,290,0,290
PUNJAB,2002,N.D.P.S. ACT,0,0,0,629,40,669,165,28,193,29,11,40,823,79,902
PUNJAB,2002,GAMBLING ACT,0,0,0,166,0,166,35,0,35,2,0,2,203,0,203
PUNJAB,2002,EXCISE ACT,0,0,0,528,28,556,98,13,111,9,3,12,635,44,679
PUNJAB,2002,PROHIBITION ACT,0,0,0,82,0,82,40,15,55,30,10,40,152,25,177
PUNJAB,2002,EXPLOSIVE & EXPLOSIVE SUBST. ACT,0,0,0,0,0,0,0,0,0,0,0,0,0,0,0
PUNJAB,2002,TERRORIST & DISRUPTIVE ACTIVITIES (TATA),0,0,0,0,0,0,0,0,0,0,0,0,0,0,0
PUNJAB,2002,IMMORAL TRAFFIC (PREVENTION) ACT,0,0,0,39,0,39,55,10,65,15,4,19,109,14,123
PUNJAB,2002,INDIAN RAILWAYS ACT,0,0,0,19,0,19,19,0,19,0,0,0,38,0,38
PUNJAB,2002,REGISTRATION OF FOREIGNERS ACT,0,0,0,0,0,0,0,0,0,0,0,0,0,0,0
PUNJAB,2002,PROTECTION OF CIVIL RIGHTS ACT,0,0,0,0,0,0,0,0,0,0,0,0,0,0,0
PUNJAB,2002,SC/ST (PREVENTION OF ATROCITIES) ACT,0,0,0,0,0,0,0,0,0,0,0,0,0,0,0
PUNJAB,2002,INDIAN PASSPORT ACT,0,0,0,39,0,39,2,0,2,0,0,0,41,0,41
PUNJAB,2002,ESSENTIAL COMMODITIES ACT,0,0,0,14,0,14,5,0,5,0,0,0,19,0,19
PUNJAB,2002,ANTIQUITIES AND ART TREASURE ACT,0,0,0,5,0,5,0,0,0,0,0,0,5,0,5
PUNJAB,2002,DOWRY PROHIBITION ACT,0,0,0,150,0,150,26,0,26,5,0,5,181,0,181
PUNJAB,2002,FOREIGN EXCHANGE REGULATION ACT-1973,0,0,0,0,0,0,0,0,0,0,0,0,0,0,0
PUNJAB,2002,PREVENTION OF CORRUPTION ACT-1988,0,0,0,196,0,196,129,0,129,81,0,81,406,0,406
PUNJAB,2002,CONSER.OF FORGN.EXCH.&PREV. OF SMUG.ACT,0,0,0,24,0,24,29,0,29,6,0,6,59,0,59
PUNJAB,2002,OTHER SLL OFFENCE,0,0,0,81,0,81,191,70,261,0,40,40,272,110,382
PUNJAB,2002,TOTAL,0,0,0,2241,68,2309,801,136,937,191,68,259,3233,272,3505
PUNJAB,2003,ARMS ACT,0,0,0,105,0,105,53,0,53,10,0,10,168,0,168
PUNJAB,2003,N.D.P.S. ACT,0,0,0,353,44,397,284,35,319,64,7,71,701,86,787
PUNJAB,2003,GAMBLING ACT,0,0,0,28,0,28,77,10,87,17,4,21,122,14,136
PUNJAB,2003,EXCISE ACT,0,0,0,154,26,180,237,15,252,75,11,86,466,52,518
PUNJAB,2003,PROHIBITION ACT,0,0,0,0,0,0,0,0,0,0,0,0,0,0,0
PUNJAB,2003,EXPLOSIVE & EXPLOSIVE SUBST. ACT,0,0,0,30,11,41,6,4,10,32,11,43,68,26,94
PUNJAB,2003,TERRORIST & DISRUPTIVE ACTIVITIES (TATA),0,0,0,0,0,0,0,0,0,0,0,0,0,0,0
PUNJAB,2003,IMMORAL TRAFFIC (PREVENTION) ACT,0,0,0,43,13,56,18,4,22,0,0,0,61,17,78
PUNJAB,2003,INDIAN RAILWAYS ACT,0,0,0,15,0,15,6,1,7,11,0,11,32,1,33
PUNJAB,2003,REGISTRATION OF FOREIGNERS ACT,0,0,0,0,0,0,0,0,0,0,0,0,0,0,0
PUNJAB,2003,PROTECTION OF CIVIL RIGHTS ACT,0,0,0,0,0,0,0,0,0,0,0,0,0,0,0
PUNJAB,2003,SC/ST (PREVENTION OF ATROCITIES) ACT,0,0,0,0,0,0,0,0,0,0,0,0,0,0,0
PUNJAB,2003,INDIAN PASSPORT ACT,0,0,0,38,0,38,1,0,1,0,0,0,39,0,39
PUNJAB,2003,ESSENTIAL COMMODITIES ACT,0,0,0,0,0,0,0,0,0,0,0,0,0,0,0
PUNJAB,2003,ANTIQUITIES AND ART TREASURE ACT,0,0,0,0,0,0,0,0,0,0,0,0,0,0,0
PUNJAB,2003,DOWRY PROHIBITION ACT,0,0,0,149,0,149,26,0,26,0,0,0,175,0,175
PUNJAB,2003,FOREIGN EXCHANGE REGULATION ACT-1973,0,0,0,2,0,2,0,0,0,0,0,0,2,0,2
PUNJAB,2003,PREVENTION OF CORRUPTION ACT-1988,0,0,0,73,0,73,150,0,150,50,0,50,273,0,273
PUNJAB,2003,CONSER.OF FORGN.EXCH.&PREV. OF SMUG.ACT,0,0,0,0,0,0,0,0,0,0,0,0,0,0,0
PUNJAB,2003,OTHER SLL OFFENCE,0,0,0,85,10,95,120,12,132,0,0,0,205,22,227
PUNJAB,2003,TOTAL,0,0,0,1075,104,1179,978,81,1059,259,33,292,2312,218,2530
PUNJAB,2004,ARMS ACT,0,0,0,250,0,250,58,0,58,21,0,21,329,0,329
PUNJAB,2004,N.D.P.S. ACT,0,0,0,364,40,404,295,30,325,69,4,73,728,74,802
PUNJAB,2004,GAMBLING ACT,0,0,0,35,0,35,91,8,99,27,2,29,153,10,163
PUNJAB,2004,EXCISE ACT,0,0,0,162,22,184,248,12,260,89,8,97,499,42,541
PUNJAB,2004,PROHIBITION ACT,0,0,0,0,0,0,0,0,0,0,0,0,0,0,0
PUNJAB,2004,EXPLOSIVE & EXPLOSIVE SUBST. ACT,0,0,0,38,13,51,5,3,8,52,3,55,95,19,114
PUNJAB,2004,TERRORIST & DISRUPTIVE ACTIVITIES (TATA),0,0,0,0,0,0,0,0,0,0,0,0,0,0,0
PUNJAB,2004,IMMORAL TRAFFIC (PREVENTION) ACT,0,0,0,55,10,65,18,4,22,0,0,0,73,14,87
PUNJAB,2004,INDIAN RAILWAYS ACT,0,0,0,20,0,20,7,1,8,25,0,25,52,1,53
PUNJAB,2004,REGISTRATION OF FOREIGNERS ACT,0,0,0,0,0,0,0,0,0,0,0,0,0,0,0
PUNJAB,2004,PROTECTION OF CIVIL RIGHTS ACT,0,0,0,0,0,0,0,0,0,0,0,0,0,0,0
PUNJAB,2004,SC/ST (PREVENTION OF ATROCITIES) ACT,0,0,0,0,0,0,0,0,0,0,0,0,0,0,0
PUNJAB,2004,INDIAN PASSPORT ACT,0,0,0,58,0,58,1,0,1,0,0,0,59,0,59
PUNJAB,2004,ESSENTIAL COMMODITIES ACT,0,0,0,0,0,0,0,0,0,0,0,0,0,0,0
PUNJAB,2004,ANTIQUITIES AND ART TREASURE ACT,0,0,0,0,0,0,0,0,0,0,0,0,0,0,0
PUNJAB,2004,DOWRY PROHIBITION ACT,0,0,0,169,0,169,36,0,36,0,0,0,205,0,205
PUNJAB,2004,FOREIGN EXCHANGE REGULATION ACT-1973,0,0,0,3,0,3,0,0,0,0,0,0,3,0,3
PUNJAB,2004,PREVENTION OF CORRUPTION ACT-1988,0,0,0,85,0,85,201,0,201,30,0,30,316,0,316
PUNJAB,2004,CONSER.OF FORGN.EXCH.&PREV. OF SMUG.ACT,0,0,0,0,0,0,0,0,0,0,0,0,0,0,0
PUNJAB,2004,OTHER SLL OFFENCE,0,0,0,95,8,103,123,10,133,0,0,0,218,18,236
PUNJAB,2004,TOTAL,0,0,0,1334,93,1427,1083,68,1151,313,17,330,2730,178,2908
PUNJAB,2005,ARMS ACT,0,0,0,210,0,210,162,0,162,40,0,40,412,0,412
PUNJAB,2005,N.D.P.S. ACT,0,0,0,235,18,253,281,42,323,31,5,36,547,65,612
PUNJAB,2005,GAMBLING ACT,0,0,0,40,0,40,142,7,149,18,4,22,200,11,211
PUNJAB,2005,EXCISE ACT,0,0,0,136,0,136,165,18,183,11,10,21,312,28,340
PUNJAB,2005,PROHIBITION ACT,0,0,0,0,0,0,0,0,0,0,0,0,0,0,0
PUNJAB,2005,EXPLOSIVE & EXPLOSIVE SUBST. ACT,0,0,0,52,12,64,47,4,51,21,5,26,120,21,141
PUNJAB,2005,TERRORIST & DISRUPTIVE ACTIVITIES (TATA),0,0,0,0,0,0,0,0,0,0,0,0,0,0,0
PUNJAB,2005,IMMORAL TRAFFIC (PREVENTION) ACT,0,0,0,51,8,59,80,6,86,0,0,0,131,14,145
PUNJAB,2005,INDIAN RAILWAYS ACT,0,0,0,22,0,22,19,3,22,10,3,13,51,6,57
PUNJAB,2005,REGISTRATION OF FOREIGNERS ACT,0,0,0,0,0,0,0,0,0,0,0,0,0,0,0
PUNJAB,2005,PROTECTION OF CIVIL RIGHTS ACT,0,0,0,0,0,0,0,0,0,0,0,0,0,0,0
PUNJAB,2005,SC/ST (PREVENTION OF ATROCITIES) ACT,0,0,0,0,0,0,0,0,0,0,0,0,0,0,0
PUNJAB,2005,INDIAN PASSPORT ACT,0,0,0,72,0,72,2,0,2,0,0,0,74,0,74
PUNJAB,2005,ESSENTIAL COMMODITIES ACT,0,0,0,0,0,0,0,0,0,0,0,0,0,0,0
PUNJAB,2005,ANTIQUITIES AND ART TREASURE ACT,0,0,0,0,0,0,0,0,0,0,0,0,0,0,0
PUNJAB,2005,DOWRY PROHIBITION ACT,0,0,0,125,0,125,61,0,61,0,0,0,186,0,186
PUNJAB,2005,FOREIGN EXCHANGE REGULATION ACT-1973,0,0,0,2,0,2,0,0,0,0,0,0,2,0,2
PUNJAB,2005,PREVENTION OF CORRUPTION ACT-1988,0,0,0,80,0,80,110,0,110,11,0,11,201,0,201
PUNJAB,2005,CONSER.OF FORGN.EXCH.&PREV. OF SMUG.ACT,0,0,0,0,0,0,0,0,0,0,0,0,0,0,0
PUNJAB,2005,OTHER SLL OFFENCE,0,0,0,71,3,74,125,17,142,0,0,0,196,20,216
PUNJAB,2005,TOTAL,0,0,0,1096,41,1137,1194,97,1291,142,27,169,2432,165,2597
PUNJAB,2006,ARMS ACT,0,0,0,208,0,208,45,0,45,14,0,14,267,0,267
PUNJAB,2006,N.D.P.S. ACT,0,0,0,292,14,306,248,21,269,37,11,48,577,46,623
PUNJAB,2006,GAMBLING ACT,0,0,0,40,0,40,172,12,184,77,4,81,289,16,305
PUNJAB,2006,EXCISE ACT,0,0,0,146,28,174,331,9,340,9,20,29,486,57,543
PUNJAB,2006,PROHIBITION ACT,0,0,0,0,0,0,0,0,0,0,0,0,0,0,0
PUNJAB,2006,EXPLOSIVE & EXPLOSIVE SUBST. ACT,0,0,0,34,0,34,2,0,2,0,0,0,36,0,36
PUNJAB,2006,TERRORIST & DISRUPTIVE ACTIVITIES (TATA),0,0,0,0,0,0,0,0,0,0,0,0,0,0,0
PUNJAB,2006,IMMORAL TRAFFIC (PREVENTION) ACT,0,0,0,70,0,70,25,0,25,0,0,0,95,0,95
PUNJAB,2006,INDIAN RAILWAYS ACT,0,0,0,22,0,22,21,3,24,15,4,19,58,7,65
PUNJAB,2006,REGISTRATION OF FOREIGNERS ACT,0,0,0,0,0,0,0,0,0,0,0,0,0,0,0
PUNJAB,2006,PROTECTION OF CIVIL RIGHTS ACT,0,0,0,0,0,0,0,0,0,0,0,0,0,0,0
PUNJAB,2006,SC/ST (PREVENTION OF ATROCITIES) ACT,0,0,0,0,0,0,0,0,0,0,0,0,0,0,0
PUNJAB,2006,INDIAN PASSPORT ACT,0,0,0,62,0,62,14,0,14,0,0,0,76,0,76
PUNJAB,2006,ESSENTIAL COMMODITIES ACT,0,0,0,0,0,0,0,0,0,0,0,0,0,0,0
PUNJAB,2006,ANTIQUITIES AND ART TREASURE ACT,0,0,0,0,0,0,0,0,0,0,0,0,0,0,0
PUNJAB,2006,DOWRY PROHIBITION ACT,0,0,0,125,0,125,42,0,42,0,0,0,167,0,167
PUNJAB,2006,FOREIGN EXCHANGE REGULATION ACT-1973,0,0,0,2,0,2,0,0,0,0,0,0,2,0,2
PUNJAB,2006,PREVENTION OF CORRUPTION ACT-1988,0,0,0,80,0,80,116,0,116,60,0,60,256,0,256
PUNJAB,2006,CONSER.OF FORGN.EXCH.&PREV. OF SMUG.ACT,0,0,0,0,0,0,0,0,0,0,0,0,0,0,0
PUNJAB,2006,OTHER SLL OFFENCE,0,0,0,56,9,65,160,22,182,0,0,0,216,31,247
PUNJAB,2006,TOTAL,0,0,0,1137,51,1188,1176,67,1243,212,39,251,2525,157,2682
PUNJAB,2007,ARMS ACT,0,0,0,227,0,227,41,0,41,17,0,17,285,0,285
PUNJAB,2007,N.D.P.S. ACT,0,0,0,307,21,328,265,23,288,78,17,95,650,61,711
PUNJAB,2007,GAMBLING ACT,0,0,0,59,0,59,189,7,196,99,0,99,347,7,354
PUNJAB,2007,EXCISE ACT,0,0,0,156,32,188,348,16,364,47,21,68,551,69,620
PUNJAB,2007,PROHIBITION ACT,0,0,0,0,0,0,0,0,0,0,0,0,0,0,0
PUNJAB,2007,EXPLOSIVE & EXPLOSIVE SUBST. ACT,0,0,0,43,0,43,5,0,5,0,0,0,48,0,48
PUNJAB,2007,TERRORIST & DISRUPTIVE ACTIVITIES (TATA),0,0,0,0,0,0,0,0,0,0,0,0,0,0,0
PUNJAB,2007,IMMORAL TRAFFIC (PREVENTION) ACT,0,0,0,81,0,81,27,0,27,0,0,0,108,0,108
PUNJAB,2007,INDIAN RAILWAYS ACT,0,0,0,51,0,51,61,11,72,37,11,48,149,22,171
PUNJAB,2007,REGISTRATION OF FOREIGNERS ACT,0,0,0,0,0,0,0,0,0,0,0,0,0,0,0
PUNJAB,2007,PROTECTION OF CIVIL RIGHTS ACT,0,0,0,0,0,0,0,0,0,0,0,0,0,0,0
PUNJAB,2007,SC/ST (PREVENTION OF ATROCITIES) ACT,0,0,0,0,0,0,0,0,0,0,0,0,0,0,0
PUNJAB,2007,INDIAN PASSPORT ACT,0,0,0,73,0,73,31,0,31,0,0,0,104,0,104
PUNJAB,2007,ESSENTIAL COMMODITIES ACT,0,0,0,0,0,0,0,0,0,0,0,0,0,0,0
PUNJAB,2007,ANTIQUITIES AND ART TREASURE ACT,0,0,0,0,0,0,0,0,0,0,0,0,0,0,0
PUNJAB,2007,DOWRY PROHIBITION ACT,0,0,0,137,0,137,63,0,63,0,0,0,200,0,200
PUNJAB,2007,FOREIGN EXCHANGE REGULATION ACT-1973,0,0,0,11,0,11,0,0,0,0,0,0,11,0,11
PUNJAB,2007,PREVENTION OF CORRUPTION ACT-1988,0,0,0,91,0,91,131,0,131,93,0,93,315,0,315
PUNJAB,2007,CONSER.OF FORGN.EXCH.&PREV. OF SMUG.ACT,0,0,0,0,0,0,0,0,0,0,0,0,0,0,0
PUNJAB,2007,OTHER SLL OFFENCE,0,0,0,89,15,104,203,27,230,29,7,36,321,49,370
PUNJAB,2007,TOTAL,0,0,0,1325,68,1393,1364,84,1448,400,56,456,3089,208,3297
PUNJAB,2008,ARMS ACT,0,0,0,91,0,91,44,0,44,9,0,9,144,0,144
PUNJAB,2008,N.D.P.S. ACT,0,0,0,403,15,418,286,21,307,75,15,90,764,51,815
PUNJAB,2008,GAMBLING ACT,0,0,0,47,0,47,232,6,238,82,0,82,361,6,367
PUNJAB,2008,EXCISE ACT,0,0,0,197,23,220,357,14,371,36,17,53,590,54,644
PUNJAB,2008,PROHIBITION ACT,0,0,0,0,0,0,0,0,0,0,0,0,0,0,0
PUNJAB,2008,EXPLOSIVE & EXPLOSIVE SUBST. ACT,0,0,0,21,0,21,7,0,7,0,0,0,28,0,28
PUNJAB,2008,TERRORIST & DISRUPTIVE ACTIVITIES (TATA),0,0,0,0,0,0,0,0,0,0,0,0,0,0,0
PUNJAB,2008,IMMORAL TRAFFIC (PREVENTION) ACT,0,0,0,50,0,50,31,0,31,0,0,0,81,0,81
PUNJAB,2008,INDIAN RAILWAYS ACT,0,0,0,61,0,61,69,10,79,29,9,38,159,19,178
PUNJAB,2008,REGISTRATION OF FOREIGNERS ACT,0,0,0,0,0,0,0,0,0,0,0,0,0,0,0
PUNJAB,2008,PROTECTION OF CIVIL RIGHTS ACT,0,0,0,0,0,0,0,0,0,0,0,0,0,0,0
PUNJAB,2008,SC/ST (PREVENTION OF ATROCITIES) ACT,0,0,0,0,0,0,0,0,0,0,0,0,0,0,0
PUNJAB,2008,INDIAN PASSPORT ACT,0,0,0,51,0,51,29,0,29,0,0,0,80,0,80
PUNJAB,2008,ESSENTIAL COMMODITIES ACT,0,0,0,0,0,0,0,0,0,0,0,0,0,0,0
PUNJAB,2008,ANTIQUITIES AND ART TREASURE ACT,0,0,0,0,0,0,0,0,0,0,0,0,0,0,0
PUNJAB,2008,DOWRY PROHIBITION ACT,0,0,0,96,0,96,75,0,75,0,0,0,171,0,171
PUNJAB,2008,FOREIGN EXCHANGE REGULATION ACT-1973,0,0,0,6,0,6,0,0,0,0,0,0,6,0,6
PUNJAB,2008,PREVENTION OF CORRUPTION ACT-1988,0,0,0,69,0,69,164,0,164,71,0,71,304,0,304
PUNJAB,2008,CONSER.OF FORGN.EXCH.&PREV. OF SMUG.ACT,0,0,0,0,0,0,0,0,0,0,0,0,0,0,0
PUNJAB,2008,OTHER SLL OFFENCE,0,0,0,57,9,66,225,24,249,27,6,33,309,39,348
PUNJAB,2008,TOTAL,0,0,0,1149,47,1196,1519,75,1594,329,47,376,2997,169,3166
PUNJAB,2009,ARMS ACT,0,0,0,125,0,125,66,0,66,12,6,18,203,6,209
PUNJAB,2009,N.D.P.S. ACT,0,0,0,510,46,556,310,21,331,180,14,194,1000,81,1081
PUNJAB,2009,GAMBLING ACT,0,0,0,48,0,48,0,0,0,0,0,0,48,0,48
PUNJAB,2009,EXCISE ACT,0,0,0,245,29,274,201,9,210,115,11,126,561,49,610
PUNJAB,2009,PROHIBITION ACT,0,0,0,0,0,0,0,0,0,0,0,0,0,0,0
PUNJAB,2009,EXPLOSIVE & EXPLOSIVE SUBST. ACT,0,0,0,24,6,30,6,0,6,0,0,0,30,6,36
PUNJAB,2009,TERRORIST & DISRUPTIVE ACTIVITIES (TATA),0,0,0,18,0,18,0,0,0,0,0,0,18,0,18
PUNJAB,2009,IMMORAL TRAFFIC (PREVENTION) ACT,0,0,0,57,0,57,13,0,13,0,0,0,70,0,70
PUNJAB,2009,INDIAN RAILWAYS ACT,0,0,0,62,0,62,11,4,15,12,0,12,85,4,89
PUNJAB,2009,REGISTRATION OF FOREIGNERS ACT,0,0,0,0,0,0,0,0,0,0,0,0,0,0,0
PUNJAB,2009,PROTECTION OF CIVIL RIGHTS ACT,0,0,0,0,0,0,0,0,0,0,0,0,0,0,0
PUNJAB,2009,SC/ST (PREVENTION OF ATROCITIES) ACT,0,0,0,0,0,0,0,0,0,0,0,0,0,0,0
PUNJAB,2009,INDIAN PASSPORT ACT,0,0,0,35,0,35,18,0,18,0,0,0,53,0,53
PUNJAB,2009,ESSENTIAL COMMODITIES ACT,0,0,0,0,0,0,0,0,0,0,0,0,0,0,0
PUNJAB,2009,ANTIQUITIES AND ART TREASURE ACT,0,0,0,0,0,0,0,0,0,0,0,0,0,0,0
PUNJAB,2009,DOWRY PROHIBITION ACT,0,0,0,120,11,131,20,11,31,43,2,45,183,24,207
PUNJAB,2009,FOREIGN EXCHANGE REGULATION ACT-1973,0,0,0,28,0,28,0,0,0,0,0,0,28,0,28
PUNJAB,2009,PREVENTION OF CORRUPTION ACT-1988,0,0,0,50,0,50,13,0,13,0,0,0,63,0,63
PUNJAB,2009,CONSER.OF FORGN.EXCH.&PREV. OF SMUG.ACT,0,0,0,11,0,11,12,1,13,4,0,4,27,1,28
PUNJAB,2009,OTHER SLL OFFENCE,0,0,0,13,13,26,11,7,18,13,1,14,37,21,58
PUNJAB,2009,TOTAL,0,0,0,1346,105,1451,681,53,734,379,34,413,2406,192,2598
PUNJAB,2010,ARMS ACT,0,0,0,121,0,121,72,0,72,5,0,5,198,0,198
PUNJAB,2010,N.D.P.S. ACT,0,0,0,579,62,641,374,26,400,88,14,102,1041,102,1143
PUNJAB,2010,GAMBLING ACT,0,0,0,42,0,42,0,0,0,0,0,0,42,0,42
PUNJAB,2010,EXCISE ACT,0,0,0,235,28,263,210,8,218,40,5,45,485,41,526
PUNJAB,2010,PROHIBITION ACT,0,0,0,0,0,0,0,0,0,0,0,0,0,0,0
PUNJAB,2010,EXPLOSIVE & EXPLOSIVE SUBST. ACT,0,0,0,22,5,27,4,0,4,0,0,0,26,5,31
PUNJAB,2010,TERRORIST & DISRUPTIVE ACTIVITIES (TATA),0,0,0,1,0,1,0,0,0,0,0,0,1,0,1
PUNJAB,2010,IMMORAL TRAFFIC (PREVENTION) ACT,0,0,0,0,0,0,0,0,0,0,0,0,0,0,0
PUNJAB,2010,INDIAN RAILWAYS ACT,0,0,0,60,0,60,18,8,26,4,2,6,82,10,92
PUNJAB,2010,REGISTRATION OF FOREIGNERS ACT,0,0,0,0,0,0,0,0,0,0,0,0,0,0,0
PUNJAB,2010,PROTECTION OF CIVIL RIGHTS ACT,0,0,0,0,0,0,0,0,0,0,0,0,0,0,0
PUNJAB,2010,SC/ST (PREVENTION OF ATROCITIES) ACT,0,0,0,0,0,0,0,0,0,0,0,0,0,0,0
PUNJAB,2010,INDIAN PASSPORT ACT,0,0,0,33,0,33,23,0,23,0,0,0,56,0,56
PUNJAB,2010,ESSENTIAL COMMODITIES ACT,0,0,0,0,0,0,0,0,0,0,0,0,0,0,0
PUNJAB,2010,ANTIQUITIES AND ART TREASURE ACT,0,0,0,0,0,0,0,0,0,0,0,0,0,0,0
PUNJAB,2010,DOWRY PROHIBITION ACT,0,0,0,112,14,126,26,10,36,8,1,9,146,25,171
PUNJAB,2010,FOREIGN EXCHANGE REGULATION ACT-1973,0,0,0,22,0,22,0,0,0,0,0,0,22,0,22
PUNJAB,2010,PREVENTION OF CORRUPTION ACT-1988,0,0,0,49,0,49,18,0,18,0,0,0,67,0,67
PUNJAB,2010,CONSER.OF FORGN.EXCH.&PREV. OF SMUG.ACT,0,0,0,10,0,10,10,1,11,2,0,2,22,1,23
PUNJAB,2010,OTHER SLL OFFENCE,0,0,0,11,16,27,36,7,43,2,0,2,49,23,72
PUNJAB,2010,TOTAL,0,0,0,1297,125,1422,791,60,851,149,22,171,2237,207,2444
PUNJAB,2011,ARMS ACT,0,0,0,125,121,246,72,5,77,5,2,7,202,128,330
PUNJAB,2011,N.D.P.S. ACT,0,0,0,679,2,681,375,5,380,70,3,73,1124,10,1134
PUNJAB,2011,GAMBLING ACT,0,0,0,45,0,45,0,0,0,0,0,0,45,0,45
PUNJAB,2011,EXCISE ACT,0,0,0,240,2,242,215,2,217,45,5,50,500,9,509
PUNJAB,2011,PROHIBITION ACT,0,0,0,0,0,0,0,0,0,0,0,0,0,0,0
PUNJAB,2011,EXPLOSIVE & EXPLOSIVE SUBST. ACT,0,0,0,85,0,85,55,0,55,0,0,0,140,0,140
PUNJAB,2011,TERRORIST & DISRUPTIVE ACTIVITIES (TATA),0,0,0,2,5,7,0,4,4,5,0,5,7,9,16
PUNJAB,2011,IMMORAL TRAFFIC (PREVENTION) ACT,0,0,0,25,0,25,0,6,6,0,0,0,25,6,31
PUNJAB,2011,INDIAN RAILWAYS ACT,0,0,0,25,0,25,70,0,70,5,0,5,100,0,100
PUNJAB,2011,REGISTRATION OF FOREIGNERS ACT,0,0,0,0,0,0,0,0,0,0,0,0,0,0,0
PUNJAB,2011,PROTECTION OF CIVIL RIGHTS ACT,0,0,0,0,0,0,0,0,0,0,1,1,0,1,1
PUNJAB,2011,SC/ST (PREVENTION OF ATROCITIES) ACT,0,0,0,0,0,0,0,0,0,0,0,0,0,0,0
PUNJAB,2011,INDIAN PASSPORT ACT,0,0,0,35,2,37,75,5,80,0,1,1,110,8,118
PUNJAB,2011,ESSENTIAL COMMODITIES ACT,0,0,0,0,0,0,0,0,0,0,0,0,0,0,0
PUNJAB,2011,ANTIQUITIES AND ART TREASURE ACT,0,0,0,0,0,0,0,0,0,0,0,0,0,0,0
PUNJAB,2011,DOWRY PROHIBITION ACT,0,0,0,112,0,112,70,2,72,10,0,10,192,2,194
PUNJAB,2011,FOREIGN EXCHANGE REGULATION ACT-1973,0,0,0,22,2,24,0,0,0,0,0,0,22,2,24
PUNJAB,2011,PREVENTION OF CORRUPTION ACT-1988,0,0,0,150,0,150,0,5,5,0,0,0,150,5,155
PUNJAB,2011,CONSER.OF FORGN.EXCH.&PREV. OF SMUG.ACT,0,0,0,0,1,1,62,0,62,3,0,3,65,1,66
PUNJAB,2011,OTHER SLL OFFENCE,0,0,0,11,0,11,4,6,10,10,1,11,25,7,32
PUNJAB,2011,TOTAL,0,0,0,1556,135,1691,998,40,1038,153,13,166,2707,188,2895
PUNJAB,2012,ARMS ACT,0,0,0,215,0,215,289,0,289,78,0,78,582,0,582
PUNJAB,2012,N.D.P.S. ACT,0,0,0,948,43,991,1410,57,1467,393,25,418,2751,125,2876
PUNJAB,2012,GAMBLING ACT,0,0,0,102,2,104,95,0,95,62,0,62,259,2,261
PUNJAB,2012,EXCISE ACT,0,0,0,240,8,248,338,19,357,149,5,154,727,32,759
PUNJAB,2012,PROHIBITION ACT,0,0,0,0,0,0,0,0,0,6,2,8,6,2,8
PUNJAB,2012,EXPLOSIVE & EXPLOSIVE SUBST. ACT,0,0,0,7,1,8,9,0,9,2,0,2,18,1,19
PUNJAB,2012,TERRORIST & DISRUPTIVE ACTIVITIES (TATA),0,0,0,1,0,1,2,0,2,0,0,0,3,0,3
PUNJAB,2012,IMMORAL TRAFFIC (PREVENTION) ACT,0,0,0,79,15,94,67,27,94,30,14,44,176,56,232
PUNJAB,2012,INDIAN RAILWAYS ACT,0,0,0,112,0,112,160,0,160,31,0,31,303,0,303
PUNJAB,2012,REGISTRATION OF FOREIGNERS ACT,0,0,0,84,4,88,38,0,38,18,0,18,140,4,144
PUNJAB,2012,PROTECTION OF CIVIL RIGHTS ACT,0,0,0,63,0,63,46,0,46,25,0,25,134,0,134
PUNJAB,2012,SC/ST (PREVENTION OF ATROCITIES) ACT,0,0,0,6,0,6,73,0,73,26,0,26,105,0,105
PUNJAB,2012,INDIAN PASSPORT ACT,0,0,0,49,0,49,48,1,49,15,0,15,112,1,113
PUNJAB,2012,ESSENTIAL COMMODITIES ACT,0,0,0,3,0,3,33,0,33,9,0,9,45,0,45
PUNJAB,2012,ANTIQUITIES AND ART TREASURE ACT,0,0,0,59,4,63,138,5,143,35,2,37,232,11,243
PUNJAB,2012,DOWRY PROHIBITION ACT,0,0,0,112,15,127,150,9,159,40,18,58,302,42,344
PUNJAB,2012,FOREIGN EXCHANGE REGULATION ACT-1973,0,0,0,0,0,0,0,0,0,2,0,2,2,0,2
PUNJAB,2012,PREVENTION OF CORRUPTION ACT-1988,0,0,0,8,0,8,46,0,46,20,4,24,74,4,78
PUNJAB,2012,CONSER.OF FORGN.EXCH.&PREV. OF SMUG.ACT,0,0,0,12,0,12,3,0,3,0,0,0,15,0,15
PUNJAB,2012,OTHER SLL OFFENCE,0,0,0,5,40,45,7,30,37,8,3,11,20,73,93
PUNJAB,2012,TOTAL,0,0,0,2105,132,2237,2952,148,3100,949,73,1022,6006,353,6359
RAJASTHAN,2001,ARMS ACT,0,0,0,53,0,53,23,0,23,0,0,0,76,0,76
RAJASTHAN,2001,N.D.P.S. ACT,0,0,0,486,20,506,369,16,385,74,2,76,929,38,967
RAJASTHAN,2001,GAMBLING ACT,0,0,0,17,0,17,1,0,1,0,0,0,18,0,18
RAJASTHAN,2001,EXCISE ACT,0,0,0,92,1,93,80,1,81,17,2,19,189,4,193
RAJASTHAN,2001,PROHIBITION ACT,0,0,0,0,0,0,0,0,0,0,0,0,0,0,0
RAJASTHAN,2001,EXPLOSIVE & EXPLOSIVE SUBST. ACT,0,0,0,0,0,0,2,0,2,1,0,1,3,0,3
RAJASTHAN,2001,TERRORIST & DISRUPTIVE ACTIVITIES (TATA),0,0,0,7,0,7,8,0,8,2,0,2,17,0,17
RAJASTHAN,2001,IMMORAL TRAFFIC (PREVENTION) ACT,0,0,0,2,0,2,0,0,0,0,0,0,2,0,2
RAJASTHAN,2001,INDIAN RAILWAYS ACT,0,0,0,14,0,14,13,0,13,5,0,5,32,0,32
RAJASTHAN,2001,REGISTRATION OF FOREIGNERS ACT,0,0,0,1,0,1,0,0,0,0,0,0,1,0,1
RAJASTHAN,2001,PROTECTION OF CIVIL RIGHTS ACT,0,0,0,1,0,1,0,0,0,0,0,0,1,0,1
RAJASTHAN,2001,SC/ST (PREVENTION OF ATROCITIES) ACT,0,0,0,37,0,37,22,0,22,5,0,5,64,0,64
RAJASTHAN,2001,INDIAN PASSPORT ACT,0,0,0,0,0,0,7,0,7,2,0,2,9,0,9
RAJASTHAN,2001,ESSENTIAL COMMODITIES ACT,0,0,0,0,0,0,0,0,0,0,0,0,0,0,0
RAJASTHAN,2001,ANTIQUITIES AND ART TREASURE ACT,0,0,0,2,0,2,0,0,0,0,0,0,2,0,2
RAJASTHAN,2001,DOWRY PROHIBITION ACT,0,0,0,86,1,87,87,21,108,16,4,20,189,26,215
RAJASTHAN,2001,FOREIGN EXCHANGE REGULATION ACT-1973,0,0,0,0,0,0,0,0,0,0,0,0,0,0,0
RAJASTHAN,2001,PREVENTION OF CORRUPTION ACT-1988,0,0,0,0,0,0,2,0,2,0,0,0,2,0,2
RAJASTHAN,2001,CONSER.OF FORGN.EXCH.&PREV. OF SMUG.ACT,0,0,0,1,0,1,0,0,0,0,0,0,1,0,1
RAJASTHAN,2001,OTHER SLL OFFENCE,1,0,1,123,2,125,117,2,119,39,0,39,280,4,284
RAJASTHAN,2001,TOTAL,1,0,1,922,24,946,731,40,771,161,8,169,1815,72,1887
RAJASTHAN,2002,ARMS ACT,0,0,0,57,0,57,42,0,42,1,0,1,100,0,100
RAJASTHAN,2002,N.D.P.S. ACT,1,0,1,238,9,247,227,12,239,69,2,71,535,23,558
RAJASTHAN,2002,GAMBLING ACT,0,0,0,7,0,7,5,0,5,7,0,7,19,0,19
RAJASTHAN,2002,EXCISE ACT,0,0,0,90,0,90,57,1,58,15,0,15,162,1,163
RAJASTHAN,2002,PROHIBITION ACT,0,0,0,0,0,0,0,0,0,0,0,0,0,0,0
RAJASTHAN,2002,EXPLOSIVE & EXPLOSIVE SUBST. ACT,0,0,0,0,0,0,3,0,3,0,0,0,3,0,3
RAJASTHAN,2002,TERRORIST & DISRUPTIVE ACTIVITIES (TATA),0,0,0,4,0,4,5,0,5,3,0,3,12,0,12
RAJASTHAN,2002,IMMORAL TRAFFIC (PREVENTION) ACT,0,0,0,7,0,7,1,1,2,3,0,3,11,1,12
RAJASTHAN,2002,INDIAN RAILWAYS ACT,4,0,4,11,0,11,13,0,13,3,0,3,31,0,31
RAJASTHAN,2002,REGISTRATION OF FOREIGNERS ACT,0,0,0,2,0,2,5,0,5,1,0,1,8,0,8
RAJASTHAN,2002,PROTECTION OF CIVIL RIGHTS ACT,0,0,0,0,0,0,0,0,0,0,0,0,0,0,0
RAJASTHAN,2002,SC/ST (PREVENTION OF ATROCITIES) ACT,0,0,0,3,0,3,1,0,1,0,0,0,4,0,4
RAJASTHAN,2002,INDIAN PASSPORT ACT,0,0,0,0,0,0,1,0,1,0,0,0,1,0,1
RAJASTHAN,2002,ESSENTIAL COMMODITIES ACT,0,0,0,0,0,0,0,0,0,0,0,0,0,0,0
RAJASTHAN,2002,ANTIQUITIES AND ART TREASURE ACT,0,0,0,0,0,0,0,0,0,0,0,0,0,0,0
RAJASTHAN,2002,DOWRY PROHIBITION ACT,0,0,0,31,0,31,25,0,25,3,3,6,59,3,62
RAJASTHAN,2002,FOREIGN EXCHANGE REGULATION ACT-1973,0,0,0,0,0,0,0,0,0,0,0,0,0,0,0
RAJASTHAN,2002,PREVENTION OF CORRUPTION ACT-1988,0,0,0,0,0,0,5,0,5,0,0,0,5,0,5
RAJASTHAN,2002,CONSER.OF FORGN.EXCH.&PREV. OF SMUG.ACT,0,0,0,0,0,0,2,0,2,0,0,0,2,0,2
RAJASTHAN,2002,OTHER SLL OFFENCE,6,0,6,125,0,125,154,9,163,41,0,41,326,9,335
RAJASTHAN,2002,TOTAL,11,0,11,575,9,584,546,23,569,146,5,151,1278,37,1315
RAJASTHAN,2003,ARMS ACT,0,0,0,101,0,101,37,0,37,8,0,8,146,0,146
RAJASTHAN,2003,N.D.P.S. ACT,0,0,0,220,2,222,150,6,156,21,1,22,391,9,400
RAJASTHAN,2003,GAMBLING ACT,0,0,0,10,0,10,8,0,8,2,0,2,20,0,20
RAJASTHAN,2003,EXCISE ACT,0,0,0,101,1,102,58,1,59,9,0,9,168,2,170
RAJASTHAN,2003,PROHIBITION ACT,0,0,0,4,0,4,1,0,1,0,0,0,5,0,5
RAJASTHAN,2003,EXPLOSIVE & EXPLOSIVE SUBST. ACT,0,0,0,1,0,1,0,0,0,0,0,0,1,0,1
RAJASTHAN,2003,TERRORIST & DISRUPTIVE ACTIVITIES (TATA),0,0,0,2,0,2,9,0,9,2,0,2,13,0,13
RAJASTHAN,2003,IMMORAL TRAFFIC (PREVENTION) ACT,0,0,0,0,4,4,0,1,1,0,0,0,0,5,5
RAJASTHAN,2003,INDIAN RAILWAYS ACT,0,0,0,26,1,27,15,0,15,4,0,4,45,1,46
RAJASTHAN,2003,REGISTRATION OF FOREIGNERS ACT,0,0,0,2,0,2,1,0,1,0,0,0,3,0,3
RAJASTHAN,2003,PROTECTION OF CIVIL RIGHTS ACT,0,0,0,0,0,0,0,0,0,0,0,0,0,0,0
RAJASTHAN,2003,SC/ST (PREVENTION OF ATROCITIES) ACT,0,0,0,1,0,1,1,0,1,0,0,0,2,0,2
RAJASTHAN,2003,INDIAN PASSPORT ACT,0,0,0,2,0,2,1,0,1,1,0,1,4,0,4
RAJASTHAN,2003,ESSENTIAL COMMODITIES ACT,0,0,0,1,0,1,0,0,0,0,0,0,1,0,1
RAJASTHAN,2003,ANTIQUITIES AND ART TREASURE ACT,0,0,0,4,0,4,2,0,2,4,0,4,10,0,10
RAJASTHAN,2003,DOWRY PROHIBITION ACT,0,0,0,22,0,22,16,1,17,3,3,6,41,4,45
RAJASTHAN,2003,FOREIGN EXCHANGE REGULATION ACT-1973,0,0,0,0,0,0,0,0,0,0,0,0,0,0,0
RAJASTHAN,2003,PREVENTION OF CORRUPTION ACT-1988,0,0,0,0,0,0,0,0,0,0,0,0,0,0,0
RAJASTHAN,2003,CONSER.OF FORGN.EXCH.&PREV. OF SMUG.ACT,0,0,0,0,0,0,0,0,0,0,0,0,0,0,0
RAJASTHAN,2003,OTHER SLL OFFENCE,0,0,0,61,5,66,69,0,69,9,0,9,139,5,144
RAJASTHAN,2003,TOTAL,0,0,0,558,13,571,368,9,377,63,4,67,989,26,1015
RAJASTHAN,2004,ARMS ACT,0,0,0,50,1,51,54,1,55,5,0,5,109,2,111
RAJASTHAN,2004,N.D.P.S. ACT,0,0,0,294,5,299,219,17,236,52,0,52,565,22,587
RAJASTHAN,2004,GAMBLING ACT,0,0,0,8,0,8,2,0,2,0,0,0,10,0,10
RAJASTHAN,2004,EXCISE ACT,0,0,0,123,1,124,70,0,70,13,0,13,206,1,207
RAJASTHAN,2004,PROHIBITION ACT,0,0,0,0,0,0,0,0,0,2,0,2,2,0,2
RAJASTHAN,2004,EXPLOSIVE & EXPLOSIVE SUBST. ACT,0,0,0,1,0,1,0,0,0,0,0,0,1,0,1
RAJASTHAN,2004,TERRORIST & DISRUPTIVE ACTIVITIES (TATA),0,0,0,0,0,0,0,0,0,0,0,0,0,0,0
RAJASTHAN,2004,IMMORAL TRAFFIC (PREVENTION) ACT,0,0,0,9,2,11,3,1,4,0,0,0,12,3,15
RAJASTHAN,2004,INDIAN RAILWAYS ACT,0,0,0,34,2,36,29,2,31,6,0,6,69,4,73
RAJASTHAN,2004,REGISTRATION OF FOREIGNERS ACT,0,0,0,8,0,8,8,0,8,7,0,7,23,0,23
RAJASTHAN,2004,PROTECTION OF CIVIL RIGHTS ACT,0,0,0,1,0,1,0,0,0,0,0,0,1,0,1
RAJASTHAN,2004,SC/ST (PREVENTION OF ATROCITIES) ACT,0,0,0,5,0,5,3,0,3,2,0,2,10,0,10
RAJASTHAN,2004,INDIAN PASSPORT ACT,0,0,0,1,0,1,2,0,2,0,0,0,3,0,3
RAJASTHAN,2004,ESSENTIAL COMMODITIES ACT,0,0,0,0,0,0,0,0,0,0,0,0,0,0,0
RAJASTHAN,2004,ANTIQUITIES AND ART TREASURE ACT,0,0,0,4,0,4,2,0,2,0,0,0,6,0,6
RAJASTHAN,2004,DOWRY PROHIBITION ACT,0,0,0,6,0,6,6,2,8,3,0,3,15,2,17
RAJASTHAN,2004,FOREIGN EXCHANGE REGULATION ACT-1973,0,0,0,3,0,3,4,0,4,0,0,0,7,0,7
RAJASTHAN,2004,PREVENTION OF CORRUPTION ACT-1988,0,0,0,5,0,5,16,0,16,2,0,2,23,0,23
RAJASTHAN,2004,CONSER.OF FORGN.EXCH.&PREV. OF SMUG.ACT,0,0,0,10,0,10,3,0,3,0,0,0,13,0,13
RAJASTHAN,2004,OTHER SLL OFFENCE,0,0,0,152,4,156,110,5,115,28,0,28,290,9,299
RAJASTHAN,2004,TOTAL,0,0,0,714,15,729,531,28,559,120,0,120,1365,43,1408
RAJASTHAN,2005,ARMS ACT,0,0,0,80,1,81,54,1,55,2,0,2,136,2,138
RAJASTHAN,2005,N.D.P.S. ACT,0,0,0,370,6,376,269,25,294,78,2,80,717,33,750
RAJASTHAN,2005,GAMBLING ACT,0,0,0,2,0,2,3,3,6,0,0,0,5,3,8
RAJASTHAN,2005,EXCISE ACT,0,0,0,121,1,122,90,4,94,24,1,25,235,6,241
RAJASTHAN,2005,PROHIBITION ACT,0,0,0,4,0,4,1,0,1,0,0,0,5,0,5
RAJASTHAN,2005,EXPLOSIVE & EXPLOSIVE SUBST. ACT,0,0,0,1,0,1,0,0,0,0,0,0,1,0,1
RAJASTHAN,2005,TERRORIST & DISRUPTIVE ACTIVITIES (TATA),0,0,0,0,0,0,1,0,1,0,0,0,1,0,1
RAJASTHAN,2005,IMMORAL TRAFFIC (PREVENTION) ACT,0,0,0,2,1,3,0,0,0,0,0,0,2,1,3
RAJASTHAN,2005,INDIAN RAILWAYS ACT,0,0,0,75,0,75,45,0,45,8,0,8,128,0,128
RAJASTHAN,2005,REGISTRATION OF FOREIGNERS ACT,0,0,0,3,0,3,2,0,2,0,0,0,5,0,5
RAJASTHAN,2005,PROTECTION OF CIVIL RIGHTS ACT,0,0,0,0,0,0,0,0,0,0,0,0,0,0,0
RAJASTHAN,2005,SC/ST (PREVENTION OF ATROCITIES) ACT,0,0,0,5,0,5,4,0,4,0,0,0,9,0,9
RAJASTHAN,2005,INDIAN PASSPORT ACT,0,0,0,6,0,6,5,0,5,1,0,1,12,0,12
RAJASTHAN,2005,ESSENTIAL COMMODITIES ACT,0,0,0,3,0,3,0,0,0,0,0,0,3,0,3
RAJASTHAN,2005,ANTIQUITIES AND ART TREASURE ACT,0,0,0,0,0,0,0,0,0,0,0,0,0,0,0
RAJASTHAN,2005,DOWRY PROHIBITION ACT,0,0,0,11,0,11,5,0,5,1,0,1,17,0,17
RAJASTHAN,2005,FOREIGN EXCHANGE REGULATION ACT-1973,0,0,0,2,0,2,2,0,2,2,0,2,6,0,6
RAJASTHAN,2005,PREVENTION OF CORRUPTION ACT-1988,0,0,0,3,0,3,4,0,4,2,0,2,9,0,9
RAJASTHAN,2005,CONSER.OF FORGN.EXCH.&PREV. OF SMUG.ACT,0,0,0,0,0,0,0,0,0,0,0,0,0,0,0
RAJASTHAN,2005,OTHER SLL OFFENCE,0,0,0,147,0,147,139,3,142,24,1,25,310,4,314
RAJASTHAN,2005,TOTAL,0,0,0,835,9,844,624,36,660,142,4,146,1601,49,1650
RAJASTHAN,2006,ARMS ACT,0,0,0,158,1,159,92,0,92,6,0,6,256,1,257
RAJASTHAN,2006,N.D.P.S. ACT,0,0,0,374,6,380,369,20,389,91,1,92,834,27,861
RAJASTHAN,2006,GAMBLING ACT,0,0,0,5,0,5,4,0,4,1,0,1,10,0,10
RAJASTHAN,2006,EXCISE ACT,0,0,0,134,0,134,103,2,105,21,0,21,258,2,260
RAJASTHAN,2006,PROHIBITION ACT,0,0,0,3,0,3,15,0,15,0,0,0,18,0,18
RAJASTHAN,2006,EXPLOSIVE & EXPLOSIVE SUBST. ACT,0,0,0,7,0,7,4,0,4,0,0,0,11,0,11
RAJASTHAN,2006,TERRORIST & DISRUPTIVE ACTIVITIES (TATA),0,0,0,0,0,0,1,0,1,0,0,0,1,0,1
RAJASTHAN,2006,IMMORAL TRAFFIC (PREVENTION) ACT,0,0,0,4,5,9,2,0,2,0,0,0,6,5,11
RAJASTHAN,2006,INDIAN RAILWAYS ACT,0,0,0,36,2,38,13,0,13,5,0,5,54,2,56
RAJASTHAN,2006,REGISTRATION OF FOREIGNERS ACT,0,0,0,2,0,2,1,0,1,1,0,1,4,0,4
RAJASTHAN,2006,PROTECTION OF CIVIL RIGHTS ACT,0,0,0,0,0,0,0,0,0,0,0,0,0,0,0
RAJASTHAN,2006,SC/ST (PREVENTION OF ATROCITIES) ACT,0,0,0,9,0,9,10,0,10,1,0,1,20,0,20
RAJASTHAN,2006,INDIAN PASSPORT ACT,0,0,0,4,0,4,3,0,3,0,0,0,7,0,7
RAJASTHAN,2006,ESSENTIAL COMMODITIES ACT,0,0,0,0,0,0,0,0,0,0,0,0,0,0,0
RAJASTHAN,2006,ANTIQUITIES AND ART TREASURE ACT,0,0,0,0,0,0,0,0,0,0,0,0,0,0,0
RAJASTHAN,2006,DOWRY PROHIBITION ACT,0,0,0,12,0,12,18,6,24,2,0,2,32,6,38
RAJASTHAN,2006,FOREIGN EXCHANGE REGULATION ACT-1973,0,0,0,0,0,0,0,0,0,0,0,0,0,0,0
RAJASTHAN,2006,PREVENTION OF CORRUPTION ACT-1988,0,0,0,0,0,0,0,0,0,0,0,0,0,0,0
RAJASTHAN,2006,CONSER.OF FORGN.EXCH.&PREV. OF SMUG.ACT,0,0,0,12,0,12,14,0,14,0,0,0,26,0,26
RAJASTHAN,2006,OTHER SLL OFFENCE,0,0,0,224,6,230,246,12,258,87,2,89,557,20,577
RAJASTHAN,2006,TOTAL,0,0,0,984,20,1004,895,40,935,215,3,218,2094,63,2157
RAJASTHAN,2007,ARMS ACT,0,0,0,142,1,143,79,2,81,14,0,14,235,3,238
RAJASTHAN,2007,N.D.P.S. ACT,0,0,0,388,6,394,342,7,349,60,1,61,790,14,804
RAJASTHAN,2007,GAMBLING ACT,0,0,0,7,0,7,3,0,3,0,0,0,10,0,10
RAJASTHAN,2007,EXCISE ACT,0,0,0,164,2,166,126,3,129,21,0,21,311,5,316
RAJASTHAN,2007,PROHIBITION ACT,0,0,0,21,0,21,14,0,14,1,0,1,36,0,36
RAJASTHAN,2007,EXPLOSIVE & EXPLOSIVE SUBST. ACT,0,0,0,0,0,0,2,0,2,0,0,0,2,0,2
RAJASTHAN,2007,TERRORIST & DISRUPTIVE ACTIVITIES (TATA),0,0,0,1,0,1,0,0,0,0,0,0,1,0,1
RAJASTHAN,2007,IMMORAL TRAFFIC (PREVENTION) ACT,0,0,0,29,0,29,3,0,3,0,0,0,32,0,32
RAJASTHAN,2007,INDIAN RAILWAYS ACT,0,0,0,35,0,35,18,0,18,7,0,7,60,0,60
RAJASTHAN,2007,REGISTRATION OF FOREIGNERS ACT,0,0,0,0,0,0,0,0,0,0,0,0,0,0,0
RAJASTHAN,2007,PROTECTION OF CIVIL RIGHTS ACT,0,0,0,5,0,5,7,0,7,0,0,0,12,0,12
RAJASTHAN,2007,SC/ST (PREVENTION OF ATROCITIES) ACT,0,0,0,10,0,10,15,0,15,4,0,4,29,0,29
RAJASTHAN,2007,INDIAN PASSPORT ACT,0,0,0,1,0,1,6,0,6,3,0,3,10,0,10
RAJASTHAN,2007,ESSENTIAL COMMODITIES ACT,0,0,0,2,0,2,4,0,4,1,0,1,7,0,7
RAJASTHAN,2007,ANTIQUITIES AND ART TREASURE ACT,0,0,0,15,0,15,9,0,9,2,0,2,26,0,26
RAJASTHAN,2007,DOWRY PROHIBITION ACT,0,0,0,19,0,19,11,0,11,1,0,1,31,0,31
RAJASTHAN,2007,FOREIGN EXCHANGE REGULATION ACT-1973,0,0,0,0,0,0,0,0,0,0,0,0,0,0,0
RAJASTHAN,2007,PREVENTION OF CORRUPTION ACT-1988,0,0,0,2,0,2,3,0,3,1,0,1,6,0,6
RAJASTHAN,2007,CONSER.OF FORGN.EXCH.&PREV. OF SMUG.ACT,0,0,0,15,0,15,9,0,9,6,0,6,30,0,30
RAJASTHAN,2007,OTHER SLL OFFENCE,0,0,0,171,8,179,109,4,113,50,0,50,330,12,342
RAJASTHAN,2007,TOTAL,0,0,0,1027,17,1044,760,16,776,171,1,172,1958,34,1992
RAJASTHAN,2008,ARMS ACT,0,0,0,157,0,157,151,0,151,48,0,48,356,0,356
RAJASTHAN,2008,N.D.P.S. ACT,0,0,0,283,3,286,386,12,398,59,0,59,728,15,743
RAJASTHAN,2008,GAMBLING ACT,0,0,0,46,0,46,15,0,15,3,0,3,64,0,64
RAJASTHAN,2008,EXCISE ACT,0,0,0,126,0,126,123,3,126,26,0,26,275,3,278
RAJASTHAN,2008,PROHIBITION ACT,0,0,0,4,0,4,1,0,1,0,0,0,5,0,5
RAJASTHAN,2008,EXPLOSIVE & EXPLOSIVE SUBST. ACT,0,0,0,8,0,8,17,0,17,3,0,3,28,0,28
RAJASTHAN,2008,TERRORIST & DISRUPTIVE ACTIVITIES (TATA),0,0,0,2,0,2,2,0,2,1,0,1,5,0,5
RAJASTHAN,2008,IMMORAL TRAFFIC (PREVENTION) ACT,0,0,0,7,3,10,6,0,6,1,1,2,14,4,18
RAJASTHAN,2008,INDIAN RAILWAYS ACT,0,0,0,14,0,14,9,0,9,4,0,4,27,0,27
RAJASTHAN,2008,REGISTRATION OF FOREIGNERS ACT,0,0,0,0,0,0,2,0,2,0,0,0,2,0,2
RAJASTHAN,2008,PROTECTION OF CIVIL RIGHTS ACT,0,0,0,0,0,0,1,0,1,0,0,0,1,0,1
RAJASTHAN,2008,SC/ST (PREVENTION OF ATROCITIES) ACT,0,0,0,6,0,6,5,0,5,2,0,2,13,0,13
RAJASTHAN,2008,INDIAN PASSPORT ACT,0,0,0,3,0,3,3,0,3,2,0,2,8,0,8
RAJASTHAN,2008,ESSENTIAL COMMODITIES ACT,0,0,0,2,0,2,4,0,4,0,0,0,6,0,6
RAJASTHAN,2008,ANTIQUITIES AND ART TREASURE ACT,0,0,0,0,0,0,0,0,0,0,0,0,0,0,0
RAJASTHAN,2008,DOWRY PROHIBITION ACT,0,0,0,2,0,2,1,0,1,0,0,0,3,0,3
RAJASTHAN,2008,FOREIGN EXCHANGE REGULATION ACT-1973,0,0,0,0,0,0,0,0,0,0,0,0,0,0,0
RAJASTHAN,2008,PREVENTION OF CORRUPTION ACT-1988,0,0,0,0,0,0,3,0,3,1,1,2,4,1,5
RAJASTHAN,2008,CONSER.OF FORGN.EXCH.&PREV. OF SMUG.ACT,0,0,0,2,0,2,9,2,11,3,0,3,14,2,16
RAJASTHAN,2008,OTHER SLL OFFENCE,0,0,0,215,0,215,124,6,130,29,1,30,368,7,375
RAJASTHAN,2008,TOTAL,0,0,0,877,6,883,862,23,885,182,3,185,1921,32,1953
RAJASTHAN,2009,ARMS ACT,0,0,0,183,0,183,166,1,167,23,0,23,372,1,373
RAJASTHAN,2009,N.D.P.S. ACT,0,0,0,402,12,414,397,13,410,100,2,102,899,27,926
RAJASTHAN,2009,GAMBLING ACT,0,0,0,3,0,3,5,0,5,0,0,0,8,0,8
RAJASTHAN,2009,EXCISE ACT,0,0,0,199,1,200,157,4,161,22,1,23,378,6,384
RAJASTHAN,2009,PROHIBITION ACT,0,0,0,3,0,3,3,0,3,0,0,0,6,0,6
RAJASTHAN,2009,EXPLOSIVE & EXPLOSIVE SUBST. ACT,0,0,0,5,0,5,3,0,3,0,0,0,8,0,8
RAJASTHAN,2009,TERRORIST & DISRUPTIVE ACTIVITIES (TATA),0,0,0,0,0,0,2,0,2,0,0,0,2,0,2
RAJASTHAN,2009,IMMORAL TRAFFIC (PREVENTION) ACT,0,0,0,9,4,13,7,5,12,4,2,6,20,11,31
RAJASTHAN,2009,INDIAN RAILWAYS ACT,0,0,0,12,0,12,6,0,6,5,0,5,23,0,23
RAJASTHAN,2009,REGISTRATION OF FOREIGNERS ACT,0,0,0,2,0,2,6,0,6,0,0,0,8,0,8
RAJASTHAN,2009,PROTECTION OF CIVIL RIGHTS ACT,0,0,0,3,0,3,3,0,3,1,0,1,7,0,7
RAJASTHAN,2009,SC/ST (PREVENTION OF ATROCITIES) ACT,0,0,0,10,0,10,5,0,5,0,0,0,15,0,15
RAJASTHAN,2009,INDIAN PASSPORT ACT,0,0,0,3,0,3,1,0,1,1,0,1,5,0,5
RAJASTHAN,2009,ESSENTIAL COMMODITIES ACT,0,0,0,0,0,0,3,0,3,0,0,0,3,0,3
RAJASTHAN,2009,ANTIQUITIES AND ART TREASURE ACT,0,0,0,0,0,0,0,0,0,0,0,0,0,0,0
RAJASTHAN,2009,DOWRY PROHIBITION ACT,0,0,0,9,5,14,9,7,16,5,7,12,23,19,42
RAJASTHAN,2009,FOREIGN EXCHANGE REGULATION ACT-1973,0,0,0,0,0,0,0,0,0,0,0,0,0,0,0
RAJASTHAN,2009,PREVENTION OF CORRUPTION ACT-1988,0,0,0,0,0,0,2,0,2,1,0,1,3,0,3
RAJASTHAN,2009,CONSER.OF FORGN.EXCH.&PREV. OF SMUG.ACT,0,0,0,38,0,38,24,0,24,3,0,3,65,0,65
RAJASTHAN,2009,OTHER SLL OFFENCE,0,0,0,158,2,160,86,3,89,32,1,33,276,6,282
RAJASTHAN,2009,TOTAL,0,0,0,1039,24,1063,885,33,918,197,13,210,2121,70,2191
RAJASTHAN,2010,ARMS ACT,0,0,0,148,0,148,135,0,135,27,0,27,310,0,310
RAJASTHAN,2010,N.D.P.S. ACT,0,0,0,373,3,376,360,6,366,81,4,85,814,13,827
RAJASTHAN,2010,GAMBLING ACT,0,0,0,8,0,8,18,0,18,4,0,4,30,0,30
RAJASTHAN,2010,EXCISE ACT,0,0,0,132,2,134,152,1,153,62,2,64,346,5,351
RAJASTHAN,2010,PROHIBITION ACT,0,0,0,9,0,9,4,3,7,1,0,1,14,3,17
RAJASTHAN,2010,EXPLOSIVE & EXPLOSIVE SUBST. ACT,0,0,0,11,0,11,12,1,13,0,0,0,23,1,24
RAJASTHAN,2010,TERRORIST & DISRUPTIVE ACTIVITIES (TATA),0,0,0,1,2,3,3,5,8,0,0,0,4,7,11
RAJASTHAN,2010,IMMORAL TRAFFIC (PREVENTION) ACT,0,0,0,3,0,3,0,0,0,0,0,0,3,0,3
RAJASTHAN,2010,INDIAN RAILWAYS ACT,0,0,0,18,0,18,31,1,32,9,0,9,58,1,59
RAJASTHAN,2010,REGISTRATION OF FOREIGNERS ACT,0,0,0,1,0,1,4,0,4,0,0,0,5,0,5
RAJASTHAN,2010,PROTECTION OF CIVIL RIGHTS ACT,0,0,0,4,0,4,3,0,3,0,0,0,7,0,7
RAJASTHAN,2010,SC/ST (PREVENTION OF ATROCITIES) ACT,0,0,0,10,0,10,10,0,10,1,0,1,21,0,21
RAJASTHAN,2010,INDIAN PASSPORT ACT,0,0,0,2,0,2,5,0,5,2,0,2,9,0,9
RAJASTHAN,2010,ESSENTIAL COMMODITIES ACT,0,0,0,10,0,10,9,0,9,0,0,0,19,0,19
RAJASTHAN,2010,ANTIQUITIES AND ART TREASURE ACT,0,0,0,0,0,0,0,0,0,0,0,0,0,0,0
RAJASTHAN,2010,DOWRY PROHIBITION ACT,0,0,0,25,0,25,11,0,11,3,0,3,39,0,39
RAJASTHAN,2010,FOREIGN EXCHANGE REGULATION ACT-1973,0,0,0,0,0,0,0,0,0,0,0,0,0,0,0
RAJASTHAN,2010,PREVENTION OF CORRUPTION ACT-1988,0,0,0,1,0,1,3,0,3,2,0,2,6,0,6
RAJASTHAN,2010,CONSER.OF FORGN.EXCH.&PREV. OF SMUG.ACT,0,0,0,0,0,0,0,0,0,0,0,0,0,0,0
RAJASTHAN,2010,OTHER SLL OFFENCE,0,0,0,159,4,163,200,2,202,23,0,23,382,6,388
RAJASTHAN,2010,TOTAL,0,0,0,915,11,926,960,19,979,215,6,221,2090,36,2126
RAJASTHAN,2011,ARMS ACT,0,0,0,193,0,193,160,0,160,35,0,35,388,0,388
RAJASTHAN,2011,N.D.P.S. ACT,0,0,0,392,2,394,397,7,404,72,0,72,861,9,870
RAJASTHAN,2011,GAMBLING ACT,0,0,0,10,0,10,18,0,18,1,0,1,29,0,29
RAJASTHAN,2011,EXCISE ACT,0,0,0,185,3,188,176,1,177,52,0,52,413,4,417
RAJASTHAN,2011,PROHIBITION ACT,0,0,0,12,0,12,6,5,11,1,0,1,19,5,24
RAJASTHAN,2011,EXPLOSIVE & EXPLOSIVE SUBST. ACT,0,0,0,14,0,14,7,1,8,2,0,2,23,1,24
RAJASTHAN,2011,TERRORIST & DISRUPTIVE ACTIVITIES (TATA),0,0,0,1,0,1,2,0,2,0,0,0,3,0,3
RAJASTHAN,2011,IMMORAL TRAFFIC (PREVENTION) ACT,0,0,0,5,4,9,0,3,3,0,0,0,5,7,12
RAJASTHAN,2011,INDIAN RAILWAYS ACT,0,0,0,21,3,24,23,1,24,11,0,11,55,4,59
RAJASTHAN,2011,REGISTRATION OF FOREIGNERS ACT,0,0,0,3,0,3,6,0,6,0,0,0,9,0,9
RAJASTHAN,2011,PROTECTION OF CIVIL RIGHTS ACT,0,0,0,4,0,4,0,0,0,0,0,0,4,0,4
RAJASTHAN,2011,SC/ST (PREVENTION OF ATROCITIES) ACT,0,0,0,28,0,28,12,0,12,3,0,3,43,0,43
RAJASTHAN,2011,INDIAN PASSPORT ACT,0,0,0,2,0,2,5,0,5,3,0,3,10,0,10
RAJASTHAN,2011,ESSENTIAL COMMODITIES ACT,0,0,0,0,0,0,3,0,3,0,0,0,3,0,3
RAJASTHAN,2011,ANTIQUITIES AND ART TREASURE ACT,0,0,0,0,0,0,0,0,0,0,0,0,0,0,0
RAJASTHAN,2011,DOWRY PROHIBITION ACT,0,0,0,25,1,26,38,6,44,7,9,16,70,16,86
RAJASTHAN,2011,FOREIGN EXCHANGE REGULATION ACT-1973,0,0,0,0,0,0,0,0,0,1,0,1,1,0,1
RAJASTHAN,2011,PREVENTION OF CORRUPTION ACT-1988,0,0,0,3,0,3,5,0,5,4,0,4,12,0,12
RAJASTHAN,2011,CONSER.OF FORGN.EXCH.&PREV. OF SMUG.ACT,0,0,0,5,0,5,1,0,1,0,0,0,6,0,6
RAJASTHAN,2011,OTHER SLL OFFENCE,0,0,0,245,2,247,120,6,126,55,0,55,420,8,428
RAJASTHAN,2011,TOTAL,0,0,0,1148,15,1163,979,30,1009,247,9,256,2374,54,2428
RAJASTHAN,2012,ARMS ACT,0,0,0,229,0,229,176,0,176,53,0,53,458,0,458
RAJASTHAN,2012,N.D.P.S. ACT,0,0,0,506,1,507,518,4,522,113,0,113,1137,5,1142
RAJASTHAN,2012,GAMBLING ACT,0,0,0,17,0,17,26,2,28,2,0,2,45,2,47
RAJASTHAN,2012,EXCISE ACT,0,0,0,177,2,179,137,1,138,39,1,40,353,4,357
RAJASTHAN,2012,PROHIBITION ACT,0,0,0,4,0,4,11,0,11,0,0,0,15,0,15
RAJASTHAN,2012,EXPLOSIVE & EXPLOSIVE SUBST. ACT,0,0,0,9,0,9,6,0,6,2,0,2,17,0,17
RAJASTHAN,2012,TERRORIST & DISRUPTIVE ACTIVITIES (TATA),0,0,0,0,0,0,0,0,0,2,0,2,2,0,2
RAJASTHAN,2012,IMMORAL TRAFFIC (PREVENTION) ACT,0,0,0,7,0,7,3,0,3,0,1,1,10,1,11
RAJASTHAN,2012,INDIAN RAILWAYS ACT,0,0,0,21,0,21,21,0,21,7,0,7,49,0,49
RAJASTHAN,2012,REGISTRATION OF FOREIGNERS ACT,0,0,0,0,0,0,3,0,3,0,0,0,3,0,3
RAJASTHAN,2012,PROTECTION OF CIVIL RIGHTS ACT,0,0,0,4,0,4,0,0,0,2,0,2,6,0,6
RAJASTHAN,2012,SC/ST (PREVENTION OF ATROCITIES) ACT,0,0,0,13,0,13,17,0,17,12,0,12,42,0,42
RAJASTHAN,2012,INDIAN PASSPORT ACT,0,0,0,3,0,3,5,0,5,5,0,5,13,0,13
RAJASTHAN,2012,ESSENTIAL COMMODITIES ACT,0,0,0,0,0,0,2,0,2,9,0,9,11,0,11
RAJASTHAN,2012,ANTIQUITIES AND ART TREASURE ACT,0,0,0,0,0,0,0,0,0,2,0,2,2,0,2
RAJASTHAN,2012,DOWRY PROHIBITION ACT,0,0,0,15,1,16,21,2,23,13,0,13,49,3,52
RAJASTHAN,2012,FOREIGN EXCHANGE REGULATION ACT-1973,0,0,0,1,0,1,0,0,0,3,0,3,4,0,4
RAJASTHAN,2012,PREVENTION OF CORRUPTION ACT-1988,0,0,0,3,0,3,6,0,6,5,0,5,14,0,14
RAJASTHAN,2012,CONSER.OF FORGN.EXCH.&PREV. OF SMUG.ACT,0,0,0,29,0,29,0,0,0,1,0,1,30,0,30
RAJASTHAN,2012,OTHER SLL OFFENCE,0,0,0,256,22,278,167,7,174,73,3,76,496,32,528
RAJASTHAN,2012,TOTAL,0,0,0,1294,26,1320,1119,16,1135,343,5,348,2756,47,2803
SIKKIM,2001,ARMS ACT,0,0,0,6,0,6,0,0,0,0,0,0,6,0,6
SIKKIM,2001,N.D.P.S. ACT,0,0,0,5,0,5,0,0,0,0,0,0,5,0,5
SIKKIM,2001,GAMBLING ACT,0,0,0,0,0,0,0,0,0,0,0,0,0,0,0
SIKKIM,2001,EXCISE ACT,0,0,0,0,0,0,0,0,0,0,0,0,0,0,0
SIKKIM,2001,PROHIBITION ACT,0,0,0,0,0,0,0,0,0,0,0,0,0,0,0
SIKKIM,2001,EXPLOSIVE & EXPLOSIVE SUBST. ACT,0,0,0,2,0,2,0,0,0,0,0,0,2,0,2
SIKKIM,2001,TERRORIST & DISRUPTIVE ACTIVITIES (TATA),0,0,0,0,0,0,0,0,0,0,0,0,0,0,0
SIKKIM,2001,IMMORAL TRAFFIC (PREVENTION) ACT,0,0,0,0,0,0,0,0,0,0,0,0,0,0,0
SIKKIM,2001,INDIAN RAILWAYS ACT,0,0,0,0,0,0,0,0,0,0,0,0,0,0,0
SIKKIM,2001,REGISTRATION OF FOREIGNERS ACT,0,0,0,0,0,0,0,0,0,0,0,0,0,0,0
SIKKIM,2001,PROTECTION OF CIVIL RIGHTS ACT,0,0,0,0,0,0,0,0,0,0,0,0,0,0,0
SIKKIM,2001,SC/ST (PREVENTION OF ATROCITIES) ACT,0,0,0,0,0,0,0,0,0,0,0,0,0,0,0
SIKKIM,2001,INDIAN PASSPORT ACT,0,0,0,0,0,0,0,0,0,0,0,0,0,0,0
SIKKIM,2001,ESSENTIAL COMMODITIES ACT,0,0,0,0,0,0,0,0,0,0,0,0,0,0,0
SIKKIM,2001,ANTIQUITIES AND ART TREASURE ACT,0,0,0,0,0,0,0,0,0,0,0,0,0,0,0
SIKKIM,2001,DOWRY PROHIBITION ACT,0,0,0,0,0,0,0,0,0,0,0,0,0,0,0
SIKKIM,2001,FOREIGN EXCHANGE REGULATION ACT-1973,0,0,0,0,0,0,0,0,0,0,0,0,0,0,0
SIKKIM,2001,PREVENTION OF CORRUPTION ACT-1988,0,0,0,0,0,0,0,0,0,0,0,0,0,0,0
SIKKIM,2001,CONSER.OF FORGN.EXCH.&PREV. OF SMUG.ACT,0,0,0,0,0,0,0,0,0,0,0,0,0,0,0
SIKKIM,2001,OTHER SLL OFFENCE,0,0,0,0,0,0,0,0,0,0,0,0,0,0,0
SIKKIM,2001,TOTAL,0,0,0,13,0,13,0,0,0,0,0,0,13,0,13
SIKKIM,2002,ARMS ACT,0,0,0,0,0,0,0,0,0,0,0,0,0,0,0
SIKKIM,2002,N.D.P.S. ACT,0,0,0,5,0,5,0,0,0,0,0,0,5,0,5
SIKKIM,2002,GAMBLING ACT,0,0,0,0,0,0,0,0,0,0,0,0,0,0,0
SIKKIM,2002,EXCISE ACT,0,0,0,0,0,0,0,0,0,0,0,0,0,0,0
SIKKIM,2002,PROHIBITION ACT,0,0,0,0,0,0,0,0,0,0,0,0,0,0,0
SIKKIM,2002,EXPLOSIVE & EXPLOSIVE SUBST. ACT,0,0,0,0,0,0,0,0,0,0,0,0,0,0,0
SIKKIM,2002,TERRORIST & DISRUPTIVE ACTIVITIES (TATA),0,0,0,0,0,0,0,0,0,0,0,0,0,0,0
SIKKIM,2002,IMMORAL TRAFFIC (PREVENTION) ACT,0,0,0,0,0,0,0,0,0,0,0,0,0,0,0
SIKKIM,2002,INDIAN RAILWAYS ACT,0,0,0,0,0,0,0,0,0,0,0,0,0,0,0
SIKKIM,2002,REGISTRATION OF FOREIGNERS ACT,0,0,0,0,0,0,0,0,0,0,0,0,0,0,0
SIKKIM,2002,PROTECTION OF CIVIL RIGHTS ACT,0,0,0,0,0,0,0,0,0,0,0,0,0,0,0
SIKKIM,2002,SC/ST (PREVENTION OF ATROCITIES) ACT,0,0,0,0,0,0,0,0,0,0,0,0,0,0,0
SIKKIM,2002,INDIAN PASSPORT ACT,0,0,0,0,0,0,0,0,0,0,0,0,0,0,0
SIKKIM,2002,ESSENTIAL COMMODITIES ACT,0,0,0,0,0,0,0,0,0,0,0,0,0,0,0
SIKKIM,2002,ANTIQUITIES AND ART TREASURE ACT,0,0,0,0,0,0,0,0,0,0,0,0,0,0,0
SIKKIM,2002,DOWRY PROHIBITION ACT,0,0,0,0,0,0,0,0,0,0,0,0,0,0,0
SIKKIM,2002,FOREIGN EXCHANGE REGULATION ACT-1973,0,0,0,0,0,0,0,0,0,0,0,0,0,0,0
SIKKIM,2002,PREVENTION OF CORRUPTION ACT-1988,0,0,0,0,0,0,0,0,0,0,0,0,0,0,0
SIKKIM,2002,CONSER.OF FORGN.EXCH.&PREV. OF SMUG.ACT,0,0,0,0,0,0,0,0,0,0,0,0,0,0,0
SIKKIM,2002,OTHER SLL OFFENCE,0,0,0,0,0,0,0,0,0,0,0,0,0,0,0
SIKKIM,2002,TOTAL,0,0,0,5,0,5,0,0,0,0,0,0,5,0,5
SIKKIM,2003,ARMS ACT,0,0,0,0,0,0,0,0,0,0,0,0,0,0,0
SIKKIM,2003,N.D.P.S. ACT,0,0,0,2,2,4,0,0,0,0,0,0,2,2,4
SIKKIM,2003,GAMBLING ACT,0,0,0,0,0,0,0,0,0,0,0,0,0,0,0
SIKKIM,2003,EXCISE ACT,0,0,0,0,0,0,0,0,0,0,0,0,0,0,0
SIKKIM,2003,PROHIBITION ACT,0,0,0,0,0,0,0,0,0,0,0,0,0,0,0
SIKKIM,2003,EXPLOSIVE & EXPLOSIVE SUBST. ACT,0,0,0,0,0,0,0,0,0,0,0,0,0,0,0
SIKKIM,2003,TERRORIST & DISRUPTIVE ACTIVITIES (TATA),0,0,0,0,0,0,0,0,0,0,0,0,0,0,0
SIKKIM,2003,IMMORAL TRAFFIC (PREVENTION) ACT,0,0,0,0,0,0,0,0,0,0,0,0,0,0,0
SIKKIM,2003,INDIAN RAILWAYS ACT,0,0,0,0,0,0,0,0,0,0,0,0,0,0,0
SIKKIM,2003,REGISTRATION OF FOREIGNERS ACT,0,0,0,0,0,0,0,0,0,0,0,0,0,0,0
SIKKIM,2003,PROTECTION OF CIVIL RIGHTS ACT,0,0,0,0,0,0,0,0,0,0,0,0,0,0,0
SIKKIM,2003,SC/ST (PREVENTION OF ATROCITIES) ACT,0,0,0,0,0,0,0,0,0,0,0,0,0,0,0
SIKKIM,2003,INDIAN PASSPORT ACT,0,0,0,0,0,0,0,0,0,0,0,0,0,0,0
SIKKIM,2003,ESSENTIAL COMMODITIES ACT,0,0,0,0,0,0,0,0,0,0,0,0,0,0,0
SIKKIM,2003,ANTIQUITIES AND ART TREASURE ACT,0,0,0,0,0,0,0,0,0,0,0,0,0,0,0
SIKKIM,2003,DOWRY PROHIBITION ACT,0,0,0,0,0,0,0,0,0,0,0,0,0,0,0
SIKKIM,2003,FOREIGN EXCHANGE REGULATION ACT-1973,0,0,0,0,0,0,0,0,0,0,0,0,0,0,0
SIKKIM,2003,PREVENTION OF CORRUPTION ACT-1988,0,0,0,0,0,0,0,0,0,0,0,0,0,0,0
SIKKIM,2003,CONSER.OF FORGN.EXCH.&PREV. OF SMUG.ACT,0,0,0,0,0,0,0,0,0,0,0,0,0,0,0
SIKKIM,2003,OTHER SLL OFFENCE,0,0,0,0,0,0,0,0,0,0,0,0,0,0,0
SIKKIM,2003,TOTAL,0,0,0,2,2,4,0,0,0,0,0,0,2,2,4
SIKKIM,2004,ARMS ACT,0,0,0,0,0,0,0,0,0,0,0,0,0,0,0
SIKKIM,2004,N.D.P.S. ACT,0,0,0,4,0,4,1,0,1,0,0,0,5,0,5
SIKKIM,2004,GAMBLING ACT,0,0,0,0,0,0,0,0,0,0,0,0,0,0,0
SIKKIM,2004,EXCISE ACT,0,0,0,0,0,0,0,0,0,0,0,0,0,0,0
SIKKIM,2004,PROHIBITION ACT,0,0,0,0,0,0,0,0,0,0,0,0,0,0,0
SIKKIM,2004,EXPLOSIVE & EXPLOSIVE SUBST. ACT,0,0,0,3,0,3,0,0,0,0,0,0,3,0,3
SIKKIM,2004,TERRORIST & DISRUPTIVE ACTIVITIES (TATA),0,0,0,0,0,0,0,0,0,0,0,0,0,0,0
SIKKIM,2004,IMMORAL TRAFFIC (PREVENTION) ACT,0,0,0,0,0,0,0,0,0,0,0,0,0,0,0
SIKKIM,2004,INDIAN RAILWAYS ACT,0,0,0,0,0,0,0,0,0,0,0,0,0,0,0
SIKKIM,2004,REGISTRATION OF FOREIGNERS ACT,0,0,0,0,0,0,0,0,0,0,0,0,0,0,0
SIKKIM,2004,PROTECTION OF CIVIL RIGHTS ACT,0,0,0,0,0,0,0,0,0,0,0,0,0,0,0
SIKKIM,2004,SC/ST (PREVENTION OF ATROCITIES) ACT,0,0,0,0,0,0,0,0,0,0,0,0,0,0,0
SIKKIM,2004,INDIAN PASSPORT ACT,0,0,0,0,0,0,0,0,0,0,0,0,0,0,0
SIKKIM,2004,ESSENTIAL COMMODITIES ACT,0,0,0,0,0,0,0,0,0,0,0,0,0,0,0
SIKKIM,2004,ANTIQUITIES AND ART TREASURE ACT,0,0,0,0,0,0,0,0,0,0,0,0,0,0,0
SIKKIM,2004,DOWRY PROHIBITION ACT,0,0,0,0,0,0,0,0,0,0,0,0,0,0,0
SIKKIM,2004,FOREIGN EXCHANGE REGULATION ACT-1973,0,0,0,0,0,0,0,0,0,0,0,0,0,0,0
SIKKIM,2004,PREVENTION OF CORRUPTION ACT-1988,0,0,0,0,0,0,0,0,0,0,0,0,0,0,0
SIKKIM,2004,CONSER.OF FORGN.EXCH.&PREV. OF SMUG.ACT,0,0,0,0,0,0,0,0,0,0,0,0,0,0,0
SIKKIM,2004,OTHER SLL OFFENCE,0,0,0,7,0,7,5,0,5,0,0,0,12,0,12
SIKKIM,2004,TOTAL,0,0,0,14,0,14,6,0,6,0,0,0,20,0,20
SIKKIM,2005,ARMS ACT,0,0,0,0,0,0,0,0,0,0,0,0,0,0,0
SIKKIM,2005,N.D.P.S. ACT,0,0,0,5,2,7,1,0,1,0,0,0,6,2,8
SIKKIM,2005,GAMBLING ACT,0,0,0,0,0,0,0,0,0,0,0,0,0,0,0
SIKKIM,2005,EXCISE ACT,0,0,0,0,0,0,0,0,0,0,0,0,0,0,0
SIKKIM,2005,PROHIBITION ACT,0,0,0,0,0,0,0,0,0,0,0,0,0,0,0
SIKKIM,2005,EXPLOSIVE & EXPLOSIVE SUBST. ACT,0,0,0,3,0,3,0,0,0,0,0,0,3,0,3
SIKKIM,2005,TERRORIST & DISRUPTIVE ACTIVITIES (TATA),0,0,0,0,0,0,0,0,0,0,0,0,0,0,0
SIKKIM,2005,IMMORAL TRAFFIC (PREVENTION) ACT,0,0,0,0,0,0,0,0,0,0,0,0,0,0,0
SIKKIM,2005,INDIAN RAILWAYS ACT,0,0,0,0,0,0,0,0,0,0,0,0,0,0,0
SIKKIM,2005,REGISTRATION OF FOREIGNERS ACT,0,0,0,0,0,0,0,0,0,0,0,0,0,0,0
SIKKIM,2005,PROTECTION OF CIVIL RIGHTS ACT,0,0,0,0,0,0,0,0,0,0,0,0,0,0,0
SIKKIM,2005,SC/ST (PREVENTION OF ATROCITIES) ACT,0,0,0,0,0,0,0,0,0,0,0,0,0,0,0
SIKKIM,2005,INDIAN PASSPORT ACT,0,0,0,0,0,0,0,0,0,0,0,0,0,0,0
SIKKIM,2005,ESSENTIAL COMMODITIES ACT,0,0,0,0,0,0,0,0,0,0,0,0,0,0,0
SIKKIM,2005,ANTIQUITIES AND ART TREASURE ACT,0,0,0,0,0,0,0,0,0,0,0,0,0,0,0
SIKKIM,2005,DOWRY PROHIBITION ACT,0,0,0,0,0,0,0,0,0,0,0,0,0,0,0
SIKKIM,2005,FOREIGN EXCHANGE REGULATION ACT-1973,0,0,0,0,0,0,0,0,0,0,0,0,0,0,0
SIKKIM,2005,PREVENTION OF CORRUPTION ACT-1988,0,0,0,0,0,0,0,0,0,0,0,0,0,0,0
SIKKIM,2005,CONSER.OF FORGN.EXCH.&PREV. OF SMUG.ACT,0,0,0,0,0,0,0,0,0,0,0,0,0,0,0
SIKKIM,2005,OTHER SLL OFFENCE,0,0,0,7,1,8,9,1,10,0,0,0,16,2,18
SIKKIM,2005,TOTAL,0,0,0,15,3,18,10,1,11,0,0,0,25,4,29
SIKKIM,2006,ARMS ACT,0,0,0,0,0,0,0,0,0,0,0,0,0,0,0
SIKKIM,2006,N.D.P.S. ACT,0,0,0,4,0,4,1,0,1,0,0,0,5,0,5
SIKKIM,2006,GAMBLING ACT,0,0,0,0,0,0,0,0,0,0,0,0,0,0,0
SIKKIM,2006,EXCISE ACT,0,0,0,0,0,0,0,0,0,0,0,0,0,0,0
SIKKIM,2006,PROHIBITION ACT,0,0,0,0,0,0,0,0,0,0,0,0,0,0,0
SIKKIM,2006,EXPLOSIVE & EXPLOSIVE SUBST. ACT,0,0,0,0,0,0,2,0,2,0,0,0,2,0,2
SIKKIM,2006,TERRORIST & DISRUPTIVE ACTIVITIES (TATA),0,0,0,0,0,0,0,0,0,0,0,0,0,0,0
SIKKIM,2006,IMMORAL TRAFFIC (PREVENTION) ACT,0,0,0,0,0,0,0,0,0,0,0,0,0,0,0
SIKKIM,2006,INDIAN RAILWAYS ACT,0,0,0,0,0,0,0,0,0,0,0,0,0,0,0
SIKKIM,2006,REGISTRATION OF FOREIGNERS ACT,0,0,0,0,0,0,0,0,0,0,0,0,0,0,0
SIKKIM,2006,PROTECTION OF CIVIL RIGHTS ACT,0,0,0,0,0,0,0,0,0,0,0,0,0,0,0
SIKKIM,2006,SC/ST (PREVENTION OF ATROCITIES) ACT,0,0,0,0,0,0,0,0,0,0,0,0,0,0,0
SIKKIM,2006,INDIAN PASSPORT ACT,0,0,0,0,0,0,0,0,0,0,0,0,0,0,0
SIKKIM,2006,ESSENTIAL COMMODITIES ACT,0,0,0,0,0,0,0,0,0,0,0,0,0,0,0
SIKKIM,2006,ANTIQUITIES AND ART TREASURE ACT,0,0,0,0,0,0,0,0,0,0,0,0,0,0,0
SIKKIM,2006,DOWRY PROHIBITION ACT,0,0,0,0,0,0,0,0,0,0,0,0,0,0,0
SIKKIM,2006,FOREIGN EXCHANGE REGULATION ACT-1973,0,0,0,0,0,0,0,0,0,0,0,0,0,0,0
SIKKIM,2006,PREVENTION OF CORRUPTION ACT-1988,0,0,0,0,0,0,0,0,0,0,0,0,0,0,0
SIKKIM,2006,CONSER.OF FORGN.EXCH.&PREV. OF SMUG.ACT,0,0,0,0,0,0,0,0,0,0,0,0,0,0,0
SIKKIM,2006,OTHER SLL OFFENCE,0,0,0,2,0,2,1,0,1,0,0,0,3,0,3
SIKKIM,2006,TOTAL,0,0,0,6,0,6,4,0,4,0,0,0,10,0,10
SIKKIM,2007,ARMS ACT,0,0,0,0,0,0,0,0,0,0,0,0,0,0,0
SIKKIM,2007,N.D.P.S. ACT,0,0,0,2,0,2,0,0,0,0,0,0,2,0,2
SIKKIM,2007,GAMBLING ACT,0,0,0,0,0,0,0,0,0,0,0,0,0,0,0
SIKKIM,2007,EXCISE ACT,0,0,0,0,0,0,0,0,0,0,0,0,0,0,0
SIKKIM,2007,PROHIBITION ACT,0,0,0,0,0,0,0,0,0,0,0,0,0,0,0
SIKKIM,2007,EXPLOSIVE & EXPLOSIVE SUBST. ACT,0,0,0,0,0,0,1,0,1,0,0,0,1,0,1
SIKKIM,2007,TERRORIST & DISRUPTIVE ACTIVITIES (TATA),0,0,0,0,0,0,0,0,0,0,0,0,0,0,0
SIKKIM,2007,IMMORAL TRAFFIC (PREVENTION) ACT,0,0,0,0,1,1,0,0,0,0,0,0,0,1,1
SIKKIM,2007,INDIAN RAILWAYS ACT,0,0,0,0,0,0,0,0,0,0,0,0,0,0,0
SIKKIM,2007,REGISTRATION OF FOREIGNERS ACT,0,0,0,0,0,0,0,0,0,0,0,0,0,0,0
SIKKIM,2007,PROTECTION OF CIVIL RIGHTS ACT,0,0,0,0,0,0,0,0,0,0,0,0,0,0,0
SIKKIM,2007,SC/ST (PREVENTION OF ATROCITIES) ACT,0,0,0,0,0,0,0,0,0,0,0,0,0,0,0
SIKKIM,2007,INDIAN PASSPORT ACT,0,0,0,0,0,0,0,0,0,0,0,0,0,0,0
SIKKIM,2007,ESSENTIAL COMMODITIES ACT,0,0,0,0,0,0,0,0,0,0,0,0,0,0,0
SIKKIM,2007,ANTIQUITIES AND ART TREASURE ACT,0,0,0,0,0,0,0,0,0,0,0,0,0,0,0
SIKKIM,2007,DOWRY PROHIBITION ACT,0,0,0,0,0,0,0,0,0,0,0,0,0,0,0
SIKKIM,2007,FOREIGN EXCHANGE REGULATION ACT-1973,0,0,0,0,0,0,0,0,0,0,0,0,0,0,0
SIKKIM,2007,PREVENTION OF CORRUPTION ACT-1988,0,0,0,0,0,0,0,0,0,0,0,0,0,0,0
SIKKIM,2007,CONSER.OF FORGN.EXCH.&PREV. OF SMUG.ACT,0,0,0,0,0,0,0,0,0,0,0,0,0,0,0
SIKKIM,2007,OTHER SLL OFFENCE,0,0,0,1,0,1,0,0,0,0,0,0,1,0,1
SIKKIM,2007,TOTAL,0,0,0,3,1,4,1,0,1,0,0,0,4,1,5
SIKKIM,2008,ARMS ACT,0,0,0,0,0,0,0,0,0,0,0,0,0,0,0
SIKKIM,2008,N.D.P.S. ACT,0,0,0,15,0,15,0,0,0,0,0,0,15,0,15
SIKKIM,2008,GAMBLING ACT,0,0,0,0,0,0,0,0,0,0,0,0,0,0,0
SIKKIM,2008,EXCISE ACT,0,0,0,0,0,0,0,0,0,0,0,0,0,0,0
SIKKIM,2008,PROHIBITION ACT,0,0,0,0,0,0,0,0,0,0,0,0,0,0,0
SIKKIM,2008,EXPLOSIVE & EXPLOSIVE SUBST. ACT,0,0,0,2,0,2,1,0,1,0,0,0,3,0,3
SIKKIM,2008,TERRORIST & DISRUPTIVE ACTIVITIES (TATA),0,0,0,0,0,0,0,0,0,0,0,0,0,0,0
SIKKIM,2008,IMMORAL TRAFFIC (PREVENTION) ACT,0,0,0,0,0,0,0,0,0,0,0,0,0,0,0
SIKKIM,2008,INDIAN RAILWAYS ACT,0,0,0,0,0,0,0,0,0,0,0,0,0,0,0
SIKKIM,2008,REGISTRATION OF FOREIGNERS ACT,0,0,0,5,1,6,0,0,0,0,0,0,5,1,6
SIKKIM,2008,PROTECTION OF CIVIL RIGHTS ACT,0,0,0,0,0,0,0,0,0,0,0,0,0,0,0
SIKKIM,2008,SC/ST (PREVENTION OF ATROCITIES) ACT,0,0,0,0,0,0,0,0,0,0,0,0,0,0,0
SIKKIM,2008,INDIAN PASSPORT ACT,0,0,0,0,0,0,0,0,0,0,0,0,0,0,0
SIKKIM,2008,ESSENTIAL COMMODITIES ACT,0,0,0,0,0,0,0,0,0,0,0,0,0,0,0
SIKKIM,2008,ANTIQUITIES AND ART TREASURE ACT,0,0,0,0,0,0,0,0,0,0,0,0,0,0,0
SIKKIM,2008,DOWRY PROHIBITION ACT,0,0,0,0,0,0,0,0,0,0,0,0,0,0,0
SIKKIM,2008,FOREIGN EXCHANGE REGULATION ACT-1973,0,0,0,0,0,0,0,0,0,0,0,0,0,0,0
SIKKIM,2008,PREVENTION OF CORRUPTION ACT-1988,0,0,0,0,0,0,0,0,0,0,0,0,0,0,0
SIKKIM,2008,CONSER.OF FORGN.EXCH.&PREV. OF SMUG.ACT,0,0,0,0,0,0,0,0,0,0,0,0,0,0,0
SIKKIM,2008,OTHER SLL OFFENCE,0,0,0,7,1,8,2,1,3,1,0,1,10,2,12
SIKKIM,2008,TOTAL,0,0,0,29,2,31,3,1,4,1,0,1,33,3,36
SIKKIM,2009,ARMS ACT,0,0,0,0,0,0,1,0,1,0,0,0,1,0,1
SIKKIM,2009,N.D.P.S. ACT,0,0,0,0,0,0,0,0,0,0,0,0,0,0,0
SIKKIM,2009,GAMBLING ACT,0,0,0,0,0,0,0,0,0,0,0,0,0,0,0
SIKKIM,2009,EXCISE ACT,0,0,0,0,0,0,0,0,0,0,0,0,0,0,0
SIKKIM,2009,PROHIBITION ACT,0,0,0,0,0,0,0,0,0,0,0,0,0,0,0
SIKKIM,2009,EXPLOSIVE & EXPLOSIVE SUBST. ACT,0,0,0,1,0,1,1,0,1,0,0,0,2,0,2
SIKKIM,2009,TERRORIST & DISRUPTIVE ACTIVITIES (TATA),0,0,0,0,0,0,0,0,0,0,0,0,0,0,0
SIKKIM,2009,IMMORAL TRAFFIC (PREVENTION) ACT,0,0,0,0,0,0,0,0,0,0,0,0,0,0,0
SIKKIM,2009,INDIAN RAILWAYS ACT,0,0,0,0,0,0,0,0,0,0,0,0,0,0,0
SIKKIM,2009,REGISTRATION OF FOREIGNERS ACT,0,0,0,0,0,0,0,0,0,0,0,0,0,0,0
SIKKIM,2009,PROTECTION OF CIVIL RIGHTS ACT,0,0,0,0,0,0,0,0,0,0,0,0,0,0,0
SIKKIM,2009,SC/ST (PREVENTION OF ATROCITIES) ACT,0,0,0,0,0,0,0,0,0,0,0,0,0,0,0
SIKKIM,2009,INDIAN PASSPORT ACT,0,0,0,0,0,0,0,0,0,0,0,0,0,0,0
SIKKIM,2009,ESSENTIAL COMMODITIES ACT,0,0,0,0,0,0,0,0,0,0,0,0,0,0,0
SIKKIM,2009,ANTIQUITIES AND ART TREASURE ACT,0,0,0,0,0,0,0,0,0,0,0,0,0,0,0
SIKKIM,2009,DOWRY PROHIBITION ACT,0,0,0,0,0,0,0,0,0,0,0,0,0,0,0
SIKKIM,2009,FOREIGN EXCHANGE REGULATION ACT-1973,0,0,0,0,0,0,0,0,0,0,0,0,0,0,0
SIKKIM,2009,PREVENTION OF CORRUPTION ACT-1988,0,0,0,0,0,0,0,0,0,0,0,0,0,0,0
SIKKIM,2009,CONSER.OF FORGN.EXCH.&PREV. OF SMUG.ACT,0,0,0,0,0,0,0,0,0,0,0,0,0,0,0
SIKKIM,2009,OTHER SLL OFFENCE,0,0,0,15,0,15,4,1,5,0,0,0,19,1,20
SIKKIM,2009,TOTAL,0,0,0,16,0,16,6,1,7,0,0,0,22,1,23
SIKKIM,2010,ARMS ACT,0,0,0,0,0,0,0,0,0,0,0,0,0,0,0
SIKKIM,2010,N.D.P.S. ACT,0,0,0,0,0,0,0,0,0,0,0,0,0,0,0
SIKKIM,2010,GAMBLING ACT,0,0,0,0,0,0,0,0,0,0,0,0,0,0,0
SIKKIM,2010,EXCISE ACT,0,0,0,0,0,0,0,0,0,0,0,0,0,0,0
SIKKIM,2010,PROHIBITION ACT,0,0,0,0,0,0,0,0,0,0,0,0,0,0,0
SIKKIM,2010,EXPLOSIVE & EXPLOSIVE SUBST. ACT,0,0,0,0,0,0,0,0,0,0,0,0,0,0,0
SIKKIM,2010,TERRORIST & DISRUPTIVE ACTIVITIES (TATA),0,0,0,0,0,0,0,0,0,0,0,0,0,0,0
SIKKIM,2010,IMMORAL TRAFFIC (PREVENTION) ACT,0,0,0,0,1,1,0,0,0,0,0,0,0,1,1
SIKKIM,2010,INDIAN RAILWAYS ACT,0,0,0,0,0,0,0,0,0,0,0,0,0,0,0
SIKKIM,2010,REGISTRATION OF FOREIGNERS ACT,0,0,0,0,0,0,1,0,1,0,0,0,1,0,1
SIKKIM,2010,PROTECTION OF CIVIL RIGHTS ACT,0,0,0,0,0,0,0,0,0,0,0,0,0,0,0
SIKKIM,2010,SC/ST (PREVENTION OF ATROCITIES) ACT,0,0,0,0,0,0,0,0,0,0,0,0,0,0,0
SIKKIM,2010,INDIAN PASSPORT ACT,0,0,0,0,0,0,0,0,0,0,0,0,0,0,0
SIKKIM,2010,ESSENTIAL COMMODITIES ACT,0,0,0,0,0,0,0,0,0,0,0,0,0,0,0
SIKKIM,2010,ANTIQUITIES AND ART TREASURE ACT,0,0,0,0,0,0,0,0,0,0,0,0,0,0,0
SIKKIM,2010,DOWRY PROHIBITION ACT,0,0,0,0,0,0,0,0,0,0,0,0,0,0,0
SIKKIM,2010,FOREIGN EXCHANGE REGULATION ACT-1973,0,0,0,0,0,0,0,0,0,0,0,0,0,0,0
SIKKIM,2010,PREVENTION OF CORRUPTION ACT-1988,0,0,0,0,0,0,0,0,0,0,0,0,0,0,0
SIKKIM,2010,CONSER.OF FORGN.EXCH.&PREV. OF SMUG.ACT,0,0,0,0,0,0,0,0,0,0,0,0,0,0,0
SIKKIM,2010,OTHER SLL OFFENCE,0,0,0,26,2,28,8,2,10,0,0,0,34,4,38
SIKKIM,2010,TOTAL,0,0,0,26,3,29,9,2,11,0,0,0,35,5,40
SIKKIM,2011,ARMS ACT,0,0,0,0,0,0,0,0,0,0,0,0,0,0,0
SIKKIM,2011,N.D.P.S. ACT,0,0,0,0,0,0,0,0,0,0,0,0,0,0,0
SIKKIM,2011,GAMBLING ACT,0,0,0,0,0,0,0,0,0,0,0,0,0,0,0
SIKKIM,2011,EXCISE ACT,0,0,0,0,0,0,0,0,0,0,0,0,0,0,0
SIKKIM,2011,PROHIBITION ACT,0,0,0,0,0,0,0,0,0,0,0,0,0,0,0
SIKKIM,2011,EXPLOSIVE & EXPLOSIVE SUBST. ACT,0,0,0,0,0,0,0,0,0,0,0,0,0,0,0
SIKKIM,2011,TERRORIST & DISRUPTIVE ACTIVITIES (TATA),0,0,0,0,0,0,0,0,0,0,0,0,0,0,0
SIKKIM,2011,IMMORAL TRAFFIC (PREVENTION) ACT,0,0,0,0,0,0,0,0,0,0,0,0,0,0,0
SIKKIM,2011,INDIAN RAILWAYS ACT,0,0,0,0,0,0,0,0,0,0,0,0,0,0,0
SIKKIM,2011,REGISTRATION OF FOREIGNERS ACT,0,0,0,0,0,0,0,0,0,0,0,0,0,0,0
SIKKIM,2011,PROTECTION OF CIVIL RIGHTS ACT,0,0,0,0,0,0,0,0,0,0,0,0,0,0,0
SIKKIM,2011,SC/ST (PREVENTION OF ATROCITIES) ACT,0,0,0,0,0,0,0,0,0,0,0,0,0,0,0
SIKKIM,2011,INDIAN PASSPORT ACT,0,0,0,1,0,1,0,0,0,0,0,0,1,0,1
SIKKIM,2011,ESSENTIAL COMMODITIES ACT,0,0,0,0,0,0,0,0,0,0,0,0,0,0,0
SIKKIM,2011,ANTIQUITIES AND ART TREASURE ACT,0,0,0,0,0,0,0,0,0,0,0,0,0,0,0
SIKKIM,2011,DOWRY PROHIBITION ACT,0,0,0,0,0,0,0,0,0,0,0,0,0,0,0
SIKKIM,2011,FOREIGN EXCHANGE REGULATION ACT-1973,0,0,0,0,0,0,0,0,0,0,0,0,0,0,0
SIKKIM,2011,PREVENTION OF CORRUPTION ACT-1988,0,0,0,0,0,0,0,0,0,0,0,0,0,0,0
SIKKIM,2011,CONSER.OF FORGN.EXCH.&PREV. OF SMUG.ACT,0,0,0,0,0,0,0,0,0,0,0,0,0,0,0
SIKKIM,2011,OTHER SLL OFFENCE,0,0,0,22,0,22,0,0,0,1,0,1,23,0,23
SIKKIM,2011,TOTAL,0,0,0,23,0,23,0,0,0,1,0,1,24,0,24
SIKKIM,2012,ARMS ACT,0,0,0,0,0,0,0,0,0,0,0,0,0,0,0
SIKKIM,2012,N.D.P.S. ACT,0,0,0,2,0,2,0,0,0,0,0,0,2,0,2
SIKKIM,2012,GAMBLING ACT,0,0,0,0,0,0,0,0,0,0,0,0,0,0,0
SIKKIM,2012,EXCISE ACT,0,0,0,0,0,0,0,0,0,0,0,0,0,0,0
SIKKIM,2012,PROHIBITION ACT,0,0,0,0,0,0,0,0,0,0,0,0,0,0,0
SIKKIM,2012,EXPLOSIVE & EXPLOSIVE SUBST. ACT,0,0,0,0,0,0,0,0,0,0,0,0,0,0,0
SIKKIM,2012,TERRORIST & DISRUPTIVE ACTIVITIES (TATA),0,0,0,0,0,0,0,0,0,0,0,0,0,0,0
SIKKIM,2012,IMMORAL TRAFFIC (PREVENTION) ACT,0,0,0,0,0,0,0,0,0,0,0,0,0,0,0
SIKKIM,2012,INDIAN RAILWAYS ACT,0,0,0,0,0,0,0,0,0,0,0,0,0,0,0
SIKKIM,2012,REGISTRATION OF FOREIGNERS ACT,0,0,0,0,0,0,0,0,0,0,0,0,0,0,0
SIKKIM,2012,PROTECTION OF CIVIL RIGHTS ACT,0,0,0,0,0,0,0,0,0,0,0,0,0,0,0
SIKKIM,2012,SC/ST (PREVENTION OF ATROCITIES) ACT,0,0,0,0,0,0,0,0,0,0,0,0,0,0,0
SIKKIM,2012,INDIAN PASSPORT ACT,0,0,0,0,0,0,0,0,0,0,0,0,0,0,0
SIKKIM,2012,ESSENTIAL COMMODITIES ACT,0,0,0,0,0,0,0,0,0,0,0,0,0,0,0
SIKKIM,2012,ANTIQUITIES AND ART TREASURE ACT,0,0,0,0,0,0,0,0,0,0,0,0,0,0,0
SIKKIM,2012,DOWRY PROHIBITION ACT,0,0,0,0,0,0,0,0,0,0,0,0,0,0,0
SIKKIM,2012,FOREIGN EXCHANGE REGULATION ACT-1973,0,0,0,0,0,0,0,0,0,0,0,0,0,0,0
SIKKIM,2012,PREVENTION OF CORRUPTION ACT-1988,0,0,0,0,0,0,0,0,0,0,0,0,0,0,0
SIKKIM,2012,CONSER.OF FORGN.EXCH.&PREV. OF SMUG.ACT,0,0,0,0,0,0,0,0,0,0,0,0,0,0,0
SIKKIM,2012,OTHER SLL OFFENCE,0,0,0,31,1,32,9,2,11,1,1,2,41,4,45
SIKKIM,2012,TOTAL,0,0,0,33,1,34,9,2,11,1,1,2,43,4,47
TAMILNADU,2001,ARMS ACT,0,0,0,58,0,58,10,0,10,0,0,0,68,0,68
TAMILNADU,2001,N.D.P.S. ACT,0,0,0,53,4,57,81,3,84,2,1,3,136,8,144
TAMILNADU,2001,GAMBLING ACT,0,0,0,0,0,0,0,0,0,0,0,0,0,0,0
TAMILNADU,2001,EXCISE ACT,0,0,0,0,0,0,0,0,0,0,0,0,0,0,0
TAMILNADU,2001,PROHIBITION ACT,0,0,0,8,4,12,87,6,93,2,0,2,97,10,107
TAMILNADU,2001,EXPLOSIVE & EXPLOSIVE SUBST. ACT,0,0,0,19,0,19,12,0,12,0,0,0,31,0,31
TAMILNADU,2001,TERRORIST & DISRUPTIVE ACTIVITIES (TATA),0,0,0,6,0,6,0,0,0,0,0,0,6,0,6
TAMILNADU,2001,IMMORAL TRAFFIC (PREVENTION) ACT,0,0,0,0,0,0,0,0,0,0,0,0,0,0,0
TAMILNADU,2001,INDIAN RAILWAYS ACT,0,0,0,1,0,1,0,0,0,0,0,0,1,0,1
TAMILNADU,2001,REGISTRATION OF FOREIGNERS ACT,0,0,0,0,0,0,0,0,0,0,0,0,0,0,0
TAMILNADU,2001,PROTECTION OF CIVIL RIGHTS ACT,0,0,0,0,0,0,0,0,0,0,0,0,0,0,0
TAMILNADU,2001,SC/ST (PREVENTION OF ATROCITIES) ACT,0,0,0,0,0,0,0,0,0,0,0,0,0,0,0
TAMILNADU,2001,INDIAN PASSPORT ACT,0,0,0,8,0,8,9,0,9,0,0,0,17,0,17
TAMILNADU,2001,ESSENTIAL COMMODITIES ACT,0,0,0,2,0,2,2,0,2,0,0,0,4,0,4
TAMILNADU,2001,ANTIQUITIES AND ART TREASURE ACT,0,0,0,0,0,0,0,0,0,0,0,0,0,0,0
TAMILNADU,2001,DOWRY PROHIBITION ACT,0,0,0,0,0,0,0,0,0,0,0,0,0,0,0
TAMILNADU,2001,FOREIGN EXCHANGE REGULATION ACT-1973,0,0,0,0,0,0,0,0,0,0,0,0,0,0,0
TAMILNADU,2001,PREVENTION OF CORRUPTION ACT-1988,0,0,0,0,0,0,0,0,0,0,0,0,0,0,0
TAMILNADU,2001,CONSER.OF FORGN.EXCH.&PREV. OF SMUG.ACT,0,0,0,2,0,2,3,0,3,0,0,0,5,0,5
TAMILNADU,2001,OTHER SLL OFFENCE,0,0,0,11,0,11,18,0,18,17,0,17,46,0,46
TAMILNADU,2001,TOTAL,0,0,0,168,8,176,222,9,231,21,1,22,411,18,429
TAMILNADU,2002,ARMS ACT,0,0,0,39,0,39,11,1,12,1,1,2,51,2,53
TAMILNADU,2002,N.D.P.S. ACT,0,0,0,40,0,40,35,4,39,7,0,7,82,4,86
TAMILNADU,2002,GAMBLING ACT,0,0,0,0,0,0,0,0,0,0,0,0,0,0,0
TAMILNADU,2002,EXCISE ACT,0,0,0,0,0,0,0,0,0,0,0,0,0,0,0
TAMILNADU,2002,PROHIBITION ACT,0,0,0,4,0,4,7,7,14,2,0,2,13,7,20
TAMILNADU,2002,EXPLOSIVE & EXPLOSIVE SUBST. ACT,0,0,0,21,0,21,9,0,9,3,0,3,33,0,33
TAMILNADU,2002,TERRORIST & DISRUPTIVE ACTIVITIES (TATA),0,0,0,8,0,8,2,0,2,0,0,0,10,0,10
TAMILNADU,2002,IMMORAL TRAFFIC (PREVENTION) ACT,0,0,0,0,2,2,0,1,1,0,0,0,0,3,3
TAMILNADU,2002,INDIAN RAILWAYS ACT,0,0,0,0,0,0,0,0,0,0,0,0,0,0,0
TAMILNADU,2002,REGISTRATION OF FOREIGNERS ACT,0,0,0,7,0,7,20,0,20,0,0,0,27,0,27
TAMILNADU,2002,PROTECTION OF CIVIL RIGHTS ACT,0,0,0,0,0,0,0,0,0,0,0,0,0,0,0
TAMILNADU,2002,SC/ST (PREVENTION OF ATROCITIES) ACT,0,0,0,0,0,0,0,0,0,0,0,0,0,0,0
TAMILNADU,2002,INDIAN PASSPORT ACT,0,0,0,8,0,8,9,0,9,0,0,0,17,0,17
TAMILNADU,2002,ESSENTIAL COMMODITIES ACT,0,0,0,2,0,2,4,0,4,0,0,0,6,0,6
TAMILNADU,2002,ANTIQUITIES AND ART TREASURE ACT,0,0,0,0,0,0,2,0,2,0,0,0,2,0,2
TAMILNADU,2002,DOWRY PROHIBITION ACT,0,0,0,0,0,0,0,0,0,0,0,0,0,0,0
TAMILNADU,2002,FOREIGN EXCHANGE REGULATION ACT-1973,0,0,0,0,0,0,0,0,0,0,0,0,0,0,0
TAMILNADU,2002,PREVENTION OF CORRUPTION ACT-1988,0,0,0,0,0,0,0,0,0,0,0,0,0,0,0
TAMILNADU,2002,CONSER.OF FORGN.EXCH.&PREV. OF SMUG.ACT,0,0,0,25,0,25,12,0,12,0,0,0,37,0,37
TAMILNADU,2002,OTHER SLL OFFENCE,0,0,0,0,0,0,0,0,0,1,0,1,1,0,1
TAMILNADU,2002,TOTAL,0,0,0,154,2,156,111,13,124,14,1,15,279,16,295
TAMILNADU,2003,ARMS ACT,0,0,0,45,0,45,13,1,14,3,1,4,61,2,63
TAMILNADU,2003,N.D.P.S. ACT,0,0,0,51,0,51,42,4,46,10,0,10,103,4,107
TAMILNADU,2003,GAMBLING ACT,0,0,0,0,0,0,0,0,0,0,0,0,0,0,0
TAMILNADU,2003,EXCISE ACT,0,0,0,0,0,0,0,0,0,0,0,0,0,0,0
TAMILNADU,2003,PROHIBITION ACT,0,0,0,6,0,6,11,7,18,4,0,4,21,7,28
TAMILNADU,2003,EXPLOSIVE & EXPLOSIVE SUBST. ACT,0,0,0,27,0,27,15,0,15,7,0,7,49,0,49
TAMILNADU,2003,TERRORIST & DISRUPTIVE ACTIVITIES (TATA),0,0,0,10,0,10,4,0,4,0,0,0,14,0,14
TAMILNADU,2003,IMMORAL TRAFFIC (PREVENTION) ACT,0,0,0,0,2,2,0,1,1,0,0,0,0,3,3
TAMILNADU,2003,INDIAN RAILWAYS ACT,0,0,0,0,0,0,0,0,0,0,0,0,0,0,0
TAMILNADU,2003,REGISTRATION OF FOREIGNERS ACT,0,0,0,8,0,8,27,0,27,0,0,0,35,0,35
TAMILNADU,2003,PROTECTION OF CIVIL RIGHTS ACT,0,0,0,0,0,0,0,0,0,0,0,0,0,0,0
TAMILNADU,2003,SC/ST (PREVENTION OF ATROCITIES) ACT,0,0,0,0,0,0,0,0,0,0,0,0,0,0,0
TAMILNADU,2003,INDIAN PASSPORT ACT,0,0,0,10,0,10,11,0,11,0,0,0,21,0,21
TAMILNADU,2003,ESSENTIAL COMMODITIES ACT,0,0,0,4,0,4,6,0,6,0,0,0,10,0,10
TAMILNADU,2003,ANTIQUITIES AND ART TREASURE ACT,0,0,0,0,0,0,2,0,2,0,0,0,2,0,2
TAMILNADU,2003,DOWRY PROHIBITION ACT,0,0,0,0,0,0,0,0,0,0,0,0,0,0,0
TAMILNADU,2003,FOREIGN EXCHANGE REGULATION ACT-1973,0,0,0,0,0,0,0,0,0,0,0,0,0,0,0
TAMILNADU,2003,PREVENTION OF CORRUPTION ACT-1988,0,0,0,0,0,0,0,0,0,0,0,0,0,0,0
TAMILNADU,2003,CONSER.OF FORGN.EXCH.&PREV. OF SMUG.ACT,0,0,0,32,0,32,16,0,16,0,0,0,48,0,48
TAMILNADU,2003,OTHER SLL OFFENCE,0,0,0,0,0,0,0,0,0,1,0,1,1,0,1
TAMILNADU,2003,TOTAL,0,0,0,193,2,195,147,13,160,25,1,26,365,16,381
TAMILNADU,2004,ARMS ACT,0,0,0,13,0,13,8,0,8,0,0,0,21,0,21
TAMILNADU,2004,N.D.P.S. ACT,0,0,0,67,3,70,25,2,27,6,3,9,98,8,106
TAMILNADU,2004,GAMBLING ACT,0,0,0,0,0,0,0,0,0,0,0,0,0,0,0
TAMILNADU,2004,EXCISE ACT,0,0,0,0,0,0,0,0,0,0,0,0,0,0,0
TAMILNADU,2004,PROHIBITION ACT,0,0,0,14,2,16,15,5,20,3,0,3,32,7,39
TAMILNADU,2004,EXPLOSIVE & EXPLOSIVE SUBST. ACT,0,0,0,14,0,14,12,0,12,0,0,0,26,0,26
TAMILNADU,2004,TERRORIST & DISRUPTIVE ACTIVITIES (TATA),0,0,0,13,0,13,11,0,11,0,0,0,24,0,24
TAMILNADU,2004,IMMORAL TRAFFIC (PREVENTION) ACT,0,0,0,6,0,6,4,0,4,0,0,0,10,0,10
TAMILNADU,2004,INDIAN RAILWAYS ACT,0,0,0,0,0,0,0,0,0,0,0,0,0,0,0
TAMILNADU,2004,REGISTRATION OF FOREIGNERS ACT,0,0,0,14,0,14,8,0,8,0,0,0,22,0,22
TAMILNADU,2004,PROTECTION OF CIVIL RIGHTS ACT,0,0,0,5,0,5,3,0,3,0,0,0,8,0,8
TAMILNADU,2004,SC/ST (PREVENTION OF ATROCITIES) ACT,0,0,0,0,0,0,0,0,0,0,0,0,0,0,0
TAMILNADU,2004,INDIAN PASSPORT ACT,0,0,0,0,0,0,0,0,0,0,0,0,0,0,0
TAMILNADU,2004,ESSENTIAL COMMODITIES ACT,0,0,0,0,0,0,0,0,0,0,0,0,0,0,0
TAMILNADU,2004,ANTIQUITIES AND ART TREASURE ACT,0,0,0,0,0,0,0,0,0,0,0,0,0,0,0
TAMILNADU,2004,DOWRY PROHIBITION ACT,0,0,0,0,0,0,0,4,4,0,0,0,0,4,4
TAMILNADU,2004,FOREIGN EXCHANGE REGULATION ACT-1973,0,0,0,0,0,0,0,0,0,0,0,0,0,0,0
TAMILNADU,2004,PREVENTION OF CORRUPTION ACT-1988,0,0,0,0,0,0,0,0,0,0,0,0,0,0,0
TAMILNADU,2004,CONSER.OF FORGN.EXCH.&PREV. OF SMUG.ACT,0,0,0,0,1,1,0,7,7,0,0,0,0,8,8
TAMILNADU,2004,OTHER SLL OFFENCE,0,0,0,0,0,0,0,0,0,0,0,0,0,0,0
TAMILNADU,2004,TOTAL,0,0,0,146,6,152,86,18,104,9,3,12,241,27,268
TAMILNADU,2005,ARMS ACT,0,0,0,0,0,0,0,0,0,0,0,0,0,0,0
TAMILNADU,2005,N.D.P.S. ACT,0,0,0,24,0,24,5,0,5,0,0,0,29,0,29
TAMILNADU,2005,GAMBLING ACT,0,0,0,38,3,41,6,0,6,5,0,5,49,3,52
TAMILNADU,2005,EXCISE ACT,0,0,0,0,0,0,0,0,0,0,0,0,0,0,0
TAMILNADU,2005,PROHIBITION ACT,0,0,0,14,2,16,12,0,12,0,0,0,26,2,28
TAMILNADU,2005,EXPLOSIVE & EXPLOSIVE SUBST. ACT,0,0,0,14,0,14,8,0,8,0,0,0,22,0,22
TAMILNADU,2005,TERRORIST & DISRUPTIVE ACTIVITIES (TATA),0,0,0,0,0,0,1,0,1,0,0,0,1,0,1
TAMILNADU,2005,IMMORAL TRAFFIC (PREVENTION) ACT,0,0,0,0,0,0,0,0,0,0,0,0,0,0,0
TAMILNADU,2005,INDIAN RAILWAYS ACT,0,0,0,0,0,0,0,0,0,0,0,0,0,0,0
TAMILNADU,2005,REGISTRATION OF FOREIGNERS ACT,0,0,0,9,0,9,9,0,9,0,0,0,18,0,18
TAMILNADU,2005,PROTECTION OF CIVIL RIGHTS ACT,0,0,0,0,0,0,0,0,0,0,0,0,0,0,0
TAMILNADU,2005,SC/ST (PREVENTION OF ATROCITIES) ACT,0,0,0,2,0,2,0,0,0,0,0,0,2,0,2
TAMILNADU,2005,INDIAN PASSPORT ACT,0,0,0,4,0,4,4,0,4,0,0,0,8,0,8
TAMILNADU,2005,ESSENTIAL COMMODITIES ACT,0,0,0,0,0,0,0,0,0,0,0,0,0,0,0
TAMILNADU,2005,ANTIQUITIES AND ART TREASURE ACT,0,0,0,0,0,0,0,0,0,0,0,0,0,0,0
TAMILNADU,2005,DOWRY PROHIBITION ACT,0,0,0,0,0,0,2,0,2,0,0,0,2,0,2
TAMILNADU,2005,FOREIGN EXCHANGE REGULATION ACT-1973,0,0,0,0,0,0,0,0,0,0,0,0,0,0,0
TAMILNADU,2005,PREVENTION OF CORRUPTION ACT-1988,0,0,0,2,0,2,2,0,2,0,0,0,4,0,4
TAMILNADU,2005,CONSER.OF FORGN.EXCH.&PREV. OF SMUG.ACT,0,0,0,0,0,0,0,0,0,0,0,0,0,0,0
TAMILNADU,2005,OTHER SLL OFFENCE,0,0,0,0,0,0,0,0,0,0,0,0,0,0,0
TAMILNADU,2005,TOTAL,0,0,0,107,5,112,49,0,49,5,0,5,161,5,166
TAMILNADU,2006,ARMS ACT,0,0,0,0,0,0,0,0,0,0,0,0,0,0,0
TAMILNADU,2006,N.D.P.S. ACT,0,0,0,31,1,32,4,0,4,2,0,2,37,1,38
TAMILNADU,2006,GAMBLING ACT,0,0,0,41,1,42,3,0,3,0,0,0,44,1,45
TAMILNADU,2006,EXCISE ACT,0,0,0,0,0,0,0,0,0,0,0,0,0,0,0
TAMILNADU,2006,PROHIBITION ACT,0,0,0,15,0,15,8,0,8,0,0,0,23,0,23
TAMILNADU,2006,EXPLOSIVE & EXPLOSIVE SUBST. ACT,0,0,0,17,0,17,9,0,9,0,0,0,26,0,26
TAMILNADU,2006,TERRORIST & DISRUPTIVE ACTIVITIES (TATA),0,0,0,0,0,0,1,0,1,0,0,0,1,0,1
TAMILNADU,2006,IMMORAL TRAFFIC (PREVENTION) ACT,0,0,0,0,0,0,0,0,0,0,0,0,0,0,0
TAMILNADU,2006,INDIAN RAILWAYS ACT,0,0,0,0,0,0,0,0,0,0,0,0,0,0,0
TAMILNADU,2006,REGISTRATION OF FOREIGNERS ACT,0,0,0,9,0,9,9,0,9,0,0,0,18,0,18
TAMILNADU,2006,PROTECTION OF CIVIL RIGHTS ACT,0,0,0,0,0,0,0,0,0,0,0,0,0,0,0
TAMILNADU,2006,SC/ST (PREVENTION OF ATROCITIES) ACT,0,0,0,2,0,2,0,0,0,0,0,0,2,0,2
TAMILNADU,2006,INDIAN PASSPORT ACT,0,0,0,4,0,4,7,0,7,0,0,0,11,0,11
TAMILNADU,2006,ESSENTIAL COMMODITIES ACT,0,0,0,0,0,0,0,0,0,0,0,0,0,0,0
TAMILNADU,2006,ANTIQUITIES AND ART TREASURE ACT,0,0,0,0,0,0,0,0,0,0,0,0,0,0,0
TAMILNADU,2006,DOWRY PROHIBITION ACT,0,0,0,0,0,0,3,0,3,0,0,0,3,0,3
TAMILNADU,2006,FOREIGN EXCHANGE REGULATION ACT-1973,0,0,0,0,0,0,0,0,0,0,0,0,0,0,0
TAMILNADU,2006,PREVENTION OF CORRUPTION ACT-1988,0,0,0,3,0,3,3,0,3,0,0,0,6,0,6
TAMILNADU,2006,CONSER.OF FORGN.EXCH.&PREV. OF SMUG.ACT,0,0,0,0,0,0,0,0,0,0,0,0,0,0,0
TAMILNADU,2006,OTHER SLL OFFENCE,0,0,0,0,0,0,0,0,0,0,0,0,0,0,0
TAMILNADU,2006,TOTAL,0,0,0,122,2,124,47,0,47,2,0,2,171,2,173
TAMILNADU,2007,ARMS ACT,0,0,0,0,0,0,0,0,0,0,0,0,0,0,0
TAMILNADU,2007,N.D.P.S. ACT,0,0,0,331,10,341,359,0,359,202,0,202,892,10,902
TAMILNADU,2007,GAMBLING ACT,0,0,0,47,13,60,30,0,30,0,0,0,77,13,90
TAMILNADU,2007,EXCISE ACT,0,0,0,0,0,0,0,0,0,0,0,0,0,0,0
TAMILNADU,2007,PROHIBITION ACT,0,0,0,15,0,15,8,0,8,0,0,0,23,0,23
TAMILNADU,2007,EXPLOSIVE & EXPLOSIVE SUBST. ACT,0,0,0,26,0,26,11,0,11,0,0,0,37,0,37
TAMILNADU,2007,TERRORIST & DISRUPTIVE ACTIVITIES (TATA),0,0,0,0,0,0,1,0,1,0,0,0,1,0,1
TAMILNADU,2007,IMMORAL TRAFFIC (PREVENTION) ACT,0,0,0,0,0,0,0,0,0,0,0,0,0,0,0
TAMILNADU,2007,INDIAN RAILWAYS ACT,0,0,0,0,0,0,0,0,0,0,0,0,0,0,0
TAMILNADU,2007,REGISTRATION OF FOREIGNERS ACT,0,0,0,9,0,9,9,0,9,0,0,0,18,0,18
TAMILNADU,2007,PROTECTION OF CIVIL RIGHTS ACT,0,0,0,0,0,0,0,0,0,0,0,0,0,0,0
TAMILNADU,2007,SC/ST (PREVENTION OF ATROCITIES) ACT,0,0,0,175,0,175,135,0,135,2,0,2,312,0,312
TAMILNADU,2007,INDIAN PASSPORT ACT,0,0,0,4,0,4,7,0,7,0,0,0,11,0,11
TAMILNADU,2007,ESSENTIAL COMMODITIES ACT,0,0,0,0,0,0,0,0,0,0,0,0,0,0,0
TAMILNADU,2007,ANTIQUITIES AND ART TREASURE ACT,0,0,0,0,0,0,0,0,0,0,0,0,0,0,0
TAMILNADU,2007,DOWRY PROHIBITION ACT,0,0,0,0,0,0,3,0,3,0,0,0,3,0,3
TAMILNADU,2007,FOREIGN EXCHANGE REGULATION ACT-1973,0,0,0,0,0,0,0,0,0,0,0,0,0,0,0
TAMILNADU,2007,PREVENTION OF CORRUPTION ACT-1988,0,0,0,3,0,3,3,0,3,0,0,0,6,0,6
TAMILNADU,2007,CONSER.OF FORGN.EXCH.&PREV. OF SMUG.ACT,0,0,0,0,0,0,0,0,0,0,0,0,0,0,0
TAMILNADU,2007,OTHER SLL OFFENCE,0,0,0,0,0,0,0,0,0,0,0,0,0,0,0
TAMILNADU,2007,TOTAL,0,0,0,610,23,633,566,0,566,204,0,204,1380,23,1403
TAMILNADU,2008,ARMS ACT,0,0,0,25,4,29,29,2,31,5,0,5,59,6,65
TAMILNADU,2008,N.D.P.S. ACT,0,0,0,107,1,108,60,4,64,15,0,15,182,5,187
TAMILNADU,2008,GAMBLING ACT,0,0,0,40,0,40,44,0,44,2,0,2,86,0,86
TAMILNADU,2008,EXCISE ACT,0,0,0,1,12,13,21,4,25,2,0,2,24,16,40
TAMILNADU,2008,PROHIBITION ACT,0,0,0,209,18,227,464,19,483,38,0,38,711,37,748
TAMILNADU,2008,EXPLOSIVE & EXPLOSIVE SUBST. ACT,0,0,0,21,0,21,32,0,32,0,0,0,53,0,53
TAMILNADU,2008,TERRORIST & DISRUPTIVE ACTIVITIES (TATA),0,0,0,24,0,24,21,0,21,0,0,0,45,0,45
TAMILNADU,2008,IMMORAL TRAFFIC (PREVENTION) ACT,0,0,0,9,18,27,8,4,12,2,0,2,19,22,41
TAMILNADU,2008,INDIAN RAILWAYS ACT,0,0,0,35,16,51,26,4,30,5,0,5,66,20,86
TAMILNADU,2008,REGISTRATION OF FOREIGNERS ACT,0,0,0,37,0,37,37,0,37,0,0,0,74,0,74
TAMILNADU,2008,PROTECTION OF CIVIL RIGHTS ACT,0,0,0,1,0,1,1,0,1,0,0,0,2,0,2
TAMILNADU,2008,SC/ST (PREVENTION OF ATROCITIES) ACT,0,0,0,32,5,37,13,1,14,10,0,10,55,6,61
TAMILNADU,2008,INDIAN PASSPORT ACT,0,0,0,3,0,3,2,0,2,0,2,2,5,2,7
TAMILNADU,2008,ESSENTIAL COMMODITIES ACT,0,0,0,20,0,20,17,0,17,2,0,2,39,0,39
TAMILNADU,2008,ANTIQUITIES AND ART TREASURE ACT,0,0,0,0,0,0,0,0,0,0,0,0,0,0,0
TAMILNADU,2008,DOWRY PROHIBITION ACT,0,0,0,17,2,19,6,16,22,6,2,8,29,20,49
TAMILNADU,2008,FOREIGN EXCHANGE REGULATION ACT-1973,0,0,0,0,0,0,0,0,0,0,0,0,0,0,0
TAMILNADU,2008,PREVENTION OF CORRUPTION ACT-1988,0,0,0,2,0,2,4,0,4,1,0,1,7,0,7
TAMILNADU,2008,CONSER.OF FORGN.EXCH.&PREV. OF SMUG.ACT,0,0,0,0,0,0,0,0,0,0,0,0,0,0,0
TAMILNADU,2008,OTHER SLL OFFENCE,0,0,0,7,0,7,13,0,13,0,0,0,20,0,20
TAMILNADU,2008,TOTAL,0,0,0,590,76,666,798,54,852,88,4,92,1476,134,1610
TAMILNADU,2009,ARMS ACT,0,0,0,49,0,49,17,0,17,36,0,36,102,0,102
TAMILNADU,2009,N.D.P.S. ACT,0,0,0,180,8,188,181,10,191,53,12,65,414,30,444
TAMILNADU,2009,GAMBLING ACT,0,0,0,24,0,24,22,0,22,10,0,10,56,0,56
TAMILNADU,2009,EXCISE ACT,0,0,0,26,0,26,15,0,15,16,0,16,57,0,57
TAMILNADU,2009,PROHIBITION ACT,0,0,0,231,54,285,169,57,226,68,46,114,468,157,625
TAMILNADU,2009,EXPLOSIVE & EXPLOSIVE SUBST. ACT,0,0,0,22,2,24,13,2,15,4,0,4,39,4,43
TAMILNADU,2009,TERRORIST & DISRUPTIVE ACTIVITIES (TATA),0,0,0,1,0,1,1,0,1,0,0,0,2,0,2
TAMILNADU,2009,IMMORAL TRAFFIC (PREVENTION) ACT,0,0,0,32,14,46,16,14,30,10,4,14,58,32,90
TAMILNADU,2009,INDIAN RAILWAYS ACT,0,0,0,55,0,55,20,3,23,37,1,38,112,4,116
TAMILNADU,2009,REGISTRATION OF FOREIGNERS ACT,0,0,0,13,0,13,24,3,27,11,0,11,48,3,51
TAMILNADU,2009,PROTECTION OF CIVIL RIGHTS ACT,0,0,0,0,0,0,0,0,0,0,0,0,0,0,0
TAMILNADU,2009,SC/ST (PREVENTION OF ATROCITIES) ACT,0,0,0,29,1,30,19,0,19,28,0,28,76,1,77
TAMILNADU,2009,INDIAN PASSPORT ACT,0,0,0,5,0,5,15,2,17,10,0,10,30,2,32
TAMILNADU,2009,ESSENTIAL COMMODITIES ACT,0,0,0,16,2,18,8,7,15,5,0,5,29,9,38
TAMILNADU,2009,ANTIQUITIES AND ART TREASURE ACT,0,0,0,5,0,5,0,0,0,0,0,0,5,0,5
TAMILNADU,2009,DOWRY PROHIBITION ACT,0,0,0,52,2,54,43,6,49,43,1,44,138,9,147
TAMILNADU,2009,FOREIGN EXCHANGE REGULATION ACT-1973,0,0,0,5,0,5,10,0,10,2,0,2,17,0,17
TAMILNADU,2009,PREVENTION OF CORRUPTION ACT-1988,0,0,0,11,0,11,3,2,5,3,5,8,17,7,24
TAMILNADU,2009,CONSER.OF FORGN.EXCH.&PREV. OF SMUG.ACT,0,0,0,0,0,0,0,0,0,0,0,0,0,0,0
TAMILNADU,2009,OTHER SLL OFFENCE,0,0,0,0,0,0,0,0,0,29,0,29,29,0,29
TAMILNADU,2009,TOTAL,0,0,0,756,83,839,576,106,682,365,69,434,1697,258,1955
TAMILNADU,2010,ARMS ACT,0,0,0,35,0,35,40,0,40,11,0,11,86,0,86
TAMILNADU,2010,N.D.P.S. ACT,0,0,0,102,2,104,95,2,97,48,2,50,245,6,251
TAMILNADU,2010,GAMBLING ACT,0,0,0,47,0,47,67,0,67,29,0,29,143,0,143
TAMILNADU,2010,EXCISE ACT,0,0,0,18,0,18,4,0,4,6,0,6,28,0,28
TAMILNADU,2010,PROHIBITION ACT,0,0,0,24,8,32,43,75,118,38,31,69,105,114,219
TAMILNADU,2010,EXPLOSIVE & EXPLOSIVE SUBST. ACT,0,0,0,1,0,1,0,0,0,1,0,1,2,0,2
TAMILNADU,2010,TERRORIST & DISRUPTIVE ACTIVITIES (TATA),0,0,0,1,0,1,1,0,1,3,0,3,5,0,5
TAMILNADU,2010,IMMORAL TRAFFIC (PREVENTION) ACT,0,0,0,12,4,16,8,7,15,19,0,19,39,11,50
TAMILNADU,2010,INDIAN RAILWAYS ACT,0,0,0,35,0,35,21,0,21,18,0,18,74,0,74
TAMILNADU,2010,REGISTRATION OF FOREIGNERS ACT,0,0,0,15,0,15,33,3,36,0,0,0,48,3,51
TAMILNADU,2010,PROTECTION OF CIVIL RIGHTS ACT,0,0,0,0,0,0,0,0,0,0,0,0,0,0,0
TAMILNADU,2010,SC/ST (PREVENTION OF ATROCITIES) ACT,0,0,0,16,0,16,16,0,16,13,0,13,45,0,45
TAMILNADU,2010,INDIAN PASSPORT ACT,0,0,0,6,0,6,7,0,7,0,0,0,13,0,13
TAMILNADU,2010,ESSENTIAL COMMODITIES ACT,0,0,0,1,0,1,0,2,2,0,0,0,1,2,3
TAMILNADU,2010,ANTIQUITIES AND ART TREASURE ACT,0,0,0,0,0,0,0,0,0,0,0,0,0,0,0
TAMILNADU,2010,DOWRY PROHIBITION ACT,0,0,0,52,1,53,30,11,41,21,2,23,103,14,117
TAMILNADU,2010,FOREIGN EXCHANGE REGULATION ACT-1973,0,0,0,5,0,5,13,0,13,0,0,0,18,0,18
TAMILNADU,2010,PREVENTION OF CORRUPTION ACT-1988,0,0,0,10,0,10,4,0,4,1,0,1,15,0,15
TAMILNADU,2010,CONSER.OF FORGN.EXCH.&PREV. OF SMUG.ACT,0,0,0,36,0,36,35,0,35,11,0,11,82,0,82
TAMILNADU,2010,OTHER SLL OFFENCE,0,0,0,5,8,13,76,27,103,40,8,48,121,43,164
TAMILNADU,2010,TOTAL,0,0,0,421,23,444,493,127,620,259,43,302,1173,193,1366
TAMILNADU,2011,ARMS ACT,0,0,0,6,0,6,7,0,7,2,0,2,15,0,15
TAMILNADU,2011,N.D.P.S. ACT,0,0,0,78,6,84,215,7,222,71,6,77,364,19,383
TAMILNADU,2011,GAMBLING ACT,0,0,0,25,0,25,78,0,78,38,0,38,141,0,141
TAMILNADU,2011,EXCISE ACT,0,0,0,8,22,30,89,38,127,19,19,38,116,79,195
TAMILNADU,2011,PROHIBITION ACT,0,0,0,101,15,116,208,38,246,71,6,77,380,59,439
TAMILNADU,2011,EXPLOSIVE & EXPLOSIVE SUBST. ACT,0,0,0,0,0,0,0,0,0,0,0,0,0,0,0
TAMILNADU,2011,TERRORIST & DISRUPTIVE ACTIVITIES (TATA),0,0,0,0,0,0,0,0,0,0,0,0,0,0,0
TAMILNADU,2011,IMMORAL TRAFFIC (PREVENTION) ACT,0,0,0,0,4,4,0,3,3,0,3,3,0,10,10
TAMILNADU,2011,INDIAN RAILWAYS ACT,0,0,0,69,0,69,86,0,86,12,0,12,167,0,167
TAMILNADU,2011,REGISTRATION OF FOREIGNERS ACT,0,0,0,0,1,1,9,0,9,1,0,1,10,1,11
TAMILNADU,2011,PROTECTION OF CIVIL RIGHTS ACT,0,0,0,0,0,0,0,0,0,0,0,0,0,0,0
TAMILNADU,2011,SC/ST (PREVENTION OF ATROCITIES) ACT,0,0,0,5,0,5,13,0,13,4,0,4,22,0,22
TAMILNADU,2011,INDIAN PASSPORT ACT,0,0,0,0,2,2,3,0,3,1,0,1,4,2,6
TAMILNADU,2011,ESSENTIAL COMMODITIES ACT,0,0,0,0,12,12,5,2,7,1,1,2,6,15,21
TAMILNADU,2011,ANTIQUITIES AND ART TREASURE ACT,0,0,0,0,0,0,0,0,0,0,0,0,0,0,0
TAMILNADU,2011,DOWRY PROHIBITION ACT,0,0,0,14,0,14,11,2,13,25,1,26,50,3,53
TAMILNADU,2011,FOREIGN EXCHANGE REGULATION ACT-1973,0,0,0,0,0,0,0,0,0,0,0,0,0,0,0
TAMILNADU,2011,PREVENTION OF CORRUPTION ACT-1988,0,0,0,0,0,0,34,0,34,1,0,1,35,0,35
TAMILNADU,2011,CONSER.OF FORGN.EXCH.&PREV. OF SMUG.ACT,0,0,0,0,0,0,0,0,0,0,0,0,0,0,0
TAMILNADU,2011,OTHER SLL OFFENCE,0,0,0,0,0,0,0,3,3,0,0,0,0,3,3
TAMILNADU,2011,TOTAL,0,0,0,306,62,368,758,93,851,246,36,282,1310,191,1501
TAMILNADU,2012,ARMS ACT,0,0,0,24,0,24,31,0,31,8,0,8,63,0,63
TAMILNADU,2012,N.D.P.S. ACT,0,0,0,118,7,125,116,8,124,12,4,16,246,19,265
TAMILNADU,2012,GAMBLING ACT,0,0,0,0,0,0,0,0,0,0,0,0,0,0,0
TAMILNADU,2012,EXCISE ACT,0,0,0,0,22,22,0,23,23,0,1,1,0,46,46
TAMILNADU,2012,PROHIBITION ACT,0,0,0,57,7,64,46,26,72,19,7,26,122,40,162
TAMILNADU,2012,EXPLOSIVE & EXPLOSIVE SUBST. ACT,0,0,0,2,0,2,5,0,5,1,0,1,8,0,8
TAMILNADU,2012,TERRORIST & DISRUPTIVE ACTIVITIES (TATA),0,0,0,0,0,0,0,0,0,0,0,0,0,0,0
TAMILNADU,2012,IMMORAL TRAFFIC (PREVENTION) ACT,0,0,0,0,4,4,0,18,18,0,5,5,0,27,27
TAMILNADU,2012,INDIAN RAILWAYS ACT,0,0,0,76,2,78,57,6,63,6,0,6,139,8,147
TAMILNADU,2012,REGISTRATION OF FOREIGNERS ACT,0,0,0,0,0,0,0,0,0,0,0,0,0,0,0
TAMILNADU,2012,PROTECTION OF CIVIL RIGHTS ACT,0,0,0,0,0,0,0,0,0,0,0,0,0,0,0
TAMILNADU,2012,SC/ST (PREVENTION OF ATROCITIES) ACT,0,0,0,30,0,30,0,0,0,3,0,3,33,0,33
TAMILNADU,2012,INDIAN PASSPORT ACT,0,0,0,4,0,4,8,0,8,2,0,2,14,0,14
TAMILNADU,2012,ESSENTIAL COMMODITIES ACT,0,0,0,0,0,0,0,16,16,0,0,0,0,16,16
TAMILNADU,2012,ANTIQUITIES AND ART TREASURE ACT,0,0,0,0,0,0,0,0,0,0,0,0,0,0,0
TAMILNADU,2012,DOWRY PROHIBITION ACT,0,0,0,123,10,133,9,3,12,0,0,0,132,13,145
TAMILNADU,2012,FOREIGN EXCHANGE REGULATION ACT-1973,0,0,0,0,0,0,0,0,0,0,0,0,0,0,0
TAMILNADU,2012,PREVENTION OF CORRUPTION ACT-1988,0,0,0,5,0,5,41,0,41,1,0,1,47,0,47
TAMILNADU,2012,CONSER.OF FORGN.EXCH.&PREV. OF SMUG.ACT,0,0,0,0,0,0,0,0,0,0,0,0,0,0,0
TAMILNADU,2012,OTHER SLL OFFENCE,0,0,0,0,2,2,0,2,2,0,0,0,0,4,4
TAMILNADU,2012,TOTAL,0,0,0,439,54,493,313,102,415,52,17,69,804,173,977
TRIPURA,2001,ARMS ACT,15,0,15,37,0,37,23,0,23,0,0,0,75,0,75
TRIPURA,2001,N.D.P.S. ACT,0,0,0,1,0,1,0,0,0,1,0,1,2,0,2
TRIPURA,2001,GAMBLING ACT,0,0,0,0,0,0,0,0,0,0,0,0,0,0,0
TRIPURA,2001,EXCISE ACT,0,0,0,2,0,2,1,0,1,0,0,0,3,0,3
TRIPURA,2001,PROHIBITION ACT,0,0,0,12,0,12,3,0,3,0,0,0,15,0,15
TRIPURA,2001,EXPLOSIVE & EXPLOSIVE SUBST. ACT,5,0,5,11,0,11,4,0,4,1,0,1,21,0,21
TRIPURA,2001,TERRORIST & DISRUPTIVE ACTIVITIES (TATA),0,0,0,12,0,12,4,0,4,0,0,0,16,0,16
TRIPURA,2001,IMMORAL TRAFFIC (PREVENTION) ACT,0,0,0,10,0,10,7,0,7,0,0,0,17,0,17
TRIPURA,2001,INDIAN RAILWAYS ACT,0,0,0,0,0,0,0,0,0,0,0,0,0,0,0
TRIPURA,2001,REGISTRATION OF FOREIGNERS ACT,0,0,0,0,0,0,0,0,0,0,0,0,0,0,0
TRIPURA,2001,PROTECTION OF CIVIL RIGHTS ACT,0,0,0,0,0,0,0,0,0,0,0,0,0,0,0
TRIPURA,2001,SC/ST (PREVENTION OF ATROCITIES) ACT,0,0,0,0,0,0,0,0,0,0,0,0,0,0,0
TRIPURA,2001,INDIAN PASSPORT ACT,0,0,0,10,3,13,12,0,12,5,0,5,27,3,30
TRIPURA,2001,ESSENTIAL COMMODITIES ACT,2,0,2,5,0,5,7,0,7,0,0,0,14,0,14
TRIPURA,2001,ANTIQUITIES AND ART TREASURE ACT,0,0,0,0,0,0,0,0,0,0,0,0,0,0,0
TRIPURA,2001,DOWRY PROHIBITION ACT,0,0,0,0,0,0,1,0,1,0,0,0,1,0,1
TRIPURA,2001,FOREIGN EXCHANGE REGULATION ACT-1973,0,0,0,0,0,0,0,0,0,0,0,0,0,0,0
TRIPURA,2001,PREVENTION OF CORRUPTION ACT-1988,3,0,3,4,0,4,3,0,3,0,0,0,10,0,10
TRIPURA,2001,CONSER.OF FORGN.EXCH.&PREV. OF SMUG.ACT,0,0,0,0,0,0,0,0,0,0,0,0,0,0,0
TRIPURA,2001,OTHER SLL OFFENCE,0,0,0,2,0,2,4,0,4,3,0,3,9,0,9
TRIPURA,2001,TOTAL,25,0,25,106,3,109,69,0,69,10,0,10,210,3,213
TRIPURA,2002,ARMS ACT,5,0,5,20,0,20,12,0,12,3,0,3,40,0,40
TRIPURA,2002,N.D.P.S. ACT,1,0,1,2,0,2,3,0,3,1,0,1,7,0,7
TRIPURA,2002,GAMBLING ACT,3,0,3,0,0,0,0,0,0,0,0,0,3,0,3
TRIPURA,2002,EXCISE ACT,0,0,0,4,0,4,4,0,4,0,0,0,8,0,8
TRIPURA,2002,PROHIBITION ACT,0,0,0,2,0,2,4,0,4,1,0,1,7,0,7
TRIPURA,2002,EXPLOSIVE & EXPLOSIVE SUBST. ACT,0,0,0,4,0,4,2,0,2,0,0,0,6,0,6
TRIPURA,2002,TERRORIST & DISRUPTIVE ACTIVITIES (TATA),0,0,0,4,0,4,0,0,0,0,0,0,4,0,4
TRIPURA,2002,IMMORAL TRAFFIC (PREVENTION) ACT,0,0,0,2,0,2,3,0,3,2,0,2,7,0,7
TRIPURA,2002,INDIAN RAILWAYS ACT,0,0,0,1,0,1,0,0,0,0,0,0,1,0,1
TRIPURA,2002,REGISTRATION OF FOREIGNERS ACT,0,0,0,0,0,0,0,0,0,0,0,0,0,0,0
TRIPURA,2002,PROTECTION OF CIVIL RIGHTS ACT,0,0,0,3,0,3,0,0,0,0,0,0,3,0,3
TRIPURA,2002,SC/ST (PREVENTION OF ATROCITIES) ACT,0,0,0,2,1,3,1,1,2,0,0,0,3,2,5
TRIPURA,2002,INDIAN PASSPORT ACT,2,0,2,4,0,4,3,0,3,2,0,2,11,0,11
TRIPURA,2002,ESSENTIAL COMMODITIES ACT,0,0,0,0,0,0,0,0,0,0,0,0,0,0,0
TRIPURA,2002,ANTIQUITIES AND ART TREASURE ACT,0,0,0,0,0,0,0,0,0,0,0,0,0,0,0
TRIPURA,2002,DOWRY PROHIBITION ACT,0,0,0,0,0,0,0,0,0,5,0,5,5,0,5
TRIPURA,2002,FOREIGN EXCHANGE REGULATION ACT-1973,0,0,0,0,0,0,0,0,0,0,0,0,0,0,0
TRIPURA,2002,PREVENTION OF CORRUPTION ACT-1988,0,0,0,7,0,7,4,0,4,0,0,0,11,0,11
TRIPURA,2002,CONSER.OF FORGN.EXCH.&PREV. OF SMUG.ACT,0,0,0,0,0,0,0,0,0,0,0,0,0,0,0
TRIPURA,2002,OTHER SLL OFFENCE,1,0,1,3,0,3,5,0,5,1,0,1,10,0,10
TRIPURA,2002,TOTAL,12,0,12,58,1,59,41,1,42,15,0,15,126,2,128
TRIPURA,2003,ARMS ACT,5,0,5,52,0,52,45,0,45,0,0,0,102,0,102
TRIPURA,2003,N.D.P.S. ACT,0,0,0,4,0,4,5,0,5,0,0,0,9,0,9
TRIPURA,2003,GAMBLING ACT,0,0,0,0,0,0,0,0,0,0,0,0,0,0,0
TRIPURA,2003,EXCISE ACT,0,0,0,10,1,11,17,0,17,0,0,0,27,1,28
TRIPURA,2003,PROHIBITION ACT,0,0,0,8,0,8,5,0,5,0,0,0,13,0,13
TRIPURA,2003,EXPLOSIVE & EXPLOSIVE SUBST. ACT,0,0,0,1,0,1,0,0,0,0,0,0,1,0,1
TRIPURA,2003,TERRORIST & DISRUPTIVE ACTIVITIES (TATA),0,0,0,7,0,7,5,0,5,0,0,0,12,0,12
TRIPURA,2003,IMMORAL TRAFFIC (PREVENTION) ACT,0,0,0,0,0,0,0,0,0,0,0,0,0,0,0
TRIPURA,2003,INDIAN RAILWAYS ACT,0,0,0,0,0,0,0,0,0,0,0,0,0,0,0
TRIPURA,2003,REGISTRATION OF FOREIGNERS ACT,0,0,0,0,0,0,4,0,4,0,0,0,4,0,4
TRIPURA,2003,PROTECTION OF CIVIL RIGHTS ACT,0,0,0,0,0,0,0,0,0,0,0,0,0,0,0
TRIPURA,2003,SC/ST (PREVENTION OF ATROCITIES) ACT,0,0,0,0,0,0,0,0,0,0,0,0,0,0,0
TRIPURA,2003,INDIAN PASSPORT ACT,0,0,0,10,0,10,6,0,6,0,0,0,16,0,16
TRIPURA,2003,ESSENTIAL COMMODITIES ACT,0,0,0,0,0,0,0,0,0,0,0,0,0,0,0
TRIPURA,2003,ANTIQUITIES AND ART TREASURE ACT,0,0,0,0,0,0,0,0,0,0,0,0,0,0,0
TRIPURA,2003,DOWRY PROHIBITION ACT,0,0,0,0,0,0,9,0,9,1,0,1,10,0,10
TRIPURA,2003,FOREIGN EXCHANGE REGULATION ACT-1973,0,0,0,1,0,1,0,0,0,0,0,0,1,0,1
TRIPURA,2003,PREVENTION OF CORRUPTION ACT-1988,0,0,0,0,0,0,2,0,2,0,0,0,2,0,2
TRIPURA,2003,CONSER.OF FORGN.EXCH.&PREV. OF SMUG.ACT,0,0,0,0,0,0,0,0,0,0,0,0,0,0,0
TRIPURA,2003,OTHER SLL OFFENCE,0,0,0,3,0,3,1,0,1,5,0,5,9,0,9
TRIPURA,2003,TOTAL,5,0,5,96,1,97,99,0,99,6,0,6,206,1,207
TRIPURA,2004,ARMS ACT,5,0,5,51,0,51,66,0,66,2,0,2,124,0,124
TRIPURA,2004,N.D.P.S. ACT,0,0,0,0,0,0,0,0,0,0,0,0,0,0,0
TRIPURA,2004,GAMBLING ACT,0,0,0,0,0,0,0,0,0,0,0,0,0,0,0
TRIPURA,2004,EXCISE ACT,0,0,0,5,0,5,3,0,3,0,0,0,8,0,8
TRIPURA,2004,PROHIBITION ACT,0,0,0,0,0,0,0,0,0,0,0,0,0,0,0
TRIPURA,2004,EXPLOSIVE & EXPLOSIVE SUBST. ACT,0,0,0,0,0,0,0,0,0,0,0,0,0,0,0
TRIPURA,2004,TERRORIST & DISRUPTIVE ACTIVITIES (TATA),0,0,0,15,0,15,3,0,3,0,0,0,18,0,18
TRIPURA,2004,IMMORAL TRAFFIC (PREVENTION) ACT,0,0,0,0,0,0,0,0,0,0,0,0,0,0,0
TRIPURA,2004,INDIAN RAILWAYS ACT,0,0,0,0,0,0,0,0,0,0,0,0,0,0,0
TRIPURA,2004,REGISTRATION OF FOREIGNERS ACT,0,0,0,0,0,0,0,0,0,0,0,0,0,0,0
TRIPURA,2004,PROTECTION OF CIVIL RIGHTS ACT,0,0,0,0,0,0,0,0,0,0,0,0,0,0,0
TRIPURA,2004,SC/ST (PREVENTION OF ATROCITIES) ACT,0,0,0,0,0,0,0,0,0,0,0,0,0,0,0
TRIPURA,2004,INDIAN PASSPORT ACT,0,0,0,5,0,5,4,0,4,5,0,5,14,0,14
TRIPURA,2004,ESSENTIAL COMMODITIES ACT,0,0,0,0,0,0,0,0,0,0,0,0,0,0,0
TRIPURA,2004,ANTIQUITIES AND ART TREASURE ACT,0,0,0,0,0,0,0,0,0,0,0,0,0,0,0
TRIPURA,2004,DOWRY PROHIBITION ACT,0,0,0,1,0,1,2,0,2,0,0,0,3,0,3
TRIPURA,2004,FOREIGN EXCHANGE REGULATION ACT-1973,0,0,0,0,0,0,0,0,0,0,0,0,0,0,0
TRIPURA,2004,PREVENTION OF CORRUPTION ACT-1988,0,0,0,0,0,0,0,0,0,0,0,0,0,0,0
TRIPURA,2004,CONSER.OF FORGN.EXCH.&PREV. OF SMUG.ACT,0,0,0,0,0,0,0,0,0,0,0,0,0,0,0
TRIPURA,2004,OTHER SLL OFFENCE,0,0,0,0,0,0,0,0,0,0,0,0,0,0,0
TRIPURA,2004,TOTAL,5,0,5,77,0,77,78,0,78,7,0,7,167,0,167
TRIPURA,2005,ARMS ACT,5,0,5,36,1,37,37,0,37,0,0,0,78,1,79
TRIPURA,2005,N.D.P.S. ACT,0,0,0,1,0,1,1,0,1,0,0,0,2,0,2
TRIPURA,2005,GAMBLING ACT,0,0,0,0,0,0,0,0,0,0,0,0,0,0,0
TRIPURA,2005,EXCISE ACT,0,0,0,0,0,0,0,0,0,0,0,0,0,0,0
TRIPURA,2005,PROHIBITION ACT,0,0,0,0,0,0,0,0,0,0,0,0,0,0,0
TRIPURA,2005,EXPLOSIVE & EXPLOSIVE SUBST. ACT,0,0,0,1,0,1,0,0,0,0,0,0,1,0,1
TRIPURA,2005,TERRORIST & DISRUPTIVE ACTIVITIES (TATA),0,0,0,3,0,3,2,1,3,0,0,0,5,1,6
TRIPURA,2005,IMMORAL TRAFFIC (PREVENTION) ACT,0,0,0,0,0,0,1,0,1,0,0,0,1,0,1
TRIPURA,2005,INDIAN RAILWAYS ACT,0,0,0,0,0,0,0,0,0,0,0,0,0,0,0
TRIPURA,2005,REGISTRATION OF FOREIGNERS ACT,0,0,0,9,0,9,7,0,7,0,0,0,16,0,16
TRIPURA,2005,PROTECTION OF CIVIL RIGHTS ACT,0,0,0,0,0,0,0,0,0,0,0,0,0,0,0
TRIPURA,2005,SC/ST (PREVENTION OF ATROCITIES) ACT,0,0,0,0,0,0,0,0,0,0,0,0,0,0,0
TRIPURA,2005,INDIAN PASSPORT ACT,0,0,0,2,0,2,6,5,11,2,0,2,10,5,15
TRIPURA,2005,ESSENTIAL COMMODITIES ACT,0,0,0,0,0,0,0,0,0,0,0,0,0,0,0
TRIPURA,2005,ANTIQUITIES AND ART TREASURE ACT,0,0,0,0,0,0,0,0,0,0,0,0,0,0,0
TRIPURA,2005,DOWRY PROHIBITION ACT,0,0,0,1,0,1,3,0,3,0,0,0,4,0,4
TRIPURA,2005,FOREIGN EXCHANGE REGULATION ACT-1973,0,0,0,1,0,1,0,0,0,0,0,0,1,0,1
TRIPURA,2005,PREVENTION OF CORRUPTION ACT-1988,0,0,0,0,0,0,1,0,1,0,0,0,1,0,1
TRIPURA,2005,CONSER.OF FORGN.EXCH.&PREV. OF SMUG.ACT,0,0,0,0,0,0,0,0,0,0,0,0,0,0,0
TRIPURA,2005,OTHER SLL OFFENCE,0,0,0,1,0,1,0,0,0,0,0,0,1,0,1
TRIPURA,2005,TOTAL,5,0,5,55,1,56,58,6,64,2,0,2,120,7,127
TRIPURA,2006,ARMS ACT,2,0,2,23,0,23,5,0,5,1,0,1,31,0,31
TRIPURA,2006,N.D.P.S. ACT,0,0,0,1,0,1,2,0,2,0,0,0,3,0,3
TRIPURA,2006,GAMBLING ACT,0,0,0,0,0,0,0,0,0,0,0,0,0,0,0
TRIPURA,2006,EXCISE ACT,0,0,0,1,0,1,1,0,1,0,0,0,2,0,2
TRIPURA,2006,PROHIBITION ACT,0,0,0,0,0,0,0,0,0,0,0,0,0,0,0
TRIPURA,2006,EXPLOSIVE & EXPLOSIVE SUBST. ACT,0,0,0,2,0,2,0,0,0,1,0,1,3,0,3
TRIPURA,2006,TERRORIST & DISRUPTIVE ACTIVITIES (TATA),0,0,0,4,0,4,1,0,1,1,0,1,6,0,6
TRIPURA,2006,IMMORAL TRAFFIC (PREVENTION) ACT,0,0,0,0,0,0,0,0,0,0,0,0,0,0,0
TRIPURA,2006,INDIAN RAILWAYS ACT,0,0,0,1,0,1,1,0,1,0,0,0,2,0,2
TRIPURA,2006,REGISTRATION OF FOREIGNERS ACT,0,0,0,0,0,0,0,0,0,0,0,0,0,0,0
TRIPURA,2006,PROTECTION OF CIVIL RIGHTS ACT,0,0,0,0,0,0,0,0,0,0,0,0,0,0,0
TRIPURA,2006,SC/ST (PREVENTION OF ATROCITIES) ACT,0,0,0,0,0,0,0,0,0,0,0,0,0,0,0
TRIPURA,2006,INDIAN PASSPORT ACT,2,0,2,16,3,19,13,1,14,1,0,1,32,4,36
TRIPURA,2006,ESSENTIAL COMMODITIES ACT,0,0,0,0,0,0,0,0,0,0,0,0,0,0,0
TRIPURA,2006,ANTIQUITIES AND ART TREASURE ACT,0,0,0,0,0,0,0,0,0,0,0,0,0,0,0
TRIPURA,2006,DOWRY PROHIBITION ACT,0,0,0,0,0,0,3,0,3,0,0,0,3,0,3
TRIPURA,2006,FOREIGN EXCHANGE REGULATION ACT-1973,0,0,0,0,0,0,0,0,0,0,0,0,0,0,0
TRIPURA,2006,PREVENTION OF CORRUPTION ACT-1988,0,0,0,0,0,0,0,0,0,0,0,0,0,0,0
TRIPURA,2006,CONSER.OF FORGN.EXCH.&PREV. OF SMUG.ACT,0,0,0,0,0,0,0,0,0,0,0,0,0,0,0
TRIPURA,2006,OTHER SLL OFFENCE,0,0,0,0,0,0,0,0,0,0,0,0,0,0,0
TRIPURA,2006,TOTAL,4,0,4,48,3,51,26,1,27,4,0,4,82,4,86
TRIPURA,2007,ARMS ACT,0,0,0,17,0,17,8,0,8,8,0,8,33,0,33
TRIPURA,2007,N.D.P.S. ACT,0,0,0,0,0,0,0,0,0,0,0,0,0,0,0
TRIPURA,2007,GAMBLING ACT,0,0,0,0,0,0,0,0,0,0,0,0,0,0,0
TRIPURA,2007,EXCISE ACT,0,0,0,0,0,0,0,0,0,0,0,0,0,0,0
TRIPURA,2007,PROHIBITION ACT,0,0,0,0,0,0,0,0,0,0,0,0,0,0,0
TRIPURA,2007,EXPLOSIVE & EXPLOSIVE SUBST. ACT,0,0,0,3,0,3,2,0,2,1,0,1,6,0,6
TRIPURA,2007,TERRORIST & DISRUPTIVE ACTIVITIES (TATA),0,0,0,1,0,1,0,0,0,0,0,0,1,0,1
TRIPURA,2007,IMMORAL TRAFFIC (PREVENTION) ACT,0,0,0,3,0,3,0,0,0,0,0,0,3,0,3
TRIPURA,2007,INDIAN RAILWAYS ACT,0,0,0,0,0,0,0,0,0,0,0,0,0,0,0
TRIPURA,2007,REGISTRATION OF FOREIGNERS ACT,0,0,0,2,0,2,0,0,0,0,0,0,2,0,2
TRIPURA,2007,PROTECTION OF CIVIL RIGHTS ACT,0,0,0,0,0,0,0,0,0,0,0,0,0,0,0
TRIPURA,2007,SC/ST (PREVENTION OF ATROCITIES) ACT,0,0,0,0,0,0,0,0,0,0,0,0,0,0,0
TRIPURA,2007,INDIAN PASSPORT ACT,1,0,1,19,0,19,11,0,11,3,0,3,34,0,34
TRIPURA,2007,ESSENTIAL COMMODITIES ACT,0,0,0,0,0,0,0,0,0,0,0,0,0,0,0
TRIPURA,2007,ANTIQUITIES AND ART TREASURE ACT,0,0,0,0,0,0,0,0,0,0,0,0,0,0,0
TRIPURA,2007,DOWRY PROHIBITION ACT,0,0,0,0,0,0,0,0,0,0,0,0,0,0,0
TRIPURA,2007,FOREIGN EXCHANGE REGULATION ACT-1973,0,0,0,0,0,0,0,0,0,0,0,0,0,0,0
TRIPURA,2007,PREVENTION OF CORRUPTION ACT-1988,0,0,0,0,0,0,0,0,0,0,0,0,0,0,0
TRIPURA,2007,CONSER.OF FORGN.EXCH.&PREV. OF SMUG.ACT,0,0,0,0,0,0,0,0,0,0,0,0,0,0,0
TRIPURA,2007,OTHER SLL OFFENCE,0,0,0,0,0,0,0,0,0,0,0,0,0,0,0
TRIPURA,2007,TOTAL,1,0,1,45,0,45,21,0,21,12,0,12,79,0,79
TRIPURA,2008,ARMS ACT,0,0,0,15,0,15,9,0,9,0,0,0,24,0,24
TRIPURA,2008,N.D.P.S. ACT,0,0,0,0,0,0,0,0,0,0,0,0,0,0,0
TRIPURA,2008,GAMBLING ACT,0,0,0,0,0,0,0,0,0,0,0,0,0,0,0
TRIPURA,2008,EXCISE ACT,0,0,0,0,0,0,0,0,0,0,0,0,0,0,0
TRIPURA,2008,PROHIBITION ACT,0,0,0,0,0,0,0,0,0,0,0,0,0,0,0
TRIPURA,2008,EXPLOSIVE & EXPLOSIVE SUBST. ACT,0,0,0,0,0,0,0,0,0,0,0,0,0,0,0
TRIPURA,2008,TERRORIST & DISRUPTIVE ACTIVITIES (TATA),0,0,0,0,0,0,0,0,0,0,0,0,0,0,0
TRIPURA,2008,IMMORAL TRAFFIC (PREVENTION) ACT,0,0,0,0,0,0,0,0,0,0,0,0,0,0,0
TRIPURA,2008,INDIAN RAILWAYS ACT,0,0,0,0,0,0,0,0,0,0,0,0,0,0,0
TRIPURA,2008,REGISTRATION OF FOREIGNERS ACT,0,0,0,0,0,0,0,0,0,0,0,0,0,0,0
TRIPURA,2008,PROTECTION OF CIVIL RIGHTS ACT,0,0,0,0,0,0,0,0,0,0,0,0,0,0,0
TRIPURA,2008,SC/ST (PREVENTION OF ATROCITIES) ACT,0,0,0,0,0,0,0,0,0,0,0,0,0,0,0
TRIPURA,2008,INDIAN PASSPORT ACT,0,0,0,0,0,0,0,0,0,0,0,0,0,0,0
TRIPURA,2008,ESSENTIAL COMMODITIES ACT,3,0,3,19,0,19,6,0,6,4,0,4,32,0,32
TRIPURA,2008,ANTIQUITIES AND ART TREASURE ACT,0,0,0,0,0,0,0,0,0,0,0,0,0,0,0
TRIPURA,2008,DOWRY PROHIBITION ACT,0,0,0,0,0,0,0,0,0,0,0,0,0,0,0
TRIPURA,2008,FOREIGN EXCHANGE REGULATION ACT-1973,0,0,0,0,0,0,1,0,1,0,0,0,1,0,1
TRIPURA,2008,PREVENTION OF CORRUPTION ACT-1988,0,0,0,0,0,0,0,0,0,0,0,0,0,0,0
TRIPURA,2008,CONSER.OF FORGN.EXCH.&PREV. OF SMUG.ACT,0,0,0,0,0,0,0,0,0,0,0,0,0,0,0
TRIPURA,2008,OTHER SLL OFFENCE,0,0,0,0,0,0,12,0,12,4,0,4,16,0,16
TRIPURA,2008,TOTAL,3,0,3,34,0,34,28,0,28,8,0,8,73,0,73
TRIPURA,2009,ARMS ACT,0,0,0,7,1,8,3,0,3,1,0,1,11,1,12
TRIPURA,2009,N.D.P.S. ACT,0,0,0,1,0,1,1,0,1,0,0,0,2,0,2
TRIPURA,2009,GAMBLING ACT,0,0,0,0,0,0,0,0,0,0,0,0,0,0,0
TRIPURA,2009,EXCISE ACT,0,0,0,0,0,0,0,0,0,0,0,0,0,0,0
TRIPURA,2009,PROHIBITION ACT,0,0,0,0,0,0,0,0,0,0,0,0,0,0,0
TRIPURA,2009,EXPLOSIVE & EXPLOSIVE SUBST. ACT,0,0,0,0,0,0,0,0,0,0,0,0,0,0,0
TRIPURA,2009,TERRORIST & DISRUPTIVE ACTIVITIES (TATA),0,0,0,0,0,0,0,0,0,0,0,0,0,0,0
TRIPURA,2009,IMMORAL TRAFFIC (PREVENTION) ACT,0,0,0,0,0,0,0,0,0,0,0,0,0,0,0
TRIPURA,2009,INDIAN RAILWAYS ACT,0,0,0,0,0,0,0,0,0,0,0,0,0,0,0
TRIPURA,2009,REGISTRATION OF FOREIGNERS ACT,0,0,0,0,0,0,0,0,0,0,0,0,0,0,0
TRIPURA,2009,PROTECTION OF CIVIL RIGHTS ACT,0,0,0,0,0,0,0,0,0,0,0,0,0,0,0
TRIPURA,2009,SC/ST (PREVENTION OF ATROCITIES) ACT,0,0,0,0,0,0,0,0,0,0,0,0,0,0,0
TRIPURA,2009,INDIAN PASSPORT ACT,0,0,0,17,0,17,3,0,3,1,0,1,21,0,21
TRIPURA,2009,ESSENTIAL COMMODITIES ACT,0,0,0,0,0,0,0,0,0,0,0,0,0,0,0
TRIPURA,2009,ANTIQUITIES AND ART TREASURE ACT,0,0,0,0,0,0,0,0,0,0,0,0,0,0,0
TRIPURA,2009,DOWRY PROHIBITION ACT,0,0,0,0,0,0,0,0,0,0,0,0,0,0,0
TRIPURA,2009,FOREIGN EXCHANGE REGULATION ACT-1973,0,0,0,0,0,0,0,0,0,0,0,0,0,0,0
TRIPURA,2009,PREVENTION OF CORRUPTION ACT-1988,0,0,0,0,0,0,0,0,0,0,0,0,0,0,0
TRIPURA,2009,CONSER.OF FORGN.EXCH.&PREV. OF SMUG.ACT,0,0,0,0,0,0,0,0,0,0,0,0,0,0,0
TRIPURA,2009,OTHER SLL OFFENCE,0,0,0,3,0,3,7,0,7,0,0,0,10,0,10
TRIPURA,2009,TOTAL,0,0,0,28,1,29,14,0,14,2,0,2,44,1,45
TRIPURA,2010,ARMS ACT,0,0,0,1,0,1,1,0,1,0,0,0,2,0,2
TRIPURA,2010,N.D.P.S. ACT,0,0,0,0,0,0,2,0,2,1,0,1,3,0,3
TRIPURA,2010,GAMBLING ACT,0,0,0,0,0,0,0,0,0,0,0,0,0,0,0
TRIPURA,2010,EXCISE ACT,0,0,0,0,0,0,0,0,0,0,0,0,0,0,0
TRIPURA,2010,PROHIBITION ACT,0,0,0,0,0,0,0,0,0,0,0,0,0,0,0
TRIPURA,2010,EXPLOSIVE & EXPLOSIVE SUBST. ACT,0,0,0,0,0,0,0,0,0,0,0,0,0,0,0
TRIPURA,2010,TERRORIST & DISRUPTIVE ACTIVITIES (TATA),0,0,0,0,0,0,0,0,0,0,0,0,0,0,0
TRIPURA,2010,IMMORAL TRAFFIC (PREVENTION) ACT,0,0,0,0,0,0,0,0,0,0,0,0,0,0,0
TRIPURA,2010,INDIAN RAILWAYS ACT,0,0,0,0,0,0,0,0,0,0,0,0,0,0,0
TRIPURA,2010,REGISTRATION OF FOREIGNERS ACT,0,0,0,0,0,0,4,0,4,0,0,0,4,0,4
TRIPURA,2010,PROTECTION OF CIVIL RIGHTS ACT,0,0,0,0,0,0,0,0,0,0,0,0,0,0,0
TRIPURA,2010,SC/ST (PREVENTION OF ATROCITIES) ACT,0,0,0,0,0,0,0,0,0,0,0,0,0,0,0
TRIPURA,2010,INDIAN PASSPORT ACT,0,0,0,8,0,8,2,1,3,1,0,1,11,1,12
TRIPURA,2010,ESSENTIAL COMMODITIES ACT,0,0,0,0,0,0,0,0,0,0,0,0,0,0,0
TRIPURA,2010,ANTIQUITIES AND ART TREASURE ACT,0,0,0,0,0,0,0,0,0,0,0,0,0,0,0
TRIPURA,2010,DOWRY PROHIBITION ACT,0,0,0,0,0,0,0,0,0,0,0,0,0,0,0
TRIPURA,2010,FOREIGN EXCHANGE REGULATION ACT-1973,0,0,0,0,0,0,0,0,0,0,0,0,0,0,0
TRIPURA,2010,PREVENTION OF CORRUPTION ACT-1988,0,0,0,0,0,0,0,0,0,0,0,0,0,0,0
TRIPURA,2010,CONSER.OF FORGN.EXCH.&PREV. OF SMUG.ACT,0,0,0,0,0,0,0,0,0,0,0,0,0,0,0
TRIPURA,2010,OTHER SLL OFFENCE,0,0,0,0,0,0,1,0,1,2,0,2,3,0,3
TRIPURA,2010,TOTAL,0,0,0,9,0,9,10,1,11,4,0,4,23,1,24
TRIPURA,2011,ARMS ACT,0,0,0,4,0,4,6,0,6,0,0,0,10,0,10
TRIPURA,2011,N.D.P.S. ACT,0,0,0,2,0,2,1,0,1,0,0,0,3,0,3
TRIPURA,2011,GAMBLING ACT,0,0,0,0,0,0,0,0,0,0,0,0,0,0,0
TRIPURA,2011,EXCISE ACT,0,0,0,0,0,0,0,0,0,0,0,0,0,0,0
TRIPURA,2011,PROHIBITION ACT,0,0,0,0,0,0,0,0,0,0,0,0,0,0,0
TRIPURA,2011,EXPLOSIVE & EXPLOSIVE SUBST. ACT,0,0,0,2,0,2,1,0,1,0,0,0,3,0,3
TRIPURA,2011,TERRORIST & DISRUPTIVE ACTIVITIES (TATA),0,0,0,0,0,0,0,0,0,0,0,0,0,0,0
TRIPURA,2011,IMMORAL TRAFFIC (PREVENTION) ACT,0,0,0,0,0,0,0,0,0,0,0,0,0,0,0
TRIPURA,2011,INDIAN RAILWAYS ACT,0,0,0,0,0,0,0,0,0,0,0,0,0,0,0
TRIPURA,2011,REGISTRATION OF FOREIGNERS ACT,0,0,0,24,6,30,5,2,7,0,0,0,29,8,37
TRIPURA,2011,PROTECTION OF CIVIL RIGHTS ACT,0,0,0,0,0,0,0,0,0,0,0,0,0,0,0
TRIPURA,2011,SC/ST (PREVENTION OF ATROCITIES) ACT,0,0,0,0,0,0,0,0,0,0,0,0,0,0,0
TRIPURA,2011,INDIAN PASSPORT ACT,0,0,0,18,2,20,8,0,8,0,1,1,26,3,29
TRIPURA,2011,ESSENTIAL COMMODITIES ACT,0,0,0,0,0,0,0,0,0,0,0,0,0,0,0
TRIPURA,2011,ANTIQUITIES AND ART TREASURE ACT,0,0,0,0,0,0,0,0,0,0,0,0,0,0,0
TRIPURA,2011,DOWRY PROHIBITION ACT,0,0,0,0,0,0,0,0,0,0,0,0,0,0,0
TRIPURA,2011,FOREIGN EXCHANGE REGULATION ACT-1973,0,0,0,0,0,0,0,0,0,0,0,0,0,0,0
TRIPURA,2011,PREVENTION OF CORRUPTION ACT-1988,0,0,0,0,0,0,0,0,0,0,0,0,0,0,0
TRIPURA,2011,CONSER.OF FORGN.EXCH.&PREV. OF SMUG.ACT,0,0,0,0,0,0,0,0,0,0,0,0,0,0,0
TRIPURA,2011,OTHER SLL OFFENCE,0,0,0,0,0,0,0,0,0,0,0,0,0,0,0
TRIPURA,2011,TOTAL,0,0,0,50,8,58,21,2,23,0,1,1,71,11,82
TRIPURA,2012,ARMS ACT,0,0,0,0,0,0,0,0,0,0,0,0,0,0,0
TRIPURA,2012,N.D.P.S. ACT,0,0,0,1,0,1,2,0,2,0,0,0,3,0,3
TRIPURA,2012,GAMBLING ACT,0,0,0,0,0,0,0,0,0,0,0,0,0,0,0
TRIPURA,2012,EXCISE ACT,0,0,0,0,0,0,0,0,0,0,0,0,0,0,0
TRIPURA,2012,PROHIBITION ACT,0,0,0,0,0,0,0,0,0,0,0,0,0,0,0
TRIPURA,2012,EXPLOSIVE & EXPLOSIVE SUBST. ACT,0,0,0,0,0,0,0,0,0,0,0,0,0,0,0
TRIPURA,2012,TERRORIST & DISRUPTIVE ACTIVITIES (TATA),0,0,0,3,0,3,1,0,1,0,0,0,4,0,4
TRIPURA,2012,IMMORAL TRAFFIC (PREVENTION) ACT,0,0,0,0,0,0,0,0,0,0,0,0,0,0,0
TRIPURA,2012,INDIAN RAILWAYS ACT,0,0,0,0,0,0,0,0,0,0,0,0,0,0,0
TRIPURA,2012,REGISTRATION OF FOREIGNERS ACT,0,0,0,0,0,0,0,0,0,0,0,0,0,0,0
TRIPURA,2012,PROTECTION OF CIVIL RIGHTS ACT,0,0,0,0,0,0,0,0,0,0,0,0,0,0,0
TRIPURA,2012,SC/ST (PREVENTION OF ATROCITIES) ACT,0,0,0,0,0,0,0,0,0,0,0,0,0,0,0
TRIPURA,2012,INDIAN PASSPORT ACT,0,0,0,8,0,8,2,0,2,1,0,1,11,0,11
TRIPURA,2012,ESSENTIAL COMMODITIES ACT,0,0,0,0,0,0,0,0,0,0,0,0,0,0,0
TRIPURA,2012,ANTIQUITIES AND ART TREASURE ACT,0,0,0,0,0,0,0,0,0,0,0,0,0,0,0
TRIPURA,2012,DOWRY PROHIBITION ACT,0,0,0,2,0,2,2,0,2,0,0,0,4,0,4
TRIPURA,2012,FOREIGN EXCHANGE REGULATION ACT-1973,0,0,0,0,0,0,0,0,0,0,0,0,0,0,0
TRIPURA,2012,PREVENTION OF CORRUPTION ACT-1988,0,0,0,0,0,0,0,0,0,0,0,0,0,0,0
TRIPURA,2012,CONSER.OF FORGN.EXCH.&PREV. OF SMUG.ACT,0,0,0,0,0,0,0,0,0,0,0,0,0,0,0
TRIPURA,2012,OTHER SLL OFFENCE,0,0,0,0,0,0,0,0,0,0,0,0,0,0,0
TRIPURA,2012,TOTAL,0,0,0,14,0,14,7,0,7,1,0,1,22,0,22
UTTAR PRADESH,2001,ARMS ACT,158,0,158,1588,0,1588,1266,9,1275,160,1,161,3172,10,3182
UTTAR PRADESH,2001,N.D.P.S. ACT,113,0,113,2140,41,2181,2144,27,2171,456,6,462,4853,74,4927
UTTAR PRADESH,2001,GAMBLING ACT,10,0,10,137,0,137,197,5,202,75,0,75,419,5,424
UTTAR PRADESH,2001,EXCISE ACT,18,0,18,378,23,401,533,23,556,151,1,152,1080,47,1127
UTTAR PRADESH,2001,PROHIBITION ACT,1,0,1,102,0,102,54,0,54,7,0,7,164,0,164
UTTAR PRADESH,2001,EXPLOSIVE & EXPLOSIVE SUBST. ACT,14,0,14,127,0,127,287,6,293,20,0,20,448,6,454
UTTAR PRADESH,2001,TERRORIST & DISRUPTIVE ACTIVITIES (TATA),0,0,0,8,0,8,18,6,24,0,0,0,26,6,32
UTTAR PRADESH,2001,IMMORAL TRAFFIC (PREVENTION) ACT,18,0,18,63,6,69,160,5,165,28,0,28,269,11,280
UTTAR PRADESH,2001,INDIAN RAILWAYS ACT,44,0,44,460,2,462,318,0,318,52,0,52,874,2,876
UTTAR PRADESH,2001,REGISTRATION OF FOREIGNERS ACT,5,0,5,19,18,37,7,7,14,0,0,0,31,25,56
UTTAR PRADESH,2001,PROTECTION OF CIVIL RIGHTS ACT,0,0,0,20,0,20,19,0,19,8,0,8,47,0,47
UTTAR PRADESH,2001,SC/ST (PREVENTION OF ATROCITIES) ACT,5,0,5,192,1,193,369,3,372,101,2,103,667,6,673
UTTAR PRADESH,2001,INDIAN PASSPORT ACT,0,0,0,9,1,10,15,0,15,2,0,2,26,1,27
UTTAR PRADESH,2001,ESSENTIAL COMMODITIES ACT,0,0,0,22,0,22,102,0,102,16,0,16,140,0,140
UTTAR PRADESH,2001,ANTIQUITIES AND ART TREASURE ACT,0,0,0,29,2,31,36,16,52,32,4,36,97,22,119
UTTAR PRADESH,2001,DOWRY PROHIBITION ACT,30,0,30,710,74,784,889,117,1006,331,29,360,1960,220,2180
UTTAR PRADESH,2001,FOREIGN EXCHANGE REGULATION ACT-1973,0,0,0,35,5,40,13,2,15,16,4,20,64,11,75
UTTAR PRADESH,2001,PREVENTION OF CORRUPTION ACT-1988,0,0,0,5,0,5,7,0,7,3,0,3,15,0,15
UTTAR PRADESH,2001,CONSER.OF FORGN.EXCH.&PREV. OF SMUG.ACT,0,0,0,0,0,0,0,0,0,1,0,1,1,0,1
UTTAR PRADESH,2001,OTHER SLL OFFENCE,5,0,5,245,1,246,477,5,482,196,2,198,923,8,931
UTTAR PRADESH,2001,TOTAL,421,0,421,6289,174,6463,6911,231,7142,1655,49,1704,15276,454,15730
UTTAR PRADESH,2002,ARMS ACT,88,0,88,1446,2,1448,978,1,979,189,0,189,2701,3,2704
UTTAR PRADESH,2002,N.D.P.S. ACT,63,0,63,1282,19,1301,1488,23,1511,415,1,416,3248,43,3291
UTTAR PRADESH,2002,GAMBLING ACT,2,0,2,113,0,113,183,0,183,50,0,50,348,0,348
UTTAR PRADESH,2002,EXCISE ACT,5,0,5,309,20,329,335,16,351,122,0,122,771,36,807
UTTAR PRADESH,2002,PROHIBITION ACT,0,0,0,8,0,8,19,0,19,5,0,5,32,0,32
UTTAR PRADESH,2002,EXPLOSIVE & EXPLOSIVE SUBST. ACT,4,0,4,136,0,136,148,0,148,20,0,20,308,0,308
UTTAR PRADESH,2002,TERRORIST & DISRUPTIVE ACTIVITIES (TATA),0,0,0,7,0,7,7,0,7,0,0,0,14,0,14
UTTAR PRADESH,2002,IMMORAL TRAFFIC (PREVENTION) ACT,11,0,11,20,0,20,21,0,21,0,0,0,52,0,52
UTTAR PRADESH,2002,INDIAN RAILWAYS ACT,19,0,19,401,2,403,328,0,328,103,0,103,851,2,853
UTTAR PRADESH,2002,REGISTRATION OF FOREIGNERS ACT,6,0,6,15,1,16,8,0,8,0,0,0,29,1,30
UTTAR PRADESH,2002,PROTECTION OF CIVIL RIGHTS ACT,0,0,0,27,0,27,47,0,47,11,0,11,85,0,85
UTTAR PRADESH,2002,SC/ST (PREVENTION OF ATROCITIES) ACT,2,0,2,254,1,255,311,0,311,57,0,57,624,1,625
UTTAR PRADESH,2002,INDIAN PASSPORT ACT,0,0,0,13,0,13,16,2,18,3,0,3,32,2,34
UTTAR PRADESH,2002,ESSENTIAL COMMODITIES ACT,0,0,0,35,0,35,44,0,44,17,0,17,96,0,96
UTTAR PRADESH,2002,ANTIQUITIES AND ART TREASURE ACT,0,0,0,15,0,15,35,1,36,24,1,25,74,2,76
UTTAR PRADESH,2002,DOWRY PROHIBITION ACT,2,0,2,571,85,656,408,119,527,145,28,173,1126,232,1358
UTTAR PRADESH,2002,FOREIGN EXCHANGE REGULATION ACT-1973,7,0,7,12,7,19,9,11,20,0,0,0,28,18,46
UTTAR PRADESH,2002,PREVENTION OF CORRUPTION ACT-1988,0,0,0,11,2,13,16,0,16,5,0,5,32,2,34
UTTAR PRADESH,2002,CONSER.OF FORGN.EXCH.&PREV. OF SMUG.ACT,0,0,0,2,0,2,1,0,1,0,0,0,3,0,3
UTTAR PRADESH,2002,OTHER SLL OFFENCE,2,0,2,530,2,532,529,1,530,129,0,129,1190,3,1193
UTTAR PRADESH,2002,TOTAL,211,0,211,5207,141,5348,4931,174,5105,1295,30,1325,11644,345,11989
UTTAR PRADESH,2003,ARMS ACT,83,0,83,1433,5,1438,956,2,958,271,0,271,2743,7,2750
UTTAR PRADESH,2003,N.D.P.S. ACT,65,0,65,1215,27,1242,1323,22,1345,556,2,558,3159,51,3210
UTTAR PRADESH,2003,GAMBLING ACT,19,0,19,155,0,155,225,0,225,51,0,51,450,0,450
UTTAR PRADESH,2003,EXCISE ACT,4,0,4,381,8,389,443,14,457,169,0,169,997,22,1019
UTTAR PRADESH,2003,PROHIBITION ACT,0,0,0,16,0,16,12,0,12,10,0,10,38,0,38
UTTAR PRADESH,2003,EXPLOSIVE & EXPLOSIVE SUBST. ACT,2,0,2,253,0,253,191,0,191,22,0,22,468,0,468
UTTAR PRADESH,2003,TERRORIST & DISRUPTIVE ACTIVITIES (TATA),0,0,0,24,0,24,16,0,16,1,0,1,41,0,41
UTTAR PRADESH,2003,IMMORAL TRAFFIC (PREVENTION) ACT,0,0,0,78,1,79,52,0,52,12,0,12,142,1,143
UTTAR PRADESH,2003,INDIAN RAILWAYS ACT,14,0,14,474,0,474,496,6,502,62,0,62,1046,6,1052
UTTAR PRADESH,2003,REGISTRATION OF FOREIGNERS ACT,10,0,10,85,4,89,28,1,29,6,0,6,129,5,134
UTTAR PRADESH,2003,PROTECTION OF CIVIL RIGHTS ACT,0,0,0,0,0,0,0,0,0,0,0,0,0,0,0
UTTAR PRADESH,2003,SC/ST (PREVENTION OF ATROCITIES) ACT,3,0,3,385,1,386,395,2,397,124,4,128,907,7,914
UTTAR PRADESH,2003,INDIAN PASSPORT ACT,0,0,0,18,0,18,43,0,43,15,0,15,76,0,76
UTTAR PRADESH,2003,ESSENTIAL COMMODITIES ACT,0,0,0,59,0,59,84,4,88,5,3,8,148,7,155
UTTAR PRADESH,2003,ANTIQUITIES AND ART TREASURE ACT,0,0,0,6,0,6,2,0,2,0,0,0,8,0,8
UTTAR PRADESH,2003,DOWRY PROHIBITION ACT,15,0,15,559,61,620,470,72,542,236,29,265,1280,162,1442
UTTAR PRADESH,2003,FOREIGN EXCHANGE REGULATION ACT-1973,0,0,0,39,9,48,41,2,43,23,1,24,103,12,115
UTTAR PRADESH,2003,PREVENTION OF CORRUPTION ACT-1988,0,0,0,33,0,33,73,0,73,6,0,6,112,0,112
UTTAR PRADESH,2003,CONSER.OF FORGN.EXCH.&PREV. OF SMUG.ACT,0,0,0,20,0,20,18,0,18,8,0,8,46,0,46
UTTAR PRADESH,2003,OTHER SLL OFFENCE,4,0,4,0,0,0,237,2,239,45,0,45,286,2,288
UTTAR PRADESH,2003,TOTAL,219,0,219,5233,116,5349,5105,127,5232,1622,39,1661,12179,282,12461
UTTAR PRADESH,2004,ARMS ACT,13,0,13,1149,2,1151,1028,0,1028,260,0,260,2450,2,2452
UTTAR PRADESH,2004,N.D.P.S. ACT,9,0,9,1382,29,1411,1282,18,1300,417,1,418,3090,48,3138
UTTAR PRADESH,2004,GAMBLING ACT,2,0,2,296,3,299,289,0,289,89,0,89,676,3,679
UTTAR PRADESH,2004,EXCISE ACT,2,0,2,374,3,377,418,0,418,150,0,150,944,3,947
UTTAR PRADESH,2004,PROHIBITION ACT,0,0,0,31,0,31,15,1,16,6,0,6,52,1,53
UTTAR PRADESH,2004,EXPLOSIVE & EXPLOSIVE SUBST. ACT,0,0,0,146,0,146,154,1,155,37,0,37,337,1,338
UTTAR PRADESH,2004,TERRORIST & DISRUPTIVE ACTIVITIES (TATA),0,0,0,6,0,6,2,0,2,0,0,0,8,0,8
UTTAR PRADESH,2004,IMMORAL TRAFFIC (PREVENTION) ACT,3,0,3,64,4,68,73,6,79,17,0,17,157,10,167
UTTAR PRADESH,2004,INDIAN RAILWAYS ACT,9,0,9,342,0,342,261,3,264,78,0,78,690,3,693
UTTAR PRADESH,2004,REGISTRATION OF FOREIGNERS ACT,0,0,0,33,1,34,15,0,15,6,0,6,54,1,55
UTTAR PRADESH,2004,PROTECTION OF CIVIL RIGHTS ACT,0,0,0,2,0,2,13,0,13,13,0,13,28,0,28
UTTAR PRADESH,2004,SC/ST (PREVENTION OF ATROCITIES) ACT,0,0,0,310,0,310,379,3,382,150,3,153,839,6,845
UTTAR PRADESH,2004,INDIAN PASSPORT ACT,11,1,12,45,9,54,26,6,32,6,1,7,88,17,105
UTTAR PRADESH,2004,ESSENTIAL COMMODITIES ACT,0,0,0,37,0,37,54,0,54,3,0,3,94,0,94
UTTAR PRADESH,2004,ANTIQUITIES AND ART TREASURE ACT,0,0,0,15,6,21,94,6,100,29,3,32,138,15,153
UTTAR PRADESH,2004,DOWRY PROHIBITION ACT,2,0,2,583,48,631,614,48,662,232,20,252,1431,116,1547
UTTAR PRADESH,2004,FOREIGN EXCHANGE REGULATION ACT-1973,0,0,0,3,0,3,1,0,1,1,0,1,5,0,5
UTTAR PRADESH,2004,PREVENTION OF CORRUPTION ACT-1988,0,0,0,6,0,6,13,0,13,2,0,2,21,0,21
UTTAR PRADESH,2004,CONSER.OF FORGN.EXCH.&PREV. OF SMUG.ACT,0,0,0,5,0,5,13,0,13,7,0,7,25,0,25
UTTAR PRADESH,2004,OTHER SLL OFFENCE,5,1,6,805,0,805,649,53,702,158,17,175,1617,71,1688
UTTAR PRADESH,2004,TOTAL,56,2,58,5634,105,5739,5393,145,5538,1661,45,1706,12744,297,13041
UTTAR PRADESH,2005,ARMS ACT,153,0,153,1359,0,1359,1368,0,1368,322,0,322,3202,0,3202
UTTAR PRADESH,2005,N.D.P.S. ACT,144,0,144,1612,15,1627,1623,23,1646,455,2,457,3834,40,3874
UTTAR PRADESH,2005,GAMBLING ACT,0,0,0,277,0,277,264,0,264,60,0,60,601,0,601
UTTAR PRADESH,2005,EXCISE ACT,31,0,31,508,4,512,461,4,465,175,2,177,1175,10,1185
UTTAR PRADESH,2005,PROHIBITION ACT,0,0,0,19,0,19,20,6,26,9,1,10,48,7,55
UTTAR PRADESH,2005,EXPLOSIVE & EXPLOSIVE SUBST. ACT,0,0,0,154,0,154,116,0,116,30,0,30,300,0,300
UTTAR PRADESH,2005,TERRORIST & DISRUPTIVE ACTIVITIES (TATA),0,0,0,32,0,32,20,0,20,0,0,0,52,0,52
UTTAR PRADESH,2005,IMMORAL TRAFFIC (PREVENTION) ACT,0,0,0,74,14,88,54,10,64,10,0,10,138,24,162
UTTAR PRADESH,2005,INDIAN RAILWAYS ACT,19,0,19,281,2,283,324,0,324,100,0,100,724,2,726
UTTAR PRADESH,2005,REGISTRATION OF FOREIGNERS ACT,0,0,0,3,0,3,4,0,4,4,0,4,11,0,11
UTTAR PRADESH,2005,PROTECTION OF CIVIL RIGHTS ACT,0,0,0,10,0,10,8,0,8,0,0,0,18,0,18
UTTAR PRADESH,2005,SC/ST (PREVENTION OF ATROCITIES) ACT,0,0,0,372,1,373,391,5,396,277,3,280,1040,9,1049
UTTAR PRADESH,2005,INDIAN PASSPORT ACT,2,0,2,29,8,37,48,0,48,4,0,4,83,8,91
UTTAR PRADESH,2005,ESSENTIAL COMMODITIES ACT,0,0,0,19,0,19,40,0,40,20,0,20,79,0,79
UTTAR PRADESH,2005,ANTIQUITIES AND ART TREASURE ACT,0,0,0,18,0,18,31,0,31,4,0,4,53,0,53
UTTAR PRADESH,2005,DOWRY PROHIBITION ACT,5,0,5,409,51,460,692,82,774,401,39,440,1507,172,1679
UTTAR PRADESH,2005,FOREIGN EXCHANGE REGULATION ACT-1973,0,0,0,26,2,28,19,3,22,12,0,12,57,5,62
UTTAR PRADESH,2005,PREVENTION OF CORRUPTION ACT-1988,0,0,0,99,0,99,116,14,130,40,0,40,255,14,269
UTTAR PRADESH,2005,CONSER.OF FORGN.EXCH.&PREV. OF SMUG.ACT,0,0,0,539,5,544,264,6,270,127,0,127,930,11,941
UTTAR PRADESH,2005,OTHER SLL OFFENCE,8,0,8,276,3,279,256,6,262,126,4,130,666,13,679
UTTAR PRADESH,2005,TOTAL,362,0,362,6116,105,6221,6119,159,6278,2176,51,2227,14773,315,15088
UTTAR PRADESH,2006,ARMS ACT,65,0,65,1026,3,1029,794,4,798,270,0,270,2155,7,2162
UTTAR PRADESH,2006,N.D.P.S. ACT,78,0,78,1076,13,1089,709,34,743,393,14,407,2256,61,2317
UTTAR PRADESH,2006,GAMBLING ACT,0,0,0,222,0,222,401,1,402,93,1,94,716,2,718
UTTAR PRADESH,2006,EXCISE ACT,15,0,15,352,2,354,394,6,400,77,0,77,838,8,846
UTTAR PRADESH,2006,PROHIBITION ACT,0,0,0,56,0,56,40,1,41,10,0,10,106,1,107
UTTAR PRADESH,2006,EXPLOSIVE & EXPLOSIVE SUBST. ACT,0,0,0,166,0,166,200,0,200,35,0,35,401,0,401
UTTAR PRADESH,2006,TERRORIST & DISRUPTIVE ACTIVITIES (TATA),0,0,0,27,0,27,59,0,59,18,0,18,104,0,104
UTTAR PRADESH,2006,IMMORAL TRAFFIC (PREVENTION) ACT,0,0,0,40,9,49,30,2,32,22,8,30,92,19,111
UTTAR PRADESH,2006,INDIAN RAILWAYS ACT,11,0,11,193,1,194,197,1,198,165,1,166,566,3,569
UTTAR PRADESH,2006,REGISTRATION OF FOREIGNERS ACT,0,0,0,27,0,27,13,0,13,11,0,11,51,0,51
UTTAR PRADESH,2006,PROTECTION OF CIVIL RIGHTS ACT,0,0,0,12,0,12,17,0,17,3,0,3,32,0,32
UTTAR PRADESH,2006,SC/ST (PREVENTION OF ATROCITIES) ACT,0,0,0,377,2,379,312,7,319,134,6,140,823,15,838
UTTAR PRADESH,2006,INDIAN PASSPORT ACT,0,0,0,26,1,27,20,2,22,14,0,14,60,3,63
UTTAR PRADESH,2006,ESSENTIAL COMMODITIES ACT,0,0,0,36,0,36,77,0,77,25,0,25,138,0,138
UTTAR PRADESH,2006,ANTIQUITIES AND ART TREASURE ACT,0,0,0,12,2,14,13,1,14,1,0,1,26,3,29
UTTAR PRADESH,2006,DOWRY PROHIBITION ACT,14,0,14,614,46,660,772,75,847,230,40,270,1630,161,1791
UTTAR PRADESH,2006,FOREIGN EXCHANGE REGULATION ACT-1973,0,0,0,2,0,2,2,2,4,0,0,0,4,2,6
UTTAR PRADESH,2006,PREVENTION OF CORRUPTION ACT-1988,0,0,0,10,0,10,30,0,30,20,0,20,60,0,60
UTTAR PRADESH,2006,CONSER.OF FORGN.EXCH.&PREV. OF SMUG.ACT,0,0,0,2,0,2,1,0,1,0,0,0,3,0,3
UTTAR PRADESH,2006,OTHER SLL OFFENCE,32,0,32,0,0,0,167,1,168,21,5,26,220,6,226
UTTAR PRADESH,2006,TOTAL,215,0,215,4276,79,4355,4248,137,4385,1542,75,1617,10281,291,10572
UTTAR PRADESH,2007,ARMS ACT,6,0,6,1633,2,1635,1767,2,1769,243,2,245,3649,6,3655
UTTAR PRADESH,2007,N.D.P.S. ACT,0,0,0,1645,15,1660,1479,54,1533,383,12,395,3507,81,3588
UTTAR PRADESH,2007,GAMBLING ACT,0,0,0,519,0,519,610,2,612,176,1,177,1305,3,1308
UTTAR PRADESH,2007,EXCISE ACT,0,0,0,733,3,736,1004,11,1015,201,2,203,1938,16,1954
UTTAR PRADESH,2007,PROHIBITION ACT,0,0,0,30,0,30,70,0,70,47,0,47,147,0,147
UTTAR PRADESH,2007,EXPLOSIVE & EXPLOSIVE SUBST. ACT,0,0,0,161,0,161,152,0,152,51,0,51,364,0,364
UTTAR PRADESH,2007,TERRORIST & DISRUPTIVE ACTIVITIES (TATA),0,0,0,11,0,11,11,0,11,3,0,3,25,0,25
UTTAR PRADESH,2007,IMMORAL TRAFFIC (PREVENTION) ACT,0,0,0,29,6,35,39,3,42,27,0,27,95,9,104
UTTAR PRADESH,2007,INDIAN RAILWAYS ACT,1,0,1,277,0,277,349,0,349,112,0,112,739,0,739
UTTAR PRADESH,2007,REGISTRATION OF FOREIGNERS ACT,0,0,0,42,0,42,21,2,23,8,1,9,71,3,74
UTTAR PRADESH,2007,PROTECTION OF CIVIL RIGHTS ACT,0,0,0,23,0,23,46,0,46,21,0,21,90,0,90
UTTAR PRADESH,2007,SC/ST (PREVENTION OF ATROCITIES) ACT,0,0,0,434,1,435,630,9,639,198,0,198,1262,10,1272
UTTAR PRADESH,2007,INDIAN PASSPORT ACT,0,0,0,19,0,19,22,0,22,7,0,7,48,0,48
UTTAR PRADESH,2007,ESSENTIAL COMMODITIES ACT,0,0,0,65,1,66,179,0,179,38,0,38,282,1,283
UTTAR PRADESH,2007,ANTIQUITIES AND ART TREASURE ACT,0,0,0,12,0,12,20,1,21,29,1,30,61,2,63
UTTAR PRADESH,2007,DOWRY PROHIBITION ACT,0,0,0,680,83,763,508,54,562,288,45,333,1476,182,1658
UTTAR PRADESH,2007,FOREIGN EXCHANGE REGULATION ACT-1973,0,0,0,0,0,0,0,0,0,0,0,0,0,0,0
UTTAR PRADESH,2007,PREVENTION OF CORRUPTION ACT-1988,0,0,0,0,0,0,30,0,30,17,0,17,47,0,47
UTTAR PRADESH,2007,CONSER.OF FORGN.EXCH.&PREV. OF SMUG.ACT,0,0,0,0,0,0,9,0,9,0,0,0,9,0,9
UTTAR PRADESH,2007,OTHER SLL OFFENCE,0,0,0,241,38,279,184,0,184,71,8,79,496,46,542
UTTAR PRADESH,2007,TOTAL,7,0,7,6554,149,6703,7130,138,7268,1920,72,1992,15611,359,15970
UTTAR PRADESH,2008,ARMS ACT,14,0,14,1576,0,1576,1918,6,1924,538,0,538,4046,6,4052
UTTAR PRADESH,2008,N.D.P.S. ACT,3,0,3,1439,36,1475,1786,45,1831,553,14,567,3781,95,3876
UTTAR PRADESH,2008,GAMBLING ACT,0,0,0,485,0,485,532,2,534,160,1,161,1177,3,1180
UTTAR PRADESH,2008,EXCISE ACT,0,0,0,749,2,751,920,20,940,333,0,333,2002,22,2024
UTTAR PRADESH,2008,PROHIBITION ACT,0,0,0,43,0,43,60,0,60,13,0,13,116,0,116
UTTAR PRADESH,2008,EXPLOSIVE & EXPLOSIVE SUBST. ACT,0,0,0,102,0,102,192,0,192,84,0,84,378,0,378
UTTAR PRADESH,2008,TERRORIST & DISRUPTIVE ACTIVITIES (TATA),0,0,0,0,0,0,36,0,36,5,0,5,41,0,41
UTTAR PRADESH,2008,IMMORAL TRAFFIC (PREVENTION) ACT,0,0,0,26,1,27,36,3,39,10,0,10,72,4,76
UTTAR PRADESH,2008,INDIAN RAILWAYS ACT,6,0,6,351,9,360,349,2,351,120,1,121,826,12,838
UTTAR PRADESH,2008,REGISTRATION OF FOREIGNERS ACT,0,0,0,19,2,21,38,0,38,17,0,17,74,2,76
UTTAR PRADESH,2008,PROTECTION OF CIVIL RIGHTS ACT,0,0,0,2,0,2,1,0,1,0,0,0,3,0,3
UTTAR PRADESH,2008,SC/ST (PREVENTION OF ATROCITIES) ACT,0,0,0,548,4,552,666,12,678,246,3,249,1460,19,1479
UTTAR PRADESH,2008,INDIAN PASSPORT ACT,0,3,3,26,3,29,33,3,36,32,0,32,91,9,100
UTTAR PRADESH,2008,ESSENTIAL COMMODITIES ACT,0,0,0,72,0,72,162,0,162,44,0,44,278,0,278
UTTAR PRADESH,2008,ANTIQUITIES AND ART TREASURE ACT,0,0,0,2,0,2,6,0,6,0,0,0,8,0,8
UTTAR PRADESH,2008,DOWRY PROHIBITION ACT,9,0,9,503,75,578,812,75,887,337,55,392,1661,205,1866
UTTAR PRADESH,2008,FOREIGN EXCHANGE REGULATION ACT-1973,0,0,0,0,1,1,0,0,0,0,0,0,0,1,1
UTTAR PRADESH,2008,PREVENTION OF CORRUPTION ACT-1988,0,0,0,26,0,26,56,0,56,11,0,11,93,0,93
UTTAR PRADESH,2008,CONSER.OF FORGN.EXCH.&PREV. OF SMUG.ACT,0,0,0,0,0,0,0,0,0,0,0,0,0,0,0
UTTAR PRADESH,2008,OTHER SLL OFFENCE,0,0,0,194,9,203,250,14,264,89,2,91,533,25,558
UTTAR PRADESH,2008,TOTAL,32,3,35,6163,142,6305,7853,182,8035,2592,76,2668,16640,403,17043
UTTAR PRADESH,2009,ARMS ACT,0,0,0,1600,1,1601,1568,9,1577,373,0,373,3541,10,3551
UTTAR PRADESH,2009,N.D.P.S. ACT,0,0,0,1609,9,1618,1589,34,1623,539,19,558,3737,62,3799
UTTAR PRADESH,2009,GAMBLING ACT,0,0,0,249,3,252,347,4,351,151,1,152,747,8,755
UTTAR PRADESH,2009,EXCISE ACT,0,0,0,623,5,628,847,10,857,293,1,294,1763,16,1779
UTTAR PRADESH,2009,PROHIBITION ACT,0,0,0,17,1,18,65,0,65,21,0,21,103,1,104
UTTAR PRADESH,2009,EXPLOSIVE & EXPLOSIVE SUBST. ACT,0,0,0,127,2,129,147,4,151,54,0,54,328,6,334
UTTAR PRADESH,2009,TERRORIST & DISRUPTIVE ACTIVITIES (TATA),0,0,0,0,0,0,2,0,2,0,0,0,2,0,2
UTTAR PRADESH,2009,IMMORAL TRAFFIC (PREVENTION) ACT,0,0,0,32,2,34,22,2,24,7,0,7,61,4,65
UTTAR PRADESH,2009,INDIAN RAILWAYS ACT,0,0,0,272,8,280,371,42,413,190,13,203,833,63,896
UTTAR PRADESH,2009,REGISTRATION OF FOREIGNERS ACT,0,0,0,9,1,10,5,0,5,3,0,3,17,1,18
UTTAR PRADESH,2009,PROTECTION OF CIVIL RIGHTS ACT,0,0,0,0,0,0,0,0,0,0,0,0,0,0,0
UTTAR PRADESH,2009,SC/ST (PREVENTION OF ATROCITIES) ACT,0,0,0,540,7,547,596,17,613,271,9,280,1407,33,1440
UTTAR PRADESH,2009,INDIAN PASSPORT ACT,0,0,0,24,4,28,13,1,14,3,1,4,40,6,46
UTTAR PRADESH,2009,ESSENTIAL COMMODITIES ACT,0,0,0,76,0,76,238,0,238,62,0,62,376,0,376
UTTAR PRADESH,2009,ANTIQUITIES AND ART TREASURE ACT,0,0,0,4,0,4,10,0,10,0,0,0,14,0,14
UTTAR PRADESH,2009,DOWRY PROHIBITION ACT,0,0,0,471,45,516,650,81,731,230,16,246,1351,142,1493
UTTAR PRADESH,2009,FOREIGN EXCHANGE REGULATION ACT-1973,0,0,0,4,1,5,2,0,2,1,0,1,7,1,8
UTTAR PRADESH,2009,PREVENTION OF CORRUPTION ACT-1988,0,0,0,14,0,14,49,0,49,8,0,8,71,0,71
UTTAR PRADESH,2009,CONSER.OF FORGN.EXCH.&PREV. OF SMUG.ACT,0,0,0,0,0,0,0,0,0,0,0,0,0,0,0
UTTAR PRADESH,2009,OTHER SLL OFFENCE,0,0,0,606,0,606,865,11,876,34,2,36,1505,13,1518
UTTAR PRADESH,2009,TOTAL,0,0,0,6277,89,6366,7386,215,7601,2240,62,2302,15903,366,16269
UTTAR PRADESH,2010,ARMS ACT,0,0,0,1532,1,1533,1568,7,1575,373,0,373,3473,8,3481
UTTAR PRADESH,2010,N.D.P.S. ACT,0,0,0,1498,9,1507,1589,28,1617,539,19,558,3626,56,3682
UTTAR PRADESH,2010,GAMBLING ACT,0,0,0,236,3,239,347,2,349,151,1,152,734,6,740
UTTAR PRADESH,2010,EXCISE ACT,0,0,0,496,5,501,847,8,855,293,1,294,1636,14,1650
UTTAR PRADESH,2010,PROHIBITION ACT,0,0,0,15,1,16,65,0,65,18,0,18,98,1,99
UTTAR PRADESH,2010,EXPLOSIVE & EXPLOSIVE SUBST. ACT,0,0,0,118,2,120,147,4,151,48,0,48,313,6,319
UTTAR PRADESH,2010,TERRORIST & DISRUPTIVE ACTIVITIES (TATA),0,0,0,0,0,0,2,0,2,0,0,0,2,0,2
UTTAR PRADESH,2010,IMMORAL TRAFFIC (PREVENTION) ACT,0,0,0,31,2,33,22,2,24,7,0,7,60,4,64
UTTAR PRADESH,2010,INDIAN RAILWAYS ACT,0,0,0,248,4,252,371,35,406,182,11,193,801,50,851
UTTAR PRADESH,2010,REGISTRATION OF FOREIGNERS ACT,0,0,0,9,1,10,5,0,5,3,0,3,17,1,18
UTTAR PRADESH,2010,PROTECTION OF CIVIL RIGHTS ACT,0,0,0,0,0,0,0,0,0,0,0,0,0,0,0
UTTAR PRADESH,2010,SC/ST (PREVENTION OF ATROCITIES) ACT,0,0,0,498,7,505,596,12,608,271,7,278,1365,26,1391
UTTAR PRADESH,2010,INDIAN PASSPORT ACT,0,0,0,21,4,25,13,1,14,3,1,4,37,6,43
UTTAR PRADESH,2010,ESSENTIAL COMMODITIES ACT,0,0,0,51,0,51,252,0,252,48,0,48,351,0,351
UTTAR PRADESH,2010,ANTIQUITIES AND ART TREASURE ACT,0,0,0,2,0,2,10,0,10,0,0,0,12,0,12
UTTAR PRADESH,2010,DOWRY PROHIBITION ACT,0,0,0,327,29,356,654,122,776,208,12,220,1189,163,1352
UTTAR PRADESH,2010,FOREIGN EXCHANGE REGULATION ACT-1973,0,0,0,2,1,3,2,0,2,1,0,1,5,1,6
UTTAR PRADESH,2010,PREVENTION OF CORRUPTION ACT-1988,0,0,0,11,0,11,49,0,49,8,0,8,68,0,68
UTTAR PRADESH,2010,CONSER.OF FORGN.EXCH.&PREV. OF SMUG.ACT,0,0,0,0,0,0,0,0,0,0,0,0,0,0,0
UTTAR PRADESH,2010,OTHER SLL OFFENCE,0,0,0,428,0,428,865,11,876,34,2,36,1327,13,1340
UTTAR PRADESH,2010,TOTAL,0,0,0,5523,69,5592,7404,232,7636,2187,54,2241,15114,355,15469
UTTAR PRADESH,2011,ARMS ACT,0,0,0,1497,4,1501,1541,13,1554,372,0,372,3410,17,3427
UTTAR PRADESH,2011,N.D.P.S. ACT,0,0,0,1447,13,1460,1537,42,1579,537,20,557,3521,75,3596
UTTAR PRADESH,2011,GAMBLING ACT,0,0,0,224,7,231,323,6,329,149,2,151,696,15,711
UTTAR PRADESH,2011,EXCISE ACT,0,0,0,481,6,487,841,12,853,292,2,294,1614,20,1634
UTTAR PRADESH,2011,PROHIBITION ACT,0,0,0,15,1,16,52,0,52,17,0,17,84,1,85
UTTAR PRADESH,2011,EXPLOSIVE & EXPLOSIVE SUBST. ACT,0,0,0,113,3,116,109,5,114,47,0,47,269,8,277
UTTAR PRADESH,2011,TERRORIST & DISRUPTIVE ACTIVITIES (TATA),0,0,0,0,0,0,1,0,1,0,0,0,1,0,1
UTTAR PRADESH,2011,IMMORAL TRAFFIC (PREVENTION) ACT,0,0,0,25,3,28,17,4,21,6,0,6,48,7,55
UTTAR PRADESH,2011,INDIAN RAILWAYS ACT,0,0,0,224,9,233,340,47,387,178,13,191,742,69,811
UTTAR PRADESH,2011,REGISTRATION OF FOREIGNERS ACT,0,0,0,9,1,10,4,0,4,1,0,1,14,1,15
UTTAR PRADESH,2011,PROTECTION OF CIVIL RIGHTS ACT,0,0,0,0,0,0,0,0,0,0,0,0,0,0,0
UTTAR PRADESH,2011,SC/ST (PREVENTION OF ATROCITIES) ACT,0,0,0,464,7,471,564,16,580,269,11,280,1297,34,1331
UTTAR PRADESH,2011,INDIAN PASSPORT ACT,0,0,0,19,4,23,9,3,12,2,2,4,30,9,39
UTTAR PRADESH,2011,ESSENTIAL COMMODITIES ACT,0,0,0,40,0,40,244,0,244,46,0,46,330,0,330
UTTAR PRADESH,2011,ANTIQUITIES AND ART TREASURE ACT,0,0,0,1,0,1,8,0,8,0,0,0,9,0,9
UTTAR PRADESH,2011,DOWRY PROHIBITION ACT,0,0,0,307,44,351,624,137,761,204,17,221,1135,198,1333
UTTAR PRADESH,2011,FOREIGN EXCHANGE REGULATION ACT-1973,0,0,0,1,1,2,1,0,1,0,0,0,2,1,3
UTTAR PRADESH,2011,PREVENTION OF CORRUPTION ACT-1988,0,0,0,9,0,9,44,0,44,7,0,7,60,0,60
UTTAR PRADESH,2011,CONSER.OF FORGN.EXCH.&PREV. OF SMUG.ACT,0,0,0,0,0,0,0,0,0,0,0,0,0,0,0
UTTAR PRADESH,2011,OTHER SLL OFFENCE,0,0,0,505,4,509,810,13,823,71,8,79,1386,25,1411
UTTAR PRADESH,2011,TOTAL,0,0,0,5381,107,5488,7069,298,7367,2198,75,2273,14648,480,15128
UTTAR PRADESH,2012,ARMS ACT,0,0,0,1501,4,1505,1540,15,1555,369,0,369,3410,19,3429
UTTAR PRADESH,2012,N.D.P.S. ACT,0,0,0,1452,13,1465,1535,39,1574,533,19,552,3520,71,3591
UTTAR PRADESH,2012,GAMBLING ACT,0,0,0,222,7,229,321,10,331,145,3,148,688,20,708
UTTAR PRADESH,2012,EXCISE ACT,0,0,0,479,6,485,835,16,851,289,2,291,1603,24,1627
UTTAR PRADESH,2012,PROHIBITION ACT,0,0,0,17,2,19,48,0,48,15,0,15,80,2,82
UTTAR PRADESH,2012,EXPLOSIVE & EXPLOSIVE SUBST. ACT,0,0,0,113,3,116,105,8,113,45,0,45,263,11,274
UTTAR PRADESH,2012,TERRORIST & DISRUPTIVE ACTIVITIES (TATA),0,0,0,0,0,0,2,0,2,0,0,0,2,0,2
UTTAR PRADESH,2012,IMMORAL TRAFFIC (PREVENTION) ACT,0,0,0,24,4,28,15,3,18,5,0,5,44,7,51
UTTAR PRADESH,2012,INDIAN RAILWAYS ACT,0,0,0,215,10,225,331,48,379,174,14,188,720,72,792
UTTAR PRADESH,2012,REGISTRATION OF FOREIGNERS ACT,0,0,0,9,2,11,3,0,3,0,0,0,12,2,14
UTTAR PRADESH,2012,PROTECTION OF CIVIL RIGHTS ACT,0,0,0,0,0,0,0,0,0,0,0,0,0,0,0
UTTAR PRADESH,2012,SC/ST (PREVENTION OF ATROCITIES) ACT,0,0,0,467,7,474,561,19,580,272,13,285,1300,39,1339
UTTAR PRADESH,2012,INDIAN PASSPORT ACT,0,0,0,19,5,24,8,7,15,3,3,6,30,15,45
UTTAR PRADESH,2012,ESSENTIAL COMMODITIES ACT,0,0,0,42,0,42,241,0,241,44,0,44,327,0,327
UTTAR PRADESH,2012,ANTIQUITIES AND ART TREASURE ACT,0,0,0,0,0,0,6,0,6,0,0,0,6,0,6
UTTAR PRADESH,2012,DOWRY PROHIBITION ACT,0,0,0,308,46,354,621,141,762,208,16,224,1137,203,1340
UTTAR PRADESH,2012,FOREIGN EXCHANGE REGULATION ACT-1973,0,0,0,3,1,4,1,0,1,0,0,0,4,1,5
UTTAR PRADESH,2012,PREVENTION OF CORRUPTION ACT-1988,0,0,0,11,0,11,41,0,41,6,0,6,58,0,58
UTTAR PRADESH,2012,CONSER.OF FORGN.EXCH.&PREV. OF SMUG.ACT,0,0,0,0,0,0,0,0,0,0,0,0,0,0,0
UTTAR PRADESH,2012,OTHER SLL OFFENCE,0,0,0,522,4,526,817,16,833,111,7,118,1450,27,1477
UTTAR PRADESH,2012,TOTAL,0,0,0,5404,114,5518,7031,322,7353,2219,77,2296,14654,513,15167
UTTARANCHAL,2001,ARMS ACT,9,0,9,21,0,21,18,0,18,9,0,9,57,0,57
UTTARANCHAL,2001,N.D.P.S. ACT,0,0,0,43,0,43,38,0,38,21,0,21,102,0,102
UTTARANCHAL,2001,GAMBLING ACT,0,0,0,20,0,20,21,0,21,0,0,0,41,0,41
UTTARANCHAL,2001,EXCISE ACT,6,0,6,18,0,18,9,0,9,24,0,24,57,0,57
UTTARANCHAL,2001,PROHIBITION ACT,0,0,0,0,0,0,0,0,0,0,0,0,0,0,0
UTTARANCHAL,2001,EXPLOSIVE & EXPLOSIVE SUBST. ACT,0,0,0,0,0,0,0,0,0,0,0,0,0,0,0
UTTARANCHAL,2001,TERRORIST & DISRUPTIVE ACTIVITIES (TATA),0,0,0,0,0,0,0,0,0,0,0,0,0,0,0
UTTARANCHAL,2001,IMMORAL TRAFFIC (PREVENTION) ACT,0,0,0,0,0,0,4,0,4,0,0,0,4,0,4
UTTARANCHAL,2001,INDIAN RAILWAYS ACT,0,0,0,11,0,11,0,0,0,0,0,0,11,0,11
UTTARANCHAL,2001,REGISTRATION OF FOREIGNERS ACT,0,0,0,0,0,0,0,0,0,0,0,0,0,0,0
UTTARANCHAL,2001,PROTECTION OF CIVIL RIGHTS ACT,0,0,0,0,0,0,0,0,0,0,0,0,0,0,0
UTTARANCHAL,2001,SC/ST (PREVENTION OF ATROCITIES) ACT,4,0,4,31,5,36,11,0,11,0,0,0,46,5,51
UTTARANCHAL,2001,INDIAN PASSPORT ACT,0,0,0,0,0,0,0,0,0,0,0,0,0,0,0
UTTARANCHAL,2001,ESSENTIAL COMMODITIES ACT,0,0,0,4,0,4,6,0,6,0,0,0,10,0,10
UTTARANCHAL,2001,ANTIQUITIES AND ART TREASURE ACT,0,0,0,0,0,0,0,0,0,0,0,0,0,0,0
UTTARANCHAL,2001,DOWRY PROHIBITION ACT,0,0,0,0,0,0,0,0,0,0,0,0,0,0,0
UTTARANCHAL,2001,FOREIGN EXCHANGE REGULATION ACT-1973,0,0,0,0,0,0,0,0,0,0,0,0,0,0,0
UTTARANCHAL,2001,PREVENTION OF CORRUPTION ACT-1988,0,0,0,0,0,0,0,0,0,0,0,0,0,0,0
UTTARANCHAL,2001,CONSER.OF FORGN.EXCH.&PREV. OF SMUG.ACT,0,0,0,0,0,0,0,0,0,0,0,0,0,0,0
UTTARANCHAL,2001,OTHER SLL OFFENCE,0,0,0,0,0,0,0,0,0,0,0,0,0,0,0
UTTARANCHAL,2001,TOTAL,19,0,19,148,5,153,107,0,107,54,0,54,328,5,333
UTTARANCHAL,2002,ARMS ACT,11,0,11,45,0,45,48,0,48,24,0,24,128,0,128
UTTARANCHAL,2002,N.D.P.S. ACT,2,0,2,29,2,31,26,1,27,28,0,28,85,3,88
UTTARANCHAL,2002,GAMBLING ACT,2,0,2,18,0,18,13,0,13,27,0,27,60,0,60
UTTARANCHAL,2002,EXCISE ACT,5,0,5,38,0,38,21,0,21,29,0,29,93,0,93
UTTARANCHAL,2002,PROHIBITION ACT,0,0,0,0,0,0,0,0,0,0,0,0,0,0,0
UTTARANCHAL,2002,EXPLOSIVE & EXPLOSIVE SUBST. ACT,0,0,0,0,0,0,0,0,0,0,0,0,0,0,0
UTTARANCHAL,2002,TERRORIST & DISRUPTIVE ACTIVITIES (TATA),0,0,0,0,0,0,0,0,0,0,0,0,0,0,0
UTTARANCHAL,2002,IMMORAL TRAFFIC (PREVENTION) ACT,0,0,0,0,0,0,0,0,0,0,0,0,0,0,0
UTTARANCHAL,2002,INDIAN RAILWAYS ACT,0,0,0,6,0,6,29,0,29,18,0,18,53,0,53
UTTARANCHAL,2002,REGISTRATION OF FOREIGNERS ACT,0,0,0,2,0,2,0,0,0,0,0,0,2,0,2
UTTARANCHAL,2002,PROTECTION OF CIVIL RIGHTS ACT,0,0,0,0,0,0,0,0,0,0,0,0,0,0,0
UTTARANCHAL,2002,SC/ST (PREVENTION OF ATROCITIES) ACT,0,0,0,2,2,4,11,1,12,13,0,13,26,3,29
UTTARANCHAL,2002,INDIAN PASSPORT ACT,0,0,0,0,0,0,0,0,0,0,0,0,0,0,0
UTTARANCHAL,2002,ESSENTIAL COMMODITIES ACT,0,0,0,1,0,1,0,0,0,4,0,4,5,0,5
UTTARANCHAL,2002,ANTIQUITIES AND ART TREASURE ACT,0,0,0,0,0,0,0,0,0,0,0,0,0,0,0
UTTARANCHAL,2002,DOWRY PROHIBITION ACT,0,0,0,4,0,4,5,0,5,12,0,12,21,0,21
UTTARANCHAL,2002,FOREIGN EXCHANGE REGULATION ACT-1973,0,0,0,0,0,0,0,0,0,0,0,0,0,0,0
UTTARANCHAL,2002,PREVENTION OF CORRUPTION ACT-1988,0,0,0,0,0,0,0,0,0,0,0,0,0,0,0
UTTARANCHAL,2002,CONSER.OF FORGN.EXCH.&PREV. OF SMUG.ACT,0,0,0,0,0,0,0,0,0,0,0,0,0,0,0
UTTARANCHAL,2002,OTHER SLL OFFENCE,0,0,0,2,0,2,3,2,5,12,0,12,17,2,19
UTTARANCHAL,2002,TOTAL,20,0,20,147,4,151,156,4,160,167,0,167,490,8,498
UTTARANCHAL,2003,ARMS ACT,10,0,10,84,0,84,31,0,31,52,0,52,177,0,177
UTTARANCHAL,2003,N.D.P.S. ACT,0,0,0,52,3,55,41,0,41,37,0,37,130,3,133
UTTARANCHAL,2003,GAMBLING ACT,0,0,0,26,0,26,18,0,18,8,0,8,52,0,52
UTTARANCHAL,2003,EXCISE ACT,10,0,10,65,5,70,62,0,62,22,0,22,159,5,164
UTTARANCHAL,2003,PROHIBITION ACT,0,0,0,0,0,0,0,0,0,0,0,0,0,0,0
UTTARANCHAL,2003,EXPLOSIVE & EXPLOSIVE SUBST. ACT,0,0,0,1,0,1,0,0,0,0,0,0,1,0,1
UTTARANCHAL,2003,TERRORIST & DISRUPTIVE ACTIVITIES (TATA),0,0,0,0,0,0,0,0,0,0,0,0,0,0,0
UTTARANCHAL,2003,IMMORAL TRAFFIC (PREVENTION) ACT,0,0,0,3,0,3,4,0,4,2,0,2,9,0,9
UTTARANCHAL,2003,INDIAN RAILWAYS ACT,22,0,22,33,0,33,22,0,22,5,0,5,82,0,82
UTTARANCHAL,2003,REGISTRATION OF FOREIGNERS ACT,0,0,0,0,0,0,0,0,0,0,0,0,0,0,0
UTTARANCHAL,2003,PROTECTION OF CIVIL RIGHTS ACT,0,0,0,0,0,0,0,0,0,0,0,0,0,0,0
UTTARANCHAL,2003,SC/ST (PREVENTION OF ATROCITIES) ACT,0,0,0,12,0,12,4,1,5,3,0,3,19,1,20
UTTARANCHAL,2003,INDIAN PASSPORT ACT,0,0,0,0,0,0,0,0,0,0,0,0,0,0,0
UTTARANCHAL,2003,ESSENTIAL COMMODITIES ACT,0,0,0,0,0,0,1,0,1,0,0,0,1,0,1
UTTARANCHAL,2003,ANTIQUITIES AND ART TREASURE ACT,0,0,0,0,0,0,0,0,0,0,0,0,0,0,0
UTTARANCHAL,2003,DOWRY PROHIBITION ACT,0,0,0,6,2,8,4,0,4,0,0,0,10,2,12
UTTARANCHAL,2003,FOREIGN EXCHANGE REGULATION ACT-1973,0,0,0,0,0,0,0,0,0,0,0,0,0,0,0
UTTARANCHAL,2003,PREVENTION OF CORRUPTION ACT-1988,0,0,0,0,0,0,0,0,0,0,0,0,0,0,0
UTTARANCHAL,2003,CONSER.OF FORGN.EXCH.&PREV. OF SMUG.ACT,0,0,0,0,0,0,0,0,0,0,0,0,0,0,0
UTTARANCHAL,2003,OTHER SLL OFFENCE,0,0,0,5,0,5,4,0,4,32,0,32,41,0,41
UTTARANCHAL,2003,TOTAL,42,0,42,287,10,297,191,1,192,161,0,161,681,11,692
UTTARANCHAL,2004,ARMS ACT,0,0,0,41,2,43,55,2,57,36,0,36,132,4,136
UTTARANCHAL,2004,N.D.P.S. ACT,0,0,0,39,3,42,22,5,27,25,5,30,86,13,99
UTTARANCHAL,2004,GAMBLING ACT,0,0,0,12,0,12,14,0,14,12,0,12,38,0,38
UTTARANCHAL,2004,EXCISE ACT,0,0,0,27,0,27,33,0,33,38,0,38,98,0,98
UTTARANCHAL,2004,PROHIBITION ACT,0,0,0,0,0,0,0,0,0,0,0,0,0,0,0
UTTARANCHAL,2004,EXPLOSIVE & EXPLOSIVE SUBST. ACT,0,0,0,0,0,0,0,0,0,0,0,0,0,0,0
UTTARANCHAL,2004,TERRORIST & DISRUPTIVE ACTIVITIES (TATA),0,0,0,0,0,0,0,0,0,0,0,0,0,0,0
UTTARANCHAL,2004,IMMORAL TRAFFIC (PREVENTION) ACT,0,0,0,52,3,55,80,3,83,27,0,27,159,6,165
UTTARANCHAL,2004,INDIAN RAILWAYS ACT,0,0,0,0,0,0,0,0,0,0,0,0,0,0,0
UTTARANCHAL,2004,REGISTRATION OF FOREIGNERS ACT,0,0,0,0,0,0,0,0,0,0,0,0,0,0,0
UTTARANCHAL,2004,PROTECTION OF CIVIL RIGHTS ACT,0,0,0,0,0,0,0,0,0,0,0,0,0,0,0
UTTARANCHAL,2004,SC/ST (PREVENTION OF ATROCITIES) ACT,0,0,0,12,0,12,14,3,17,16,5,21,42,8,50
UTTARANCHAL,2004,INDIAN PASSPORT ACT,0,0,0,0,0,0,0,0,0,0,0,0,0,0,0
UTTARANCHAL,2004,ESSENTIAL COMMODITIES ACT,0,0,0,0,0,0,0,0,0,0,0,0,0,0,0
UTTARANCHAL,2004,ANTIQUITIES AND ART TREASURE ACT,0,0,0,0,0,0,0,0,0,0,0,0,0,0,0
UTTARANCHAL,2004,DOWRY PROHIBITION ACT,0,0,0,0,0,0,0,0,0,0,0,0,0,0,0
UTTARANCHAL,2004,FOREIGN EXCHANGE REGULATION ACT-1973,0,0,0,0,0,0,0,0,0,0,0,0,0,0,0
UTTARANCHAL,2004,PREVENTION OF CORRUPTION ACT-1988,0,0,0,0,0,0,0,0,0,0,0,0,0,0,0
UTTARANCHAL,2004,CONSER.OF FORGN.EXCH.&PREV. OF SMUG.ACT,0,0,0,0,0,0,0,0,0,0,0,0,0,0,0
UTTARANCHAL,2004,OTHER SLL OFFENCE,0,0,0,0,0,0,0,0,0,0,0,0,0,0,0
UTTARANCHAL,2004,TOTAL,0,0,0,183,8,191,218,13,231,154,10,164,555,31,586
UTTARANCHAL,2005,ARMS ACT,2,0,2,46,0,46,36,0,36,18,0,18,102,0,102
UTTARANCHAL,2005,N.D.P.S. ACT,0,0,0,26,0,26,39,1,40,26,0,26,91,1,92
UTTARANCHAL,2005,GAMBLING ACT,0,0,0,20,0,20,14,0,14,9,0,9,43,0,43
UTTARANCHAL,2005,EXCISE ACT,0,0,0,59,0,59,46,0,46,35,0,35,140,0,140
UTTARANCHAL,2005,PROHIBITION ACT,0,0,0,0,0,0,0,0,0,0,0,0,0,0,0
UTTARANCHAL,2005,EXPLOSIVE & EXPLOSIVE SUBST. ACT,0,0,0,0,0,0,2,0,2,0,0,0,2,0,2
UTTARANCHAL,2005,TERRORIST & DISRUPTIVE ACTIVITIES (TATA),0,0,0,0,0,0,0,0,0,0,0,0,0,0,0
UTTARANCHAL,2005,IMMORAL TRAFFIC (PREVENTION) ACT,0,0,0,0,0,0,0,0,0,2,0,2,2,0,2
UTTARANCHAL,2005,INDIAN RAILWAYS ACT,15,0,15,40,0,40,20,0,20,10,0,10,85,0,85
UTTARANCHAL,2005,REGISTRATION OF FOREIGNERS ACT,0,0,0,0,0,0,0,0,0,0,0,0,0,0,0
UTTARANCHAL,2005,PROTECTION OF CIVIL RIGHTS ACT,0,0,0,0,0,0,0,0,0,0,0,0,0,0,0
UTTARANCHAL,2005,SC/ST (PREVENTION OF ATROCITIES) ACT,0,0,0,8,0,8,8,0,8,2,0,2,18,0,18
UTTARANCHAL,2005,INDIAN PASSPORT ACT,0,0,0,0,0,0,0,0,0,0,0,0,0,0,0
UTTARANCHAL,2005,ESSENTIAL COMMODITIES ACT,0,0,0,1,0,1,3,0,3,1,0,1,5,0,5
UTTARANCHAL,2005,ANTIQUITIES AND ART TREASURE ACT,0,0,0,0,0,0,0,0,0,0,0,0,0,0,0
UTTARANCHAL,2005,DOWRY PROHIBITION ACT,0,0,0,6,0,6,13,3,16,5,0,5,24,3,27
UTTARANCHAL,2005,FOREIGN EXCHANGE REGULATION ACT-1973,0,0,0,0,0,0,0,0,0,0,0,0,0,0,0
UTTARANCHAL,2005,PREVENTION OF CORRUPTION ACT-1988,0,0,0,0,0,0,0,0,0,2,0,2,2,0,2
UTTARANCHAL,2005,CONSER.OF FORGN.EXCH.&PREV. OF SMUG.ACT,0,0,0,0,0,0,0,0,0,0,0,0,0,0,0
UTTARANCHAL,2005,OTHER SLL OFFENCE,0,0,0,6,3,9,5,0,5,2,0,2,13,3,16
UTTARANCHAL,2005,TOTAL,17,0,17,212,3,215,186,4,190,112,0,112,527,7,534
UTTARANCHAL,2006,ARMS ACT,3,0,3,64,0,64,33,0,33,12,0,12,112,0,112
UTTARANCHAL,2006,N.D.P.S. ACT,0,0,0,56,0,56,36,1,37,18,0,18,110,1,111
UTTARANCHAL,2006,GAMBLING ACT,0,0,0,5,0,5,28,0,28,14,0,14,47,0,47
UTTARANCHAL,2006,EXCISE ACT,1,0,1,52,3,55,56,0,56,38,1,39,147,4,151
UTTARANCHAL,2006,PROHIBITION ACT,0,0,0,0,0,0,0,0,0,1,0,1,1,0,1
UTTARANCHAL,2006,EXPLOSIVE & EXPLOSIVE SUBST. ACT,0,0,0,1,0,1,0,0,0,0,0,0,1,0,1
UTTARANCHAL,2006,TERRORIST & DISRUPTIVE ACTIVITIES (TATA),0,0,0,0,0,0,0,0,0,0,0,0,0,0,0
UTTARANCHAL,2006,IMMORAL TRAFFIC (PREVENTION) ACT,0,0,0,10,0,10,8,0,8,5,0,5,23,0,23
UTTARANCHAL,2006,INDIAN RAILWAYS ACT,3,0,3,18,0,18,13,0,13,8,0,8,42,0,42
UTTARANCHAL,2006,REGISTRATION OF FOREIGNERS ACT,0,0,0,0,0,0,0,0,0,0,0,0,0,0,0
UTTARANCHAL,2006,PROTECTION OF CIVIL RIGHTS ACT,0,0,0,0,0,0,0,0,0,0,0,0,0,0,0
UTTARANCHAL,2006,SC/ST (PREVENTION OF ATROCITIES) ACT,0,0,0,13,0,13,2,1,3,4,0,4,19,1,20
UTTARANCHAL,2006,INDIAN PASSPORT ACT,0,0,0,0,0,0,0,0,0,0,0,0,0,0,0
UTTARANCHAL,2006,ESSENTIAL COMMODITIES ACT,0,0,0,0,0,0,1,0,1,0,0,0,1,0,1
UTTARANCHAL,2006,ANTIQUITIES AND ART TREASURE ACT,0,0,0,0,0,0,0,0,0,0,0,0,0,0,0
UTTARANCHAL,2006,DOWRY PROHIBITION ACT,0,0,0,8,0,8,9,2,11,9,0,9,26,2,28
UTTARANCHAL,2006,FOREIGN EXCHANGE REGULATION ACT-1973,0,0,0,0,0,0,0,0,0,0,0,0,0,0,0
UTTARANCHAL,2006,PREVENTION OF CORRUPTION ACT-1988,0,0,0,0,0,0,8,0,8,0,0,0,8,0,8
UTTARANCHAL,2006,CONSER.OF FORGN.EXCH.&PREV. OF SMUG.ACT,0,0,0,0,0,0,0,0,0,0,0,0,0,0,0
UTTARANCHAL,2006,OTHER SLL OFFENCE,0,0,0,22,0,22,17,0,17,13,0,13,52,0,52
UTTARANCHAL,2006,TOTAL,7,0,7,249,3,252,211,4,215,122,1,123,589,8,597
UTTARANCHAL,2007,ARMS ACT,2,0,2,19,0,19,24,0,24,4,0,4,49,0,49
UTTARANCHAL,2007,N.D.P.S. ACT,0,0,0,24,2,26,45,0,45,9,1,10,78,3,81
UTTARANCHAL,2007,GAMBLING ACT,0,0,0,19,0,19,10,0,10,4,0,4,33,0,33
UTTARANCHAL,2007,EXCISE ACT,0,0,0,12,2,14,19,0,19,8,0,8,39,2,41
UTTARANCHAL,2007,PROHIBITION ACT,0,0,0,2,0,2,3,0,3,0,0,0,5,0,5
UTTARANCHAL,2007,EXPLOSIVE & EXPLOSIVE SUBST. ACT,0,0,0,0,0,0,0,0,0,0,0,0,0,0,0
UTTARANCHAL,2007,TERRORIST & DISRUPTIVE ACTIVITIES (TATA),0,0,0,0,0,0,0,0,0,0,0,0,0,0,0
UTTARANCHAL,2007,IMMORAL TRAFFIC (PREVENTION) ACT,0,0,0,0,0,0,0,0,0,0,0,0,0,0,0
UTTARANCHAL,2007,INDIAN RAILWAYS ACT,0,0,0,23,2,25,17,0,17,12,0,12,52,2,54
UTTARANCHAL,2007,REGISTRATION OF FOREIGNERS ACT,0,0,0,12,0,12,5,0,5,1,0,1,18,0,18
UTTARANCHAL,2007,PROTECTION OF CIVIL RIGHTS ACT,0,0,0,0,0,0,0,0,0,0,0,0,0,0,0
UTTARANCHAL,2007,SC/ST (PREVENTION OF ATROCITIES) ACT,0,0,0,9,0,9,9,0,9,2,0,2,20,0,20
UTTARANCHAL,2007,INDIAN PASSPORT ACT,0,0,0,2,0,2,6,0,6,3,0,3,11,0,11
UTTARANCHAL,2007,ESSENTIAL COMMODITIES ACT,0,0,0,3,0,3,13,0,13,0,0,0,16,0,16
UTTARANCHAL,2007,ANTIQUITIES AND ART TREASURE ACT,0,0,0,0,0,0,0,0,0,0,0,0,0,0,0
UTTARANCHAL,2007,DOWRY PROHIBITION ACT,0,0,0,5,0,5,16,0,16,13,1,14,34,1,35
UTTARANCHAL,2007,FOREIGN EXCHANGE REGULATION ACT-1973,0,0,0,0,0,0,0,0,0,0,0,0,0,0,0
UTTARANCHAL,2007,PREVENTION OF CORRUPTION ACT-1988,0,0,0,0,0,0,0,0,0,0,0,0,0,0,0
UTTARANCHAL,2007,CONSER.OF FORGN.EXCH.&PREV. OF SMUG.ACT,0,0,0,0,0,0,0,0,0,0,0,0,0,0,0
UTTARANCHAL,2007,OTHER SLL OFFENCE,0,0,0,17,0,17,6,0,6,14,0,14,37,0,37
UTTARANCHAL,2007,TOTAL,2,0,2,147,6,153,173,0,173,70,2,72,392,8,400
UTTARANCHAL,2008,ARMS ACT,0,0,0,50,0,50,44,0,44,13,0,13,107,0,107
UTTARANCHAL,2008,N.D.P.S. ACT,0,0,0,50,0,50,48,0,48,13,0,13,111,0,111
UTTARANCHAL,2008,GAMBLING ACT,0,0,0,14,0,14,17,0,17,5,0,5,36,0,36
UTTARANCHAL,2008,EXCISE ACT,0,0,0,52,2,54,50,0,50,25,0,25,127,2,129
UTTARANCHAL,2008,PROHIBITION ACT,0,0,0,0,0,0,1,0,1,0,0,0,1,0,1
UTTARANCHAL,2008,EXPLOSIVE & EXPLOSIVE SUBST. ACT,0,0,0,3,0,3,5,0,5,0,0,0,8,0,8
UTTARANCHAL,2008,TERRORIST & DISRUPTIVE ACTIVITIES (TATA),0,0,0,0,0,0,0,0,0,0,0,0,0,0,0
UTTARANCHAL,2008,IMMORAL TRAFFIC (PREVENTION) ACT,0,0,0,2,0,2,3,0,3,2,0,2,7,0,7
UTTARANCHAL,2008,INDIAN RAILWAYS ACT,0,0,0,5,0,5,8,0,8,4,0,4,17,0,17
UTTARANCHAL,2008,REGISTRATION OF FOREIGNERS ACT,0,0,0,9,0,9,7,0,7,4,0,4,20,0,20
UTTARANCHAL,2008,PROTECTION OF CIVIL RIGHTS ACT,0,0,0,2,0,2,9,0,9,0,0,0,11,0,11
UTTARANCHAL,2008,SC/ST (PREVENTION OF ATROCITIES) ACT,0,0,0,13,1,14,5,0,5,0,0,0,18,1,19
UTTARANCHAL,2008,INDIAN PASSPORT ACT,0,0,0,7,0,7,14,0,14,4,0,4,25,0,25
UTTARANCHAL,2008,ESSENTIAL COMMODITIES ACT,0,0,0,6,0,6,21,0,21,5,0,5,32,0,32
UTTARANCHAL,2008,ANTIQUITIES AND ART TREASURE ACT,0,0,0,3,0,3,2,0,2,2,0,2,7,0,7
UTTARANCHAL,2008,DOWRY PROHIBITION ACT,0,0,0,4,3,7,12,2,14,12,2,14,28,7,35
UTTARANCHAL,2008,FOREIGN EXCHANGE REGULATION ACT-1973,0,0,0,0,0,0,0,0,0,0,0,0,0,0,0
UTTARANCHAL,2008,PREVENTION OF CORRUPTION ACT-1988,0,0,0,0,0,0,5,0,5,9,1,10,14,1,15
UTTARANCHAL,2008,CONSER.OF FORGN.EXCH.&PREV. OF SMUG.ACT,0,0,0,0,0,0,0,0,0,0,0,0,0,0,0
UTTARANCHAL,2008,OTHER SLL OFFENCE,0,0,0,18,0,18,13,0,13,3,0,3,34,0,34
UTTARANCHAL,2008,TOTAL,0,0,0,238,6,244,264,2,266,101,3,104,603,11,614
UTTARANCHAL,2009,ARMS ACT,0,0,0,71,0,71,42,0,42,4,0,4,117,0,117
UTTARANCHAL,2009,N.D.P.S. ACT,0,0,0,67,0,67,46,1,47,7,0,7,120,1,121
UTTARANCHAL,2009,GAMBLING ACT,0,0,0,11,0,11,11,0,11,1,0,1,23,0,23
UTTARANCHAL,2009,EXCISE ACT,0,0,0,66,0,66,36,0,36,11,0,11,113,0,113
UTTARANCHAL,2009,PROHIBITION ACT,0,0,0,1,0,1,1,0,1,0,0,0,2,0,2
UTTARANCHAL,2009,EXPLOSIVE & EXPLOSIVE SUBST. ACT,0,0,0,5,0,5,4,0,4,0,0,0,9,0,9
UTTARANCHAL,2009,TERRORIST & DISRUPTIVE ACTIVITIES (TATA),0,0,0,0,0,0,0,0,0,0,0,0,0,0,0
UTTARANCHAL,2009,IMMORAL TRAFFIC (PREVENTION) ACT,0,0,0,10,0,10,5,1,6,3,0,3,18,1,19
UTTARANCHAL,2009,INDIAN RAILWAYS ACT,0,0,0,19,0,19,6,0,6,2,0,2,27,0,27
UTTARANCHAL,2009,REGISTRATION OF FOREIGNERS ACT,0,0,0,10,1,11,0,0,0,0,0,0,10,1,11
UTTARANCHAL,2009,PROTECTION OF CIVIL RIGHTS ACT,0,0,0,0,0,0,2,0,2,0,0,0,2,0,2
UTTARANCHAL,2009,SC/ST (PREVENTION OF ATROCITIES) ACT,0,0,0,31,2,33,23,0,23,3,0,3,57,2,59
UTTARANCHAL,2009,INDIAN PASSPORT ACT,0,0,0,3,0,3,7,0,7,0,0,0,10,0,10
UTTARANCHAL,2009,ESSENTIAL COMMODITIES ACT,0,0,0,7,0,7,1,0,1,0,0,0,8,0,8
UTTARANCHAL,2009,ANTIQUITIES AND ART TREASURE ACT,0,0,0,0,0,0,0,1,1,0,0,0,0,1,1
UTTARANCHAL,2009,DOWRY PROHIBITION ACT,0,0,0,1,2,3,11,7,18,0,1,1,12,10,22
UTTARANCHAL,2009,FOREIGN EXCHANGE REGULATION ACT-1973,0,0,0,0,0,0,1,0,1,0,0,0,1,0,1
UTTARANCHAL,2009,PREVENTION OF CORRUPTION ACT-1988,0,0,0,0,0,0,1,0,1,0,0,0,1,0,1
UTTARANCHAL,2009,CONSER.OF FORGN.EXCH.&PREV. OF SMUG.ACT,0,0,0,0,0,0,0,0,0,0,0,0,0,0,0
UTTARANCHAL,2009,OTHER SLL OFFENCE,0,0,0,4,0,4,13,0,13,3,0,3,20,0,20
UTTARANCHAL,2009,TOTAL,0,0,0,306,5,311,210,10,220,34,1,35,550,16,566
UTTARANCHAL,2010,ARMS ACT,0,0,0,40,0,40,48,0,48,12,0,12,100,0,100
UTTARANCHAL,2010,N.D.P.S. ACT,0,0,0,40,2,42,33,3,36,11,0,11,84,5,89
UTTARANCHAL,2010,GAMBLING ACT,0,0,0,49,0,49,41,0,41,10,0,10,100,0,100
UTTARANCHAL,2010,EXCISE ACT,0,0,0,57,2,59,32,0,32,15,0,15,104,2,106
UTTARANCHAL,2010,PROHIBITION ACT,0,0,0,2,0,2,3,0,3,1,0,1,6,0,6
UTTARANCHAL,2010,EXPLOSIVE & EXPLOSIVE SUBST. ACT,0,0,0,4,0,4,2,0,2,1,0,1,7,0,7
UTTARANCHAL,2010,TERRORIST & DISRUPTIVE ACTIVITIES (TATA),0,0,0,0,0,0,0,0,0,0,0,0,0,0,0
UTTARANCHAL,2010,IMMORAL TRAFFIC (PREVENTION) ACT,0,0,0,5,1,6,10,0,10,0,0,0,15,1,16
UTTARANCHAL,2010,INDIAN RAILWAYS ACT,0,0,0,19,0,19,27,0,27,2,0,2,48,0,48
UTTARANCHAL,2010,REGISTRATION OF FOREIGNERS ACT,0,0,0,1,0,1,0,0,0,0,0,0,1,0,1
UTTARANCHAL,2010,PROTECTION OF CIVIL RIGHTS ACT,0,0,0,0,0,0,0,0,0,0,0,0,0,0,0
UTTARANCHAL,2010,SC/ST (PREVENTION OF ATROCITIES) ACT,0,0,0,10,0,10,18,0,18,2,0,2,30,0,30
UTTARANCHAL,2010,INDIAN PASSPORT ACT,0,0,0,1,0,1,0,0,0,0,0,0,1,0,1
UTTARANCHAL,2010,ESSENTIAL COMMODITIES ACT,0,0,0,0,0,0,0,0,0,0,0,0,0,0,0
UTTARANCHAL,2010,ANTIQUITIES AND ART TREASURE ACT,0,0,0,0,0,0,0,0,0,0,0,0,0,0,0
UTTARANCHAL,2010,DOWRY PROHIBITION ACT,0,0,0,13,2,15,20,0,20,0,0,0,33,2,35
UTTARANCHAL,2010,FOREIGN EXCHANGE REGULATION ACT-1973,0,0,0,0,0,0,0,0,0,0,0,0,0,0,0
UTTARANCHAL,2010,PREVENTION OF CORRUPTION ACT-1988,0,0,0,0,0,0,2,0,2,0,0,0,2,0,2
UTTARANCHAL,2010,CONSER.OF FORGN.EXCH.&PREV. OF SMUG.ACT,0,0,0,0,0,0,0,0,0,0,0,0,0,0,0
UTTARANCHAL,2010,OTHER SLL OFFENCE,0,0,0,11,8,19,35,0,35,9,0,9,55,8,63
UTTARANCHAL,2010,TOTAL,0,0,0,252,15,267,271,3,274,63,0,63,586,18,604
UTTARANCHAL,2011,ARMS ACT,0,0,0,86,0,86,6,1,7,1,0,1,93,1,94
UTTARANCHAL,2011,N.D.P.S. ACT,0,0,0,102,2,104,5,3,8,2,0,2,109,5,114
UTTARANCHAL,2011,GAMBLING ACT,0,0,0,64,0,64,2,0,2,3,0,3,69,0,69
UTTARANCHAL,2011,EXCISE ACT,0,0,0,96,1,97,6,1,7,14,0,14,116,2,118
UTTARANCHAL,2011,PROHIBITION ACT,0,0,0,4,0,4,0,0,0,0,0,0,4,0,4
UTTARANCHAL,2011,EXPLOSIVE & EXPLOSIVE SUBST. ACT,0,0,0,5,0,5,0,0,0,0,0,0,5,0,5
UTTARANCHAL,2011,TERRORIST & DISRUPTIVE ACTIVITIES (TATA),0,0,0,0,0,0,0,0,0,0,0,0,0,0,0
UTTARANCHAL,2011,IMMORAL TRAFFIC (PREVENTION) ACT,0,0,0,6,0,6,0,0,0,0,0,0,6,0,6
UTTARANCHAL,2011,INDIAN RAILWAYS ACT,0,0,0,35,0,35,0,0,0,0,0,0,35,0,35
UTTARANCHAL,2011,REGISTRATION OF FOREIGNERS ACT,0,0,0,1,0,1,0,0,0,0,0,0,1,0,1
UTTARANCHAL,2011,PROTECTION OF CIVIL RIGHTS ACT,0,0,0,0,0,0,0,0,0,0,0,0,0,0,0
UTTARANCHAL,2011,SC/ST (PREVENTION OF ATROCITIES) ACT,0,0,0,24,0,24,0,0,0,0,0,0,24,0,24
UTTARANCHAL,2011,INDIAN PASSPORT ACT,0,0,0,2,0,2,0,0,0,0,0,0,2,0,2
UTTARANCHAL,2011,ESSENTIAL COMMODITIES ACT,0,0,0,0,0,0,0,0,0,0,0,0,0,0,0
UTTARANCHAL,2011,ANTIQUITIES AND ART TREASURE ACT,0,0,0,0,0,0,0,0,0,0,0,0,0,0,0
UTTARANCHAL,2011,DOWRY PROHIBITION ACT,0,0,0,33,3,36,3,2,5,4,0,4,40,5,45
UTTARANCHAL,2011,FOREIGN EXCHANGE REGULATION ACT-1973,0,0,0,0,0,0,0,0,0,0,0,0,0,0,0
UTTARANCHAL,2011,PREVENTION OF CORRUPTION ACT-1988,0,0,0,0,0,0,0,0,0,0,0,0,0,0,0
UTTARANCHAL,2011,CONSER.OF FORGN.EXCH.&PREV. OF SMUG.ACT,0,0,0,12,0,12,0,0,0,0,0,0,12,0,12
UTTARANCHAL,2011,OTHER SLL OFFENCE,0,0,0,0,0,0,0,0,0,0,0,0,0,0,0
UTTARANCHAL,2011,TOTAL,0,0,0,470,6,476,22,7,29,24,0,24,516,13,529
UTTARANCHAL,2012,ARMS ACT,0,0,0,32,0,32,67,1,68,7,1,8,106,2,108
UTTARANCHAL,2012,N.D.P.S. ACT,0,0,0,72,3,75,66,2,68,5,1,6,143,6,149
UTTARANCHAL,2012,GAMBLING ACT,0,0,0,65,0,65,22,0,22,6,1,7,93,1,94
UTTARANCHAL,2012,EXCISE ACT,0,0,0,43,2,45,21,1,22,14,0,14,78,3,81
UTTARANCHAL,2012,PROHIBITION ACT,0,0,0,4,0,4,0,0,0,0,0,0,4,0,4
UTTARANCHAL,2012,EXPLOSIVE & EXPLOSIVE SUBST. ACT,0,0,0,5,0,5,0,0,0,0,0,0,5,0,5
UTTARANCHAL,2012,TERRORIST & DISRUPTIVE ACTIVITIES (TATA),0,0,0,0,0,0,0,0,0,0,0,0,0,0,0
UTTARANCHAL,2012,IMMORAL TRAFFIC (PREVENTION) ACT,0,0,0,6,0,6,0,0,0,0,0,0,6,0,6
UTTARANCHAL,2012,INDIAN RAILWAYS ACT,0,0,0,33,0,33,0,0,0,0,0,0,33,0,33
UTTARANCHAL,2012,REGISTRATION OF FOREIGNERS ACT,0,0,0,0,0,0,0,0,0,0,0,0,0,0,0
UTTARANCHAL,2012,PROTECTION OF CIVIL RIGHTS ACT,0,0,0,0,0,0,0,0,0,0,0,0,0,0,0
UTTARANCHAL,2012,SC/ST (PREVENTION OF ATROCITIES) ACT,0,0,0,25,0,25,0,0,0,0,0,0,25,0,25
UTTARANCHAL,2012,INDIAN PASSPORT ACT,0,0,0,3,0,3,0,0,0,0,0,0,3,0,3
UTTARANCHAL,2012,ESSENTIAL COMMODITIES ACT,0,0,0,0,0,0,0,0,0,0,0,0,0,0,0
UTTARANCHAL,2012,ANTIQUITIES AND ART TREASURE ACT,0,0,0,0,0,0,0,0,0,0,0,0,0,0,0
UTTARANCHAL,2012,DOWRY PROHIBITION ACT,0,0,0,34,4,38,18,1,19,4,0,4,56,5,61
UTTARANCHAL,2012,FOREIGN EXCHANGE REGULATION ACT-1973,0,0,0,0,0,0,0,0,0,0,0,0,0,0,0
UTTARANCHAL,2012,PREVENTION OF CORRUPTION ACT-1988,0,0,0,0,0,0,0,0,0,0,0,0,0,0,0
UTTARANCHAL,2012,CONSER.OF FORGN.EXCH.&PREV. OF SMUG.ACT,0,0,0,0,0,0,0,0,0,0,0,0,0,0,0
UTTARANCHAL,2012,OTHER SLL OFFENCE,0,0,0,5,0,5,0,0,0,0,0,0,5,0,5
UTTARANCHAL,2012,TOTAL,0,0,0,327,9,336,194,5,199,36,3,39,557,17,574
WEST BENGAL,2001,ARMS ACT,9,0,9,351,5,356,222,1,223,55,0,55,637,6,643
WEST BENGAL,2001,N.D.P.S. ACT,8,0,8,168,6,174,120,9,129,26,0,26,322,15,337
WEST BENGAL,2001,GAMBLING ACT,7,0,7,97,0,97,59,0,59,46,0,46,209,0,209
WEST BENGAL,2001,EXCISE ACT,0,0,0,48,4,52,41,1,42,14,0,14,103,5,108
WEST BENGAL,2001,PROHIBITION ACT,0,0,0,7,5,12,2,4,6,0,0,0,9,9,18
WEST BENGAL,2001,EXPLOSIVE & EXPLOSIVE SUBST. ACT,0,0,0,104,0,104,49,0,49,13,1,14,166,1,167
WEST BENGAL,2001,TERRORIST & DISRUPTIVE ACTIVITIES (TATA),0,0,0,0,0,0,0,0,0,0,0,0,0,0,0
WEST BENGAL,2001,IMMORAL TRAFFIC (PREVENTION) ACT,0,2,2,16,16,32,9,1,10,0,0,0,25,19,44
WEST BENGAL,2001,INDIAN RAILWAYS ACT,10,1,11,104,1,105,112,2,114,21,0,21,247,4,251
WEST BENGAL,2001,REGISTRATION OF FOREIGNERS ACT,28,0,28,230,21,251,95,13,108,54,7,61,407,41,448
WEST BENGAL,2001,PROTECTION OF CIVIL RIGHTS ACT,0,0,0,0,0,0,0,0,0,0,0,0,0,0,0
WEST BENGAL,2001,SC/ST (PREVENTION OF ATROCITIES) ACT,0,0,0,0,0,0,0,0,0,0,0,0,0,0,0
WEST BENGAL,2001,INDIAN PASSPORT ACT,0,0,0,18,2,20,25,0,25,6,0,6,49,2,51
WEST BENGAL,2001,ESSENTIAL COMMODITIES ACT,0,0,0,15,0,15,16,0,16,0,0,0,31,0,31
WEST BENGAL,2001,ANTIQUITIES AND ART TREASURE ACT,0,0,0,0,0,0,0,0,0,4,0,4,4,0,4
WEST BENGAL,2001,DOWRY PROHIBITION ACT,0,0,0,19,4,23,31,18,49,13,8,21,63,30,93
WEST BENGAL,2001,FOREIGN EXCHANGE REGULATION ACT-1973,0,0,0,8,1,9,15,2,17,0,0,0,23,3,26
WEST BENGAL,2001,PREVENTION OF CORRUPTION ACT-1988,0,0,0,6,0,6,4,0,4,0,0,0,10,0,10
WEST BENGAL,2001,CONSER.OF FORGN.EXCH.&PREV. OF SMUG.ACT,0,6,6,0,0,0,15,0,15,0,0,0,15,6,21
WEST BENGAL,2001,OTHER SLL OFFENCE,0,0,0,36,0,36,7,0,7,0,0,0,43,0,43
WEST BENGAL,2001,TOTAL,62,9,71,1227,65,1292,822,51,873,252,16,268,2363,141,2504
WEST BENGAL,2002,ARMS ACT,30,1,31,510,8,518,322,3,325,46,0,46,908,12,920
WEST BENGAL,2002,N.D.P.S. ACT,17,2,19,349,8,357,253,18,271,48,3,51,667,31,698
WEST BENGAL,2002,GAMBLING ACT,4,0,4,171,0,171,151,0,151,22,0,22,348,0,348
WEST BENGAL,2002,EXCISE ACT,5,2,7,58,2,60,113,5,118,32,0,32,208,9,217
WEST BENGAL,2002,PROHIBITION ACT,0,0,0,41,0,41,2,0,2,3,0,3,46,0,46
WEST BENGAL,2002,EXPLOSIVE & EXPLOSIVE SUBST. ACT,10,0,10,120,0,120,60,0,60,23,0,23,213,0,213
WEST BENGAL,2002,TERRORIST & DISRUPTIVE ACTIVITIES (TATA),0,0,0,0,0,0,0,0,0,0,0,0,0,0,0
WEST BENGAL,2002,IMMORAL TRAFFIC (PREVENTION) ACT,0,4,4,9,0,9,11,3,14,16,0,16,36,7,43
WEST BENGAL,2002,INDIAN RAILWAYS ACT,40,0,40,308,1,309,173,3,176,91,0,91,612,4,616
WEST BENGAL,2002,REGISTRATION OF FOREIGNERS ACT,30,8,38,442,56,498,285,62,347,77,9,86,834,135,969
WEST BENGAL,2002,PROTECTION OF CIVIL RIGHTS ACT,0,0,0,0,0,0,0,0,0,0,0,0,0,0,0
WEST BENGAL,2002,SC/ST (PREVENTION OF ATROCITIES) ACT,0,0,0,0,0,0,0,0,0,0,0,0,0,0,0
WEST BENGAL,2002,INDIAN PASSPORT ACT,0,0,0,11,0,11,1,0,1,0,0,0,12,0,12
WEST BENGAL,2002,ESSENTIAL COMMODITIES ACT,0,0,0,19,1,20,11,0,11,3,0,3,33,1,34
WEST BENGAL,2002,ANTIQUITIES AND ART TREASURE ACT,0,0,0,0,0,0,0,0,0,0,0,0,0,0,0
WEST BENGAL,2002,DOWRY PROHIBITION ACT,2,0,2,45,1,46,34,11,45,13,3,16,94,15,109
WEST BENGAL,2002,FOREIGN EXCHANGE REGULATION ACT-1973,0,0,0,10,4,14,29,3,32,0,0,0,39,7,46
WEST BENGAL,2002,PREVENTION OF CORRUPTION ACT-1988,0,0,0,0,0,0,0,0,0,3,0,3,3,0,3
WEST BENGAL,2002,CONSER.OF FORGN.EXCH.&PREV. OF SMUG.ACT,0,0,0,0,0,0,1,0,1,0,0,0,1,0,1
WEST BENGAL,2002,OTHER SLL OFFENCE,0,0,0,69,2,71,91,6,97,33,3,36,193,11,204
WEST BENGAL,2002,TOTAL,138,17,155,2162,83,2245,1537,114,1651,410,18,428,4247,232,4479
WEST BENGAL,2003,ARMS ACT,0,0,0,339,8,347,296,5,301,54,0,54,689,13,702
WEST BENGAL,2003,N.D.P.S. ACT,0,0,0,290,8,298,251,27,278,42,1,43,583,36,619
WEST BENGAL,2003,GAMBLING ACT,0,0,0,39,0,39,141,0,141,18,0,18,198,0,198
WEST BENGAL,2003,EXCISE ACT,0,0,0,32,2,34,58,1,59,20,0,20,110,3,113
WEST BENGAL,2003,PROHIBITION ACT,0,0,0,21,0,21,32,0,32,2,0,2,55,0,55
WEST BENGAL,2003,EXPLOSIVE & EXPLOSIVE SUBST. ACT,0,0,0,17,0,17,56,1,57,8,0,8,81,1,82
WEST BENGAL,2003,TERRORIST & DISRUPTIVE ACTIVITIES (TATA),0,0,0,4,0,4,3,0,3,1,0,1,8,0,8
WEST BENGAL,2003,IMMORAL TRAFFIC (PREVENTION) ACT,0,0,0,7,4,11,13,2,15,0,0,0,20,6,26
WEST BENGAL,2003,INDIAN RAILWAYS ACT,0,0,0,138,8,146,138,0,138,28,0,28,304,8,312
WEST BENGAL,2003,REGISTRATION OF FOREIGNERS ACT,0,0,0,118,29,147,102,34,136,17,6,23,237,69,306
WEST BENGAL,2003,PROTECTION OF CIVIL RIGHTS ACT,0,0,0,0,0,0,0,0,0,0,0,0,0,0,0
WEST BENGAL,2003,SC/ST (PREVENTION OF ATROCITIES) ACT,0,0,0,0,0,0,0,0,0,0,0,0,0,0,0
WEST BENGAL,2003,INDIAN PASSPORT ACT,0,0,0,55,3,58,46,0,46,8,0,8,109,3,112
WEST BENGAL,2003,ESSENTIAL COMMODITIES ACT,0,0,0,1,0,1,11,0,11,12,0,12,24,0,24
WEST BENGAL,2003,ANTIQUITIES AND ART TREASURE ACT,0,0,0,0,0,0,0,0,0,0,0,0,0,0,0
WEST BENGAL,2003,DOWRY PROHIBITION ACT,0,0,0,48,13,61,34,26,60,29,11,40,111,50,161
WEST BENGAL,2003,FOREIGN EXCHANGE REGULATION ACT-1973,0,0,0,5,2,7,2,0,2,4,0,4,11,2,13
WEST BENGAL,2003,PREVENTION OF CORRUPTION ACT-1988,0,0,0,0,0,0,0,0,0,0,0,0,0,0,0
WEST BENGAL,2003,CONSER.OF FORGN.EXCH.&PREV. OF SMUG.ACT,0,0,0,0,0,0,0,0,0,0,0,0,0,0,0
WEST BENGAL,2003,OTHER SLL OFFENCE,0,0,0,10,0,10,106,0,106,66,0,66,182,0,182
WEST BENGAL,2003,TOTAL,0,0,0,1124,77,1201,1289,96,1385,309,18,327,2722,191,2913
WEST BENGAL,2004,ARMS ACT,0,0,0,342,0,342,229,0,229,35,0,35,606,0,606
WEST BENGAL,2004,N.D.P.S. ACT,0,0,0,258,10,268,244,19,263,59,2,61,561,31,592
WEST BENGAL,2004,GAMBLING ACT,0,0,0,103,0,103,73,0,73,13,0,13,189,0,189
WEST BENGAL,2004,EXCISE ACT,0,0,0,60,3,63,43,2,45,24,0,24,127,5,132
WEST BENGAL,2004,PROHIBITION ACT,0,0,0,13,0,13,25,0,25,0,0,0,38,0,38
WEST BENGAL,2004,EXPLOSIVE & EXPLOSIVE SUBST. ACT,0,0,0,48,0,48,50,0,50,5,0,5,103,0,103
WEST BENGAL,2004,TERRORIST & DISRUPTIVE ACTIVITIES (TATA),0,0,0,2,1,3,0,0,0,0,0,0,2,1,3
WEST BENGAL,2004,IMMORAL TRAFFIC (PREVENTION) ACT,0,0,0,27,6,33,25,7,32,0,1,1,52,14,66
WEST BENGAL,2004,INDIAN RAILWAYS ACT,0,0,0,112,4,116,53,3,56,7,0,7,172,7,179
WEST BENGAL,2004,REGISTRATION OF FOREIGNERS ACT,0,0,0,99,50,149,70,34,104,14,2,16,183,86,269
WEST BENGAL,2004,PROTECTION OF CIVIL RIGHTS ACT,0,0,0,0,0,0,0,0,0,0,0,0,0,0,0
WEST BENGAL,2004,SC/ST (PREVENTION OF ATROCITIES) ACT,0,0,0,0,0,0,0,0,0,0,0,0,0,0,0
WEST BENGAL,2004,INDIAN PASSPORT ACT,0,0,0,13,1,14,14,0,14,2,0,2,29,1,30
WEST BENGAL,2004,ESSENTIAL COMMODITIES ACT,0,0,0,23,0,23,25,0,25,5,0,5,53,0,53
WEST BENGAL,2004,ANTIQUITIES AND ART TREASURE ACT,0,0,0,0,0,0,6,0,6,0,0,0,6,0,6
WEST BENGAL,2004,DOWRY PROHIBITION ACT,0,0,0,14,5,19,9,5,14,4,0,4,27,10,37
WEST BENGAL,2004,FOREIGN EXCHANGE REGULATION ACT-1973,0,0,0,65,21,86,29,12,41,0,6,6,94,39,133
WEST BENGAL,2004,PREVENTION OF CORRUPTION ACT-1988,0,0,0,0,0,0,0,0,0,0,0,0,0,0,0
WEST BENGAL,2004,CONSER.OF FORGN.EXCH.&PREV. OF SMUG.ACT,0,0,0,0,0,0,0,0,0,0,0,0,0,0,0
WEST BENGAL,2004,OTHER SLL OFFENCE,0,0,0,26,0,26,72,0,72,31,0,31,129,0,129
WEST BENGAL,2004,TOTAL,0,0,0,1205,101,1306,967,82,1049,199,11,210,2371,194,2565
WEST BENGAL,2005,ARMS ACT,0,0,0,215,0,215,297,5,302,56,3,59,568,8,576
WEST BENGAL,2005,N.D.P.S. ACT,0,0,0,118,17,135,241,24,265,42,2,44,401,43,444
WEST BENGAL,2005,GAMBLING ACT,0,0,0,51,0,51,95,0,95,13,0,13,159,0,159
WEST BENGAL,2005,EXCISE ACT,0,0,0,0,0,0,49,2,51,5,0,5,54,2,56
WEST BENGAL,2005,PROHIBITION ACT,0,0,0,0,0,0,27,0,27,0,0,0,27,0,27
WEST BENGAL,2005,EXPLOSIVE & EXPLOSIVE SUBST. ACT,0,0,0,12,0,12,50,0,50,6,0,6,68,0,68
WEST BENGAL,2005,TERRORIST & DISRUPTIVE ACTIVITIES (TATA),0,0,0,10,4,14,6,0,6,1,0,1,17,4,21
WEST BENGAL,2005,IMMORAL TRAFFIC (PREVENTION) ACT,0,0,0,4,2,6,29,7,36,5,1,6,38,10,48
WEST BENGAL,2005,INDIAN RAILWAYS ACT,127,9,136,112,62,174,76,21,97,18,4,22,333,96,429
WEST BENGAL,2005,REGISTRATION OF FOREIGNERS ACT,8,1,9,434,148,582,395,98,493,67,25,92,904,272,1176
WEST BENGAL,2005,PROTECTION OF CIVIL RIGHTS ACT,0,0,0,0,0,0,0,0,0,0,0,0,0,0,0
WEST BENGAL,2005,SC/ST (PREVENTION OF ATROCITIES) ACT,0,0,0,0,0,0,0,0,0,0,0,0,0,0,0
WEST BENGAL,2005,INDIAN PASSPORT ACT,0,0,0,5,1,6,15,0,15,11,0,11,31,1,32
WEST BENGAL,2005,ESSENTIAL COMMODITIES ACT,0,0,0,0,0,0,27,0,27,5,0,5,32,0,32
WEST BENGAL,2005,ANTIQUITIES AND ART TREASURE ACT,0,0,0,0,0,0,0,0,0,0,0,0,0,0,0
WEST BENGAL,2005,DOWRY PROHIBITION ACT,0,0,0,0,5,5,18,3,21,0,0,0,18,8,26
WEST BENGAL,2005,FOREIGN EXCHANGE REGULATION ACT-1973,0,0,0,41,12,53,37,12,49,0,2,2,78,26,104
WEST BENGAL,2005,PREVENTION OF CORRUPTION ACT-1988,0,0,0,0,0,0,0,0,0,0,0,0,0,0,0
WEST BENGAL,2005,CONSER.OF FORGN.EXCH.&PREV. OF SMUG.ACT,0,0,0,0,0,0,0,0,0,0,0,0,0,0,0
WEST BENGAL,2005,OTHER SLL OFFENCE,0,0,0,19,0,19,87,1,88,55,2,57,161,3,164
WEST BENGAL,2005,TOTAL,135,10,145,1021,251,1272,1449,173,1622,284,39,323,2889,473,3362
WEST BENGAL,2006,ARMS ACT,0,0,0,349,0,349,290,0,290,66,0,66,705,0,705
WEST BENGAL,2006,N.D.P.S. ACT,5,0,5,189,25,214,186,25,211,38,3,41,418,53,471
WEST BENGAL,2006,GAMBLING ACT,0,0,0,93,0,93,74,0,74,22,0,22,189,0,189
WEST BENGAL,2006,EXCISE ACT,0,0,0,13,0,13,52,0,52,6,0,6,71,0,71
WEST BENGAL,2006,PROHIBITION ACT,0,0,0,0,0,0,0,0,0,0,0,0,0,0,0
WEST BENGAL,2006,EXPLOSIVE & EXPLOSIVE SUBST. ACT,0,0,0,38,0,38,54,0,54,5,0,5,97,0,97
WEST BENGAL,2006,TERRORIST & DISRUPTIVE ACTIVITIES (TATA),0,0,0,3,0,3,0,0,0,0,0,0,3,0,3
WEST BENGAL,2006,IMMORAL TRAFFIC (PREVENTION) ACT,0,0,0,20,28,48,9,10,19,5,0,5,34,38,72
WEST BENGAL,2006,INDIAN RAILWAYS ACT,1,0,1,135,2,137,64,0,64,28,2,30,228,4,232
WEST BENGAL,2006,REGISTRATION OF FOREIGNERS ACT,4,0,4,350,23,373,363,19,382,46,5,51,763,47,810
WEST BENGAL,2006,PROTECTION OF CIVIL RIGHTS ACT,0,0,0,0,0,0,0,0,0,0,0,0,0,0,0
WEST BENGAL,2006,SC/ST (PREVENTION OF ATROCITIES) ACT,0,0,0,0,0,0,0,0,0,0,0,0,0,0,0
WEST BENGAL,2006,INDIAN PASSPORT ACT,3,1,4,50,47,97,41,34,75,13,17,30,107,99,206
WEST BENGAL,2006,ESSENTIAL COMMODITIES ACT,0,0,0,0,0,0,11,0,11,5,0,5,16,0,16
WEST BENGAL,2006,ANTIQUITIES AND ART TREASURE ACT,0,0,0,0,0,0,0,0,0,0,0,0,0,0,0
WEST BENGAL,2006,DOWRY PROHIBITION ACT,2,3,5,22,4,26,36,1,37,16,3,19,76,11,87
WEST BENGAL,2006,FOREIGN EXCHANGE REGULATION ACT-1973,0,0,0,11,0,11,0,0,0,0,0,0,11,0,11
WEST BENGAL,2006,PREVENTION OF CORRUPTION ACT-1988,0,0,0,9,0,9,7,0,7,4,0,4,20,0,20
WEST BENGAL,2006,CONSER.OF FORGN.EXCH.&PREV. OF SMUG.ACT,0,0,0,0,0,0,0,0,0,7,0,7,7,0,7
WEST BENGAL,2006,OTHER SLL OFFENCE,0,0,0,38,5,43,78,4,82,38,0,38,154,9,163
WEST BENGAL,2006,TOTAL,15,4,19,1320,134,1454,1265,93,1358,299,30,329,2899,261,3160
WEST BENGAL,2007,ARMS ACT,3,0,3,255,1,256,228,1,229,34,0,34,520,2,522
WEST BENGAL,2007,N.D.P.S. ACT,0,0,0,253,28,281,293,23,316,22,2,24,568,53,621
WEST BENGAL,2007,GAMBLING ACT,0,0,0,41,0,41,47,0,47,14,0,14,102,0,102
WEST BENGAL,2007,EXCISE ACT,0,0,0,15,0,15,27,0,27,2,0,2,44,0,44
WEST BENGAL,2007,PROHIBITION ACT,0,0,0,0,0,0,0,0,0,0,0,0,0,0,0
WEST BENGAL,2007,EXPLOSIVE & EXPLOSIVE SUBST. ACT,0,0,0,14,0,14,25,0,25,5,0,5,44,0,44
WEST BENGAL,2007,TERRORIST & DISRUPTIVE ACTIVITIES (TATA),0,0,0,0,0,0,6,0,6,0,0,0,6,0,6
WEST BENGAL,2007,IMMORAL TRAFFIC (PREVENTION) ACT,0,0,0,12,11,23,13,1,14,3,0,3,28,12,40
WEST BENGAL,2007,INDIAN RAILWAYS ACT,1,0,1,84,3,87,47,0,47,12,0,12,144,3,147
WEST BENGAL,2007,REGISTRATION OF FOREIGNERS ACT,0,1,1,404,43,447,471,36,507,57,10,67,932,90,1022
WEST BENGAL,2007,PROTECTION OF CIVIL RIGHTS ACT,0,0,0,0,0,0,0,0,0,0,0,0,0,0,0
WEST BENGAL,2007,SC/ST (PREVENTION OF ATROCITIES) ACT,0,0,0,0,0,0,0,0,0,0,0,0,0,0,0
WEST BENGAL,2007,INDIAN PASSPORT ACT,9,28,37,48,92,140,36,60,96,9,14,23,102,194,296
WEST BENGAL,2007,ESSENTIAL COMMODITIES ACT,0,0,0,13,0,13,11,0,11,1,0,1,25,0,25
WEST BENGAL,2007,ANTIQUITIES AND ART TREASURE ACT,0,0,0,0,0,0,0,0,0,0,0,0,0,0,0
WEST BENGAL,2007,DOWRY PROHIBITION ACT,0,0,0,8,0,8,50,6,56,18,4,22,76,10,86
WEST BENGAL,2007,FOREIGN EXCHANGE REGULATION ACT-1973,28,0,28,68,21,89,93,12,105,20,2,22,209,35,244
WEST BENGAL,2007,PREVENTION OF CORRUPTION ACT-1988,0,0,0,0,0,0,0,0,0,0,0,0,0,0,0
WEST BENGAL,2007,CONSER.OF FORGN.EXCH.&PREV. OF SMUG.ACT,0,0,0,0,0,0,0,0,0,0,0,0,0,0,0
WEST BENGAL,2007,OTHER SLL OFFENCE,1,0,1,54,3,57,63,2,65,17,0,17,135,5,140
WEST BENGAL,2007,TOTAL,42,29,71,1269,202,1471,1410,141,1551,214,32,246,2935,404,3339
WEST BENGAL,2008,ARMS ACT,0,0,0,237,0,237,259,1,260,36,0,36,532,1,533
WEST BENGAL,2008,N.D.P.S. ACT,0,0,0,208,26,234,320,19,339,58,6,64,586,51,637
WEST BENGAL,2008,GAMBLING ACT,0,0,0,24,0,24,40,0,40,5,0,5,69,0,69
WEST BENGAL,2008,EXCISE ACT,0,0,0,12,2,14,20,0,20,9,0,9,41,2,43
WEST BENGAL,2008,PROHIBITION ACT,0,0,0,0,0,0,0,0,0,0,0,0,0,0,0
WEST BENGAL,2008,EXPLOSIVE & EXPLOSIVE SUBST. ACT,0,0,0,18,0,18,14,0,14,4,0,4,36,0,36
WEST BENGAL,2008,TERRORIST & DISRUPTIVE ACTIVITIES (TATA),0,0,0,3,0,3,0,0,0,0,0,0,3,0,3
WEST BENGAL,2008,IMMORAL TRAFFIC (PREVENTION) ACT,0,0,0,14,10,24,11,7,18,2,0,2,27,17,44
WEST BENGAL,2008,INDIAN RAILWAYS ACT,0,0,0,103,5,108,58,3,61,10,0,10,171,8,179
WEST BENGAL,2008,REGISTRATION OF FOREIGNERS ACT,0,0,0,472,148,620,375,81,456,98,23,121,945,252,1197
WEST BENGAL,2008,PROTECTION OF CIVIL RIGHTS ACT,0,0,0,0,0,0,0,0,0,0,0,0,0,0,0
WEST BENGAL,2008,SC/ST (PREVENTION OF ATROCITIES) ACT,0,0,0,0,0,0,0,0,0,0,0,0,0,0,0
WEST BENGAL,2008,INDIAN PASSPORT ACT,0,0,0,20,6,26,25,13,38,5,3,8,50,22,72
WEST BENGAL,2008,ESSENTIAL COMMODITIES ACT,0,0,0,0,0,0,5,0,5,3,0,3,8,0,8
WEST BENGAL,2008,ANTIQUITIES AND ART TREASURE ACT,0,0,0,0,0,0,0,0,0,0,0,0,0,0,0
WEST BENGAL,2008,DOWRY PROHIBITION ACT,0,0,0,36,10,46,54,18,72,25,6,31,115,34,149
WEST BENGAL,2008,FOREIGN EXCHANGE REGULATION ACT-1973,0,0,0,2,0,2,0,0,0,0,0,0,2,0,2
WEST BENGAL,2008,PREVENTION OF CORRUPTION ACT-1988,0,0,0,0,0,0,0,0,0,0,0,0,0,0,0
WEST BENGAL,2008,CONSER.OF FORGN.EXCH.&PREV. OF SMUG.ACT,0,0,0,0,0,0,0,0,0,0,0,0,0,0,0
WEST BENGAL,2008,OTHER SLL OFFENCE,0,0,0,70,4,74,64,6,70,15,0,15,149,10,159
WEST BENGAL,2008,TOTAL,0,0,0,1219,211,1430,1245,148,1393,270,38,308,2734,397,3131
WEST BENGAL,2009,ARMS ACT,0,0,0,170,0,170,210,0,210,43,0,43,423,0,423
WEST BENGAL,2009,N.D.P.S. ACT,0,0,0,215,12,227,208,20,228,70,2,72,493,34,527
WEST BENGAL,2009,GAMBLING ACT,0,0,0,31,0,31,30,0,30,13,0,13,74,0,74
WEST BENGAL,2009,EXCISE ACT,0,0,0,26,0,26,28,2,30,14,0,14,68,2,70
WEST BENGAL,2009,PROHIBITION ACT,0,0,0,0,0,0,0,0,0,0,0,0,0,0,0
WEST BENGAL,2009,EXPLOSIVE & EXPLOSIVE SUBST. ACT,0,0,0,33,0,33,19,0,19,8,0,8,60,0,60
WEST BENGAL,2009,TERRORIST & DISRUPTIVE ACTIVITIES (TATA),0,0,0,0,0,0,0,0,0,0,0,0,0,0,0
WEST BENGAL,2009,IMMORAL TRAFFIC (PREVENTION) ACT,0,0,0,22,12,34,16,6,22,5,0,5,43,18,61
WEST BENGAL,2009,INDIAN RAILWAYS ACT,0,0,0,52,1,53,52,0,52,7,0,7,111,1,112
WEST BENGAL,2009,REGISTRATION OF FOREIGNERS ACT,3,0,3,441,53,494,281,39,320,94,18,112,819,110,929
WEST BENGAL,2009,PROTECTION OF CIVIL RIGHTS ACT,0,0,0,0,0,0,0,0,0,0,0,0,0,0,0
WEST BENGAL,2009,SC/ST (PREVENTION OF ATROCITIES) ACT,0,0,0,0,0,0,1,0,1,0,0,0,1,0,1
WEST BENGAL,2009,INDIAN PASSPORT ACT,0,0,0,0,1,1,0,0,0,0,0,0,0,1,1
WEST BENGAL,2009,ESSENTIAL COMMODITIES ACT,0,0,0,1,0,1,5,0,5,2,0,2,8,0,8
WEST BENGAL,2009,ANTIQUITIES AND ART TREASURE ACT,0,0,0,0,0,0,0,0,0,0,0,0,0,0,0
WEST BENGAL,2009,DOWRY PROHIBITION ACT,0,0,0,9,4,13,23,11,34,7,0,7,39,15,54
WEST BENGAL,2009,FOREIGN EXCHANGE REGULATION ACT-1973,0,0,0,0,0,0,0,0,0,0,0,0,0,0,0
WEST BENGAL,2009,PREVENTION OF CORRUPTION ACT-1988,0,0,0,0,0,0,0,0,0,0,0,0,0,0,0
WEST BENGAL,2009,CONSER.OF FORGN.EXCH.&PREV. OF SMUG.ACT,0,0,0,0,0,0,0,0,0,0,0,0,0,0,0
WEST BENGAL,2009,OTHER SLL OFFENCE,0,0,0,58,4,62,38,2,40,7,0,7,103,6,109
WEST BENGAL,2009,TOTAL,3,0,3,1058,87,1145,911,80,991,270,20,290,2242,187,2429
WEST BENGAL,2010,ARMS ACT,0,0,0,311,0,311,293,0,293,52,0,52,656,0,656
WEST BENGAL,2010,N.D.P.S. ACT,0,0,0,309,8,317,251,13,264,47,4,51,607,25,632
WEST BENGAL,2010,GAMBLING ACT,0,0,0,43,0,43,67,0,67,4,0,4,114,0,114
WEST BENGAL,2010,EXCISE ACT,0,0,0,29,1,30,46,0,46,12,0,12,87,1,88
WEST BENGAL,2010,PROHIBITION ACT,0,0,0,0,0,0,0,0,0,0,0,0,0,0,0
WEST BENGAL,2010,EXPLOSIVE & EXPLOSIVE SUBST. ACT,0,0,0,35,0,35,60,0,60,2,0,2,97,0,97
WEST BENGAL,2010,TERRORIST & DISRUPTIVE ACTIVITIES (TATA),0,0,0,13,0,13,4,0,4,5,0,5,22,0,22
WEST BENGAL,2010,IMMORAL TRAFFIC (PREVENTION) ACT,0,0,0,23,4,27,25,8,33,9,3,12,57,15,72
WEST BENGAL,2010,INDIAN RAILWAYS ACT,0,0,0,69,0,69,73,0,73,10,0,10,152,0,152
WEST BENGAL,2010,REGISTRATION OF FOREIGNERS ACT,0,0,0,246,62,308,193,19,212,65,8,73,504,89,593
WEST BENGAL,2010,PROTECTION OF CIVIL RIGHTS ACT,0,0,0,0,0,0,0,0,0,0,0,0,0,0,0
WEST BENGAL,2010,SC/ST (PREVENTION OF ATROCITIES) ACT,0,0,0,0,0,0,0,0,0,0,0,0,0,0,0
WEST BENGAL,2010,INDIAN PASSPORT ACT,0,0,0,59,4,63,50,3,53,2,1,3,111,8,119
WEST BENGAL,2010,ESSENTIAL COMMODITIES ACT,0,0,0,9,0,9,9,0,9,1,0,1,19,0,19
WEST BENGAL,2010,ANTIQUITIES AND ART TREASURE ACT,0,0,0,0,0,0,0,0,0,0,0,0,0,0,0
WEST BENGAL,2010,DOWRY PROHIBITION ACT,0,0,0,30,1,31,35,6,41,29,6,35,94,13,107
WEST BENGAL,2010,FOREIGN EXCHANGE REGULATION ACT-1973,0,0,0,9,1,10,12,2,14,2,0,2,23,3,26
WEST BENGAL,2010,PREVENTION OF CORRUPTION ACT-1988,0,0,0,1,0,1,3,0,3,3,0,3,7,0,7
WEST BENGAL,2010,CONSER.OF FORGN.EXCH.&PREV. OF SMUG.ACT,0,0,0,0,0,0,1,0,1,0,0,0,1,0,1
WEST BENGAL,2010,OTHER SLL OFFENCE,0,0,0,61,10,71,44,4,48,7,0,7,112,14,126
WEST BENGAL,2010,TOTAL,0,0,0,1247,91,1338,1166,55,1221,250,22,272,2663,168,2831
WEST BENGAL,2011,ARMS ACT,0,0,0,340,1,341,240,2,242,56,1,57,636,4,640
WEST BENGAL,2011,N.D.P.S. ACT,0,0,0,309,4,313,250,12,262,54,6,60,613,22,635
WEST BENGAL,2011,GAMBLING ACT,0,0,0,57,0,57,55,1,56,12,1,13,124,2,126
WEST BENGAL,2011,EXCISE ACT,0,0,0,40,0,40,73,0,73,7,0,7,120,0,120
WEST BENGAL,2011,PROHIBITION ACT,0,0,0,10,0,10,3,0,3,2,0,2,15,0,15
WEST BENGAL,2011,EXPLOSIVE & EXPLOSIVE SUBST. ACT,0,0,0,35,0,35,60,0,60,2,0,2,97,0,97
WEST BENGAL,2011,TERRORIST & DISRUPTIVE ACTIVITIES (TATA),0,0,0,0,0,0,0,0,0,0,0,0,0,0,0
WEST BENGAL,2011,IMMORAL TRAFFIC (PREVENTION) ACT,0,0,0,49,7,56,47,6,53,16,3,19,112,16,128
WEST BENGAL,2011,INDIAN RAILWAYS ACT,0,0,0,74,0,74,73,0,73,19,0,19,166,0,166
WEST BENGAL,2011,REGISTRATION OF FOREIGNERS ACT,0,0,0,460,38,498,248,34,282,78,8,86,786,80,866
WEST BENGAL,2011,PROTECTION OF CIVIL RIGHTS ACT,0,0,0,0,0,0,0,0,0,0,0,0,0,0,0
WEST BENGAL,2011,SC/ST (PREVENTION OF ATROCITIES) ACT,0,0,0,0,0,0,0,0,0,0,0,0,0,0,0
WEST BENGAL,2011,INDIAN PASSPORT ACT,0,0,0,60,2,62,50,0,50,7,0,7,117,2,119
WEST BENGAL,2011,ESSENTIAL COMMODITIES ACT,0,0,0,10,0,10,9,0,9,2,0,2,21,0,21
WEST BENGAL,2011,ANTIQUITIES AND ART TREASURE ACT,0,0,0,0,0,0,0,0,0,0,0,0,0,0,0
WEST BENGAL,2011,DOWRY PROHIBITION ACT,0,0,0,54,10,64,48,10,58,37,4,41,139,24,163
WEST BENGAL,2011,FOREIGN EXCHANGE REGULATION ACT-1973,0,0,0,9,0,9,12,0,12,2,0,2,23,0,23
WEST BENGAL,2011,PREVENTION OF CORRUPTION ACT-1988,0,0,0,1,0,1,3,0,3,3,0,3,7,0,7
WEST BENGAL,2011,CONSER.OF FORGN.EXCH.&PREV. OF SMUG.ACT,0,0,0,2,1,3,2,1,3,1,0,1,5,2,7
WEST BENGAL,2011,OTHER SLL OFFENCE,0,0,0,61,10,71,16,4,20,6,0,6,83,14,97
WEST BENGAL,2011,TOTAL,0,0,0,1571,73,1644,1189,70,1259,304,23,327,3064,166,3230
WEST BENGAL,2012,ARMS ACT,0,0,0,169,2,171,156,3,159,39,3,42,364,8,372
WEST BENGAL,2012,N.D.P.S. ACT,0,0,0,456,21,477,402,17,419,131,13,144,989,51,1040
WEST BENGAL,2012,GAMBLING ACT,0,0,0,43,0,43,38,1,39,13,0,13,94,1,95
WEST BENGAL,2012,EXCISE ACT,0,0,0,35,1,36,37,0,37,11,0,11,83,1,84
WEST BENGAL,2012,PROHIBITION ACT,0,0,0,7,0,7,1,0,1,1,0,1,9,0,9
WEST BENGAL,2012,EXPLOSIVE & EXPLOSIVE SUBST. ACT,0,0,0,15,0,15,13,0,13,1,0,1,29,0,29
WEST BENGAL,2012,TERRORIST & DISRUPTIVE ACTIVITIES (TATA),0,0,0,1,1,2,11,1,12,3,0,3,15,2,17
WEST BENGAL,2012,IMMORAL TRAFFIC (PREVENTION) ACT,0,0,0,5,1,6,4,5,9,1,2,3,10,8,18
WEST BENGAL,2012,INDIAN RAILWAYS ACT,0,0,0,68,0,68,50,0,50,20,0,20,138,0,138
WEST BENGAL,2012,REGISTRATION OF FOREIGNERS ACT,0,0,0,660,107,767,336,57,393,95,19,114,1091,183,1274
WEST BENGAL,2012,PROTECTION OF CIVIL RIGHTS ACT,0,0,0,0,0,0,0,0,0,0,0,0,0,0,0
WEST BENGAL,2012,SC/ST (PREVENTION OF ATROCITIES) ACT,0,0,0,4,0,4,2,0,2,1,0,1,7,0,7
WEST BENGAL,2012,INDIAN PASSPORT ACT,0,0,0,20,0,20,36,0,36,7,0,7,63,0,63
WEST BENGAL,2012,ESSENTIAL COMMODITIES ACT,0,0,0,6,0,6,4,0,4,1,0,1,11,0,11
WEST BENGAL,2012,ANTIQUITIES AND ART TREASURE ACT,0,0,0,2,0,2,1,0,1,0,0,0,3,0,3
WEST BENGAL,2012,DOWRY PROHIBITION ACT,0,0,0,45,1,46,67,0,67,22,2,24,134,3,137
WEST BENGAL,2012,FOREIGN EXCHANGE REGULATION ACT-1973,0,0,0,1,2,3,0,0,0,0,0,0,1,2,3
WEST BENGAL,2012,PREVENTION OF CORRUPTION ACT-1988,0,0,0,0,0,0,1,0,1,1,0,1,2,0,2
WEST BENGAL,2012,CONSER.OF FORGN.EXCH.&PREV. OF SMUG.ACT,0,0,0,0,0,0,0,0,0,0,0,0,0,0,0
WEST BENGAL,2012,OTHER SLL OFFENCE,0,0,0,39,4,43,22,3,25,4,0,4,65,7,72
WEST BENGAL,2012,TOTAL,0,0,0,1576,140,1716,1181,87,1268,351,39,390,3108,266,3374
A & N ISLANDS,2001,ARMS ACT,0,0,0,0,0,0,0,0,0,0,0,0,0,0,0
A & N ISLANDS,2001,N.D.P.S. ACT,0,0,0,0,0,0,0,0,0,0,0,0,0,0,0
A & N ISLANDS,2001,GAMBLING ACT,0,0,0,0,0,0,0,0,0,0,0,0,0,0,0
A & N ISLANDS,2001,EXCISE ACT,0,0,0,0,0,0,0,0,0,0,0,0,0,0,0
A & N ISLANDS,2001,PROHIBITION ACT,0,0,0,0,0,0,0,0,0,0,0,0,0,0,0
A & N ISLANDS,2001,EXPLOSIVE & EXPLOSIVE SUBST. ACT,0,0,0,0,0,0,0,0,0,0,0,0,0,0,0
A & N ISLANDS,2001,TERRORIST & DISRUPTIVE ACTIVITIES (TATA),0,0,0,0,0,0,0,0,0,0,0,0,0,0,0
A & N ISLANDS,2001,IMMORAL TRAFFIC (PREVENTION) ACT,0,0,0,0,0,0,0,0,0,0,0,0,0,0,0
A & N ISLANDS,2001,INDIAN RAILWAYS ACT,0,0,0,0,0,0,0,0,0,0,0,0,0,0,0
A & N ISLANDS,2001,REGISTRATION OF FOREIGNERS ACT,0,0,0,61,0,61,47,0,47,5,0,5,113,0,113
A & N ISLANDS,2001,PROTECTION OF CIVIL RIGHTS ACT,0,0,0,0,0,0,0,0,0,0,0,0,0,0,0
A & N ISLANDS,2001,SC/ST (PREVENTION OF ATROCITIES) ACT,0,0,0,0,0,0,0,0,0,0,0,0,0,0,0
A & N ISLANDS,2001,INDIAN PASSPORT ACT,0,0,0,0,0,0,0,0,0,0,0,0,0,0,0
A & N ISLANDS,2001,ESSENTIAL COMMODITIES ACT,0,0,0,0,0,0,0,0,0,0,0,0,0,0,0
A & N ISLANDS,2001,ANTIQUITIES AND ART TREASURE ACT,0,0,0,0,0,0,0,0,0,0,0,0,0,0,0
A & N ISLANDS,2001,DOWRY PROHIBITION ACT,0,0,0,0,0,0,0,0,0,0,0,0,0,0,0
A & N ISLANDS,2001,FOREIGN EXCHANGE REGULATION ACT-1973,0,0,0,0,0,0,0,0,0,0,0,0,0,0,0
A & N ISLANDS,2001,PREVENTION OF CORRUPTION ACT-1988,0,0,0,0,0,0,0,0,0,0,0,0,0,0,0
A & N ISLANDS,2001,CONSER.OF FORGN.EXCH.&PREV. OF SMUG.ACT,0,0,0,0,0,0,0,0,0,0,0,0,0,0,0
A & N ISLANDS,2001,OTHER SLL OFFENCE,0,0,0,0,0,0,0,0,0,0,0,0,0,0,0
A & N ISLANDS,2001,TOTAL,0,0,0,61,0,61,47,0,47,5,0,5,113,0,113
A & N ISLANDS,2002,ARMS ACT,0,0,0,0,0,0,0,0,0,0,0,0,0,0,0
A & N ISLANDS,2002,N.D.P.S. ACT,0,0,0,0,0,0,0,0,0,0,0,0,0,0,0
A & N ISLANDS,2002,GAMBLING ACT,0,0,0,0,0,0,0,0,0,0,0,0,0,0,0
A & N ISLANDS,2002,EXCISE ACT,0,0,0,0,0,0,0,0,0,0,0,0,0,0,0
A & N ISLANDS,2002,PROHIBITION ACT,0,0,0,0,0,0,0,0,0,0,0,0,0,0,0
A & N ISLANDS,2002,EXPLOSIVE & EXPLOSIVE SUBST. ACT,0,0,0,0,0,0,0,0,0,0,0,0,0,0,0
A & N ISLANDS,2002,TERRORIST & DISRUPTIVE ACTIVITIES (TATA),0,0,0,0,0,0,0,0,0,0,0,0,0,0,0
A & N ISLANDS,2002,IMMORAL TRAFFIC (PREVENTION) ACT,0,0,0,0,0,0,0,0,0,0,0,0,0,0,0
A & N ISLANDS,2002,INDIAN RAILWAYS ACT,0,0,0,0,0,0,0,0,0,0,0,0,0,0,0
A & N ISLANDS,2002,REGISTRATION OF FOREIGNERS ACT,0,0,0,75,0,75,41,0,41,5,0,5,121,0,121
A & N ISLANDS,2002,PROTECTION OF CIVIL RIGHTS ACT,0,0,0,0,0,0,0,0,0,0,0,0,0,0,0
A & N ISLANDS,2002,SC/ST (PREVENTION OF ATROCITIES) ACT,0,0,0,0,0,0,0,0,0,0,0,0,0,0,0
A & N ISLANDS,2002,INDIAN PASSPORT ACT,0,0,0,0,0,0,0,0,0,0,0,0,0,0,0
A & N ISLANDS,2002,ESSENTIAL COMMODITIES ACT,0,0,0,0,0,0,0,0,0,0,0,0,0,0,0
A & N ISLANDS,2002,ANTIQUITIES AND ART TREASURE ACT,0,0,0,0,0,0,0,0,0,0,0,0,0,0,0
A & N ISLANDS,2002,DOWRY PROHIBITION ACT,0,0,0,0,0,0,0,0,0,0,0,0,0,0,0
A & N ISLANDS,2002,FOREIGN EXCHANGE REGULATION ACT-1973,0,0,0,0,0,0,0,0,0,0,0,0,0,0,0
A & N ISLANDS,2002,PREVENTION OF CORRUPTION ACT-1988,0,0,0,0,0,0,0,0,0,0,0,0,0,0,0
A & N ISLANDS,2002,CONSER.OF FORGN.EXCH.&PREV. OF SMUG.ACT,0,0,0,0,0,0,0,0,0,0,0,0,0,0,0
A & N ISLANDS,2002,OTHER SLL OFFENCE,0,0,0,0,0,0,0,0,0,0,0,0,0,0,0
A & N ISLANDS,2002,TOTAL,0,0,0,75,0,75,41,0,41,5,0,5,121,0,121
A & N ISLANDS,2003,ARMS ACT,0,0,0,0,0,0,0,0,0,0,0,0,0,0,0
A & N ISLANDS,2003,N.D.P.S. ACT,0,0,0,1,0,1,0,0,0,0,0,0,1,0,1
A & N ISLANDS,2003,GAMBLING ACT,0,0,0,0,0,0,0,0,0,0,0,0,0,0,0
A & N ISLANDS,2003,EXCISE ACT,0,0,0,0,0,0,0,0,0,0,0,0,0,0,0
A & N ISLANDS,2003,PROHIBITION ACT,0,0,0,0,0,0,0,0,0,0,0,0,0,0,0
A & N ISLANDS,2003,EXPLOSIVE & EXPLOSIVE SUBST. ACT,0,0,0,0,0,0,0,0,0,0,0,0,0,0,0
A & N ISLANDS,2003,TERRORIST & DISRUPTIVE ACTIVITIES (TATA),0,0,0,0,0,0,0,0,0,0,0,0,0,0,0
A & N ISLANDS,2003,IMMORAL TRAFFIC (PREVENTION) ACT,0,0,0,0,0,0,0,0,0,0,0,0,0,0,0
A & N ISLANDS,2003,INDIAN RAILWAYS ACT,0,0,0,0,0,0,0,0,0,0,0,0,0,0,0
A & N ISLANDS,2003,REGISTRATION OF FOREIGNERS ACT,0,0,0,81,0,81,31,0,31,2,0,2,114,0,114
A & N ISLANDS,2003,PROTECTION OF CIVIL RIGHTS ACT,0,0,0,0,0,0,0,0,0,0,0,0,0,0,0
A & N ISLANDS,2003,SC/ST (PREVENTION OF ATROCITIES) ACT,0,0,0,0,0,0,0,0,0,0,0,0,0,0,0
A & N ISLANDS,2003,INDIAN PASSPORT ACT,0,0,0,0,0,0,0,0,0,0,0,0,0,0,0
A & N ISLANDS,2003,ESSENTIAL COMMODITIES ACT,0,0,0,0,0,0,0,0,0,0,0,0,0,0,0
A & N ISLANDS,2003,ANTIQUITIES AND ART TREASURE ACT,0,0,0,0,0,0,0,0,0,0,0,0,0,0,0
A & N ISLANDS,2003,DOWRY PROHIBITION ACT,0,0,0,0,0,0,0,0,0,0,0,0,0,0,0
A & N ISLANDS,2003,FOREIGN EXCHANGE REGULATION ACT-1973,0,0,0,0,0,0,0,0,0,0,0,0,0,0,0
A & N ISLANDS,2003,PREVENTION OF CORRUPTION ACT-1988,0,0,0,0,0,0,0,0,0,0,0,0,0,0,0
A & N ISLANDS,2003,CONSER.OF FORGN.EXCH.&PREV. OF SMUG.ACT,0,0,0,0,0,0,0,0,0,0,0,0,0,0,0
A & N ISLANDS,2003,OTHER SLL OFFENCE,0,0,0,0,0,0,0,0,0,0,0,0,0,0,0
A & N ISLANDS,2003,TOTAL,0,0,0,82,0,82,31,0,31,2,0,2,115,0,115
A & N ISLANDS,2004,ARMS ACT,0,0,0,0,0,0,0,0,0,0,0,0,0,0,0
A & N ISLANDS,2004,N.D.P.S. ACT,0,0,0,0,0,0,0,0,0,0,0,0,0,0,0
A & N ISLANDS,2004,GAMBLING ACT,0,0,0,0,0,0,0,0,0,0,0,0,0,0,0
A & N ISLANDS,2004,EXCISE ACT,0,0,0,0,0,0,0,0,0,0,0,0,0,0,0
A & N ISLANDS,2004,PROHIBITION ACT,0,0,0,0,0,0,0,0,0,0,0,0,0,0,0
A & N ISLANDS,2004,EXPLOSIVE & EXPLOSIVE SUBST. ACT,0,0,0,0,0,0,0,0,0,0,0,0,0,0,0
A & N ISLANDS,2004,TERRORIST & DISRUPTIVE ACTIVITIES (TATA),0,0,0,0,0,0,0,0,0,0,0,0,0,0,0
A & N ISLANDS,2004,IMMORAL TRAFFIC (PREVENTION) ACT,0,0,0,0,0,0,0,0,0,0,0,0,0,0,0
A & N ISLANDS,2004,INDIAN RAILWAYS ACT,0,0,0,0,0,0,0,0,0,0,0,0,0,0,0
A & N ISLANDS,2004,REGISTRATION OF FOREIGNERS ACT,0,0,0,0,0,0,0,0,0,0,0,0,0,0,0
A & N ISLANDS,2004,PROTECTION OF CIVIL RIGHTS ACT,0,0,0,0,0,0,0,0,0,0,0,0,0,0,0
A & N ISLANDS,2004,SC/ST (PREVENTION OF ATROCITIES) ACT,0,0,0,0,0,0,0,0,0,0,0,0,0,0,0
A & N ISLANDS,2004,INDIAN PASSPORT ACT,0,0,0,0,0,0,0,0,0,0,0,0,0,0,0
A & N ISLANDS,2004,ESSENTIAL COMMODITIES ACT,0,0,0,0,0,0,0,0,0,0,0,0,0,0,0
A & N ISLANDS,2004,ANTIQUITIES AND ART TREASURE ACT,0,0,0,0,0,0,0,0,0,0,0,0,0,0,0
A & N ISLANDS,2004,DOWRY PROHIBITION ACT,0,0,0,0,0,0,0,0,0,0,0,0,0,0,0
A & N ISLANDS,2004,FOREIGN EXCHANGE REGULATION ACT-1973,0,0,0,0,0,0,0,0,0,0,0,0,0,0,0
A & N ISLANDS,2004,PREVENTION OF CORRUPTION ACT-1988,0,0,0,0,0,0,0,0,0,0,0,0,0,0,0
A & N ISLANDS,2004,CONSER.OF FORGN.EXCH.&PREV. OF SMUG.ACT,0,0,0,0,0,0,0,0,0,0,0,0,0,0,0
A & N ISLANDS,2004,OTHER SLL OFFENCE,0,0,0,35,0,35,18,0,18,2,0,2,55,0,55
A & N ISLANDS,2004,TOTAL,0,0,0,35,0,35,18,0,18,2,0,2,55,0,55
A & N ISLANDS,2005,ARMS ACT,0,0,0,0,0,0,0,0,0,0,0,0,0,0,0
A & N ISLANDS,2005,N.D.P.S. ACT,0,0,0,0,0,0,0,0,0,0,0,0,0,0,0
A & N ISLANDS,2005,GAMBLING ACT,0,0,0,0,0,0,0,0,0,0,0,0,0,0,0
A & N ISLANDS,2005,EXCISE ACT,0,0,0,0,0,0,0,0,0,0,0,0,0,0,0
A & N ISLANDS,2005,PROHIBITION ACT,0,0,0,0,0,0,0,0,0,0,0,0,0,0,0
A & N ISLANDS,2005,EXPLOSIVE & EXPLOSIVE SUBST. ACT,0,0,0,0,0,0,0,0,0,0,0,0,0,0,0
A & N ISLANDS,2005,TERRORIST & DISRUPTIVE ACTIVITIES (TATA),0,0,0,0,0,0,0,0,0,0,0,0,0,0,0
A & N ISLANDS,2005,IMMORAL TRAFFIC (PREVENTION) ACT,0,0,0,0,0,0,0,0,0,0,0,0,0,0,0
A & N ISLANDS,2005,INDIAN RAILWAYS ACT,0,0,0,0,0,0,0,0,0,0,0,0,0,0,0
A & N ISLANDS,2005,REGISTRATION OF FOREIGNERS ACT,0,0,0,32,0,32,21,2,23,0,0,0,53,2,55
A & N ISLANDS,2005,PROTECTION OF CIVIL RIGHTS ACT,0,0,0,0,0,0,0,0,0,0,0,0,0,0,0
A & N ISLANDS,2005,SC/ST (PREVENTION OF ATROCITIES) ACT,0,0,0,0,0,0,0,0,0,0,0,0,0,0,0
A & N ISLANDS,2005,INDIAN PASSPORT ACT,0,0,0,0,0,0,0,0,0,0,0,0,0,0,0
A & N ISLANDS,2005,ESSENTIAL COMMODITIES ACT,0,0,0,0,0,0,0,0,0,0,0,0,0,0,0
A & N ISLANDS,2005,ANTIQUITIES AND ART TREASURE ACT,0,0,0,0,0,0,0,0,0,0,0,0,0,0,0
A & N ISLANDS,2005,DOWRY PROHIBITION ACT,0,0,0,0,0,0,0,0,0,0,0,0,0,0,0
A & N ISLANDS,2005,FOREIGN EXCHANGE REGULATION ACT-1973,0,0,0,0,0,0,0,0,0,0,0,0,0,0,0
A & N ISLANDS,2005,PREVENTION OF CORRUPTION ACT-1988,0,0,0,0,0,0,0,0,0,0,0,0,0,0,0
A & N ISLANDS,2005,CONSER.OF FORGN.EXCH.&PREV. OF SMUG.ACT,0,0,0,0,0,0,0,0,0,0,0,0,0,0,0
A & N ISLANDS,2005,OTHER SLL OFFENCE,0,0,0,0,0,0,0,0,0,0,0,0,0,0,0
A & N ISLANDS,2005,TOTAL,0,0,0,32,0,32,21,2,23,0,0,0,53,2,55
A & N ISLANDS,2006,ARMS ACT,0,0,0,0,0,0,0,0,0,0,0,0,0,0,0
A & N ISLANDS,2006,N.D.P.S. ACT,0,0,0,0,0,0,0,0,0,0,0,0,0,0,0
A & N ISLANDS,2006,GAMBLING ACT,0,0,0,0,0,0,0,0,0,0,0,0,0,0,0
A & N ISLANDS,2006,EXCISE ACT,0,0,0,0,0,0,0,0,0,0,0,0,0,0,0
A & N ISLANDS,2006,PROHIBITION ACT,0,0,0,0,0,0,0,0,0,0,0,0,0,0,0
A & N ISLANDS,2006,EXPLOSIVE & EXPLOSIVE SUBST. ACT,0,0,0,0,0,0,0,0,0,0,0,0,0,0,0
A & N ISLANDS,2006,TERRORIST & DISRUPTIVE ACTIVITIES (TATA),0,0,0,0,0,0,0,0,0,0,0,0,0,0,0
A & N ISLANDS,2006,IMMORAL TRAFFIC (PREVENTION) ACT,0,0,0,0,0,0,0,0,0,0,0,0,0,0,0
A & N ISLANDS,2006,INDIAN RAILWAYS ACT,0,0,0,0,0,0,0,0,0,0,0,0,0,0,0
A & N ISLANDS,2006,REGISTRATION OF FOREIGNERS ACT,0,0,0,110,0,110,68,0,68,0,0,0,178,0,178
A & N ISLANDS,2006,PROTECTION OF CIVIL RIGHTS ACT,0,0,0,0,0,0,0,0,0,0,0,0,0,0,0
A & N ISLANDS,2006,SC/ST (PREVENTION OF ATROCITIES) ACT,0,0,0,0,0,0,0,0,0,0,0,0,0,0,0
A & N ISLANDS,2006,INDIAN PASSPORT ACT,0,0,0,0,0,0,0,0,0,0,0,0,0,0,0
A & N ISLANDS,2006,ESSENTIAL COMMODITIES ACT,0,0,0,0,0,0,0,0,0,0,0,0,0,0,0
A & N ISLANDS,2006,ANTIQUITIES AND ART TREASURE ACT,0,0,0,0,0,0,0,0,0,0,0,0,0,0,0
A & N ISLANDS,2006,DOWRY PROHIBITION ACT,0,0,0,0,0,0,0,0,0,0,0,0,0,0,0
A & N ISLANDS,2006,FOREIGN EXCHANGE REGULATION ACT-1973,0,0,0,0,0,0,0,0,0,0,0,0,0,0,0
A & N ISLANDS,2006,PREVENTION OF CORRUPTION ACT-1988,0,0,0,0,0,0,0,0,0,0,0,0,0,0,0
A & N ISLANDS,2006,CONSER.OF FORGN.EXCH.&PREV. OF SMUG.ACT,0,0,0,0,0,0,0,0,0,0,0,0,0,0,0
A & N ISLANDS,2006,OTHER SLL OFFENCE,0,0,0,0,0,0,0,0,0,0,0,0,0,0,0
A & N ISLANDS,2006,TOTAL,0,0,0,110,0,110,68,0,68,0,0,0,178,0,178
A & N ISLANDS,2007,ARMS ACT,0,0,0,0,0,0,0,0,0,0,0,0,0,0,0
A & N ISLANDS,2007,N.D.P.S. ACT,0,0,0,1,0,1,2,0,2,0,0,0,3,0,3
A & N ISLANDS,2007,GAMBLING ACT,0,0,0,0,0,0,0,0,0,0,0,0,0,0,0
A & N ISLANDS,2007,EXCISE ACT,0,0,0,0,0,0,0,0,0,0,0,0,0,0,0
A & N ISLANDS,2007,PROHIBITION ACT,0,0,0,0,0,0,0,0,0,0,0,0,0,0,0
A & N ISLANDS,2007,EXPLOSIVE & EXPLOSIVE SUBST. ACT,0,0,0,0,0,0,0,0,0,0,0,0,0,0,0
A & N ISLANDS,2007,TERRORIST & DISRUPTIVE ACTIVITIES (TATA),0,0,0,0,0,0,0,0,0,0,0,0,0,0,0
A & N ISLANDS,2007,IMMORAL TRAFFIC (PREVENTION) ACT,0,0,0,0,0,0,0,0,0,0,0,0,0,0,0
A & N ISLANDS,2007,INDIAN RAILWAYS ACT,0,0,0,0,0,0,0,0,0,0,0,0,0,0,0
A & N ISLANDS,2007,REGISTRATION OF FOREIGNERS ACT,0,0,0,146,0,146,110,0,110,0,0,0,256,0,256
A & N ISLANDS,2007,PROTECTION OF CIVIL RIGHTS ACT,0,0,0,0,0,0,0,0,0,0,0,0,0,0,0
A & N ISLANDS,2007,SC/ST (PREVENTION OF ATROCITIES) ACT,0,0,0,0,0,0,0,0,0,0,0,0,0,0,0
A & N ISLANDS,2007,INDIAN PASSPORT ACT,0,0,0,0,0,0,0,0,0,0,0,0,0,0,0
A & N ISLANDS,2007,ESSENTIAL COMMODITIES ACT,0,0,0,0,0,0,0,0,0,0,0,0,0,0,0
A & N ISLANDS,2007,ANTIQUITIES AND ART TREASURE ACT,0,0,0,0,0,0,0,0,0,0,0,0,0,0,0
A & N ISLANDS,2007,DOWRY PROHIBITION ACT,0,0,0,0,0,0,0,0,0,0,0,0,0,0,0
A & N ISLANDS,2007,FOREIGN EXCHANGE REGULATION ACT-1973,0,0,0,0,0,0,0,0,0,0,0,0,0,0,0
A & N ISLANDS,2007,PREVENTION OF CORRUPTION ACT-1988,0,0,0,0,0,0,0,0,0,0,0,0,0,0,0
A & N ISLANDS,2007,CONSER.OF FORGN.EXCH.&PREV. OF SMUG.ACT,0,0,0,0,0,0,0,0,0,0,0,0,0,0,0
A & N ISLANDS,2007,OTHER SLL OFFENCE,0,0,0,0,0,0,0,0,0,0,0,0,0,0,0
A & N ISLANDS,2007,TOTAL,0,0,0,147,0,147,112,0,112,0,0,0,259,0,259
A & N ISLANDS,2008,ARMS ACT,0,0,0,0,0,0,0,0,0,0,0,0,0,0,0
A & N ISLANDS,2008,N.D.P.S. ACT,0,0,0,1,0,1,4,0,4,0,0,0,5,0,5
A & N ISLANDS,2008,GAMBLING ACT,0,0,0,0,0,0,0,0,0,0,0,0,0,0,0
A & N ISLANDS,2008,EXCISE ACT,0,0,0,0,0,0,0,0,0,0,0,0,0,0,0
A & N ISLANDS,2008,PROHIBITION ACT,0,0,0,0,0,0,0,0,0,0,0,0,0,0,0
A & N ISLANDS,2008,EXPLOSIVE & EXPLOSIVE SUBST. ACT,0,0,0,0,0,0,0,0,0,0,0,0,0,0,0
A & N ISLANDS,2008,TERRORIST & DISRUPTIVE ACTIVITIES (TATA),0,0,0,0,0,0,0,0,0,0,0,0,0,0,0
A & N ISLANDS,2008,IMMORAL TRAFFIC (PREVENTION) ACT,0,0,0,0,0,0,0,0,0,0,0,0,0,0,0
A & N ISLANDS,2008,INDIAN RAILWAYS ACT,0,0,0,0,0,0,0,0,0,0,0,0,0,0,0
A & N ISLANDS,2008,REGISTRATION OF FOREIGNERS ACT,0,0,0,28,0,28,21,0,21,1,0,1,50,0,50
A & N ISLANDS,2008,PROTECTION OF CIVIL RIGHTS ACT,0,0,0,0,0,0,0,0,0,0,0,0,0,0,0
A & N ISLANDS,2008,SC/ST (PREVENTION OF ATROCITIES) ACT,0,0,0,0,0,0,0,0,0,0,0,0,0,0,0
A & N ISLANDS,2008,INDIAN PASSPORT ACT,0,0,0,0,0,0,0,0,0,0,0,0,0,0,0
A & N ISLANDS,2008,ESSENTIAL COMMODITIES ACT,0,0,0,0,0,0,0,0,0,0,0,0,0,0,0
A & N ISLANDS,2008,ANTIQUITIES AND ART TREASURE ACT,0,0,0,0,0,0,0,0,0,0,0,0,0,0,0
A & N ISLANDS,2008,DOWRY PROHIBITION ACT,0,0,0,0,0,0,0,0,0,0,0,0,0,0,0
A & N ISLANDS,2008,FOREIGN EXCHANGE REGULATION ACT-1973,0,0,0,0,0,0,0,0,0,0,0,0,0,0,0
A & N ISLANDS,2008,PREVENTION OF CORRUPTION ACT-1988,0,0,0,0,0,0,0,0,0,0,0,0,0,0,0
A & N ISLANDS,2008,CONSER.OF FORGN.EXCH.&PREV. OF SMUG.ACT,0,0,0,0,0,0,0,0,0,0,0,0,0,0,0
A & N ISLANDS,2008,OTHER SLL OFFENCE,0,0,0,0,0,0,0,0,0,0,0,0,0,0,0
A & N ISLANDS,2008,TOTAL,0,0,0,29,0,29,25,0,25,1,0,1,55,0,55
A & N ISLANDS,2009,ARMS ACT,0,0,0,0,0,0,0,0,0,0,0,0,0,0,0
A & N ISLANDS,2009,N.D.P.S. ACT,0,0,0,2,0,2,1,0,1,0,0,0,3,0,3
A & N ISLANDS,2009,GAMBLING ACT,0,0,0,0,0,0,0,0,0,0,0,0,0,0,0
A & N ISLANDS,2009,EXCISE ACT,0,0,0,0,0,0,0,0,0,0,0,0,0,0,0
A & N ISLANDS,2009,PROHIBITION ACT,0,0,0,0,0,0,0,0,0,0,0,0,0,0,0
A & N ISLANDS,2009,EXPLOSIVE & EXPLOSIVE SUBST. ACT,0,0,0,0,0,0,0,0,0,0,0,0,0,0,0
A & N ISLANDS,2009,TERRORIST & DISRUPTIVE ACTIVITIES (TATA),0,0,0,0,0,0,0,0,0,0,0,0,0,0,0
A & N ISLANDS,2009,IMMORAL TRAFFIC (PREVENTION) ACT,0,0,0,0,0,0,0,0,0,0,0,0,0,0,0
A & N ISLANDS,2009,INDIAN RAILWAYS ACT,0,0,0,0,0,0,0,0,0,0,0,0,0,0,0
A & N ISLANDS,2009,REGISTRATION OF FOREIGNERS ACT,0,0,0,48,0,48,54,0,54,3,0,3,105,0,105
A & N ISLANDS,2009,PROTECTION OF CIVIL RIGHTS ACT,0,0,0,0,0,0,0,0,0,0,0,0,0,0,0
A & N ISLANDS,2009,SC/ST (PREVENTION OF ATROCITIES) ACT,0,0,0,0,0,0,0,0,0,0,0,0,0,0,0
A & N ISLANDS,2009,INDIAN PASSPORT ACT,0,0,0,0,0,0,0,0,0,0,0,0,0,0,0
A & N ISLANDS,2009,ESSENTIAL COMMODITIES ACT,0,0,0,0,0,0,0,0,0,0,0,0,0,0,0
A & N ISLANDS,2009,ANTIQUITIES AND ART TREASURE ACT,0,0,0,0,0,0,0,0,0,0,0,0,0,0,0
A & N ISLANDS,2009,DOWRY PROHIBITION ACT,0,0,0,0,0,0,0,0,0,0,0,0,0,0,0
A & N ISLANDS,2009,FOREIGN EXCHANGE REGULATION ACT-1973,0,0,0,0,0,0,0,0,0,0,0,0,0,0,0
A & N ISLANDS,2009,PREVENTION OF CORRUPTION ACT-1988,0,0,0,0,0,0,0,0,0,0,0,0,0,0,0
A & N ISLANDS,2009,CONSER.OF FORGN.EXCH.&PREV. OF SMUG.ACT,0,0,0,0,0,0,0,0,0,0,0,0,0,0,0
A & N ISLANDS,2009,OTHER SLL OFFENCE,0,0,0,0,0,0,0,0,0,0,0,0,0,0,0
A & N ISLANDS,2009,TOTAL,0,0,0,50,0,50,55,0,55,3,0,3,108,0,108
A & N ISLANDS,2010,ARMS ACT,0,0,0,0,0,0,0,0,0,0,0,0,0,0,0
A & N ISLANDS,2010,N.D.P.S. ACT,0,0,0,0,0,0,0,0,0,0,0,0,0,0,0
A & N ISLANDS,2010,GAMBLING ACT,0,0,0,0,0,0,0,0,0,0,0,0,0,0,0
A & N ISLANDS,2010,EXCISE ACT,0,0,0,0,0,0,0,0,0,0,0,0,0,0,0
A & N ISLANDS,2010,PROHIBITION ACT,0,0,0,0,0,0,0,0,0,0,0,0,0,0,0
A & N ISLANDS,2010,EXPLOSIVE & EXPLOSIVE SUBST. ACT,0,0,0,0,0,0,0,0,0,0,0,0,0,0,0
A & N ISLANDS,2010,TERRORIST & DISRUPTIVE ACTIVITIES (TATA),0,0,0,0,0,0,0,0,0,0,0,0,0,0,0
A & N ISLANDS,2010,IMMORAL TRAFFIC (PREVENTION) ACT,0,0,0,0,0,0,0,0,0,0,0,0,0,0,0
A & N ISLANDS,2010,INDIAN RAILWAYS ACT,0,0,0,0,0,0,0,0,0,0,0,0,0,0,0
A & N ISLANDS,2010,REGISTRATION OF FOREIGNERS ACT,0,0,0,227,0,227,246,0,246,21,0,21,494,0,494
A & N ISLANDS,2010,PROTECTION OF CIVIL RIGHTS ACT,0,0,0,0,0,0,0,0,0,0,0,0,0,0,0
A & N ISLANDS,2010,SC/ST (PREVENTION OF ATROCITIES) ACT,0,0,0,0,0,0,0,0,0,0,0,0,0,0,0
A & N ISLANDS,2010,INDIAN PASSPORT ACT,0,0,0,0,0,0,0,0,0,0,0,0,0,0,0
A & N ISLANDS,2010,ESSENTIAL COMMODITIES ACT,0,0,0,0,0,0,0,0,0,0,0,0,0,0,0
A & N ISLANDS,2010,ANTIQUITIES AND ART TREASURE ACT,0,0,0,0,0,0,0,0,0,0,0,0,0,0,0
A & N ISLANDS,2010,DOWRY PROHIBITION ACT,0,0,0,0,0,0,0,0,0,0,0,0,0,0,0
A & N ISLANDS,2010,FOREIGN EXCHANGE REGULATION ACT-1973,0,0,0,0,0,0,0,0,0,0,0,0,0,0,0
A & N ISLANDS,2010,PREVENTION OF CORRUPTION ACT-1988,0,0,0,0,0,0,0,0,0,0,0,0,0,0,0
A & N ISLANDS,2010,CONSER.OF FORGN.EXCH.&PREV. OF SMUG.ACT,0,0,0,0,0,0,0,0,0,0,0,0,0,0,0
A & N ISLANDS,2010,OTHER SLL OFFENCE,0,0,0,0,0,0,0,0,0,0,0,0,0,0,0
A & N ISLANDS,2010,TOTAL,0,0,0,227,0,227,246,0,246,21,0,21,494,0,494
A & N ISLANDS,2011,ARMS ACT,0,0,0,0,0,0,0,0,0,0,0,0,0,0,0
A & N ISLANDS,2011,N.D.P.S. ACT,0,0,0,0,0,0,0,0,0,0,0,0,0,0,0
A & N ISLANDS,2011,GAMBLING ACT,0,0,0,0,0,0,0,0,0,0,0,0,0,0,0
A & N ISLANDS,2011,EXCISE ACT,0,0,0,0,0,0,0,0,0,0,0,0,0,0,0
A & N ISLANDS,2011,PROHIBITION ACT,0,0,0,0,0,0,0,0,0,0,0,0,0,0,0
A & N ISLANDS,2011,EXPLOSIVE & EXPLOSIVE SUBST. ACT,0,0,0,1,0,1,10,0,10,5,0,5,16,0,16
A & N ISLANDS,2011,TERRORIST & DISRUPTIVE ACTIVITIES (TATA),0,0,0,0,0,0,0,0,0,0,0,0,0,0,0
A & N ISLANDS,2011,IMMORAL TRAFFIC (PREVENTION) ACT,0,0,0,0,0,0,0,0,0,0,0,0,0,0,0
A & N ISLANDS,2011,INDIAN RAILWAYS ACT,0,0,0,0,0,0,0,0,0,0,0,0,0,0,0
A & N ISLANDS,2011,REGISTRATION OF FOREIGNERS ACT,0,0,0,220,0,220,314,1,315,54,0,54,588,1,589
A & N ISLANDS,2011,PROTECTION OF CIVIL RIGHTS ACT,0,0,0,0,0,0,0,0,0,0,0,0,0,0,0
A & N ISLANDS,2011,SC/ST (PREVENTION OF ATROCITIES) ACT,0,0,0,0,0,0,0,0,0,0,0,0,0,0,0
A & N ISLANDS,2011,INDIAN PASSPORT ACT,0,0,0,0,0,0,0,0,0,0,0,0,0,0,0
A & N ISLANDS,2011,ESSENTIAL COMMODITIES ACT,0,0,0,0,0,0,0,0,0,0,0,0,0,0,0
A & N ISLANDS,2011,ANTIQUITIES AND ART TREASURE ACT,0,0,0,0,0,0,0,0,0,0,0,0,0,0,0
A & N ISLANDS,2011,DOWRY PROHIBITION ACT,0,0,0,0,0,0,0,0,0,0,0,0,0,0,0
A & N ISLANDS,2011,FOREIGN EXCHANGE REGULATION ACT-1973,0,0,0,0,0,0,0,0,0,0,0,0,0,0,0
A & N ISLANDS,2011,PREVENTION OF CORRUPTION ACT-1988,0,0,0,0,0,0,0,0,0,0,0,0,0,0,0
A & N ISLANDS,2011,CONSER.OF FORGN.EXCH.&PREV. OF SMUG.ACT,0,0,0,0,0,0,0,0,0,0,0,0,0,0,0
A & N ISLANDS,2011,OTHER SLL OFFENCE,0,0,0,0,0,0,0,0,0,0,0,0,0,0,0
A & N ISLANDS,2011,TOTAL,0,0,0,221,0,221,324,1,325,59,0,59,604,1,605
A & N ISLANDS,2012,ARMS ACT,0,0,0,0,0,0,0,0,0,0,0,0,0,0,0
A & N ISLANDS,2012,N.D.P.S. ACT,0,0,0,0,0,0,0,0,0,0,0,0,0,0,0
A & N ISLANDS,2012,GAMBLING ACT,0,0,0,0,0,0,0,0,0,0,0,0,0,0,0
A & N ISLANDS,2012,EXCISE ACT,0,0,0,0,0,0,0,0,0,0,0,0,0,0,0
A & N ISLANDS,2012,PROHIBITION ACT,0,0,0,0,0,0,0,0,0,0,0,0,0,0,0
A & N ISLANDS,2012,EXPLOSIVE & EXPLOSIVE SUBST. ACT,0,0,0,1,0,1,12,0,12,7,0,7,20,0,20
A & N ISLANDS,2012,TERRORIST & DISRUPTIVE ACTIVITIES (TATA),0,0,0,0,0,0,0,0,0,0,0,0,0,0,0
A & N ISLANDS,2012,IMMORAL TRAFFIC (PREVENTION) ACT,0,0,0,0,0,0,0,0,0,0,0,0,0,0,0
A & N ISLANDS,2012,INDIAN RAILWAYS ACT,0,0,0,0,0,0,0,0,0,0,0,0,0,0,0
A & N ISLANDS,2012,REGISTRATION OF FOREIGNERS ACT,0,0,0,98,0,98,129,1,130,37,0,37,264,1,265
A & N ISLANDS,2012,PROTECTION OF CIVIL RIGHTS ACT,0,0,0,0,0,0,0,0,0,0,0,0,0,0,0
A & N ISLANDS,2012,SC/ST (PREVENTION OF ATROCITIES) ACT,0,0,0,0,0,0,0,0,0,0,0,0,0,0,0
A & N ISLANDS,2012,INDIAN PASSPORT ACT,0,0,0,0,0,0,0,0,0,0,0,0,0,0,0
A & N ISLANDS,2012,ESSENTIAL COMMODITIES ACT,0,0,0,0,0,0,0,0,0,0,0,0,0,0,0
A & N ISLANDS,2012,ANTIQUITIES AND ART TREASURE ACT,0,0,0,0,0,0,0,0,0,0,0,0,0,0,0
A & N ISLANDS,2012,DOWRY PROHIBITION ACT,0,0,0,0,0,0,0,0,0,0,0,0,0,0,0
A & N ISLANDS,2012,FOREIGN EXCHANGE REGULATION ACT-1973,0,0,0,0,0,0,0,0,0,0,0,0,0,0,0
A & N ISLANDS,2012,PREVENTION OF CORRUPTION ACT-1988,0,0,0,0,0,0,0,0,0,0,0,0,0,0,0
A & N ISLANDS,2012,CONSER.OF FORGN.EXCH.&PREV. OF SMUG.ACT,0,0,0,0,0,0,0,0,0,0,0,0,0,0,0
A & N ISLANDS,2012,OTHER SLL OFFENCE,0,0,0,0,0,0,0,0,0,0,0,0,0,0,0
A & N ISLANDS,2012,TOTAL,0,0,0,99,0,99,141,1,142,44,0,44,284,1,285
CHANDIGARH,2001,ARMS ACT,1,0,1,0,0,0,4,0,4,1,0,1,6,0,6
CHANDIGARH,2001,N.D.P.S. ACT,0,0,0,4,0,4,7,1,8,2,0,2,13,1,14
CHANDIGARH,2001,GAMBLING ACT,0,0,0,1,0,1,3,0,3,1,0,1,5,0,5
CHANDIGARH,2001,EXCISE ACT,0,0,0,4,0,4,2,0,2,0,0,0,6,0,6
CHANDIGARH,2001,PROHIBITION ACT,0,0,0,0,0,0,0,0,0,0,0,0,0,0,0
CHANDIGARH,2001,EXPLOSIVE & EXPLOSIVE SUBST. ACT,0,0,0,6,0,6,2,0,2,1,0,1,9,0,9
CHANDIGARH,2001,TERRORIST & DISRUPTIVE ACTIVITIES (TATA),0,0,0,0,0,0,0,0,0,0,0,0,0,0,0
CHANDIGARH,2001,IMMORAL TRAFFIC (PREVENTION) ACT,0,0,0,3,0,3,3,0,3,0,0,0,6,0,6
CHANDIGARH,2001,INDIAN RAILWAYS ACT,0,0,0,0,0,0,0,0,0,0,0,0,0,0,0
CHANDIGARH,2001,REGISTRATION OF FOREIGNERS ACT,0,0,0,0,0,0,0,0,0,0,0,0,0,0,0
CHANDIGARH,2001,PROTECTION OF CIVIL RIGHTS ACT,0,0,0,0,0,0,0,0,0,0,0,0,0,0,0
CHANDIGARH,2001,SC/ST (PREVENTION OF ATROCITIES) ACT,0,0,0,0,0,0,0,0,0,0,0,0,0,0,0
CHANDIGARH,2001,INDIAN PASSPORT ACT,0,0,0,0,0,0,0,0,0,0,0,0,0,0,0
CHANDIGARH,2001,ESSENTIAL COMMODITIES ACT,0,0,0,2,0,2,4,0,4,0,0,0,6,0,6
CHANDIGARH,2001,ANTIQUITIES AND ART TREASURE ACT,0,0,0,0,0,0,0,0,0,0,0,0,0,0,0
CHANDIGARH,2001,DOWRY PROHIBITION ACT,0,0,0,0,0,0,0,0,0,0,0,0,0,0,0
CHANDIGARH,2001,FOREIGN EXCHANGE REGULATION ACT-1973,0,0,0,0,0,0,0,0,0,0,0,0,0,0,0
CHANDIGARH,2001,PREVENTION OF CORRUPTION ACT-1988,0,0,0,4,0,4,2,0,2,2,0,2,8,0,8
CHANDIGARH,2001,CONSER.OF FORGN.EXCH.&PREV. OF SMUG.ACT,0,0,0,0,0,0,0,0,0,0,0,0,0,0,0
CHANDIGARH,2001,OTHER SLL OFFENCE,0,0,0,0,0,0,0,0,0,0,0,0,0,0,0
CHANDIGARH,2001,TOTAL,1,0,1,24,0,24,27,1,28,7,0,7,59,1,60
CHANDIGARH,2002,ARMS ACT,0,0,0,6,0,6,3,0,3,0,0,0,9,0,9
CHANDIGARH,2002,N.D.P.S. ACT,0,0,0,7,0,7,8,0,8,6,0,6,21,0,21
CHANDIGARH,2002,GAMBLING ACT,0,0,0,3,0,3,2,0,2,0,0,0,5,0,5
CHANDIGARH,2002,EXCISE ACT,0,0,0,0,0,0,2,0,2,4,0,4,6,0,6
CHANDIGARH,2002,PROHIBITION ACT,0,0,0,0,0,0,0,0,0,0,0,0,0,0,0
CHANDIGARH,2002,EXPLOSIVE & EXPLOSIVE SUBST. ACT,0,0,0,5,0,5,3,0,3,1,0,1,9,0,9
CHANDIGARH,2002,TERRORIST & DISRUPTIVE ACTIVITIES (TATA),0,0,0,0,0,0,0,0,0,0,0,0,0,0,0
CHANDIGARH,2002,IMMORAL TRAFFIC (PREVENTION) ACT,0,0,0,0,0,0,1,0,1,0,0,0,1,0,1
CHANDIGARH,2002,INDIAN RAILWAYS ACT,0,0,0,0,0,0,0,0,0,0,0,0,0,0,0
CHANDIGARH,2002,REGISTRATION OF FOREIGNERS ACT,0,0,0,0,0,0,0,0,0,0,0,0,0,0,0
CHANDIGARH,2002,PROTECTION OF CIVIL RIGHTS ACT,0,0,0,0,0,0,0,0,0,0,0,0,0,0,0
CHANDIGARH,2002,SC/ST (PREVENTION OF ATROCITIES) ACT,0,0,0,0,0,0,0,0,0,0,0,0,0,0,0
CHANDIGARH,2002,INDIAN PASSPORT ACT,0,0,0,0,0,0,0,0,0,0,0,0,0,0,0
CHANDIGARH,2002,ESSENTIAL COMMODITIES ACT,0,0,0,2,0,2,3,0,3,0,0,0,5,0,5
CHANDIGARH,2002,ANTIQUITIES AND ART TREASURE ACT,0,0,0,0,0,0,0,0,0,0,0,0,0,0,0
CHANDIGARH,2002,DOWRY PROHIBITION ACT,0,0,0,0,0,0,0,0,0,0,0,0,0,0,0
CHANDIGARH,2002,FOREIGN EXCHANGE REGULATION ACT-1973,0,0,0,4,0,4,0,0,0,2,0,2,6,0,6
CHANDIGARH,2002,PREVENTION OF CORRUPTION ACT-1988,0,0,0,0,0,0,0,0,0,0,0,0,0,0,0
CHANDIGARH,2002,CONSER.OF FORGN.EXCH.&PREV. OF SMUG.ACT,0,0,0,0,0,0,0,0,0,0,0,0,0,0,0
CHANDIGARH,2002,OTHER SLL OFFENCE,0,0,0,0,0,0,0,0,0,0,0,0,0,0,0
CHANDIGARH,2002,TOTAL,0,0,0,27,0,27,22,0,22,13,0,13,62,0,62
CHANDIGARH,2003,ARMS ACT,0,0,0,1,0,1,2,0,2,1,0,1,4,0,4
CHANDIGARH,2003,N.D.P.S. ACT,0,0,0,2,0,2,5,0,5,1,0,1,8,0,8
CHANDIGARH,2003,GAMBLING ACT,0,0,0,1,0,1,1,0,1,1,0,1,3,0,3
CHANDIGARH,2003,EXCISE ACT,0,0,0,0,0,0,0,0,0,0,0,0,0,0,0
CHANDIGARH,2003,PROHIBITION ACT,0,0,0,0,0,0,0,0,0,0,0,0,0,0,0
CHANDIGARH,2003,EXPLOSIVE & EXPLOSIVE SUBST. ACT,0,0,0,0,0,0,0,0,0,0,0,0,0,0,0
CHANDIGARH,2003,TERRORIST & DISRUPTIVE ACTIVITIES (TATA),0,0,0,0,0,0,1,0,1,0,0,0,1,0,1
CHANDIGARH,2003,IMMORAL TRAFFIC (PREVENTION) ACT,0,0,0,0,0,0,0,0,0,0,0,0,0,0,0
CHANDIGARH,2003,INDIAN RAILWAYS ACT,0,0,0,0,0,0,0,0,0,0,0,0,0,0,0
CHANDIGARH,2003,REGISTRATION OF FOREIGNERS ACT,0,0,0,0,0,0,0,0,0,0,0,0,0,0,0
CHANDIGARH,2003,PROTECTION OF CIVIL RIGHTS ACT,0,0,0,0,0,0,0,0,0,0,0,0,0,0,0
CHANDIGARH,2003,SC/ST (PREVENTION OF ATROCITIES) ACT,0,0,0,0,0,0,0,0,0,0,0,0,0,0,0
CHANDIGARH,2003,INDIAN PASSPORT ACT,0,0,0,0,0,0,0,0,0,0,0,0,0,0,0
CHANDIGARH,2003,ESSENTIAL COMMODITIES ACT,0,0,0,0,0,0,0,0,0,0,0,0,0,0,0
CHANDIGARH,2003,ANTIQUITIES AND ART TREASURE ACT,0,0,0,0,0,0,0,0,0,0,0,0,0,0,0
CHANDIGARH,2003,DOWRY PROHIBITION ACT,0,0,0,0,0,0,0,0,0,0,0,0,0,0,0
CHANDIGARH,2003,FOREIGN EXCHANGE REGULATION ACT-1973,0,0,0,0,0,0,2,0,2,0,0,0,2,0,2
CHANDIGARH,2003,PREVENTION OF CORRUPTION ACT-1988,0,0,0,0,0,0,0,0,0,0,0,0,0,0,0
CHANDIGARH,2003,CONSER.OF FORGN.EXCH.&PREV. OF SMUG.ACT,0,0,0,0,0,0,0,0,0,0,0,0,0,0,0
CHANDIGARH,2003,OTHER SLL OFFENCE,0,0,0,11,0,11,22,0,22,11,0,11,44,0,44
CHANDIGARH,2003,TOTAL,0,0,0,15,0,15,33,0,33,14,0,14,62,0,62
CHANDIGARH,2004,ARMS ACT,0,0,0,2,0,2,3,0,3,1,0,1,6,0,6
CHANDIGARH,2004,N.D.P.S. ACT,0,0,0,10,0,10,6,3,9,4,0,4,20,3,23
CHANDIGARH,2004,GAMBLING ACT,0,0,0,1,0,1,3,0,3,1,0,1,5,0,5
CHANDIGARH,2004,EXCISE ACT,0,0,0,2,0,2,2,0,2,1,0,1,5,0,5
CHANDIGARH,2004,PROHIBITION ACT,0,0,0,0,0,0,1,0,1,1,0,1,2,0,2
CHANDIGARH,2004,EXPLOSIVE & EXPLOSIVE SUBST. ACT,0,0,0,0,0,0,5,0,5,1,0,1,6,0,6
CHANDIGARH,2004,TERRORIST & DISRUPTIVE ACTIVITIES (TATA),0,0,0,0,0,0,0,0,0,0,0,0,0,0,0
CHANDIGARH,2004,IMMORAL TRAFFIC (PREVENTION) ACT,0,0,0,0,0,0,2,0,2,0,0,0,2,0,2
CHANDIGARH,2004,INDIAN RAILWAYS ACT,0,0,0,0,0,0,0,0,0,0,0,0,0,0,0
CHANDIGARH,2004,REGISTRATION OF FOREIGNERS ACT,0,0,0,0,0,0,0,0,0,0,0,0,0,0,0
CHANDIGARH,2004,PROTECTION OF CIVIL RIGHTS ACT,0,0,0,0,0,0,0,0,0,0,0,0,0,0,0
CHANDIGARH,2004,SC/ST (PREVENTION OF ATROCITIES) ACT,0,0,0,0,0,0,0,0,0,0,0,0,0,0,0
CHANDIGARH,2004,INDIAN PASSPORT ACT,0,0,0,0,0,0,0,0,0,0,0,0,0,0,0
CHANDIGARH,2004,ESSENTIAL COMMODITIES ACT,0,0,0,0,0,0,0,0,0,0,0,0,0,0,0
CHANDIGARH,2004,ANTIQUITIES AND ART TREASURE ACT,0,0,0,0,0,0,0,0,0,0,0,0,0,0,0
CHANDIGARH,2004,DOWRY PROHIBITION ACT,0,0,0,2,0,2,3,0,3,1,0,1,6,0,6
CHANDIGARH,2004,FOREIGN EXCHANGE REGULATION ACT-1973,0,0,0,0,0,0,0,0,0,0,0,0,0,0,0
CHANDIGARH,2004,PREVENTION OF CORRUPTION ACT-1988,0,0,0,2,0,2,3,0,3,1,0,1,6,0,6
CHANDIGARH,2004,CONSER.OF FORGN.EXCH.&PREV. OF SMUG.ACT,0,0,0,0,0,0,0,0,0,0,0,0,0,0,0
CHANDIGARH,2004,OTHER SLL OFFENCE,0,0,0,0,0,0,0,0,0,0,0,0,0,0,0
CHANDIGARH,2004,TOTAL,0,0,0,19,0,19,28,3,31,11,0,11,58,3,61
CHANDIGARH,2005,ARMS ACT,0,0,0,4,0,4,4,0,4,2,0,2,10,0,10
CHANDIGARH,2005,N.D.P.S. ACT,0,0,0,9,0,9,8,1,9,3,2,5,20,3,23
CHANDIGARH,2005,GAMBLING ACT,0,0,0,1,0,1,2,0,2,3,0,3,6,0,6
CHANDIGARH,2005,EXCISE ACT,0,0,0,2,0,2,4,0,4,0,0,0,6,0,6
CHANDIGARH,2005,PROHIBITION ACT,0,0,0,0,0,0,0,0,0,0,0,0,0,0,0
CHANDIGARH,2005,EXPLOSIVE & EXPLOSIVE SUBST. ACT,0,0,0,0,0,0,7,0,7,1,0,1,8,0,8
CHANDIGARH,2005,TERRORIST & DISRUPTIVE ACTIVITIES (TATA),0,0,0,2,0,2,3,0,3,2,0,2,7,0,7
CHANDIGARH,2005,IMMORAL TRAFFIC (PREVENTION) ACT,0,0,0,0,0,0,0,0,0,0,0,0,0,0,0
CHANDIGARH,2005,INDIAN RAILWAYS ACT,0,0,0,0,0,0,0,0,0,0,0,0,0,0,0
CHANDIGARH,2005,REGISTRATION OF FOREIGNERS ACT,0,0,0,0,0,0,0,0,0,0,0,0,0,0,0
CHANDIGARH,2005,PROTECTION OF CIVIL RIGHTS ACT,0,0,0,0,0,0,0,0,0,0,0,0,0,0,0
CHANDIGARH,2005,SC/ST (PREVENTION OF ATROCITIES) ACT,0,0,0,0,0,0,0,0,0,0,0,0,0,0,0
CHANDIGARH,2005,INDIAN PASSPORT ACT,0,0,0,0,0,0,0,0,0,0,0,0,0,0,0
CHANDIGARH,2005,ESSENTIAL COMMODITIES ACT,0,0,0,0,0,0,0,0,0,0,0,0,0,0,0
CHANDIGARH,2005,ANTIQUITIES AND ART TREASURE ACT,0,0,0,0,0,0,0,0,0,0,0,0,0,0,0
CHANDIGARH,2005,DOWRY PROHIBITION ACT,0,0,0,0,0,0,0,0,0,0,0,0,0,0,0
CHANDIGARH,2005,FOREIGN EXCHANGE REGULATION ACT-1973,0,0,0,0,0,0,0,0,0,0,0,0,0,0,0
CHANDIGARH,2005,PREVENTION OF CORRUPTION ACT-1988,0,0,0,3,0,3,2,0,2,1,0,1,6,0,6
CHANDIGARH,2005,CONSER.OF FORGN.EXCH.&PREV. OF SMUG.ACT,0,0,0,0,0,0,0,0,0,0,0,0,0,0,0
CHANDIGARH,2005,OTHER SLL OFFENCE,0,0,0,4,0,4,3,0,3,2,0,2,9,0,9
CHANDIGARH,2005,TOTAL,0,0,0,25,0,25,33,1,34,14,2,16,72,3,75
CHANDIGARH,2006,ARMS ACT,0,0,0,2,0,2,4,0,4,2,0,2,8,0,8
CHANDIGARH,2006,N.D.P.S. ACT,0,0,0,8,0,8,13,3,16,3,0,3,24,3,27
CHANDIGARH,2006,GAMBLING ACT,0,0,0,1,0,1,2,0,2,1,0,1,4,0,4
CHANDIGARH,2006,EXCISE ACT,0,0,0,2,0,2,0,0,0,0,0,0,2,0,2
CHANDIGARH,2006,PROHIBITION ACT,0,0,0,0,0,0,0,0,0,0,0,0,0,0,0
CHANDIGARH,2006,EXPLOSIVE & EXPLOSIVE SUBST. ACT,0,0,0,0,0,0,7,0,7,1,0,1,8,0,8
CHANDIGARH,2006,TERRORIST & DISRUPTIVE ACTIVITIES (TATA),0,0,0,0,0,0,0,0,0,0,0,0,0,0,0
CHANDIGARH,2006,IMMORAL TRAFFIC (PREVENTION) ACT,0,0,0,0,0,0,0,0,0,0,0,0,0,0,0
CHANDIGARH,2006,INDIAN RAILWAYS ACT,0,0,0,0,0,0,0,0,0,0,0,0,0,0,0
CHANDIGARH,2006,REGISTRATION OF FOREIGNERS ACT,0,0,0,0,0,0,0,0,0,0,0,0,0,0,0
CHANDIGARH,2006,PROTECTION OF CIVIL RIGHTS ACT,0,0,0,0,0,0,0,0,0,0,0,0,0,0,0
CHANDIGARH,2006,SC/ST (PREVENTION OF ATROCITIES) ACT,0,0,0,0,0,0,0,0,0,0,0,0,0,0,0
CHANDIGARH,2006,INDIAN PASSPORT ACT,0,0,0,0,0,0,0,0,0,0,0,0,0,0,0
CHANDIGARH,2006,ESSENTIAL COMMODITIES ACT,0,0,0,0,0,0,0,0,0,0,0,0,0,0,0
CHANDIGARH,2006,ANTIQUITIES AND ART TREASURE ACT,0,0,0,0,0,0,0,0,0,0,0,0,0,0,0
CHANDIGARH,2006,DOWRY PROHIBITION ACT,0,0,0,0,0,0,0,0,0,0,0,0,0,0,0
CHANDIGARH,2006,FOREIGN EXCHANGE REGULATION ACT-1973,0,0,0,0,0,0,0,0,0,0,0,0,0,0,0
CHANDIGARH,2006,PREVENTION OF CORRUPTION ACT-1988,0,0,0,1,0,1,1,0,1,0,0,0,2,0,2
CHANDIGARH,2006,CONSER.OF FORGN.EXCH.&PREV. OF SMUG.ACT,0,0,0,0,0,0,0,0,0,0,0,0,0,0,0
CHANDIGARH,2006,OTHER SLL OFFENCE,0,0,0,3,0,3,3,0,3,0,0,0,6,0,6
CHANDIGARH,2006,TOTAL,0,0,0,17,0,17,30,3,33,7,0,7,54,3,57
CHANDIGARH,2007,ARMS ACT,0,0,0,4,0,4,3,0,3,3,0,3,10,0,10
CHANDIGARH,2007,N.D.P.S. ACT,0,0,0,5,1,6,18,0,18,4,0,4,27,1,28
CHANDIGARH,2007,GAMBLING ACT,0,0,0,1,0,1,4,0,4,2,0,2,7,0,7
CHANDIGARH,2007,EXCISE ACT,0,0,0,0,0,0,0,0,0,0,0,0,0,0,0
CHANDIGARH,2007,PROHIBITION ACT,0,0,0,0,0,0,0,0,0,0,0,0,0,0,0
CHANDIGARH,2007,EXPLOSIVE & EXPLOSIVE SUBST. ACT,0,0,0,0,0,0,3,0,3,1,0,1,4,0,4
CHANDIGARH,2007,TERRORIST & DISRUPTIVE ACTIVITIES (TATA),0,0,0,0,0,0,0,0,0,0,0,0,0,0,0
CHANDIGARH,2007,IMMORAL TRAFFIC (PREVENTION) ACT,0,0,0,0,0,0,0,0,0,0,0,0,0,0,0
CHANDIGARH,2007,INDIAN RAILWAYS ACT,0,0,0,0,0,0,0,0,0,0,0,0,0,0,0
CHANDIGARH,2007,REGISTRATION OF FOREIGNERS ACT,0,0,0,0,0,0,0,0,0,0,0,0,0,0,0
CHANDIGARH,2007,PROTECTION OF CIVIL RIGHTS ACT,0,0,0,0,0,0,0,0,0,0,0,0,0,0,0
CHANDIGARH,2007,SC/ST (PREVENTION OF ATROCITIES) ACT,0,0,0,0,0,0,0,0,0,0,0,0,0,0,0
CHANDIGARH,2007,INDIAN PASSPORT ACT,0,0,0,0,0,0,0,0,0,0,0,0,0,0,0
CHANDIGARH,2007,ESSENTIAL COMMODITIES ACT,0,0,0,0,0,0,0,0,0,0,0,0,0,0,0
CHANDIGARH,2007,ANTIQUITIES AND ART TREASURE ACT,0,0,0,0,0,0,0,0,0,0,0,0,0,0,0
CHANDIGARH,2007,DOWRY PROHIBITION ACT,0,0,0,0,0,0,0,0,0,0,0,0,0,0,0
CHANDIGARH,2007,FOREIGN EXCHANGE REGULATION ACT-1973,0,0,0,0,0,0,0,0,0,0,0,0,0,0,0
CHANDIGARH,2007,PREVENTION OF CORRUPTION ACT-1988,0,0,0,0,0,0,4,0,4,0,0,0,4,0,4
CHANDIGARH,2007,CONSER.OF FORGN.EXCH.&PREV. OF SMUG.ACT,0,0,0,0,0,0,0,0,0,0,0,0,0,0,0
CHANDIGARH,2007,OTHER SLL OFFENCE,0,0,0,0,0,0,0,0,0,0,0,0,0,0,0
CHANDIGARH,2007,TOTAL,0,0,0,10,1,11,32,0,32,10,0,10,52,1,53
CHANDIGARH,2008,ARMS ACT,0,0,0,12,0,12,14,0,14,4,0,4,30,0,30
CHANDIGARH,2008,N.D.P.S. ACT,0,0,0,16,1,17,16,0,16,6,2,8,38,3,41
CHANDIGARH,2008,GAMBLING ACT,0,0,0,4,0,4,2,0,2,1,0,1,7,0,7
CHANDIGARH,2008,EXCISE ACT,0,0,0,3,0,3,0,0,0,0,0,0,3,0,3
CHANDIGARH,2008,PROHIBITION ACT,0,0,0,0,0,0,0,0,0,0,0,0,0,0,0
CHANDIGARH,2008,EXPLOSIVE & EXPLOSIVE SUBST. ACT,0,0,0,0,0,0,0,0,0,0,0,0,0,0,0
CHANDIGARH,2008,TERRORIST & DISRUPTIVE ACTIVITIES (TATA),0,0,0,0,0,0,0,0,0,0,0,0,0,0,0
CHANDIGARH,2008,IMMORAL TRAFFIC (PREVENTION) ACT,0,0,0,0,0,0,0,0,0,0,0,0,0,0,0
CHANDIGARH,2008,INDIAN RAILWAYS ACT,0,0,0,0,0,0,0,0,0,0,0,0,0,0,0
CHANDIGARH,2008,REGISTRATION OF FOREIGNERS ACT,0,0,0,0,0,0,0,0,0,0,0,0,0,0,0
CHANDIGARH,2008,PROTECTION OF CIVIL RIGHTS ACT,0,0,0,0,0,0,0,0,0,0,0,0,0,0,0
CHANDIGARH,2008,SC/ST (PREVENTION OF ATROCITIES) ACT,0,0,0,0,0,0,0,0,0,0,0,0,0,0,0
CHANDIGARH,2008,INDIAN PASSPORT ACT,0,0,0,0,0,0,0,0,0,0,0,0,0,0,0
CHANDIGARH,2008,ESSENTIAL COMMODITIES ACT,0,0,0,0,0,0,0,0,0,0,0,0,0,0,0
CHANDIGARH,2008,ANTIQUITIES AND ART TREASURE ACT,0,0,0,0,0,0,0,0,0,0,0,0,0,0,0
CHANDIGARH,2008,DOWRY PROHIBITION ACT,0,0,0,0,0,0,0,0,0,0,0,0,0,0,0
CHANDIGARH,2008,FOREIGN EXCHANGE REGULATION ACT-1973,0,0,0,0,0,0,0,0,0,0,0,0,0,0,0
CHANDIGARH,2008,PREVENTION OF CORRUPTION ACT-1988,0,0,0,1,0,1,3,0,3,0,0,0,4,0,4
CHANDIGARH,2008,CONSER.OF FORGN.EXCH.&PREV. OF SMUG.ACT,0,0,0,0,0,0,0,0,0,0,0,0,0,0,0
CHANDIGARH,2008,OTHER SLL OFFENCE,0,0,0,0,0,0,0,0,0,0,0,0,0,0,0
CHANDIGARH,2008,TOTAL,0,0,0,36,1,37,35,0,35,11,2,13,82,3,85
CHANDIGARH,2009,ARMS ACT,0,0,0,11,0,11,10,0,10,2,0,2,23,0,23
CHANDIGARH,2009,N.D.P.S. ACT,0,0,0,19,2,21,16,2,18,7,0,7,42,4,46
CHANDIGARH,2009,GAMBLING ACT,0,0,0,2,0,2,4,0,4,0,0,0,6,0,6
CHANDIGARH,2009,EXCISE ACT,0,0,0,3,0,3,1,0,1,2,0,2,6,0,6
CHANDIGARH,2009,PROHIBITION ACT,0,0,0,0,0,0,0,0,0,0,0,0,0,0,0
CHANDIGARH,2009,EXPLOSIVE & EXPLOSIVE SUBST. ACT,0,0,0,0,0,0,0,0,0,0,0,0,0,0,0
CHANDIGARH,2009,TERRORIST & DISRUPTIVE ACTIVITIES (TATA),0,0,0,0,0,0,0,0,0,0,0,0,0,0,0
CHANDIGARH,2009,IMMORAL TRAFFIC (PREVENTION) ACT,0,0,0,0,0,0,0,0,0,0,0,0,0,0,0
CHANDIGARH,2009,INDIAN RAILWAYS ACT,0,0,0,0,0,0,0,0,0,0,0,0,0,0,0
CHANDIGARH,2009,REGISTRATION OF FOREIGNERS ACT,0,0,0,0,0,0,0,0,0,0,0,0,0,0,0
CHANDIGARH,2009,PROTECTION OF CIVIL RIGHTS ACT,0,0,0,0,0,0,0,0,0,0,0,0,0,0,0
CHANDIGARH,2009,SC/ST (PREVENTION OF ATROCITIES) ACT,0,0,0,0,0,0,0,0,0,0,0,0,0,0,0
CHANDIGARH,2009,INDIAN PASSPORT ACT,0,0,0,0,0,0,0,0,0,0,0,0,0,0,0
CHANDIGARH,2009,ESSENTIAL COMMODITIES ACT,0,0,0,0,0,0,0,0,0,0,0,0,0,0,0
CHANDIGARH,2009,ANTIQUITIES AND ART TREASURE ACT,0,0,0,0,0,0,0,0,0,0,0,0,0,0,0
CHANDIGARH,2009,DOWRY PROHIBITION ACT,0,0,0,0,0,0,0,0,0,0,0,0,0,0,0
CHANDIGARH,2009,FOREIGN EXCHANGE REGULATION ACT-1973,0,0,0,0,0,0,0,0,0,0,0,0,0,0,0
CHANDIGARH,2009,PREVENTION OF CORRUPTION ACT-1988,0,0,0,0,0,0,2,0,2,0,0,0,2,0,2
CHANDIGARH,2009,CONSER.OF FORGN.EXCH.&PREV. OF SMUG.ACT,0,0,0,0,0,0,0,0,0,0,0,0,0,0,0
CHANDIGARH,2009,OTHER SLL OFFENCE,0,0,0,0,0,0,0,0,0,0,0,0,0,0,0
CHANDIGARH,2009,TOTAL,0,0,0,35,2,37,33,2,35,11,0,11,79,4,83
CHANDIGARH,2010,ARMS ACT,0,0,0,10,0,10,12,0,12,3,0,3,25,0,25
CHANDIGARH,2010,N.D.P.S. ACT,0,0,0,15,1,16,18,3,21,8,1,9,41,5,46
CHANDIGARH,2010,GAMBLING ACT,0,0,0,2,0,2,3,0,3,0,0,0,5,0,5
CHANDIGARH,2010,EXCISE ACT,0,0,0,4,0,4,0,0,0,2,0,2,6,0,6
CHANDIGARH,2010,PROHIBITION ACT,0,0,0,0,0,0,0,0,0,0,0,0,0,0,0
CHANDIGARH,2010,EXPLOSIVE & EXPLOSIVE SUBST. ACT,0,0,0,0,0,0,0,0,0,0,0,0,0,0,0
CHANDIGARH,2010,TERRORIST & DISRUPTIVE ACTIVITIES (TATA),0,0,0,0,0,0,0,0,0,0,0,0,0,0,0
CHANDIGARH,2010,IMMORAL TRAFFIC (PREVENTION) ACT,0,0,0,0,0,0,0,0,0,0,0,0,0,0,0
CHANDIGARH,2010,INDIAN RAILWAYS ACT,0,0,0,0,0,0,0,0,0,0,0,0,0,0,0
CHANDIGARH,2010,REGISTRATION OF FOREIGNERS ACT,0,0,0,0,0,0,0,0,0,0,0,0,0,0,0
CHANDIGARH,2010,PROTECTION OF CIVIL RIGHTS ACT,0,0,0,0,0,0,0,0,0,0,0,0,0,0,0
CHANDIGARH,2010,SC/ST (PREVENTION OF ATROCITIES) ACT,0,0,0,0,0,0,0,0,0,0,0,0,0,0,0
CHANDIGARH,2010,INDIAN PASSPORT ACT,0,0,0,0,0,0,0,0,0,0,0,0,0,0,0
CHANDIGARH,2010,ESSENTIAL COMMODITIES ACT,0,0,0,0,0,0,0,0,0,0,0,0,0,0,0
CHANDIGARH,2010,ANTIQUITIES AND ART TREASURE ACT,0,0,0,0,0,0,0,0,0,0,0,0,0,0,0
CHANDIGARH,2010,DOWRY PROHIBITION ACT,0,0,0,0,0,0,0,0,0,0,0,0,0,0,0
CHANDIGARH,2010,FOREIGN EXCHANGE REGULATION ACT-1973,0,0,0,0,0,0,0,0,0,0,0,0,0,0,0
CHANDIGARH,2010,PREVENTION OF CORRUPTION ACT-1988,0,0,0,0,0,0,1,0,1,1,0,1,2,0,2
CHANDIGARH,2010,CONSER.OF FORGN.EXCH.&PREV. OF SMUG.ACT,0,0,0,0,0,0,0,0,0,0,0,0,0,0,0
CHANDIGARH,2010,OTHER SLL OFFENCE,0,0,0,0,0,0,0,0,0,0,0,0,0,0,0
CHANDIGARH,2010,TOTAL,0,0,0,31,1,32,34,3,37,14,1,15,79,5,84
CHANDIGARH,2011,ARMS ACT,0,0,0,7,0,7,4,0,4,0,0,0,11,0,11
CHANDIGARH,2011,N.D.P.S. ACT,0,0,0,22,1,23,16,0,16,6,0,6,44,1,45
CHANDIGARH,2011,GAMBLING ACT,0,0,0,2,0,2,1,0,1,0,0,0,3,0,3
CHANDIGARH,2011,EXCISE ACT,0,0,0,3,0,3,2,0,2,1,0,1,6,0,6
CHANDIGARH,2011,PROHIBITION ACT,0,0,0,0,0,0,0,0,0,0,0,0,0,0,0
CHANDIGARH,2011,EXPLOSIVE & EXPLOSIVE SUBST. ACT,0,0,0,0,0,0,0,0,0,0,0,0,0,0,0
CHANDIGARH,2011,TERRORIST & DISRUPTIVE ACTIVITIES (TATA),0,0,0,0,0,0,0,0,0,0,0,0,0,0,0
CHANDIGARH,2011,IMMORAL TRAFFIC (PREVENTION) ACT,0,0,0,0,0,0,0,0,0,0,0,0,0,0,0
CHANDIGARH,2011,INDIAN RAILWAYS ACT,0,0,0,0,0,0,0,0,0,0,0,0,0,0,0
CHANDIGARH,2011,REGISTRATION OF FOREIGNERS ACT,0,0,0,0,0,0,0,0,0,0,0,0,0,0,0
CHANDIGARH,2011,PROTECTION OF CIVIL RIGHTS ACT,0,0,0,0,0,0,0,0,0,0,0,0,0,0,0
CHANDIGARH,2011,SC/ST (PREVENTION OF ATROCITIES) ACT,0,0,0,0,0,0,0,0,0,0,0,0,0,0,0
CHANDIGARH,2011,INDIAN PASSPORT ACT,0,0,0,0,0,0,0,0,0,0,0,0,0,0,0
CHANDIGARH,2011,ESSENTIAL COMMODITIES ACT,0,0,0,0,0,0,0,0,0,0,0,0,0,0,0
CHANDIGARH,2011,ANTIQUITIES AND ART TREASURE ACT,0,0,0,0,0,0,0,0,0,0,0,0,0,0,0
CHANDIGARH,2011,DOWRY PROHIBITION ACT,0,0,0,0,0,0,0,0,0,0,0,0,0,0,0
CHANDIGARH,2011,FOREIGN EXCHANGE REGULATION ACT-1973,0,0,0,0,0,0,0,0,0,0,0,0,0,0,0
CHANDIGARH,2011,PREVENTION OF CORRUPTION ACT-1988,0,0,0,0,0,0,1,0,1,0,0,0,1,0,1
CHANDIGARH,2011,CONSER.OF FORGN.EXCH.&PREV. OF SMUG.ACT,0,0,0,0,0,0,0,0,0,0,0,0,0,0,0
CHANDIGARH,2011,OTHER SLL OFFENCE,0,0,0,0,0,0,0,0,0,0,0,0,0,0,0
CHANDIGARH,2011,TOTAL,0,0,0,34,1,35,24,0,24,7,0,7,65,1,66
CHANDIGARH,2012,ARMS ACT,0,0,0,5,0,5,6,0,6,1,0,1,12,0,12
CHANDIGARH,2012,N.D.P.S. ACT,0,0,0,14,0,14,26,3,29,5,0,5,45,3,48
CHANDIGARH,2012,GAMBLING ACT,0,0,0,2,0,2,0,0,0,0,0,0,2,0,2
CHANDIGARH,2012,EXCISE ACT,0,0,0,0,0,0,2,0,2,0,0,0,2,0,2
CHANDIGARH,2012,PROHIBITION ACT,0,0,0,0,0,0,0,0,0,0,0,0,0,0,0
CHANDIGARH,2012,EXPLOSIVE & EXPLOSIVE SUBST. ACT,0,0,0,0,0,0,0,0,0,0,0,0,0,0,0
CHANDIGARH,2012,TERRORIST & DISRUPTIVE ACTIVITIES (TATA),0,0,0,0,0,0,0,0,0,0,0,0,0,0,0
CHANDIGARH,2012,IMMORAL TRAFFIC (PREVENTION) ACT,0,0,0,3,0,3,4,0,4,0,0,0,7,0,7
CHANDIGARH,2012,INDIAN RAILWAYS ACT,0,0,0,0,0,0,0,0,0,0,0,0,0,0,0
CHANDIGARH,2012,REGISTRATION OF FOREIGNERS ACT,0,0,0,0,0,0,0,0,0,0,0,0,0,0,0
CHANDIGARH,2012,PROTECTION OF CIVIL RIGHTS ACT,0,0,0,0,0,0,0,0,0,0,0,0,0,0,0
CHANDIGARH,2012,SC/ST (PREVENTION OF ATROCITIES) ACT,0,0,0,0,0,0,0,0,0,0,0,0,0,0,0
CHANDIGARH,2012,INDIAN PASSPORT ACT,0,0,0,0,0,0,0,0,0,0,0,0,0,0,0
CHANDIGARH,2012,ESSENTIAL COMMODITIES ACT,0,0,0,0,0,0,2,0,2,0,0,0,2,0,2
CHANDIGARH,2012,ANTIQUITIES AND ART TREASURE ACT,0,0,0,0,0,0,0,0,0,0,0,0,0,0,0
CHANDIGARH,2012,DOWRY PROHIBITION ACT,0,0,0,0,0,0,0,0,0,0,0,0,0,0,0
CHANDIGARH,2012,FOREIGN EXCHANGE REGULATION ACT-1973,0,0,0,0,0,0,0,0,0,0,0,0,0,0,0
CHANDIGARH,2012,PREVENTION OF CORRUPTION ACT-1988,0,0,0,0,0,0,3,0,3,0,0,0,3,0,3
CHANDIGARH,2012,CONSER.OF FORGN.EXCH.&PREV. OF SMUG.ACT,0,0,0,0,0,0,0,0,0,0,0,0,0,0,0
CHANDIGARH,2012,OTHER SLL OFFENCE,0,0,0,0,0,0,0,0,0,0,0,0,0,0,0
CHANDIGARH,2012,TOTAL,0,0,0,24,0,24,43,3,46,6,0,6,73,3,76
D & N HAVELI,2001,ARMS ACT,0,0,0,1,0,1,0,0,0,0,0,0,1,0,1
D & N HAVELI,2001,N.D.P.S. ACT,0,0,0,0,0,0,3,1,4,0,0,0,3,1,4
D & N HAVELI,2001,GAMBLING ACT,0,0,0,0,0,0,0,0,0,0,0,0,0,0,0
D & N HAVELI,2001,EXCISE ACT,0,0,0,8,0,8,0,0,0,0,0,0,8,0,8
D & N HAVELI,2001,PROHIBITION ACT,0,0,0,0,0,0,0,0,0,0,0,0,0,0,0
D & N HAVELI,2001,EXPLOSIVE & EXPLOSIVE SUBST. ACT,0,0,0,0,0,0,0,0,0,0,0,0,0,0,0
D & N HAVELI,2001,TERRORIST & DISRUPTIVE ACTIVITIES (TATA),0,0,0,0,0,0,0,0,0,0,0,0,0,0,0
D & N HAVELI,2001,IMMORAL TRAFFIC (PREVENTION) ACT,0,0,0,0,0,0,0,0,0,0,0,0,0,0,0
D & N HAVELI,2001,INDIAN RAILWAYS ACT,0,0,0,0,0,0,0,0,0,0,0,0,0,0,0
D & N HAVELI,2001,REGISTRATION OF FOREIGNERS ACT,0,0,0,0,0,0,0,0,0,0,0,0,0,0,0
D & N HAVELI,2001,PROTECTION OF CIVIL RIGHTS ACT,0,0,0,0,0,0,0,0,0,0,0,0,0,0,0
D & N HAVELI,2001,SC/ST (PREVENTION OF ATROCITIES) ACT,0,0,0,6,0,6,0,0,0,0,0,0,6,0,6
D & N HAVELI,2001,INDIAN PASSPORT ACT,0,0,0,0,0,0,0,0,0,0,0,0,0,0,0
D & N HAVELI,2001,ESSENTIAL COMMODITIES ACT,0,0,0,1,0,1,0,0,0,0,0,0,1,0,1
D & N HAVELI,2001,ANTIQUITIES AND ART TREASURE ACT,0,0,0,0,0,0,0,0,0,0,0,0,0,0,0
D & N HAVELI,2001,DOWRY PROHIBITION ACT,0,0,0,0,0,0,0,0,0,0,0,0,0,0,0
D & N HAVELI,2001,FOREIGN EXCHANGE REGULATION ACT-1973,0,0,0,0,0,0,0,0,0,0,0,0,0,0,0
D & N HAVELI,2001,PREVENTION OF CORRUPTION ACT-1988,0,0,0,0,0,0,0,0,0,0,0,0,0,0,0
D & N HAVELI,2001,CONSER.OF FORGN.EXCH.&PREV. OF SMUG.ACT,0,0,0,0,0,0,0,0,0,0,0,0,0,0,0
D & N HAVELI,2001,OTHER SLL OFFENCE,0,0,0,6,0,6,0,0,0,0,0,0,6,0,6
D & N HAVELI,2001,TOTAL,0,0,0,22,0,22,3,1,4,0,0,0,25,1,26
D & N HAVELI,2002,ARMS ACT,0,0,0,2,0,2,0,0,0,0,0,0,2,0,2
D & N HAVELI,2002,N.D.P.S. ACT,0,0,0,0,0,0,0,0,0,0,0,0,0,0,0
D & N HAVELI,2002,GAMBLING ACT,0,0,0,0,0,0,0,0,0,0,0,0,0,0,0
D & N HAVELI,2002,EXCISE ACT,0,0,0,0,0,0,0,0,0,0,0,0,0,0,0
D & N HAVELI,2002,PROHIBITION ACT,0,0,0,3,0,3,0,0,0,0,0,0,3,0,3
D & N HAVELI,2002,EXPLOSIVE & EXPLOSIVE SUBST. ACT,0,0,0,0,0,0,0,0,0,0,0,0,0,0,0
D & N HAVELI,2002,TERRORIST & DISRUPTIVE ACTIVITIES (TATA),0,0,0,0,0,0,0,0,0,0,0,0,0,0,0
D & N HAVELI,2002,IMMORAL TRAFFIC (PREVENTION) ACT,0,0,0,0,0,0,0,0,0,0,0,0,0,0,0
D & N HAVELI,2002,INDIAN RAILWAYS ACT,0,0,0,0,0,0,0,0,0,0,0,0,0,0,0
D & N HAVELI,2002,REGISTRATION OF FOREIGNERS ACT,0,0,0,0,0,0,0,0,0,0,0,0,0,0,0
D & N HAVELI,2002,PROTECTION OF CIVIL RIGHTS ACT,0,0,0,0,0,0,0,0,0,0,0,0,0,0,0
D & N HAVELI,2002,SC/ST (PREVENTION OF ATROCITIES) ACT,0,0,0,2,0,2,0,0,0,0,0,0,2,0,2
D & N HAVELI,2002,INDIAN PASSPORT ACT,0,0,0,0,0,0,0,0,0,0,0,0,0,0,0
D & N HAVELI,2002,ESSENTIAL COMMODITIES ACT,0,0,0,1,0,1,0,0,0,0,0,0,1,0,1
D & N HAVELI,2002,ANTIQUITIES AND ART TREASURE ACT,0,0,0,0,0,0,0,0,0,0,0,0,0,0,0
D & N HAVELI,2002,DOWRY PROHIBITION ACT,0,0,0,0,0,0,0,0,0,0,0,0,0,0,0
D & N HAVELI,2002,FOREIGN EXCHANGE REGULATION ACT-1973,0,0,0,0,0,0,0,0,0,0,0,0,0,0,0
D & N HAVELI,2002,PREVENTION OF CORRUPTION ACT-1988,0,0,0,0,0,0,0,0,0,0,0,0,0,0,0
D & N HAVELI,2002,CONSER.OF FORGN.EXCH.&PREV. OF SMUG.ACT,0,0,0,0,0,0,0,0,0,0,0,0,0,0,0
D & N HAVELI,2002,OTHER SLL OFFENCE,0,0,0,0,0,0,0,0,0,0,0,0,0,0,0
D & N HAVELI,2002,TOTAL,0,0,0,8,0,8,0,0,0,0,0,0,8,0,8
D & N HAVELI,2003,ARMS ACT,0,0,0,0,0,0,0,0,0,0,0,0,0,0,0
D & N HAVELI,2003,N.D.P.S. ACT,0,0,0,0,0,0,0,0,0,0,0,0,0,0,0
D & N HAVELI,2003,GAMBLING ACT,0,0,0,0,0,0,0,0,0,0,0,0,0,0,0
D & N HAVELI,2003,EXCISE ACT,0,0,0,0,0,0,0,0,0,0,0,0,0,0,0
D & N HAVELI,2003,PROHIBITION ACT,0,0,0,0,0,0,0,0,0,0,0,0,0,0,0
D & N HAVELI,2003,EXPLOSIVE & EXPLOSIVE SUBST. ACT,0,0,0,0,0,0,0,0,0,0,0,0,0,0,0
D & N HAVELI,2003,TERRORIST & DISRUPTIVE ACTIVITIES (TATA),0,0,0,0,0,0,0,0,0,0,0,0,0,0,0
D & N HAVELI,2003,IMMORAL TRAFFIC (PREVENTION) ACT,0,0,0,0,0,0,0,0,0,0,0,0,0,0,0
D & N HAVELI,2003,INDIAN RAILWAYS ACT,0,0,0,0,0,0,0,0,0,0,0,0,0,0,0
D & N HAVELI,2003,REGISTRATION OF FOREIGNERS ACT,0,0,0,0,0,0,0,0,0,0,0,0,0,0,0
D & N HAVELI,2003,PROTECTION OF CIVIL RIGHTS ACT,0,0,0,0,0,0,0,0,0,0,0,0,0,0,0
D & N HAVELI,2003,SC/ST (PREVENTION OF ATROCITIES) ACT,0,0,0,0,0,0,0,0,0,0,0,0,0,0,0
D & N HAVELI,2003,INDIAN PASSPORT ACT,0,0,0,0,0,0,0,0,0,0,0,0,0,0,0
D & N HAVELI,2003,ESSENTIAL COMMODITIES ACT,0,0,0,0,0,0,0,0,0,0,0,0,0,0,0
D & N HAVELI,2003,ANTIQUITIES AND ART TREASURE ACT,0,0,0,0,0,0,0,0,0,0,0,0,0,0,0
D & N HAVELI,2003,DOWRY PROHIBITION ACT,0,0,0,0,0,0,0,0,0,0,0,0,0,0,0
D & N HAVELI,2003,FOREIGN EXCHANGE REGULATION ACT-1973,0,0,0,0,0,0,0,0,0,0,0,0,0,0,0
D & N HAVELI,2003,PREVENTION OF CORRUPTION ACT-1988,0,0,0,0,0,0,0,0,0,0,0,0,0,0,0
D & N HAVELI,2003,CONSER.OF FORGN.EXCH.&PREV. OF SMUG.ACT,0,0,0,0,0,0,0,0,0,0,0,0,0,0,0
D & N HAVELI,2003,OTHER SLL OFFENCE,0,0,0,0,0,0,0,0,0,0,0,0,0,0,0
D & N HAVELI,2003,TOTAL,0,0,0,0,0,0,0,0,0,0,0,0,0,0,0
D & N HAVELI,2004,ARMS ACT,0,0,0,0,0,0,0,0,0,0,0,0,0,0,0
D & N HAVELI,2004,N.D.P.S. ACT,0,0,0,2,0,2,1,0,1,0,0,0,3,0,3
D & N HAVELI,2004,GAMBLING ACT,0,0,0,0,0,0,0,0,0,0,0,0,0,0,0
D & N HAVELI,2004,EXCISE ACT,0,0,0,0,0,0,0,0,0,0,0,0,0,0,0
D & N HAVELI,2004,PROHIBITION ACT,0,0,0,0,0,0,0,0,0,0,0,0,0,0,0
D & N HAVELI,2004,EXPLOSIVE & EXPLOSIVE SUBST. ACT,0,0,0,0,0,0,0,0,0,0,0,0,0,0,0
D & N HAVELI,2004,TERRORIST & DISRUPTIVE ACTIVITIES (TATA),0,0,0,0,0,0,0,0,0,0,0,0,0,0,0
D & N HAVELI,2004,IMMORAL TRAFFIC (PREVENTION) ACT,0,0,0,0,0,0,0,0,0,0,0,0,0,0,0
D & N HAVELI,2004,INDIAN RAILWAYS ACT,0,0,0,0,0,0,0,0,0,0,0,0,0,0,0
D & N HAVELI,2004,REGISTRATION OF FOREIGNERS ACT,0,0,0,0,0,0,0,0,0,0,0,0,0,0,0
D & N HAVELI,2004,PROTECTION OF CIVIL RIGHTS ACT,0,0,0,0,0,0,0,0,0,0,0,0,0,0,0
D & N HAVELI,2004,SC/ST (PREVENTION OF ATROCITIES) ACT,0,0,0,0,0,0,0,0,0,0,0,0,0,0,0
D & N HAVELI,2004,INDIAN PASSPORT ACT,0,0,0,0,0,0,0,0,0,0,0,0,0,0,0
D & N HAVELI,2004,ESSENTIAL COMMODITIES ACT,0,0,0,0,0,0,0,0,0,0,0,0,0,0,0
D & N HAVELI,2004,ANTIQUITIES AND ART TREASURE ACT,0,0,0,0,0,0,0,0,0,0,0,0,0,0,0
D & N HAVELI,2004,DOWRY PROHIBITION ACT,0,0,0,0,0,0,0,0,0,0,0,0,0,0,0
D & N HAVELI,2004,FOREIGN EXCHANGE REGULATION ACT-1973,0,0,0,0,0,0,0,0,0,0,0,0,0,0,0
D & N HAVELI,2004,PREVENTION OF CORRUPTION ACT-1988,0,0,0,0,0,0,0,0,0,0,0,0,0,0,0
D & N HAVELI,2004,CONSER.OF FORGN.EXCH.&PREV. OF SMUG.ACT,0,0,0,0,0,0,0,0,0,0,0,0,0,0,0
D & N HAVELI,2004,OTHER SLL OFFENCE,0,0,0,0,0,0,0,0,0,0,0,0,0,0,0
D & N HAVELI,2004,TOTAL,0,0,0,2,0,2,1,0,1,0,0,0,3,0,3
D & N HAVELI,2005,ARMS ACT,0,0,0,0,0,0,0,0,0,0,0,0,0,0,0
D & N HAVELI,2005,N.D.P.S. ACT,0,0,0,0,0,0,0,0,0,0,0,0,0,0,0
D & N HAVELI,2005,GAMBLING ACT,0,0,0,0,0,0,0,0,0,0,0,0,0,0,0
D & N HAVELI,2005,EXCISE ACT,0,0,0,0,0,0,0,0,0,0,0,0,0,0,0
D & N HAVELI,2005,PROHIBITION ACT,0,0,0,0,0,0,0,0,0,0,0,0,0,0,0
D & N HAVELI,2005,EXPLOSIVE & EXPLOSIVE SUBST. ACT,0,0,0,0,0,0,0,0,0,0,0,0,0,0,0
D & N HAVELI,2005,TERRORIST & DISRUPTIVE ACTIVITIES (TATA),0,0,0,0,0,0,0,0,0,0,0,0,0,0,0
D & N HAVELI,2005,IMMORAL TRAFFIC (PREVENTION) ACT,0,0,0,0,0,0,0,0,0,0,0,0,0,0,0
D & N HAVELI,2005,INDIAN RAILWAYS ACT,0,0,0,0,0,0,0,0,0,0,0,0,0,0,0
D & N HAVELI,2005,REGISTRATION OF FOREIGNERS ACT,0,0,0,0,0,0,0,0,0,0,0,0,0,0,0
D & N HAVELI,2005,PROTECTION OF CIVIL RIGHTS ACT,0,0,0,0,0,0,0,0,0,0,0,0,0,0,0
D & N HAVELI,2005,SC/ST (PREVENTION OF ATROCITIES) ACT,0,0,0,0,0,0,0,0,0,0,0,0,0,0,0
D & N HAVELI,2005,INDIAN PASSPORT ACT,0,0,0,0,0,0,0,0,0,0,0,0,0,0,0
D & N HAVELI,2005,ESSENTIAL COMMODITIES ACT,0,0,0,0,0,0,0,0,0,0,0,0,0,0,0
D & N HAVELI,2005,ANTIQUITIES AND ART TREASURE ACT,0,0,0,0,0,0,0,0,0,0,0,0,0,0,0
D & N HAVELI,2005,DOWRY PROHIBITION ACT,0,0,0,0,0,0,0,0,0,0,0,0,0,0,0
D & N HAVELI,2005,FOREIGN EXCHANGE REGULATION ACT-1973,0,0,0,0,0,0,0,0,0,0,0,0,0,0,0
D & N HAVELI,2005,PREVENTION OF CORRUPTION ACT-1988,0,0,0,0,0,0,0,0,0,0,0,0,0,0,0
D & N HAVELI,2005,CONSER.OF FORGN.EXCH.&PREV. OF SMUG.ACT,0,0,0,0,0,0,0,0,0,0,0,0,0,0,0
D & N HAVELI,2005,OTHER SLL OFFENCE,0,0,0,0,0,0,0,0,0,0,0,0,0,0,0
D & N HAVELI,2005,TOTAL,0,0,0,0,0,0,0,0,0,0,0,0,0,0,0
D & N HAVELI,2006,ARMS ACT,0,0,0,0,0,0,0,0,0,0,0,0,0,0,0
D & N HAVELI,2006,N.D.P.S. ACT,0,0,0,0,0,0,0,0,0,0,0,0,0,0,0
D & N HAVELI,2006,GAMBLING ACT,0,0,0,0,0,0,0,0,0,0,0,0,0,0,0
D & N HAVELI,2006,EXCISE ACT,0,0,0,0,0,0,0,0,0,0,0,0,0,0,0
D & N HAVELI,2006,PROHIBITION ACT,0,0,0,0,0,0,0,0,0,0,0,0,0,0,0
D & N HAVELI,2006,EXPLOSIVE & EXPLOSIVE SUBST. ACT,0,0,0,0,0,0,0,0,0,0,0,0,0,0,0
D & N HAVELI,2006,TERRORIST & DISRUPTIVE ACTIVITIES (TATA),0,0,0,0,0,0,0,0,0,0,0,0,0,0,0
D & N HAVELI,2006,IMMORAL TRAFFIC (PREVENTION) ACT,0,0,0,0,0,0,0,0,0,0,0,0,0,0,0
D & N HAVELI,2006,INDIAN RAILWAYS ACT,0,0,0,0,0,0,0,0,0,0,0,0,0,0,0
D & N HAVELI,2006,REGISTRATION OF FOREIGNERS ACT,0,0,0,0,0,0,0,0,0,0,0,0,0,0,0
D & N HAVELI,2006,PROTECTION OF CIVIL RIGHTS ACT,0,0,0,0,0,0,0,0,0,0,0,0,0,0,0
D & N HAVELI,2006,SC/ST (PREVENTION OF ATROCITIES) ACT,0,0,0,0,0,0,0,0,0,0,0,0,0,0,0
D & N HAVELI,2006,INDIAN PASSPORT ACT,0,0,0,0,0,0,0,0,0,0,0,0,0,0,0
D & N HAVELI,2006,ESSENTIAL COMMODITIES ACT,0,0,0,0,0,0,0,0,0,0,0,0,0,0,0
D & N HAVELI,2006,ANTIQUITIES AND ART TREASURE ACT,0,0,0,0,0,0,0,0,0,0,0,0,0,0,0
D & N HAVELI,2006,DOWRY PROHIBITION ACT,0,0,0,0,0,0,0,0,0,0,0,0,0,0,0
D & N HAVELI,2006,FOREIGN EXCHANGE REGULATION ACT-1973,0,0,0,0,0,0,0,0,0,0,0,0,0,0,0
D & N HAVELI,2006,PREVENTION OF CORRUPTION ACT-1988,0,0,0,0,0,0,0,0,0,0,0,0,0,0,0
D & N HAVELI,2006,CONSER.OF FORGN.EXCH.&PREV. OF SMUG.ACT,0,0,0,0,0,0,0,0,0,0,0,0,0,0,0
D & N HAVELI,2006,OTHER SLL OFFENCE,0,0,0,0,0,0,0,0,0,0,0,0,0,0,0
D & N HAVELI,2006,TOTAL,0,0,0,0,0,0,0,0,0,0,0,0,0,0,0
D & N HAVELI,2007,ARMS ACT,0,0,0,0,0,0,0,0,0,0,0,0,0,0,0
D & N HAVELI,2007,N.D.P.S. ACT,0,0,0,0,0,0,0,0,0,0,0,0,0,0,0
D & N HAVELI,2007,GAMBLING ACT,0,0,0,0,0,0,0,0,0,0,0,0,0,0,0
D & N HAVELI,2007,EXCISE ACT,0,0,0,0,0,0,0,0,0,0,0,0,0,0,0
D & N HAVELI,2007,PROHIBITION ACT,0,0,0,0,0,0,0,0,0,0,0,0,0,0,0
D & N HAVELI,2007,EXPLOSIVE & EXPLOSIVE SUBST. ACT,0,0,0,0,0,0,0,0,0,0,0,0,0,0,0
D & N HAVELI,2007,TERRORIST & DISRUPTIVE ACTIVITIES (TATA),0,0,0,0,0,0,0,0,0,0,0,0,0,0,0
D & N HAVELI,2007,IMMORAL TRAFFIC (PREVENTION) ACT,0,0,0,0,0,0,0,0,0,0,0,0,0,0,0
D & N HAVELI,2007,INDIAN RAILWAYS ACT,0,0,0,0,0,0,0,0,0,0,0,0,0,0,0
D & N HAVELI,2007,REGISTRATION OF FOREIGNERS ACT,0,0,0,0,0,0,0,0,0,0,0,0,0,0,0
D & N HAVELI,2007,PROTECTION OF CIVIL RIGHTS ACT,0,0,0,0,0,0,0,0,0,0,0,0,0,0,0
D & N HAVELI,2007,SC/ST (PREVENTION OF ATROCITIES) ACT,0,0,0,0,0,0,0,0,0,0,0,0,0,0,0
D & N HAVELI,2007,INDIAN PASSPORT ACT,0,0,0,0,0,0,0,0,0,0,0,0,0,0,0
D & N HAVELI,2007,ESSENTIAL COMMODITIES ACT,0,0,0,0,0,0,0,0,0,0,0,0,0,0,0
D & N HAVELI,2007,ANTIQUITIES AND ART TREASURE ACT,0,0,0,0,0,0,0,0,0,0,0,0,0,0,0
D & N HAVELI,2007,DOWRY PROHIBITION ACT,0,0,0,0,0,0,0,0,0,0,0,0,0,0,0
D & N HAVELI,2007,FOREIGN EXCHANGE REGULATION ACT-1973,0,0,0,0,0,0,0,0,0,0,0,0,0,0,0
D & N HAVELI,2007,PREVENTION OF CORRUPTION ACT-1988,0,0,0,0,0,0,0,0,0,0,0,0,0,0,0
D & N HAVELI,2007,CONSER.OF FORGN.EXCH.&PREV. OF SMUG.ACT,0,0,0,0,0,0,0,0,0,0,0,0,0,0,0
D & N HAVELI,2007,OTHER SLL OFFENCE,0,0,0,0,0,0,0,0,0,0,0,0,0,0,0
D & N HAVELI,2007,TOTAL,0,0,0,0,0,0,0,0,0,0,0,0,0,0,0
D & N HAVELI,2008,ARMS ACT,0,0,0,0,0,0,0,0,0,0,0,0,0,0,0
D & N HAVELI,2008,N.D.P.S. ACT,0,0,0,0,0,0,0,0,0,0,0,0,0,0,0
D & N HAVELI,2008,GAMBLING ACT,0,0,0,0,0,0,0,0,0,0,0,0,0,0,0
D & N HAVELI,2008,EXCISE ACT,0,0,0,0,0,0,0,0,0,0,0,0,0,0,0
D & N HAVELI,2008,PROHIBITION ACT,0,0,0,0,0,0,0,0,0,0,0,0,0,0,0
D & N HAVELI,2008,EXPLOSIVE & EXPLOSIVE SUBST. ACT,0,0,0,0,0,0,0,0,0,0,0,0,0,0,0
D & N HAVELI,2008,TERRORIST & DISRUPTIVE ACTIVITIES (TATA),0,0,0,0,0,0,0,0,0,0,0,0,0,0,0
D & N HAVELI,2008,IMMORAL TRAFFIC (PREVENTION) ACT,0,0,0,0,0,0,0,0,0,0,0,0,0,0,0
D & N HAVELI,2008,INDIAN RAILWAYS ACT,0,0,0,0,0,0,0,0,0,0,0,0,0,0,0
D & N HAVELI,2008,REGISTRATION OF FOREIGNERS ACT,0,0,0,0,0,0,0,0,0,0,0,0,0,0,0
D & N HAVELI,2008,PROTECTION OF CIVIL RIGHTS ACT,0,0,0,0,0,0,0,0,0,0,0,0,0,0,0
D & N HAVELI,2008,SC/ST (PREVENTION OF ATROCITIES) ACT,0,0,0,0,0,0,0,0,0,0,0,0,0,0,0
D & N HAVELI,2008,INDIAN PASSPORT ACT,0,0,0,0,0,0,0,0,0,0,0,0,0,0,0
D & N HAVELI,2008,ESSENTIAL COMMODITIES ACT,0,0,0,0,0,0,0,0,0,0,0,0,0,0,0
D & N HAVELI,2008,ANTIQUITIES AND ART TREASURE ACT,0,0,0,0,0,0,0,0,0,0,0,0,0,0,0
D & N HAVELI,2008,DOWRY PROHIBITION ACT,0,0,0,0,0,0,0,0,0,0,0,0,0,0,0
D & N HAVELI,2008,FOREIGN EXCHANGE REGULATION ACT-1973,0,0,0,0,0,0,0,0,0,0,0,0,0,0,0
D & N HAVELI,2008,PREVENTION OF CORRUPTION ACT-1988,0,0,0,0,0,0,0,0,0,0,0,0,0,0,0
D & N HAVELI,2008,CONSER.OF FORGN.EXCH.&PREV. OF SMUG.ACT,0,0,0,0,0,0,0,0,0,0,0,0,0,0,0
D & N HAVELI,2008,OTHER SLL OFFENCE,0,0,0,0,0,0,0,0,0,0,0,0,0,0,0
D & N HAVELI,2008,TOTAL,0,0,0,0,0,0,0,0,0,0,0,0,0,0,0
D & N HAVELI,2009,ARMS ACT,0,0,0,2,0,2,0,0,0,0,0,0,2,0,2
D & N HAVELI,2009,N.D.P.S. ACT,0,0,0,0,0,0,0,0,0,0,0,0,0,0,0
D & N HAVELI,2009,GAMBLING ACT,0,0,0,0,0,0,0,0,0,0,0,0,0,0,0
D & N HAVELI,2009,EXCISE ACT,0,0,0,0,0,0,0,0,0,0,0,0,0,0,0
D & N HAVELI,2009,PROHIBITION ACT,0,0,0,0,0,0,0,0,0,0,0,0,0,0,0
D & N HAVELI,2009,EXPLOSIVE & EXPLOSIVE SUBST. ACT,0,0,0,0,0,0,0,0,0,0,0,0,0,0,0
D & N HAVELI,2009,TERRORIST & DISRUPTIVE ACTIVITIES (TATA),0,0,0,0,0,0,0,0,0,0,0,0,0,0,0
D & N HAVELI,2009,IMMORAL TRAFFIC (PREVENTION) ACT,0,0,0,0,0,0,0,0,0,0,0,0,0,0,0
D & N HAVELI,2009,INDIAN RAILWAYS ACT,0,0,0,0,0,0,0,0,0,0,0,0,0,0,0
D & N HAVELI,2009,REGISTRATION OF FOREIGNERS ACT,0,0,0,0,0,0,0,0,0,0,0,0,0,0,0
D & N HAVELI,2009,PROTECTION OF CIVIL RIGHTS ACT,0,0,0,0,0,0,0,0,0,0,0,0,0,0,0
D & N HAVELI,2009,SC/ST (PREVENTION OF ATROCITIES) ACT,0,0,0,0,0,0,0,0,0,0,0,0,0,0,0
D & N HAVELI,2009,INDIAN PASSPORT ACT,0,0,0,0,0,0,0,0,0,0,0,0,0,0,0
D & N HAVELI,2009,ESSENTIAL COMMODITIES ACT,0,0,0,0,0,0,0,0,0,0,0,0,0,0,0
D & N HAVELI,2009,ANTIQUITIES AND ART TREASURE ACT,0,0,0,0,0,0,0,0,0,0,0,0,0,0,0
D & N HAVELI,2009,DOWRY PROHIBITION ACT,0,0,0,0,0,0,0,0,0,0,0,0,0,0,0
D & N HAVELI,2009,FOREIGN EXCHANGE REGULATION ACT-1973,0,0,0,0,0,0,0,0,0,0,0,0,0,0,0
D & N HAVELI,2009,PREVENTION OF CORRUPTION ACT-1988,0,0,0,0,0,0,0,0,0,0,0,0,0,0,0
D & N HAVELI,2009,CONSER.OF FORGN.EXCH.&PREV. OF SMUG.ACT,0,0,0,0,0,0,0,0,0,0,0,0,0,0,0
D & N HAVELI,2009,OTHER SLL OFFENCE,0,0,0,0,0,0,0,0,0,0,0,0,0,0,0
D & N HAVELI,2009,TOTAL,0,0,0,2,0,2,0,0,0,0,0,0,2,0,2
D & N HAVELI,2010,ARMS ACT,0,0,0,0,0,0,0,0,0,0,0,0,0,0,0
D & N HAVELI,2010,N.D.P.S. ACT,0,0,0,0,0,0,0,0,0,0,0,0,0,0,0
D & N HAVELI,2010,GAMBLING ACT,0,0,0,0,0,0,0,0,0,0,0,0,0,0,0
D & N HAVELI,2010,EXCISE ACT,0,0,0,0,0,0,0,0,0,0,0,0,0,0,0
D & N HAVELI,2010,PROHIBITION ACT,0,0,0,0,0,0,0,0,0,0,0,0,0,0,0
D & N HAVELI,2010,EXPLOSIVE & EXPLOSIVE SUBST. ACT,0,0,0,0,0,0,0,0,0,0,0,0,0,0,0
D & N HAVELI,2010,TERRORIST & DISRUPTIVE ACTIVITIES (TATA),0,0,0,0,0,0,0,0,0,0,0,0,0,0,0
D & N HAVELI,2010,IMMORAL TRAFFIC (PREVENTION) ACT,0,0,0,0,0,0,0,0,0,0,0,0,0,0,0
D & N HAVELI,2010,INDIAN RAILWAYS ACT,0,0,0,0,0,0,0,0,0,0,0,0,0,0,0
D & N HAVELI,2010,REGISTRATION OF FOREIGNERS ACT,0,0,0,0,0,0,0,0,0,0,0,0,0,0,0
D & N HAVELI,2010,PROTECTION OF CIVIL RIGHTS ACT,0,0,0,0,0,0,0,0,0,0,0,0,0,0,0
D & N HAVELI,2010,SC/ST (PREVENTION OF ATROCITIES) ACT,0,0,0,0,0,0,0,0,0,0,0,0,0,0,0
D & N HAVELI,2010,INDIAN PASSPORT ACT,0,0,0,0,0,0,0,0,0,0,0,0,0,0,0
D & N HAVELI,2010,ESSENTIAL COMMODITIES ACT,0,0,0,0,0,0,0,0,0,0,0,0,0,0,0
D & N HAVELI,2010,ANTIQUITIES AND ART TREASURE ACT,0,0,0,0,0,0,0,0,0,0,0,0,0,0,0
D & N HAVELI,2010,DOWRY PROHIBITION ACT,0,0,0,0,0,0,0,0,0,0,0,0,0,0,0
D & N HAVELI,2010,FOREIGN EXCHANGE REGULATION ACT-1973,0,0,0,0,0,0,0,0,0,0,0,0,0,0,0
D & N HAVELI,2010,PREVENTION OF CORRUPTION ACT-1988,0,0,0,0,0,0,0,0,0,0,0,0,0,0,0
D & N HAVELI,2010,CONSER.OF FORGN.EXCH.&PREV. OF SMUG.ACT,0,0,0,0,0,0,0,0,0,0,0,0,0,0,0
D & N HAVELI,2010,OTHER SLL OFFENCE,0,0,0,0,0,0,0,0,0,0,0,0,0,0,0
D & N HAVELI,2010,TOTAL,0,0,0,0,0,0,0,0,0,0,0,0,0,0,0
D & N HAVELI,2011,ARMS ACT,0,0,0,1,0,1,0,0,0,0,0,0,1,0,1
D & N HAVELI,2011,N.D.P.S. ACT,0,0,0,0,0,0,0,0,0,0,0,0,0,0,0
D & N HAVELI,2011,GAMBLING ACT,0,0,0,0,0,0,0,0,0,0,0,0,0,0,0
D & N HAVELI,2011,EXCISE ACT,0,0,0,0,0,0,0,0,0,0,0,0,0,0,0
D & N HAVELI,2011,PROHIBITION ACT,0,0,0,0,0,0,0,0,0,0,0,0,0,0,0
D & N HAVELI,2011,EXPLOSIVE & EXPLOSIVE SUBST. ACT,0,0,0,1,0,1,0,0,0,0,0,0,1,0,1
D & N HAVELI,2011,TERRORIST & DISRUPTIVE ACTIVITIES (TATA),0,0,0,0,0,0,0,0,0,0,0,0,0,0,0
D & N HAVELI,2011,IMMORAL TRAFFIC (PREVENTION) ACT,0,0,0,0,0,0,0,0,0,0,0,0,0,0,0
D & N HAVELI,2011,INDIAN RAILWAYS ACT,0,0,0,0,0,0,0,0,0,1,0,1,1,0,1
D & N HAVELI,2011,REGISTRATION OF FOREIGNERS ACT,0,0,0,0,0,0,0,0,0,0,0,0,0,0,0
D & N HAVELI,2011,PROTECTION OF CIVIL RIGHTS ACT,0,0,0,0,0,0,0,0,0,0,0,0,0,0,0
D & N HAVELI,2011,SC/ST (PREVENTION OF ATROCITIES) ACT,0,0,0,0,0,0,0,0,0,0,0,0,0,0,0
D & N HAVELI,2011,INDIAN PASSPORT ACT,0,0,0,0,0,0,0,0,0,0,0,0,0,0,0
D & N HAVELI,2011,ESSENTIAL COMMODITIES ACT,0,0,0,0,0,0,0,0,0,0,0,0,0,0,0
D & N HAVELI,2011,ANTIQUITIES AND ART TREASURE ACT,0,0,0,0,0,0,0,0,0,0,0,0,0,0,0
D & N HAVELI,2011,DOWRY PROHIBITION ACT,0,0,0,0,0,0,0,0,0,0,0,0,0,0,0
D & N HAVELI,2011,FOREIGN EXCHANGE REGULATION ACT-1973,0,0,0,0,0,0,0,0,0,0,0,0,0,0,0
D & N HAVELI,2011,PREVENTION OF CORRUPTION ACT-1988,0,0,0,0,0,0,0,0,0,0,0,0,0,0,0
D & N HAVELI,2011,CONSER.OF FORGN.EXCH.&PREV. OF SMUG.ACT,0,0,0,0,0,0,0,0,0,0,0,0,0,0,0
D & N HAVELI,2011,OTHER SLL OFFENCE,0,0,0,0,0,0,0,0,0,0,0,0,0,0,0
D & N HAVELI,2011,TOTAL,0,0,0,2,0,2,0,0,0,1,0,1,3,0,3
D & N HAVELI,2012,ARMS ACT,0,0,0,0,0,0,0,0,0,0,0,0,0,0,0
D & N HAVELI,2012,N.D.P.S. ACT,0,0,0,0,0,0,1,0,1,0,0,0,1,0,1
D & N HAVELI,2012,GAMBLING ACT,0,0,0,0,0,0,1,0,1,0,0,0,1,0,1
D & N HAVELI,2012,EXCISE ACT,0,0,0,0,0,0,0,0,0,0,0,0,0,0,0
D & N HAVELI,2012,PROHIBITION ACT,0,0,0,0,0,0,1,0,1,0,0,0,1,0,1
D & N HAVELI,2012,EXPLOSIVE & EXPLOSIVE SUBST. ACT,0,0,0,0,0,0,0,0,0,0,0,0,0,0,0
D & N HAVELI,2012,TERRORIST & DISRUPTIVE ACTIVITIES (TATA),0,0,0,0,0,0,0,0,0,0,0,0,0,0,0
D & N HAVELI,2012,IMMORAL TRAFFIC (PREVENTION) ACT,0,0,0,0,0,0,0,0,0,0,0,0,0,0,0
D & N HAVELI,2012,INDIAN RAILWAYS ACT,0,0,0,0,0,0,0,0,0,0,0,0,0,0,0
D & N HAVELI,2012,REGISTRATION OF FOREIGNERS ACT,0,0,0,0,0,0,0,0,0,0,0,0,0,0,0
D & N HAVELI,2012,PROTECTION OF CIVIL RIGHTS ACT,0,0,0,0,0,0,0,0,0,0,0,0,0,0,0
D & N HAVELI,2012,SC/ST (PREVENTION OF ATROCITIES) ACT,0,0,0,0,0,0,0,0,0,0,0,0,0,0,0
D & N HAVELI,2012,INDIAN PASSPORT ACT,0,0,0,0,0,0,0,0,0,0,0,0,0,0,0
D & N HAVELI,2012,ESSENTIAL COMMODITIES ACT,0,0,0,0,0,0,0,0,0,0,0,0,0,0,0
D & N HAVELI,2012,ANTIQUITIES AND ART TREASURE ACT,0,0,0,0,0,0,0,0,0,0,0,0,0,0,0
D & N HAVELI,2012,DOWRY PROHIBITION ACT,0,0,0,0,0,0,0,0,0,0,0,0,0,0,0
D & N HAVELI,2012,FOREIGN EXCHANGE REGULATION ACT-1973,0,0,0,0,0,0,0,0,0,0,0,0,0,0,0
D & N HAVELI,2012,PREVENTION OF CORRUPTION ACT-1988,0,0,0,0,0,0,0,0,0,0,0,0,0,0,0
D & N HAVELI,2012,CONSER.OF FORGN.EXCH.&PREV. OF SMUG.ACT,0,0,0,0,0,0,0,0,0,0,0,0,0,0,0
D & N HAVELI,2012,OTHER SLL OFFENCE,0,0,0,0,0,0,0,0,0,0,0,0,0,0,0
D & N HAVELI,2012,TOTAL,0,0,0,0,0,0,3,0,3,0,0,0,3,0,3
DAMAN & DIU,2001,ARMS ACT,0,0,0,0,0,0,0,0,0,0,0,0,0,0,0
DAMAN & DIU,2001,N.D.P.S. ACT,0,0,0,0,0,0,0,0,0,0,0,0,0,0,0
DAMAN & DIU,2001,GAMBLING ACT,0,0,0,0,0,0,0,0,0,0,0,0,0,0,0
DAMAN & DIU,2001,EXCISE ACT,0,0,0,0,0,0,0,0,0,0,0,0,0,0,0
DAMAN & DIU,2001,PROHIBITION ACT,0,0,0,0,0,0,0,0,0,0,0,0,0,0,0
DAMAN & DIU,2001,EXPLOSIVE & EXPLOSIVE SUBST. ACT,0,0,0,0,0,0,0,0,0,0,0,0,0,0,0
DAMAN & DIU,2001,TERRORIST & DISRUPTIVE ACTIVITIES (TATA),0,0,0,0,0,0,0,0,0,0,0,0,0,0,0
DAMAN & DIU,2001,IMMORAL TRAFFIC (PREVENTION) ACT,0,0,0,0,0,0,0,0,0,0,0,0,0,0,0
DAMAN & DIU,2001,INDIAN RAILWAYS ACT,0,0,0,0,0,0,0,0,0,0,0,0,0,0,0
DAMAN & DIU,2001,REGISTRATION OF FOREIGNERS ACT,0,0,0,0,0,0,0,0,0,0,0,0,0,0,0
DAMAN & DIU,2001,PROTECTION OF CIVIL RIGHTS ACT,0,0,0,0,0,0,0,0,0,0,0,0,0,0,0
DAMAN & DIU,2001,SC/ST (PREVENTION OF ATROCITIES) ACT,0,0,0,0,0,0,0,0,0,0,0,0,0,0,0
DAMAN & DIU,2001,INDIAN PASSPORT ACT,0,0,0,0,0,0,0,0,0,0,0,0,0,0,0
DAMAN & DIU,2001,ESSENTIAL COMMODITIES ACT,0,0,0,0,0,0,0,0,0,0,0,0,0,0,0
DAMAN & DIU,2001,ANTIQUITIES AND ART TREASURE ACT,0,0,0,0,0,0,0,0,0,0,0,0,0,0,0
DAMAN & DIU,2001,DOWRY PROHIBITION ACT,0,0,0,0,0,0,0,0,0,0,0,0,0,0,0
DAMAN & DIU,2001,FOREIGN EXCHANGE REGULATION ACT-1973,0,0,0,0,0,0,0,0,0,0,0,0,0,0,0
DAMAN & DIU,2001,PREVENTION OF CORRUPTION ACT-1988,0,0,0,0,0,0,0,0,0,0,0,0,0,0,0
DAMAN & DIU,2001,CONSER.OF FORGN.EXCH.&PREV. OF SMUG.ACT,0,0,0,0,0,0,0,0,0,0,0,0,0,0,0
DAMAN & DIU,2001,OTHER SLL OFFENCE,0,0,0,0,0,0,0,0,0,0,0,0,0,0,0
DAMAN & DIU,2001,TOTAL,0,0,0,0,0,0,0,0,0,0,0,0,0,0,0
DAMAN & DIU,2002,ARMS ACT,0,0,0,1,0,1,0,0,0,0,0,0,1,0,1
DAMAN & DIU,2002,N.D.P.S. ACT,0,0,0,0,0,0,0,0,0,0,0,0,0,0,0
DAMAN & DIU,2002,GAMBLING ACT,0,0,0,0,0,0,0,0,0,0,0,0,0,0,0
DAMAN & DIU,2002,EXCISE ACT,0,0,0,0,0,0,0,0,0,0,0,0,0,0,0
DAMAN & DIU,2002,PROHIBITION ACT,0,0,0,0,0,0,0,0,0,0,0,0,0,0,0
DAMAN & DIU,2002,EXPLOSIVE & EXPLOSIVE SUBST. ACT,0,0,0,0,0,0,0,0,0,0,0,0,0,0,0
DAMAN & DIU,2002,TERRORIST & DISRUPTIVE ACTIVITIES (TATA),0,0,0,0,0,0,0,0,0,0,0,0,0,0,0
DAMAN & DIU,2002,IMMORAL TRAFFIC (PREVENTION) ACT,0,0,0,0,0,0,0,0,0,0,0,0,0,0,0
DAMAN & DIU,2002,INDIAN RAILWAYS ACT,0,0,0,0,0,0,0,0,0,0,0,0,0,0,0
DAMAN & DIU,2002,REGISTRATION OF FOREIGNERS ACT,0,0,0,0,0,0,0,0,0,0,0,0,0,0,0
DAMAN & DIU,2002,PROTECTION OF CIVIL RIGHTS ACT,0,0,0,0,0,0,0,0,0,0,0,0,0,0,0
DAMAN & DIU,2002,SC/ST (PREVENTION OF ATROCITIES) ACT,0,0,0,0,0,0,0,0,0,0,0,0,0,0,0
DAMAN & DIU,2002,INDIAN PASSPORT ACT,0,0,0,0,0,0,0,0,0,0,0,0,0,0,0
DAMAN & DIU,2002,ESSENTIAL COMMODITIES ACT,0,0,0,0,0,0,0,0,0,0,0,0,0,0,0
DAMAN & DIU,2002,ANTIQUITIES AND ART TREASURE ACT,0,0,0,0,0,0,0,0,0,0,0,0,0,0,0
DAMAN & DIU,2002,DOWRY PROHIBITION ACT,0,0,0,0,0,0,0,0,0,0,0,0,0,0,0
DAMAN & DIU,2002,FOREIGN EXCHANGE REGULATION ACT-1973,0,0,0,0,0,0,0,0,0,0,0,0,0,0,0
DAMAN & DIU,2002,PREVENTION OF CORRUPTION ACT-1988,0,0,0,0,0,0,0,0,0,0,0,0,0,0,0
DAMAN & DIU,2002,CONSER.OF FORGN.EXCH.&PREV. OF SMUG.ACT,0,0,0,0,0,0,0,0,0,0,0,0,0,0,0
DAMAN & DIU,2002,OTHER SLL OFFENCE,0,0,0,0,0,0,0,0,0,0,0,0,0,0,0
DAMAN & DIU,2002,TOTAL,0,0,0,1,0,1,0,0,0,0,0,0,1,0,1
DAMAN & DIU,2003,ARMS ACT,0,0,0,0,0,0,0,0,0,0,0,0,0,0,0
DAMAN & DIU,2003,N.D.P.S. ACT,0,0,0,0,0,0,0,0,0,0,0,0,0,0,0
DAMAN & DIU,2003,GAMBLING ACT,0,0,0,0,0,0,0,0,0,0,0,0,0,0,0
DAMAN & DIU,2003,EXCISE ACT,0,0,0,0,0,0,0,0,0,0,0,0,0,0,0
DAMAN & DIU,2003,PROHIBITION ACT,0,0,0,0,0,0,0,0,0,0,0,0,0,0,0
DAMAN & DIU,2003,EXPLOSIVE & EXPLOSIVE SUBST. ACT,0,0,0,0,0,0,0,0,0,0,0,0,0,0,0
DAMAN & DIU,2003,TERRORIST & DISRUPTIVE ACTIVITIES (TATA),0,0,0,0,0,0,0,0,0,0,0,0,0,0,0
DAMAN & DIU,2003,IMMORAL TRAFFIC (PREVENTION) ACT,0,0,0,0,0,0,0,0,0,0,0,0,0,0,0
DAMAN & DIU,2003,INDIAN RAILWAYS ACT,0,0,0,0,0,0,0,0,0,0,0,0,0,0,0
DAMAN & DIU,2003,REGISTRATION OF FOREIGNERS ACT,0,0,0,0,0,0,0,0,0,0,0,0,0,0,0
DAMAN & DIU,2003,PROTECTION OF CIVIL RIGHTS ACT,0,0,0,0,0,0,0,0,0,0,0,0,0,0,0
DAMAN & DIU,2003,SC/ST (PREVENTION OF ATROCITIES) ACT,0,0,0,0,0,0,0,0,0,0,0,0,0,0,0
DAMAN & DIU,2003,INDIAN PASSPORT ACT,0,0,0,0,0,0,0,0,0,0,0,0,0,0,0
DAMAN & DIU,2003,ESSENTIAL COMMODITIES ACT,0,0,0,0,0,0,0,0,0,0,0,0,0,0,0
DAMAN & DIU,2003,ANTIQUITIES AND ART TREASURE ACT,0,0,0,0,0,0,0,0,0,0,0,0,0,0,0
DAMAN & DIU,2003,DOWRY PROHIBITION ACT,0,0,0,0,0,0,0,0,0,0,0,0,0,0,0
DAMAN & DIU,2003,FOREIGN EXCHANGE REGULATION ACT-1973,0,0,0,0,0,0,0,0,0,0,0,0,0,0,0
DAMAN & DIU,2003,PREVENTION OF CORRUPTION ACT-1988,0,0,0,0,0,0,0,0,0,0,0,0,0,0,0
DAMAN & DIU,2003,CONSER.OF FORGN.EXCH.&PREV. OF SMUG.ACT,0,0,0,0,0,0,0,0,0,0,0,0,0,0,0
DAMAN & DIU,2003,OTHER SLL OFFENCE,0,0,0,0,0,0,0,0,0,0,0,0,0,0,0
DAMAN & DIU,2003,TOTAL,0,0,0,0,0,0,0,0,0,0,0,0,0,0,0
DAMAN & DIU,2004,ARMS ACT,0,0,0,0,0,0,0,0,0,0,0,0,0,0,0
DAMAN & DIU,2004,N.D.P.S. ACT,0,0,0,0,0,0,0,0,0,0,0,0,0,0,0
DAMAN & DIU,2004,GAMBLING ACT,0,0,0,0,0,0,0,0,0,0,0,0,0,0,0
DAMAN & DIU,2004,EXCISE ACT,0,0,0,0,0,0,0,0,0,0,0,0,0,0,0
DAMAN & DIU,2004,PROHIBITION ACT,0,0,0,0,0,0,0,0,0,0,0,0,0,0,0
DAMAN & DIU,2004,EXPLOSIVE & EXPLOSIVE SUBST. ACT,0,0,0,0,0,0,0,0,0,0,0,0,0,0,0
DAMAN & DIU,2004,TERRORIST & DISRUPTIVE ACTIVITIES (TATA),0,0,0,0,0,0,0,0,0,0,0,0,0,0,0
DAMAN & DIU,2004,IMMORAL TRAFFIC (PREVENTION) ACT,0,0,0,0,0,0,0,0,0,0,0,0,0,0,0
DAMAN & DIU,2004,INDIAN RAILWAYS ACT,0,0,0,0,0,0,0,0,0,0,0,0,0,0,0
DAMAN & DIU,2004,REGISTRATION OF FOREIGNERS ACT,0,0,0,0,0,0,0,0,0,0,0,0,0,0,0
DAMAN & DIU,2004,PROTECTION OF CIVIL RIGHTS ACT,0,0,0,0,0,0,0,0,0,0,0,0,0,0,0
DAMAN & DIU,2004,SC/ST (PREVENTION OF ATROCITIES) ACT,0,0,0,0,0,0,0,0,0,0,0,0,0,0,0
DAMAN & DIU,2004,INDIAN PASSPORT ACT,0,0,0,0,0,0,0,0,0,0,0,0,0,0,0
DAMAN & DIU,2004,ESSENTIAL COMMODITIES ACT,0,0,0,0,0,0,0,0,0,0,0,0,0,0,0
DAMAN & DIU,2004,ANTIQUITIES AND ART TREASURE ACT,0,0,0,0,0,0,0,0,0,0,0,0,0,0,0
DAMAN & DIU,2004,DOWRY PROHIBITION ACT,0,0,0,0,0,0,0,0,0,0,0,0,0,0,0
DAMAN & DIU,2004,FOREIGN EXCHANGE REGULATION ACT-1973,0,0,0,0,0,0,0,0,0,0,0,0,0,0,0
DAMAN & DIU,2004,PREVENTION OF CORRUPTION ACT-1988,0,0,0,0,0,0,0,0,0,0,0,0,0,0,0
DAMAN & DIU,2004,CONSER.OF FORGN.EXCH.&PREV. OF SMUG.ACT,0,0,0,0,0,0,0,0,0,0,0,0,0,0,0
DAMAN & DIU,2004,OTHER SLL OFFENCE,0,0,0,0,0,0,0,0,0,0,0,0,0,0,0
DAMAN & DIU,2004,TOTAL,0,0,0,0,0,0,0,0,0,0,0,0,0,0,0
DAMAN & DIU,2005,ARMS ACT,0,0,0,0,0,0,0,0,0,0,0,0,0,0,0
DAMAN & DIU,2005,N.D.P.S. ACT,0,0,0,4,0,4,0,0,0,0,0,0,4,0,4
DAMAN & DIU,2005,GAMBLING ACT,0,0,0,0,0,0,0,0,0,0,0,0,0,0,0
DAMAN & DIU,2005,EXCISE ACT,0,0,0,0,0,0,0,0,0,0,0,0,0,0,0
DAMAN & DIU,2005,PROHIBITION ACT,0,0,0,0,0,0,0,0,0,0,0,0,0,0,0
DAMAN & DIU,2005,EXPLOSIVE & EXPLOSIVE SUBST. ACT,0,0,0,0,0,0,0,0,0,0,0,0,0,0,0
DAMAN & DIU,2005,TERRORIST & DISRUPTIVE ACTIVITIES (TATA),0,0,0,0,0,0,0,0,0,0,0,0,0,0,0
DAMAN & DIU,2005,IMMORAL TRAFFIC (PREVENTION) ACT,0,0,0,0,0,0,0,0,0,0,0,0,0,0,0
DAMAN & DIU,2005,INDIAN RAILWAYS ACT,0,0,0,0,0,0,0,0,0,0,0,0,0,0,0
DAMAN & DIU,2005,REGISTRATION OF FOREIGNERS ACT,0,0,0,0,0,0,0,0,0,0,0,0,0,0,0
DAMAN & DIU,2005,PROTECTION OF CIVIL RIGHTS ACT,0,0,0,0,0,0,0,0,0,0,0,0,0,0,0
DAMAN & DIU,2005,SC/ST (PREVENTION OF ATROCITIES) ACT,0,0,0,0,0,0,1,0,1,0,0,0,1,0,1
DAMAN & DIU,2005,INDIAN PASSPORT ACT,0,0,0,0,0,0,0,0,0,0,0,0,0,0,0
DAMAN & DIU,2005,ESSENTIAL COMMODITIES ACT,0,0,0,0,0,0,0,0,0,0,0,0,0,0,0
DAMAN & DIU,2005,ANTIQUITIES AND ART TREASURE ACT,0,0,0,0,0,0,0,0,0,0,0,0,0,0,0
DAMAN & DIU,2005,DOWRY PROHIBITION ACT,0,0,0,0,0,0,0,0,0,0,0,0,0,0,0
DAMAN & DIU,2005,FOREIGN EXCHANGE REGULATION ACT-1973,0,0,0,0,0,0,0,0,0,0,0,0,0,0,0
DAMAN & DIU,2005,PREVENTION OF CORRUPTION ACT-1988,0,0,0,0,0,0,0,0,0,0,0,0,0,0,0
DAMAN & DIU,2005,CONSER.OF FORGN.EXCH.&PREV. OF SMUG.ACT,0,0,0,0,0,0,0,0,0,0,0,0,0,0,0
DAMAN & DIU,2005,OTHER SLL OFFENCE,0,0,0,0,0,0,0,0,0,0,0,0,0,0,0
DAMAN & DIU,2005,TOTAL,0,0,0,4,0,4,1,0,1,0,0,0,5,0,5
DAMAN & DIU,2006,ARMS ACT,0,0,0,0,0,0,0,0,0,0,0,0,0,0,0
DAMAN & DIU,2006,N.D.P.S. ACT,0,0,0,0,0,0,0,0,0,0,0,0,0,0,0
DAMAN & DIU,2006,GAMBLING ACT,0,0,0,0,0,0,0,0,0,0,0,0,0,0,0
DAMAN & DIU,2006,EXCISE ACT,0,0,0,0,0,0,0,0,0,0,0,0,0,0,0
DAMAN & DIU,2006,PROHIBITION ACT,0,0,0,0,0,0,0,0,0,0,0,0,0,0,0
DAMAN & DIU,2006,EXPLOSIVE & EXPLOSIVE SUBST. ACT,0,0,0,0,0,0,0,0,0,0,0,0,0,0,0
DAMAN & DIU,2006,TERRORIST & DISRUPTIVE ACTIVITIES (TATA),0,0,0,0,0,0,0,0,0,0,0,0,0,0,0
DAMAN & DIU,2006,IMMORAL TRAFFIC (PREVENTION) ACT,0,0,0,0,0,0,0,0,0,0,0,0,0,0,0
DAMAN & DIU,2006,INDIAN RAILWAYS ACT,0,0,0,0,0,0,0,0,0,0,0,0,0,0,0
DAMAN & DIU,2006,REGISTRATION OF FOREIGNERS ACT,0,0,0,0,0,0,0,0,0,0,0,0,0,0,0
DAMAN & DIU,2006,PROTECTION OF CIVIL RIGHTS ACT,0,0,0,0,0,0,0,0,0,0,0,0,0,0,0
DAMAN & DIU,2006,SC/ST (PREVENTION OF ATROCITIES) ACT,0,0,0,0,0,0,0,0,0,0,0,0,0,0,0
DAMAN & DIU,2006,INDIAN PASSPORT ACT,0,0,0,0,0,0,0,0,0,0,0,0,0,0,0
DAMAN & DIU,2006,ESSENTIAL COMMODITIES ACT,0,0,0,0,0,0,0,0,0,0,0,0,0,0,0
DAMAN & DIU,2006,ANTIQUITIES AND ART TREASURE ACT,0,0,0,0,0,0,0,0,0,0,0,0,0,0,0
DAMAN & DIU,2006,DOWRY PROHIBITION ACT,0,0,0,0,0,0,0,0,0,0,0,0,0,0,0
DAMAN & DIU,2006,FOREIGN EXCHANGE REGULATION ACT-1973,0,0,0,0,0,0,0,0,0,0,0,0,0,0,0
DAMAN & DIU,2006,PREVENTION OF CORRUPTION ACT-1988,0,0,0,0,0,0,0,0,0,0,0,0,0,0,0
DAMAN & DIU,2006,CONSER.OF FORGN.EXCH.&PREV. OF SMUG.ACT,0,0,0,0,0,0,0,0,0,0,0,0,0,0,0
DAMAN & DIU,2006,OTHER SLL OFFENCE,0,0,0,0,0,0,0,0,0,0,0,0,0,0,0
DAMAN & DIU,2006,TOTAL,0,0,0,0,0,0,0,0,0,0,0,0,0,0,0
DAMAN & DIU,2007,ARMS ACT,0,0,0,0,0,0,0,0,0,0,0,0,0,0,0
DAMAN & DIU,2007,N.D.P.S. ACT,0,0,0,0,0,0,2,0,2,0,0,0,2,0,2
DAMAN & DIU,2007,GAMBLING ACT,0,0,0,0,0,0,0,0,0,0,0,0,0,0,0
DAMAN & DIU,2007,EXCISE ACT,0,0,0,0,0,0,0,0,0,0,0,0,0,0,0
DAMAN & DIU,2007,PROHIBITION ACT,0,0,0,0,0,0,0,0,0,0,0,0,0,0,0
DAMAN & DIU,2007,EXPLOSIVE & EXPLOSIVE SUBST. ACT,0,0,0,0,0,0,0,0,0,0,0,0,0,0,0
DAMAN & DIU,2007,TERRORIST & DISRUPTIVE ACTIVITIES (TATA),0,0,0,0,0,0,0,0,0,0,0,0,0,0,0
DAMAN & DIU,2007,IMMORAL TRAFFIC (PREVENTION) ACT,0,0,0,0,0,0,0,0,0,0,0,0,0,0,0
DAMAN & DIU,2007,INDIAN RAILWAYS ACT,0,0,0,0,0,0,0,0,0,0,0,0,0,0,0
DAMAN & DIU,2007,REGISTRATION OF FOREIGNERS ACT,0,0,0,0,0,0,0,0,0,0,0,0,0,0,0
DAMAN & DIU,2007,PROTECTION OF CIVIL RIGHTS ACT,0,0,0,0,0,0,0,0,0,0,0,0,0,0,0
DAMAN & DIU,2007,SC/ST (PREVENTION OF ATROCITIES) ACT,0,0,0,0,0,0,0,0,0,0,0,0,0,0,0
DAMAN & DIU,2007,INDIAN PASSPORT ACT,0,0,0,0,0,0,0,0,0,0,0,0,0,0,0
DAMAN & DIU,2007,ESSENTIAL COMMODITIES ACT,0,0,0,0,0,0,0,0,0,0,0,0,0,0,0
DAMAN & DIU,2007,ANTIQUITIES AND ART TREASURE ACT,0,0,0,0,0,0,0,0,0,0,0,0,0,0,0
DAMAN & DIU,2007,DOWRY PROHIBITION ACT,0,0,0,0,0,0,0,0,0,0,0,0,0,0,0
DAMAN & DIU,2007,FOREIGN EXCHANGE REGULATION ACT-1973,0,0,0,0,0,0,0,0,0,0,0,0,0,0,0
DAMAN & DIU,2007,PREVENTION OF CORRUPTION ACT-1988,0,0,0,0,0,0,0,0,0,0,0,0,0,0,0
DAMAN & DIU,2007,CONSER.OF FORGN.EXCH.&PREV. OF SMUG.ACT,0,0,0,0,0,0,0,0,0,0,0,0,0,0,0
DAMAN & DIU,2007,OTHER SLL OFFENCE,0,0,0,0,0,0,0,0,0,0,0,0,0,0,0
DAMAN & DIU,2007,TOTAL,0,0,0,0,0,0,2,0,2,0,0,0,2,0,2
DAMAN & DIU,2008,ARMS ACT,0,0,0,0,0,0,0,0,0,0,0,0,0,0,0
DAMAN & DIU,2008,N.D.P.S. ACT,0,0,0,0,0,0,0,0,0,0,0,0,0,0,0
DAMAN & DIU,2008,GAMBLING ACT,0,0,0,0,0,0,0,0,0,0,0,0,0,0,0
DAMAN & DIU,2008,EXCISE ACT,0,0,0,0,0,0,0,0,0,0,0,0,0,0,0
DAMAN & DIU,2008,PROHIBITION ACT,0,0,0,0,0,0,0,0,0,0,0,0,0,0,0
DAMAN & DIU,2008,EXPLOSIVE & EXPLOSIVE SUBST. ACT,0,0,0,0,0,0,0,0,0,0,0,0,0,0,0
DAMAN & DIU,2008,TERRORIST & DISRUPTIVE ACTIVITIES (TATA),0,0,0,0,0,0,0,0,0,0,0,0,0,0,0
DAMAN & DIU,2008,IMMORAL TRAFFIC (PREVENTION) ACT,0,0,0,0,0,0,0,0,0,0,0,0,0,0,0
DAMAN & DIU,2008,INDIAN RAILWAYS ACT,0,0,0,0,0,0,0,0,0,0,0,0,0,0,0
DAMAN & DIU,2008,REGISTRATION OF FOREIGNERS ACT,0,0,0,0,0,0,0,0,0,0,0,0,0,0,0
DAMAN & DIU,2008,PROTECTION OF CIVIL RIGHTS ACT,0,0,0,0,0,0,0,0,0,0,0,0,0,0,0
DAMAN & DIU,2008,SC/ST (PREVENTION OF ATROCITIES) ACT,0,0,0,0,0,0,0,0,0,0,0,0,0,0,0
DAMAN & DIU,2008,INDIAN PASSPORT ACT,0,0,0,0,0,0,0,0,0,0,0,0,0,0,0
DAMAN & DIU,2008,ESSENTIAL COMMODITIES ACT,0,0,0,0,0,0,0,0,0,0,0,0,0,0,0
DAMAN & DIU,2008,ANTIQUITIES AND ART TREASURE ACT,0,0,0,0,0,0,0,0,0,0,0,0,0,0,0
DAMAN & DIU,2008,DOWRY PROHIBITION ACT,0,0,0,0,0,0,0,0,0,0,0,0,0,0,0
DAMAN & DIU,2008,FOREIGN EXCHANGE REGULATION ACT-1973,0,0,0,0,0,0,0,0,0,0,0,0,0,0,0
DAMAN & DIU,2008,PREVENTION OF CORRUPTION ACT-1988,0,0,0,0,0,0,0,0,0,0,0,0,0,0,0
DAMAN & DIU,2008,CONSER.OF FORGN.EXCH.&PREV. OF SMUG.ACT,0,0,0,0,0,0,0,0,0,0,0,0,0,0,0
DAMAN & DIU,2008,OTHER SLL OFFENCE,0,0,0,0,0,0,0,0,0,0,0,0,0,0,0
DAMAN & DIU,2008,TOTAL,0,0,0,0,0,0,0,0,0,0,0,0,0,0,0
DAMAN & DIU,2009,ARMS ACT,0,0,0,0,0,0,0,0,0,0,0,0,0,0,0
DAMAN & DIU,2009,N.D.P.S. ACT,0,0,0,0,0,0,0,0,0,0,0,0,0,0,0
DAMAN & DIU,2009,GAMBLING ACT,0,0,0,0,0,0,0,0,0,0,0,0,0,0,0
DAMAN & DIU,2009,EXCISE ACT,0,0,0,0,0,0,0,0,0,0,0,0,0,0,0
DAMAN & DIU,2009,PROHIBITION ACT,0,0,0,0,0,0,0,0,0,0,0,0,0,0,0
DAMAN & DIU,2009,EXPLOSIVE & EXPLOSIVE SUBST. ACT,0,0,0,0,0,0,0,0,0,0,0,0,0,0,0
DAMAN & DIU,2009,TERRORIST & DISRUPTIVE ACTIVITIES (TATA),0,0,0,0,0,0,0,0,0,0,0,0,0,0,0
DAMAN & DIU,2009,IMMORAL TRAFFIC (PREVENTION) ACT,0,0,0,0,0,0,0,0,0,0,0,0,0,0,0
DAMAN & DIU,2009,INDIAN RAILWAYS ACT,0,0,0,0,0,0,0,0,0,0,0,0,0,0,0
DAMAN & DIU,2009,REGISTRATION OF FOREIGNERS ACT,0,0,0,0,0,0,0,0,0,0,0,0,0,0,0
DAMAN & DIU,2009,PROTECTION OF CIVIL RIGHTS ACT,0,0,0,0,0,0,0,0,0,0,0,0,0,0,0
DAMAN & DIU,2009,SC/ST (PREVENTION OF ATROCITIES) ACT,0,0,0,0,0,0,0,0,0,0,0,0,0,0,0
DAMAN & DIU,2009,INDIAN PASSPORT ACT,0,0,0,0,0,0,0,0,0,0,0,0,0,0,0
DAMAN & DIU,2009,ESSENTIAL COMMODITIES ACT,0,0,0,0,0,0,0,0,0,0,0,0,0,0,0
DAMAN & DIU,2009,ANTIQUITIES AND ART TREASURE ACT,0,0,0,0,0,0,0,0,0,0,0,0,0,0,0
DAMAN & DIU,2009,DOWRY PROHIBITION ACT,0,0,0,0,0,0,0,0,0,0,0,0,0,0,0
DAMAN & DIU,2009,FOREIGN EXCHANGE REGULATION ACT-1973,0,0,0,0,0,0,0,0,0,0,0,0,0,0,0
DAMAN & DIU,2009,PREVENTION OF CORRUPTION ACT-1988,0,0,0,0,0,0,0,0,0,0,0,0,0,0,0
DAMAN & DIU,2009,CONSER.OF FORGN.EXCH.&PREV. OF SMUG.ACT,0,0,0,0,0,0,0,0,0,0,0,0,0,0,0
DAMAN & DIU,2009,OTHER SLL OFFENCE,0,0,0,0,0,0,0,0,0,0,0,0,0,0,0
DAMAN & DIU,2009,TOTAL,0,0,0,0,0,0,0,0,0,0,0,0,0,0,0
DAMAN & DIU,2010,ARMS ACT,0,0,0,0,0,0,0,0,0,0,0,0,0,0,0
DAMAN & DIU,2010,N.D.P.S. ACT,0,0,0,0,0,0,0,0,0,0,0,0,0,0,0
DAMAN & DIU,2010,GAMBLING ACT,0,0,0,0,0,0,0,0,0,0,0,0,0,0,0
DAMAN & DIU,2010,EXCISE ACT,0,0,0,0,0,0,0,0,0,0,0,0,0,0,0
DAMAN & DIU,2010,PROHIBITION ACT,0,0,0,0,0,0,0,0,0,0,0,0,0,0,0
DAMAN & DIU,2010,EXPLOSIVE & EXPLOSIVE SUBST. ACT,0,0,0,0,0,0,0,0,0,0,0,0,0,0,0
DAMAN & DIU,2010,TERRORIST & DISRUPTIVE ACTIVITIES (TATA),0,0,0,0,0,0,0,0,0,0,0,0,0,0,0
DAMAN & DIU,2010,IMMORAL TRAFFIC (PREVENTION) ACT,0,0,0,0,0,0,0,0,0,0,0,0,0,0,0
DAMAN & DIU,2010,INDIAN RAILWAYS ACT,0,0,0,0,0,0,0,0,0,0,0,0,0,0,0
DAMAN & DIU,2010,REGISTRATION OF FOREIGNERS ACT,0,0,0,0,0,0,0,0,0,0,0,0,0,0,0
DAMAN & DIU,2010,PROTECTION OF CIVIL RIGHTS ACT,0,0,0,0,0,0,0,0,0,0,0,0,0,0,0
DAMAN & DIU,2010,SC/ST (PREVENTION OF ATROCITIES) ACT,0,0,0,0,0,0,0,0,0,0,0,0,0,0,0
DAMAN & DIU,2010,INDIAN PASSPORT ACT,0,0,0,0,0,0,0,0,0,0,0,0,0,0,0
DAMAN & DIU,2010,ESSENTIAL COMMODITIES ACT,0,0,0,0,0,0,0,0,0,0,0,0,0,0,0
DAMAN & DIU,2010,ANTIQUITIES AND ART TREASURE ACT,0,0,0,0,0,0,0,0,0,0,0,0,0,0,0
DAMAN & DIU,2010,DOWRY PROHIBITION ACT,0,0,0,0,0,0,0,0,0,0,0,0,0,0,0
DAMAN & DIU,2010,FOREIGN EXCHANGE REGULATION ACT-1973,0,0,0,0,0,0,0,0,0,0,0,0,0,0,0
DAMAN & DIU,2010,PREVENTION OF CORRUPTION ACT-1988,0,0,0,0,0,0,0,0,0,0,0,0,0,0,0
DAMAN & DIU,2010,CONSER.OF FORGN.EXCH.&PREV. OF SMUG.ACT,0,0,0,0,0,0,0,0,0,0,0,0,0,0,0
DAMAN & DIU,2010,OTHER SLL OFFENCE,0,0,0,0,0,0,0,0,0,0,0,0,0,0,0
DAMAN & DIU,2010,TOTAL,0,0,0,0,0,0,0,0,0,0,0,0,0,0,0
DAMAN & DIU,2011,ARMS ACT,0,0,0,0,0,0,0,0,0,0,0,0,0,0,0
DAMAN & DIU,2011,N.D.P.S. ACT,0,0,0,0,0,0,0,0,0,0,0,0,0,0,0
DAMAN & DIU,2011,GAMBLING ACT,0,0,0,0,0,0,0,0,0,0,0,0,0,0,0
DAMAN & DIU,2011,EXCISE ACT,0,0,0,0,0,0,0,0,0,0,0,0,0,0,0
DAMAN & DIU,2011,PROHIBITION ACT,0,0,0,0,0,0,0,0,0,0,0,0,0,0,0
DAMAN & DIU,2011,EXPLOSIVE & EXPLOSIVE SUBST. ACT,0,0,0,0,0,0,0,0,0,0,0,0,0,0,0
DAMAN & DIU,2011,TERRORIST & DISRUPTIVE ACTIVITIES (TATA),0,0,0,0,0,0,0,0,0,0,0,0,0,0,0
DAMAN & DIU,2011,IMMORAL TRAFFIC (PREVENTION) ACT,0,0,0,0,0,0,0,0,0,0,0,0,0,0,0
DAMAN & DIU,2011,INDIAN RAILWAYS ACT,0,0,0,0,0,0,0,0,0,0,0,0,0,0,0
DAMAN & DIU,2011,REGISTRATION OF FOREIGNERS ACT,0,0,0,0,0,0,0,0,0,0,0,0,0,0,0
DAMAN & DIU,2011,PROTECTION OF CIVIL RIGHTS ACT,0,0,0,0,0,0,0,0,0,0,0,0,0,0,0
DAMAN & DIU,2011,SC/ST (PREVENTION OF ATROCITIES) ACT,0,0,0,0,0,0,0,0,0,0,0,0,0,0,0
DAMAN & DIU,2011,INDIAN PASSPORT ACT,0,0,0,0,0,0,0,0,0,0,0,0,0,0,0
DAMAN & DIU,2011,ESSENTIAL COMMODITIES ACT,0,0,0,0,0,0,0,0,0,0,0,0,0,0,0
DAMAN & DIU,2011,ANTIQUITIES AND ART TREASURE ACT,0,0,0,0,0,0,0,0,0,0,0,0,0,0,0
DAMAN & DIU,2011,DOWRY PROHIBITION ACT,0,0,0,0,0,0,0,0,0,0,0,0,0,0,0
DAMAN & DIU,2011,FOREIGN EXCHANGE REGULATION ACT-1973,0,0,0,0,0,0,0,0,0,0,0,0,0,0,0
DAMAN & DIU,2011,PREVENTION OF CORRUPTION ACT-1988,0,0,0,0,0,0,0,0,0,0,0,0,0,0,0
DAMAN & DIU,2011,CONSER.OF FORGN.EXCH.&PREV. OF SMUG.ACT,0,0,0,0,0,0,0,0,0,0,0,0,0,0,0
DAMAN & DIU,2011,OTHER SLL OFFENCE,0,0,0,0,0,0,0,0,0,0,0,0,0,0,0
DAMAN & DIU,2011,TOTAL,0,0,0,0,0,0,0,0,0,0,0,0,0,0,0
DAMAN & DIU,2012,ARMS ACT,0,0,0,0,0,0,0,0,0,0,0,0,0,0,0
DAMAN & DIU,2012,N.D.P.S. ACT,0,0,0,0,0,0,0,0,0,0,0,0,0,0,0
DAMAN & DIU,2012,GAMBLING ACT,0,0,0,0,0,0,0,0,0,0,0,0,0,0,0
DAMAN & DIU,2012,EXCISE ACT,0,0,0,0,0,0,0,0,0,0,0,0,0,0,0
DAMAN & DIU,2012,PROHIBITION ACT,0,0,0,0,0,0,0,0,0,0,0,0,0,0,0
DAMAN & DIU,2012,EXPLOSIVE & EXPLOSIVE SUBST. ACT,0,0,0,0,0,0,0,0,0,0,0,0,0,0,0
DAMAN & DIU,2012,TERRORIST & DISRUPTIVE ACTIVITIES (TATA),0,0,0,0,0,0,0,0,0,0,0,0,0,0,0
DAMAN & DIU,2012,IMMORAL TRAFFIC (PREVENTION) ACT,0,0,0,0,0,0,0,0,0,0,0,0,0,0,0
DAMAN & DIU,2012,INDIAN RAILWAYS ACT,0,0,0,0,0,0,0,0,0,0,0,0,0,0,0
DAMAN & DIU,2012,REGISTRATION OF FOREIGNERS ACT,0,0,0,0,0,0,0,0,0,0,0,0,0,0,0
DAMAN & DIU,2012,PROTECTION OF CIVIL RIGHTS ACT,0,0,0,0,0,0,0,0,0,0,0,0,0,0,0
DAMAN & DIU,2012,SC/ST (PREVENTION OF ATROCITIES) ACT,0,0,0,0,0,0,0,0,0,0,0,0,0,0,0
DAMAN & DIU,2012,INDIAN PASSPORT ACT,0,0,0,0,0,0,0,0,0,0,0,0,0,0,0
DAMAN & DIU,2012,ESSENTIAL COMMODITIES ACT,0,0,0,0,0,0,0,0,0,0,0,0,0,0,0
DAMAN & DIU,2012,ANTIQUITIES AND ART TREASURE ACT,0,0,0,0,0,0,0,0,0,0,0,0,0,0,0
DAMAN & DIU,2012,DOWRY PROHIBITION ACT,0,0,0,0,0,0,0,0,0,0,0,0,0,0,0
DAMAN & DIU,2012,FOREIGN EXCHANGE REGULATION ACT-1973,0,0,0,0,0,0,0,0,0,0,0,0,0,0,0
DAMAN & DIU,2012,PREVENTION OF CORRUPTION ACT-1988,0,0,0,0,0,0,0,0,0,0,0,0,0,0,0
DAMAN & DIU,2012,CONSER.OF FORGN.EXCH.&PREV. OF SMUG.ACT,0,0,0,0,0,0,0,0,0,0,0,0,0,0,0
DAMAN & DIU,2012,OTHER SLL OFFENCE,0,0,0,0,0,0,0,0,0,0,0,0,0,0,0
DAMAN & DIU,2012,TOTAL,0,0,0,0,0,0,0,0,0,0,0,0,0,0,0
DELHI,2001,ARMS ACT,31,0,31,373,2,375,145,0,145,4,0,4,553,2,555
DELHI,2001,N.D.P.S. ACT,7,0,7,300,27,327,313,30,343,28,14,42,648,71,719
DELHI,2001,GAMBLING ACT,5,0,5,18,0,18,1,0,1,1,0,1,25,0,25
DELHI,2001,EXCISE ACT,7,0,7,91,0,91,36,3,39,1,0,1,135,3,138
DELHI,2001,PROHIBITION ACT,0,0,0,0,0,0,0,0,0,0,0,0,0,0,0
DELHI,2001,EXPLOSIVE & EXPLOSIVE SUBST. ACT,0,0,0,62,1,63,45,2,47,1,0,1,108,3,111
DELHI,2001,TERRORIST & DISRUPTIVE ACTIVITIES (TATA),0,0,0,1,0,1,4,0,4,0,0,0,5,0,5
DELHI,2001,IMMORAL TRAFFIC (PREVENTION) ACT,0,0,0,5,7,12,1,1,2,0,0,0,6,8,14
DELHI,2001,INDIAN RAILWAYS ACT,10,0,10,62,0,62,36,0,36,1,0,1,109,0,109
DELHI,2001,REGISTRATION OF FOREIGNERS ACT,0,0,0,0,2,2,1,0,1,0,0,0,1,2,3
DELHI,2001,PROTECTION OF CIVIL RIGHTS ACT,0,0,0,0,0,0,0,0,0,0,0,0,0,0,0
DELHI,2001,SC/ST (PREVENTION OF ATROCITIES) ACT,0,0,0,0,0,0,0,0,0,0,0,0,0,0,0
DELHI,2001,INDIAN PASSPORT ACT,0,0,0,12,0,12,15,0,15,0,0,0,27,0,27
DELHI,2001,ESSENTIAL COMMODITIES ACT,0,0,0,2,0,2,0,0,0,0,0,0,2,0,2
DELHI,2001,ANTIQUITIES AND ART TREASURE ACT,0,0,0,0,0,0,0,0,0,0,0,0,0,0,0
DELHI,2001,DOWRY PROHIBITION ACT,0,0,0,67,20,87,22,26,48,6,23,29,95,69,164
DELHI,2001,FOREIGN EXCHANGE REGULATION ACT-1973,0,0,0,4,0,4,4,0,4,0,0,0,8,0,8
DELHI,2001,PREVENTION OF CORRUPTION ACT-1988,0,0,0,0,0,0,2,0,2,1,0,1,3,0,3
DELHI,2001,CONSER.OF FORGN.EXCH.&PREV. OF SMUG.ACT,0,0,0,0,0,0,0,0,0,0,0,0,0,0,0
DELHI,2001,OTHER SLL OFFENCE,7,0,7,110,0,110,58,0,58,10,0,10,185,0,185
DELHI,2001,TOTAL,67,0,67,1107,59,1166,683,62,745,53,37,90,1910,158,2068
DELHI,2002,ARMS ACT,0,0,0,625,0,625,170,1,171,9,0,9,804,1,805
DELHI,2002,N.D.P.S. ACT,0,0,0,445,24,469,317,39,356,28,0,28,790,63,853
DELHI,2002,GAMBLING ACT,0,0,0,11,0,11,9,0,9,2,0,2,22,0,22
DELHI,2002,EXCISE ACT,0,0,0,42,4,46,42,3,45,5,0,5,89,7,96
DELHI,2002,PROHIBITION ACT,0,0,0,0,0,0,0,0,0,0,0,0,0,0,0
DELHI,2002,EXPLOSIVE & EXPLOSIVE SUBST. ACT,0,0,0,61,2,63,44,2,46,1,0,1,106,4,110
DELHI,2002,TERRORIST & DISRUPTIVE ACTIVITIES (TATA),0,0,0,3,0,3,4,0,4,0,0,0,7,0,7
DELHI,2002,IMMORAL TRAFFIC (PREVENTION) ACT,0,0,0,0,7,7,0,3,3,0,0,0,0,10,10
DELHI,2002,INDIAN RAILWAYS ACT,0,0,0,78,0,78,38,0,38,2,0,2,118,0,118
DELHI,2002,REGISTRATION OF FOREIGNERS ACT,0,0,0,6,2,8,3,2,5,0,0,0,9,4,13
DELHI,2002,PROTECTION OF CIVIL RIGHTS ACT,0,0,0,0,0,0,0,0,0,0,0,0,0,0,0
DELHI,2002,SC/ST (PREVENTION OF ATROCITIES) ACT,0,0,0,0,0,0,0,0,0,0,0,0,0,0,0
DELHI,2002,INDIAN PASSPORT ACT,0,0,0,7,0,7,5,0,5,0,0,0,12,0,12
DELHI,2002,ESSENTIAL COMMODITIES ACT,0,0,0,0,0,0,0,0,0,0,0,0,0,0,0
DELHI,2002,ANTIQUITIES AND ART TREASURE ACT,0,0,0,0,0,0,0,0,0,0,0,0,0,0,0
DELHI,2002,DOWRY PROHIBITION ACT,0,0,0,14,0,14,13,4,17,10,0,10,37,4,41
DELHI,2002,FOREIGN EXCHANGE REGULATION ACT-1973,0,0,0,0,0,0,0,0,0,0,0,0,0,0,0
DELHI,2002,PREVENTION OF CORRUPTION ACT-1988,0,0,0,0,0,0,1,0,1,0,0,0,1,0,1
DELHI,2002,CONSER.OF FORGN.EXCH.&PREV. OF SMUG.ACT,0,0,0,13,0,13,6,0,6,0,0,0,19,0,19
DELHI,2002,OTHER SLL OFFENCE,0,0,0,96,0,96,55,2,57,13,0,13,164,2,166
DELHI,2002,TOTAL,0,0,0,1401,39,1440,707,56,763,70,0,70,2178,95,2273
DELHI,2003,ARMS ACT,0,0,0,636,0,636,173,0,173,8,0,8,817,0,817
DELHI,2003,N.D.P.S. ACT,0,0,0,433,46,479,344,15,359,42,6,48,819,67,886
DELHI,2003,GAMBLING ACT,0,0,0,5,0,5,2,0,2,0,0,0,7,0,7
DELHI,2003,EXCISE ACT,0,0,0,27,3,30,29,3,32,6,1,7,62,7,69
DELHI,2003,PROHIBITION ACT,0,0,0,0,0,0,0,0,0,0,0,0,0,0,0
DELHI,2003,EXPLOSIVE & EXPLOSIVE SUBST. ACT,0,0,0,54,2,56,29,1,30,1,1,2,84,4,88
DELHI,2003,TERRORIST & DISRUPTIVE ACTIVITIES (TATA),0,0,0,11,0,11,12,1,13,3,0,3,26,1,27
DELHI,2003,IMMORAL TRAFFIC (PREVENTION) ACT,0,0,0,3,8,11,0,4,4,0,0,0,3,12,15
DELHI,2003,INDIAN RAILWAYS ACT,0,0,0,76,0,76,21,0,21,4,0,4,101,0,101
DELHI,2003,REGISTRATION OF FOREIGNERS ACT,0,0,0,2,0,2,2,1,3,0,0,0,4,1,5
DELHI,2003,PROTECTION OF CIVIL RIGHTS ACT,0,0,0,0,0,0,0,0,0,0,0,0,0,0,0
DELHI,2003,SC/ST (PREVENTION OF ATROCITIES) ACT,0,0,0,0,0,0,0,0,0,0,0,0,0,0,0
DELHI,2003,INDIAN PASSPORT ACT,0,0,0,8,3,11,2,1,3,0,0,0,10,4,14
DELHI,2003,ESSENTIAL COMMODITIES ACT,0,0,0,0,0,0,0,0,0,0,0,0,0,0,0
DELHI,2003,ANTIQUITIES AND ART TREASURE ACT,0,0,0,0,0,0,0,0,0,0,0,0,0,0,0
DELHI,2003,DOWRY PROHIBITION ACT,0,0,0,25,2,27,21,1,22,7,2,9,53,5,58
DELHI,2003,FOREIGN EXCHANGE REGULATION ACT-1973,0,0,0,0,0,0,0,0,0,0,0,0,0,0,0
DELHI,2003,PREVENTION OF CORRUPTION ACT-1988,0,0,0,1,0,1,4,0,4,0,0,0,5,0,5
DELHI,2003,CONSER.OF FORGN.EXCH.&PREV. OF SMUG.ACT,0,0,0,0,0,0,0,0,0,0,0,0,0,0,0
DELHI,2003,OTHER SLL OFFENCE,0,0,0,262,0,262,146,1,147,30,0,30,438,1,439
DELHI,2003,TOTAL,0,0,0,1543,64,1607,785,28,813,101,10,111,2429,102,2531
DELHI,2004,ARMS ACT,0,0,0,796,0,796,342,0,342,16,0,16,1154,0,1154
DELHI,2004,N.D.P.S. ACT,0,0,0,637,22,659,438,33,471,39,11,50,1114,66,1180
DELHI,2004,GAMBLING ACT,0,0,0,13,0,13,2,0,2,3,0,3,18,0,18
DELHI,2004,EXCISE ACT,0,0,0,74,2,76,23,6,29,4,2,6,101,10,111
DELHI,2004,PROHIBITION ACT,0,0,0,0,0,0,0,0,0,0,0,0,0,0,0
DELHI,2004,EXPLOSIVE & EXPLOSIVE SUBST. ACT,0,0,0,54,1,55,27,1,28,7,0,7,88,2,90
DELHI,2004,TERRORIST & DISRUPTIVE ACTIVITIES (TATA),0,0,0,3,0,3,2,0,2,0,0,0,5,0,5
DELHI,2004,IMMORAL TRAFFIC (PREVENTION) ACT,0,0,0,1,11,12,9,12,21,0,0,0,10,23,33
DELHI,2004,INDIAN RAILWAYS ACT,0,0,0,53,0,53,21,0,21,0,0,0,74,0,74
DELHI,2004,REGISTRATION OF FOREIGNERS ACT,0,0,0,0,2,2,3,3,6,0,0,0,3,5,8
DELHI,2004,PROTECTION OF CIVIL RIGHTS ACT,0,0,0,0,0,0,0,0,0,0,0,0,0,0,0
DELHI,2004,SC/ST (PREVENTION OF ATROCITIES) ACT,0,0,0,0,0,0,0,0,0,0,0,0,0,0,0
DELHI,2004,INDIAN PASSPORT ACT,0,0,0,0,3,3,0,5,5,0,0,0,0,8,8
DELHI,2004,ESSENTIAL COMMODITIES ACT,0,0,0,0,0,0,0,0,0,0,0,0,0,0,0
DELHI,2004,ANTIQUITIES AND ART TREASURE ACT,0,0,0,0,0,0,0,0,0,0,0,0,0,0,0
DELHI,2004,DOWRY PROHIBITION ACT,0,0,0,43,3,46,8,4,12,28,2,30,79,9,88
DELHI,2004,FOREIGN EXCHANGE REGULATION ACT-1973,0,0,0,0,0,0,0,0,0,0,0,0,0,0,0
DELHI,2004,PREVENTION OF CORRUPTION ACT-1988,0,0,0,1,0,1,0,0,0,0,0,0,1,0,1
DELHI,2004,CONSER.OF FORGN.EXCH.&PREV. OF SMUG.ACT,0,0,0,0,0,0,11,0,11,0,0,0,11,0,11
DELHI,2004,OTHER SLL OFFENCE,0,0,0,297,0,297,210,0,210,33,0,33,540,0,540
DELHI,2004,TOTAL,0,0,0,1972,44,2016,1096,64,1160,130,15,145,3198,123,3321
DELHI,2005,ARMS ACT,0,0,0,838,1,839,415,0,415,42,0,42,1295,1,1296
DELHI,2005,N.D.P.S. ACT,0,0,0,674,23,697,239,27,266,72,6,78,985,56,1041
DELHI,2005,GAMBLING ACT,0,0,0,6,0,6,2,0,2,0,0,0,8,0,8
DELHI,2005,EXCISE ACT,0,0,0,43,3,46,33,4,37,11,2,13,87,9,96
DELHI,2005,PROHIBITION ACT,0,0,0,0,0,0,0,0,0,0,0,0,0,0,0
DELHI,2005,EXPLOSIVE & EXPLOSIVE SUBST. ACT,0,0,0,31,1,32,38,1,39,7,0,7,76,2,78
DELHI,2005,TERRORIST & DISRUPTIVE ACTIVITIES (TATA),0,0,0,7,0,7,7,1,8,2,0,2,16,1,17
DELHI,2005,IMMORAL TRAFFIC (PREVENTION) ACT,0,0,0,28,14,42,17,6,23,2,2,4,47,22,69
DELHI,2005,INDIAN RAILWAYS ACT,0,0,0,97,0,97,50,0,50,5,0,5,152,0,152
DELHI,2005,REGISTRATION OF FOREIGNERS ACT,0,0,0,7,0,7,8,0,8,2,0,2,17,0,17
DELHI,2005,PROTECTION OF CIVIL RIGHTS ACT,0,0,0,5,0,5,2,0,2,0,0,0,7,0,7
DELHI,2005,SC/ST (PREVENTION OF ATROCITIES) ACT,0,0,0,0,0,0,0,0,0,0,0,0,0,0,0
DELHI,2005,INDIAN PASSPORT ACT,0,0,0,11,0,11,8,0,8,0,0,0,19,0,19
DELHI,2005,ESSENTIAL COMMODITIES ACT,0,0,0,0,0,0,0,0,0,0,0,0,0,0,0
DELHI,2005,ANTIQUITIES AND ART TREASURE ACT,0,0,0,0,0,0,0,0,0,0,0,0,0,0,0
DELHI,2005,DOWRY PROHIBITION ACT,0,0,0,34,5,39,20,8,28,12,4,16,66,17,83
DELHI,2005,FOREIGN EXCHANGE REGULATION ACT-1973,0,0,0,0,0,0,0,0,0,0,0,0,0,0,0
DELHI,2005,PREVENTION OF CORRUPTION ACT-1988,0,0,0,6,0,6,1,1,2,1,0,1,8,1,9
DELHI,2005,CONSER.OF FORGN.EXCH.&PREV. OF SMUG.ACT,0,0,0,0,0,0,0,0,0,0,0,0,0,0,0
DELHI,2005,OTHER SLL OFFENCE,0,0,0,238,3,241,120,3,123,14,1,15,372,7,379
DELHI,2005,TOTAL,0,0,0,2025,50,2075,960,51,1011,170,15,185,3155,116,3271
DELHI,2006,ARMS ACT,0,0,0,989,0,989,427,0,427,24,0,24,1440,0,1440
DELHI,2006,N.D.P.S. ACT,0,0,0,544,20,564,285,15,300,65,1,66,894,36,930
DELHI,2006,GAMBLING ACT,0,0,0,10,0,10,10,0,10,1,0,1,21,0,21
DELHI,2006,EXCISE ACT,0,0,0,39,11,50,37,6,43,8,4,12,84,21,105
DELHI,2006,PROHIBITION ACT,0,0,0,2,0,2,0,0,0,0,0,0,2,0,2
DELHI,2006,EXPLOSIVE & EXPLOSIVE SUBST. ACT,0,0,0,39,1,40,31,0,31,2,0,2,72,1,73
DELHI,2006,TERRORIST & DISRUPTIVE ACTIVITIES (TATA),0,0,0,5,0,5,3,1,4,2,0,2,10,1,11
DELHI,2006,IMMORAL TRAFFIC (PREVENTION) ACT,0,0,0,18,25,43,8,3,11,3,0,3,29,28,57
DELHI,2006,INDIAN RAILWAYS ACT,0,0,0,85,0,85,29,0,29,2,0,2,116,0,116
DELHI,2006,REGISTRATION OF FOREIGNERS ACT,0,0,0,9,8,17,2,4,6,0,0,0,11,12,23
DELHI,2006,PROTECTION OF CIVIL RIGHTS ACT,0,0,0,2,0,2,0,0,0,0,0,0,2,0,2
DELHI,2006,SC/ST (PREVENTION OF ATROCITIES) ACT,0,0,0,0,0,0,0,0,0,0,0,0,0,0,0
DELHI,2006,INDIAN PASSPORT ACT,0,0,0,10,3,13,25,2,27,4,0,4,39,5,44
DELHI,2006,ESSENTIAL COMMODITIES ACT,0,0,0,0,0,0,0,0,0,0,0,0,0,0,0
DELHI,2006,ANTIQUITIES AND ART TREASURE ACT,0,0,0,0,0,0,0,1,1,0,0,0,0,1,1
DELHI,2006,DOWRY PROHIBITION ACT,0,0,0,60,14,74,85,10,95,6,7,13,151,31,182
DELHI,2006,FOREIGN EXCHANGE REGULATION ACT-1973,0,0,0,0,0,0,2,0,2,0,0,0,2,0,2
DELHI,2006,PREVENTION OF CORRUPTION ACT-1988,0,0,0,2,0,2,2,0,2,1,0,1,5,0,5
DELHI,2006,CONSER.OF FORGN.EXCH.&PREV. OF SMUG.ACT,0,0,0,185,0,185,0,0,0,0,0,0,185,0,185
DELHI,2006,OTHER SLL OFFENCE,0,0,0,20,42,62,46,11,57,7,3,10,73,56,129
DELHI,2006,TOTAL,0,0,0,2019,124,2143,992,53,1045,125,15,140,3136,192,3328
DELHI,2007,ARMS ACT,0,0,0,548,0,548,283,0,283,2,0,2,833,0,833
DELHI,2007,N.D.P.S. ACT,0,0,0,334,18,352,261,22,283,41,5,46,636,45,681
DELHI,2007,GAMBLING ACT,0,0,0,7,0,7,6,0,6,0,0,0,13,0,13
DELHI,2007,EXCISE ACT,0,0,0,58,7,65,50,9,59,12,3,15,120,19,139
DELHI,2007,PROHIBITION ACT,0,0,0,4,1,5,0,2,2,0,0,0,4,3,7
DELHI,2007,EXPLOSIVE & EXPLOSIVE SUBST. ACT,0,0,0,49,0,49,38,0,38,4,0,4,91,0,91
DELHI,2007,TERRORIST & DISRUPTIVE ACTIVITIES (TATA),0,0,0,3,0,3,8,0,8,1,0,1,12,0,12
DELHI,2007,IMMORAL TRAFFIC (PREVENTION) ACT,0,0,0,19,14,33,9,5,14,2,0,2,30,19,49
DELHI,2007,INDIAN RAILWAYS ACT,0,0,0,61,0,61,19,0,19,1,0,1,81,0,81
DELHI,2007,REGISTRATION OF FOREIGNERS ACT,0,0,0,19,16,35,10,7,17,0,2,2,29,25,54
DELHI,2007,PROTECTION OF CIVIL RIGHTS ACT,0,0,0,0,0,0,1,0,1,0,0,0,1,0,1
DELHI,2007,SC/ST (PREVENTION OF ATROCITIES) ACT,0,0,0,0,0,0,0,0,0,0,0,0,0,0,0
DELHI,2007,INDIAN PASSPORT ACT,0,0,0,20,2,22,23,3,26,2,0,2,45,5,50
DELHI,2007,ESSENTIAL COMMODITIES ACT,0,0,0,0,0,0,0,0,0,0,0,0,0,0,0
DELHI,2007,ANTIQUITIES AND ART TREASURE ACT,0,0,0,0,0,0,0,0,0,0,0,0,0,0,0
DELHI,2007,DOWRY PROHIBITION ACT,0,0,0,49,15,64,61,45,106,14,15,29,124,75,199
DELHI,2007,FOREIGN EXCHANGE REGULATION ACT-1973,0,0,0,8,0,8,0,0,0,0,0,0,8,0,8
DELHI,2007,PREVENTION OF CORRUPTION ACT-1988,0,0,0,0,0,0,9,0,9,6,0,6,15,0,15
DELHI,2007,CONSER.OF FORGN.EXCH.&PREV. OF SMUG.ACT,0,0,0,35,0,35,0,0,0,0,0,0,35,0,35
DELHI,2007,OTHER SLL OFFENCE,0,0,0,9,0,9,17,0,17,10,0,10,36,0,36
DELHI,2007,TOTAL,0,0,0,1223,73,1296,795,93,888,95,25,120,2113,191,2304
DELHI,2008,ARMS ACT,0,0,0,669,1,670,334,1,335,20,0,20,1023,2,1025
DELHI,2008,N.D.P.S. ACT,0,0,0,418,42,460,216,34,250,43,4,47,677,80,757
DELHI,2008,GAMBLING ACT,0,0,0,4,0,4,4,0,4,0,0,0,8,0,8
DELHI,2008,EXCISE ACT,0,0,0,93,4,97,54,0,54,2,2,4,149,6,155
DELHI,2008,PROHIBITION ACT,0,0,0,0,0,0,0,0,0,0,0,0,0,0,0
DELHI,2008,EXPLOSIVE & EXPLOSIVE SUBST. ACT,0,0,0,49,0,49,42,0,42,3,0,3,94,0,94
DELHI,2008,TERRORIST & DISRUPTIVE ACTIVITIES (TATA),0,0,0,5,1,6,11,2,13,1,0,1,17,3,20
DELHI,2008,IMMORAL TRAFFIC (PREVENTION) ACT,0,0,0,11,8,19,1,3,4,1,0,1,13,11,24
DELHI,2008,INDIAN RAILWAYS ACT,0,0,0,70,0,70,17,0,17,0,0,0,87,0,87
DELHI,2008,REGISTRATION OF FOREIGNERS ACT,0,0,0,26,14,40,18,8,26,1,2,3,45,24,69
DELHI,2008,PROTECTION OF CIVIL RIGHTS ACT,0,0,0,0,0,0,0,0,0,0,0,0,0,0,0
DELHI,2008,SC/ST (PREVENTION OF ATROCITIES) ACT,0,0,0,0,0,0,0,0,0,0,0,0,0,0,0
DELHI,2008,INDIAN PASSPORT ACT,0,0,0,49,2,51,15,1,16,1,1,2,65,4,69
DELHI,2008,ESSENTIAL COMMODITIES ACT,0,0,0,3,0,3,1,0,1,0,0,0,4,0,4
DELHI,2008,ANTIQUITIES AND ART TREASURE ACT,0,0,0,0,0,0,0,0,0,0,0,0,0,0,0
DELHI,2008,DOWRY PROHIBITION ACT,0,0,0,78,0,78,65,32,97,5,17,22,148,49,197
DELHI,2008,FOREIGN EXCHANGE REGULATION ACT-1973,0,0,0,3,0,3,2,0,2,0,0,0,5,0,5
DELHI,2008,PREVENTION OF CORRUPTION ACT-1988,0,0,0,15,0,15,9,0,9,2,0,2,26,0,26
DELHI,2008,CONSER.OF FORGN.EXCH.&PREV. OF SMUG.ACT,0,0,0,24,0,24,0,0,0,0,0,0,24,0,24
DELHI,2008,OTHER SLL OFFENCE,0,0,0,3,0,3,10,0,10,5,0,5,18,0,18
DELHI,2008,TOTAL,0,0,0,1520,72,1592,799,81,880,84,26,110,2403,179,2582
DELHI,2009,ARMS ACT,0,0,0,365,1,366,138,2,140,21,0,21,524,3,527
DELHI,2009,N.D.P.S. ACT,0,0,0,341,18,359,140,28,168,31,4,35,512,50,562
DELHI,2009,GAMBLING ACT,0,0,0,7,0,7,0,0,0,0,0,0,7,0,7
DELHI,2009,EXCISE ACT,0,0,0,37,2,39,36,1,37,7,1,8,80,4,84
DELHI,2009,PROHIBITION ACT,0,0,0,0,0,0,0,0,0,0,0,0,0,0,0
DELHI,2009,EXPLOSIVE & EXPLOSIVE SUBST. ACT,0,0,0,39,0,39,32,0,32,3,0,3,74,0,74
DELHI,2009,TERRORIST & DISRUPTIVE ACTIVITIES (TATA),0,0,0,5,1,6,10,2,12,1,0,1,16,3,19
DELHI,2009,IMMORAL TRAFFIC (PREVENTION) ACT,0,0,0,13,3,16,2,1,3,0,0,0,15,4,19
DELHI,2009,INDIAN RAILWAYS ACT,0,0,0,49,0,49,22,0,22,2,0,2,73,0,73
DELHI,2009,REGISTRATION OF FOREIGNERS ACT,0,0,0,23,11,34,11,8,19,1,2,3,35,21,56
DELHI,2009,PROTECTION OF CIVIL RIGHTS ACT,0,0,0,1,0,1,2,0,2,0,0,0,3,0,3
DELHI,2009,SC/ST (PREVENTION OF ATROCITIES) ACT,0,0,0,0,0,0,0,0,0,0,0,0,0,0,0
DELHI,2009,INDIAN PASSPORT ACT,0,0,0,36,2,38,22,1,23,3,0,3,61,3,64
DELHI,2009,ESSENTIAL COMMODITIES ACT,0,0,0,2,0,2,3,0,3,0,0,0,5,0,5
DELHI,2009,ANTIQUITIES AND ART TREASURE ACT,0,0,0,1,0,1,0,0,0,0,0,0,1,0,1
DELHI,2009,DOWRY PROHIBITION ACT,0,0,0,76,3,79,73,21,94,15,8,23,164,32,196
DELHI,2009,FOREIGN EXCHANGE REGULATION ACT-1973,0,0,0,0,0,0,0,0,0,0,0,0,0,0,0
DELHI,2009,PREVENTION OF CORRUPTION ACT-1988,0,0,0,1,0,1,11,0,11,2,0,2,14,0,14
DELHI,2009,CONSER.OF FORGN.EXCH.&PREV. OF SMUG.ACT,0,0,0,6,0,6,0,0,0,0,0,0,6,0,6
DELHI,2009,OTHER SLL OFFENCE,0,0,0,16,0,16,21,0,21,4,0,4,41,0,41
DELHI,2009,TOTAL,0,0,0,1018,41,1059,523,64,587,90,15,105,1631,120,1751
DELHI,2010,ARMS ACT,0,0,0,314,0,314,101,0,101,14,0,14,429,0,429
DELHI,2010,N.D.P.S. ACT,0,0,0,259,20,279,118,30,148,31,6,37,408,56,464
DELHI,2010,GAMBLING ACT,0,0,0,6,0,6,0,0,0,0,0,0,6,0,6
DELHI,2010,EXCISE ACT,0,0,0,30,2,32,37,6,43,6,1,7,73,9,82
DELHI,2010,PROHIBITION ACT,0,0,0,0,0,0,0,0,0,0,0,0,0,0,0
DELHI,2010,EXPLOSIVE & EXPLOSIVE SUBST. ACT,0,0,0,24,0,24,21,0,21,3,0,3,48,0,48
DELHI,2010,TERRORIST & DISRUPTIVE ACTIVITIES (TATA),0,0,0,0,1,1,6,3,9,1,0,1,7,4,11
DELHI,2010,IMMORAL TRAFFIC (PREVENTION) ACT,0,0,0,4,8,12,3,0,3,0,1,1,7,9,16
DELHI,2010,INDIAN RAILWAYS ACT,0,0,0,30,0,30,22,0,22,1,0,1,53,0,53
DELHI,2010,REGISTRATION OF FOREIGNERS ACT,0,0,0,28,7,35,26,8,34,1,6,7,55,21,76
DELHI,2010,PROTECTION OF CIVIL RIGHTS ACT,0,0,0,0,0,0,0,0,0,0,0,0,0,0,0
DELHI,2010,SC/ST (PREVENTION OF ATROCITIES) ACT,0,0,0,0,0,0,0,0,0,0,0,0,0,0,0
DELHI,2010,INDIAN PASSPORT ACT,0,0,0,1,0,1,1,0,1,0,0,0,2,0,2
DELHI,2010,ESSENTIAL COMMODITIES ACT,0,0,0,0,0,0,0,0,0,0,0,0,0,0,0
DELHI,2010,ANTIQUITIES AND ART TREASURE ACT,0,0,0,1,0,1,1,0,1,0,0,0,2,0,2
DELHI,2010,DOWRY PROHIBITION ACT,0,0,0,33,2,35,31,5,36,19,5,24,83,12,95
DELHI,2010,FOREIGN EXCHANGE REGULATION ACT-1973,0,0,0,2,0,2,0,0,0,0,0,0,2,0,2
DELHI,2010,PREVENTION OF CORRUPTION ACT-1988,0,0,0,11,0,11,12,0,12,3,0,3,26,0,26
DELHI,2010,CONSER.OF FORGN.EXCH.&PREV. OF SMUG.ACT,0,0,0,0,0,0,0,0,0,0,0,0,0,0,0
DELHI,2010,OTHER SLL OFFENCE,0,0,0,28,0,28,22,0,22,12,1,13,62,1,63
DELHI,2010,TOTAL,0,0,0,771,40,811,401,52,453,91,20,111,1263,112,1375
DELHI,2011,ARMS ACT,0,0,0,270,0,270,60,0,60,15,0,15,345,0,345
DELHI,2011,N.D.P.S. ACT,0,0,0,409,25,434,147,33,180,36,4,40,592,62,654
DELHI,2011,GAMBLING ACT,0,0,0,3,0,3,0,0,0,0,0,0,3,0,3
DELHI,2011,EXCISE ACT,0,0,0,38,0,38,34,6,40,3,4,7,75,10,85
DELHI,2011,PROHIBITION ACT,0,0,0,2,0,2,2,0,2,1,0,1,5,0,5
DELHI,2011,EXPLOSIVE & EXPLOSIVE SUBST. ACT,0,0,0,14,0,14,14,0,14,2,0,2,30,0,30
DELHI,2011,TERRORIST & DISRUPTIVE ACTIVITIES (TATA),0,0,0,0,0,0,0,0,0,0,0,0,0,0,0
DELHI,2011,IMMORAL TRAFFIC (PREVENTION) ACT,0,0,0,1,4,5,4,0,4,0,0,0,5,4,9
DELHI,2011,INDIAN RAILWAYS ACT,0,0,0,31,0,31,19,0,19,1,0,1,51,0,51
DELHI,2011,REGISTRATION OF FOREIGNERS ACT,0,0,0,17,4,21,11,0,11,0,0,0,28,4,32
DELHI,2011,PROTECTION OF CIVIL RIGHTS ACT,0,0,0,0,0,0,0,0,0,0,0,0,0,0,0
DELHI,2011,SC/ST (PREVENTION OF ATROCITIES) ACT,0,0,0,2,0,2,0,0,0,2,0,2,4,0,4
DELHI,2011,INDIAN PASSPORT ACT,0,0,0,9,0,9,8,0,8,2,0,2,19,0,19
DELHI,2011,ESSENTIAL COMMODITIES ACT,0,0,0,0,0,0,0,0,0,0,0,0,0,0,0
DELHI,2011,ANTIQUITIES AND ART TREASURE ACT,0,0,0,0,0,0,2,0,2,0,0,0,2,0,2
DELHI,2011,DOWRY PROHIBITION ACT,0,0,0,45,3,48,32,5,37,10,6,16,87,14,101
DELHI,2011,FOREIGN EXCHANGE REGULATION ACT-1973,0,0,0,0,0,0,0,0,0,0,0,0,0,0,0
DELHI,2011,PREVENTION OF CORRUPTION ACT-1988,0,0,0,1,0,1,11,1,12,8,0,8,20,1,21
DELHI,2011,CONSER.OF FORGN.EXCH.&PREV. OF SMUG.ACT,0,0,0,0,0,0,0,0,0,0,0,0,0,0,0
DELHI,2011,OTHER SLL OFFENCE,0,0,0,45,1,46,34,8,42,17,1,18,96,10,106
DELHI,2011,TOTAL,0,0,0,887,37,924,378,53,431,97,15,112,1362,105,1467
DELHI,2012,ARMS ACT,0,0,0,239,0,239,62,0,62,15,0,15,316,0,316
DELHI,2012,N.D.P.S. ACT,0,0,0,387,28,415,178,35,213,37,12,49,602,75,677
DELHI,2012,GAMBLING ACT,0,0,0,5,0,5,0,0,0,0,0,0,5,0,5
DELHI,2012,EXCISE ACT,0,0,0,36,0,36,33,4,37,4,2,6,73,6,79
DELHI,2012,PROHIBITION ACT,0,0,0,2,0,2,1,0,1,1,0,1,4,0,4
DELHI,2012,EXPLOSIVE & EXPLOSIVE SUBST. ACT,0,0,0,20,0,20,15,0,15,1,0,1,36,0,36
DELHI,2012,TERRORIST & DISRUPTIVE ACTIVITIES (TATA),0,0,0,0,0,0,0,0,0,0,0,0,0,0,0
DELHI,2012,IMMORAL TRAFFIC (PREVENTION) ACT,0,0,0,4,8,12,2,0,2,0,0,0,6,8,14
DELHI,2012,INDIAN RAILWAYS ACT,0,0,0,33,0,33,23,0,23,4,0,4,60,0,60
DELHI,2012,REGISTRATION OF FOREIGNERS ACT,0,0,0,7,0,7,5,0,5,0,0,0,12,0,12
DELHI,2012,PROTECTION OF CIVIL RIGHTS ACT,0,0,0,0,0,0,0,0,0,0,0,0,0,0,0
DELHI,2012,SC/ST (PREVENTION OF ATROCITIES) ACT,0,0,0,0,0,0,0,0,0,0,0,0,0,0,0
DELHI,2012,INDIAN PASSPORT ACT,0,0,0,4,0,4,4,0,4,0,0,0,8,0,8
DELHI,2012,ESSENTIAL COMMODITIES ACT,0,0,0,0,0,0,0,0,0,0,0,0,0,0,0
DELHI,2012,ANTIQUITIES AND ART TREASURE ACT,0,0,0,0,0,0,0,0,0,0,0,0,0,0,0
DELHI,2012,DOWRY PROHIBITION ACT,0,0,0,46,0,46,42,5,47,7,2,9,95,7,102
DELHI,2012,FOREIGN EXCHANGE REGULATION ACT-1973,0,0,0,0,0,0,0,0,0,0,0,0,0,0,0
DELHI,2012,PREVENTION OF CORRUPTION ACT-1988,0,0,0,2,0,2,12,3,15,6,0,6,20,3,23
DELHI,2012,CONSER.OF FORGN.EXCH.&PREV. OF SMUG.ACT,0,0,0,0,0,0,0,0,0,0,0,0,0,0,0
DELHI,2012,OTHER SLL OFFENCE,0,0,0,35,1,36,51,7,58,20,0,20,106,8,114
DELHI,2012,TOTAL,0,0,0,820,37,857,428,54,482,95,16,111,1343,107,1450
LAKSHADWEEP,2001,ARMS ACT,0,0,0,0,0,0,0,0,0,0,0,0,0,0,0
LAKSHADWEEP,2001,N.D.P.S. ACT,0,0,0,0,0,0,0,0,0,0,0,0,0,0,0
LAKSHADWEEP,2001,GAMBLING ACT,0,0,0,0,0,0,0,0,0,0,0,0,0,0,0
LAKSHADWEEP,2001,EXCISE ACT,0,0,0,0,0,0,0,0,0,0,0,0,0,0,0
LAKSHADWEEP,2001,PROHIBITION ACT,0,0,0,0,0,0,0,0,0,0,0,0,0,0,0
LAKSHADWEEP,2001,EXPLOSIVE & EXPLOSIVE SUBST. ACT,0,0,0,0,0,0,0,0,0,0,0,0,0,0,0
LAKSHADWEEP,2001,TERRORIST & DISRUPTIVE ACTIVITIES (TATA),0,0,0,0,0,0,0,0,0,0,0,0,0,0,0
LAKSHADWEEP,2001,IMMORAL TRAFFIC (PREVENTION) ACT,0,0,0,0,0,0,0,0,0,0,0,0,0,0,0
LAKSHADWEEP,2001,INDIAN RAILWAYS ACT,0,0,0,0,0,0,0,0,0,0,0,0,0,0,0
LAKSHADWEEP,2001,REGISTRATION OF FOREIGNERS ACT,0,0,0,0,0,0,0,0,0,0,0,0,0,0,0
LAKSHADWEEP,2001,PROTECTION OF CIVIL RIGHTS ACT,0,0,0,0,0,0,0,0,0,0,0,0,0,0,0
LAKSHADWEEP,2001,SC/ST (PREVENTION OF ATROCITIES) ACT,0,0,0,0,0,0,0,0,0,0,0,0,0,0,0
LAKSHADWEEP,2001,INDIAN PASSPORT ACT,0,0,0,0,0,0,0,0,0,0,0,0,0,0,0
LAKSHADWEEP,2001,ESSENTIAL COMMODITIES ACT,0,0,0,0,0,0,0,0,0,0,0,0,0,0,0
LAKSHADWEEP,2001,ANTIQUITIES AND ART TREASURE ACT,0,0,0,0,0,0,0,0,0,0,0,0,0,0,0
LAKSHADWEEP,2001,DOWRY PROHIBITION ACT,0,0,0,0,0,0,0,0,0,0,0,0,0,0,0
LAKSHADWEEP,2001,FOREIGN EXCHANGE REGULATION ACT-1973,0,0,0,0,0,0,0,0,0,0,0,0,0,0,0
LAKSHADWEEP,2001,PREVENTION OF CORRUPTION ACT-1988,0,0,0,0,0,0,0,0,0,0,0,0,0,0,0
LAKSHADWEEP,2001,CONSER.OF FORGN.EXCH.&PREV. OF SMUG.ACT,0,0,0,0,0,0,0,0,0,0,0,0,0,0,0
LAKSHADWEEP,2001,OTHER SLL OFFENCE,0,0,0,0,0,0,0,0,0,0,0,0,0,0,0
LAKSHADWEEP,2001,TOTAL,0,0,0,0,0,0,0,0,0,0,0,0,0,0,0
LAKSHADWEEP,2002,ARMS ACT,0,0,0,0,0,0,0,0,0,0,0,0,0,0,0
LAKSHADWEEP,2002,N.D.P.S. ACT,0,0,0,0,0,0,0,0,0,0,0,0,0,0,0
LAKSHADWEEP,2002,GAMBLING ACT,0,0,0,0,0,0,0,0,0,0,0,0,0,0,0
LAKSHADWEEP,2002,EXCISE ACT,0,0,0,0,0,0,0,0,0,0,0,0,0,0,0
LAKSHADWEEP,2002,PROHIBITION ACT,0,0,0,0,0,0,0,0,0,0,0,0,0,0,0
LAKSHADWEEP,2002,EXPLOSIVE & EXPLOSIVE SUBST. ACT,0,0,0,0,0,0,0,0,0,0,0,0,0,0,0
LAKSHADWEEP,2002,TERRORIST & DISRUPTIVE ACTIVITIES (TATA),0,0,0,0,0,0,0,0,0,0,0,0,0,0,0
LAKSHADWEEP,2002,IMMORAL TRAFFIC (PREVENTION) ACT,0,0,0,0,0,0,0,0,0,0,0,0,0,0,0
LAKSHADWEEP,2002,INDIAN RAILWAYS ACT,0,0,0,0,0,0,0,0,0,0,0,0,0,0,0
LAKSHADWEEP,2002,REGISTRATION OF FOREIGNERS ACT,0,0,0,0,0,0,0,0,0,0,0,0,0,0,0
LAKSHADWEEP,2002,PROTECTION OF CIVIL RIGHTS ACT,0,0,0,0,0,0,0,0,0,0,0,0,0,0,0
LAKSHADWEEP,2002,SC/ST (PREVENTION OF ATROCITIES) ACT,0,0,0,0,0,0,0,0,0,0,0,0,0,0,0
LAKSHADWEEP,2002,INDIAN PASSPORT ACT,0,0,0,0,0,0,0,0,0,0,0,0,0,0,0
LAKSHADWEEP,2002,ESSENTIAL COMMODITIES ACT,0,0,0,0,0,0,0,0,0,0,0,0,0,0,0
LAKSHADWEEP,2002,ANTIQUITIES AND ART TREASURE ACT,0,0,0,0,0,0,0,0,0,0,0,0,0,0,0
LAKSHADWEEP,2002,DOWRY PROHIBITION ACT,0,0,0,0,0,0,0,0,0,0,0,0,0,0,0
LAKSHADWEEP,2002,FOREIGN EXCHANGE REGULATION ACT-1973,0,0,0,0,0,0,0,0,0,0,0,0,0,0,0
LAKSHADWEEP,2002,PREVENTION OF CORRUPTION ACT-1988,0,0,0,0,0,0,0,0,0,0,0,0,0,0,0
LAKSHADWEEP,2002,CONSER.OF FORGN.EXCH.&PREV. OF SMUG.ACT,0,0,0,0,0,0,0,0,0,0,0,0,0,0,0
LAKSHADWEEP,2002,OTHER SLL OFFENCE,0,0,0,0,0,0,0,0,0,0,0,0,0,0,0
LAKSHADWEEP,2002,TOTAL,0,0,0,0,0,0,0,0,0,0,0,0,0,0,0
LAKSHADWEEP,2003,ARMS ACT,0,0,0,0,0,0,0,0,0,0,0,0,0,0,0
LAKSHADWEEP,2003,N.D.P.S. ACT,0,0,0,0,0,0,0,0,0,0,0,0,0,0,0
LAKSHADWEEP,2003,GAMBLING ACT,0,0,0,0,0,0,0,0,0,0,0,0,0,0,0
LAKSHADWEEP,2003,EXCISE ACT,0,0,0,0,0,0,0,0,0,0,0,0,0,0,0
LAKSHADWEEP,2003,PROHIBITION ACT,0,0,0,0,0,0,0,0,0,0,0,0,0,0,0
LAKSHADWEEP,2003,EXPLOSIVE & EXPLOSIVE SUBST. ACT,0,0,0,0,0,0,0,0,0,0,0,0,0,0,0
LAKSHADWEEP,2003,TERRORIST & DISRUPTIVE ACTIVITIES (TATA),0,0,0,0,0,0,0,0,0,0,0,0,0,0,0
LAKSHADWEEP,2003,IMMORAL TRAFFIC (PREVENTION) ACT,0,0,0,0,0,0,0,0,0,0,0,0,0,0,0
LAKSHADWEEP,2003,INDIAN RAILWAYS ACT,0,0,0,0,0,0,0,0,0,0,0,0,0,0,0
LAKSHADWEEP,2003,REGISTRATION OF FOREIGNERS ACT,0,0,0,0,0,0,0,0,0,0,0,0,0,0,0
LAKSHADWEEP,2003,PROTECTION OF CIVIL RIGHTS ACT,0,0,0,0,0,0,0,0,0,0,0,0,0,0,0
LAKSHADWEEP,2003,SC/ST (PREVENTION OF ATROCITIES) ACT,0,0,0,0,0,0,0,0,0,0,0,0,0,0,0
LAKSHADWEEP,2003,INDIAN PASSPORT ACT,0,0,0,0,0,0,0,0,0,0,0,0,0,0,0
LAKSHADWEEP,2003,ESSENTIAL COMMODITIES ACT,0,0,0,0,0,0,0,0,0,0,0,0,0,0,0
LAKSHADWEEP,2003,ANTIQUITIES AND ART TREASURE ACT,0,0,0,0,0,0,0,0,0,0,0,0,0,0,0
LAKSHADWEEP,2003,DOWRY PROHIBITION ACT,0,0,0,0,0,0,0,0,0,0,0,0,0,0,0
LAKSHADWEEP,2003,FOREIGN EXCHANGE REGULATION ACT-1973,0,0,0,0,0,0,0,0,0,0,0,0,0,0,0
LAKSHADWEEP,2003,PREVENTION OF CORRUPTION ACT-1988,0,0,0,0,0,0,0,0,0,0,0,0,0,0,0
LAKSHADWEEP,2003,CONSER.OF FORGN.EXCH.&PREV. OF SMUG.ACT,0,0,0,0,0,0,0,0,0,0,0,0,0,0,0
LAKSHADWEEP,2003,OTHER SLL OFFENCE,0,0,0,0,0,0,0,0,0,0,0,0,0,0,0
LAKSHADWEEP,2003,TOTAL,0,0,0,0,0,0,0,0,0,0,0,0,0,0,0
LAKSHADWEEP,2004,ARMS ACT,0,0,0,0,0,0,0,0,0,0,0,0,0,0,0
LAKSHADWEEP,2004,N.D.P.S. ACT,0,0,0,0,0,0,0,0,0,0,0,0,0,0,0
LAKSHADWEEP,2004,GAMBLING ACT,0,0,0,0,0,0,0,0,0,0,0,0,0,0,0
LAKSHADWEEP,2004,EXCISE ACT,0,0,0,0,0,0,0,0,0,0,0,0,0,0,0
LAKSHADWEEP,2004,PROHIBITION ACT,0,0,0,0,0,0,0,0,0,0,0,0,0,0,0
LAKSHADWEEP,2004,EXPLOSIVE & EXPLOSIVE SUBST. ACT,0,0,0,0,0,0,0,0,0,0,0,0,0,0,0
LAKSHADWEEP,2004,TERRORIST & DISRUPTIVE ACTIVITIES (TATA),0,0,0,0,0,0,0,0,0,0,0,0,0,0,0
LAKSHADWEEP,2004,IMMORAL TRAFFIC (PREVENTION) ACT,0,0,0,0,0,0,0,0,0,0,0,0,0,0,0
LAKSHADWEEP,2004,INDIAN RAILWAYS ACT,0,0,0,0,0,0,0,0,0,0,0,0,0,0,0
LAKSHADWEEP,2004,REGISTRATION OF FOREIGNERS ACT,0,0,0,0,0,0,0,0,0,0,0,0,0,0,0
LAKSHADWEEP,2004,PROTECTION OF CIVIL RIGHTS ACT,0,0,0,0,0,0,0,0,0,0,0,0,0,0,0
LAKSHADWEEP,2004,SC/ST (PREVENTION OF ATROCITIES) ACT,0,0,0,0,0,0,0,0,0,0,0,0,0,0,0
LAKSHADWEEP,2004,INDIAN PASSPORT ACT,0,0,0,0,0,0,0,0,0,0,0,0,0,0,0
LAKSHADWEEP,2004,ESSENTIAL COMMODITIES ACT,0,0,0,0,0,0,0,0,0,0,0,0,0,0,0
LAKSHADWEEP,2004,ANTIQUITIES AND ART TREASURE ACT,0,0,0,0,0,0,0,0,0,0,0,0,0,0,0
LAKSHADWEEP,2004,DOWRY PROHIBITION ACT,0,0,0,0,0,0,0,0,0,0,0,0,0,0,0
LAKSHADWEEP,2004,FOREIGN EXCHANGE REGULATION ACT-1973,0,0,0,0,0,0,0,0,0,0,0,0,0,0,0
LAKSHADWEEP,2004,PREVENTION OF CORRUPTION ACT-1988,0,0,0,0,0,0,0,0,0,0,0,0,0,0,0
LAKSHADWEEP,2004,CONSER.OF FORGN.EXCH.&PREV. OF SMUG.ACT,0,0,0,0,0,0,0,0,0,0,0,0,0,0,0
LAKSHADWEEP,2004,OTHER SLL OFFENCE,0,0,0,0,0,0,0,0,0,0,0,0,0,0,0
LAKSHADWEEP,2004,TOTAL,0,0,0,0,0,0,0,0,0,0,0,0,0,0,0
LAKSHADWEEP,2005,ARMS ACT,0,0,0,0,0,0,0,0,0,0,0,0,0,0,0
LAKSHADWEEP,2005,N.D.P.S. ACT,0,0,0,0,0,0,3,0,3,0,0,0,3,0,3
LAKSHADWEEP,2005,GAMBLING ACT,0,0,0,0,0,0,0,0,0,0,0,0,0,0,0
LAKSHADWEEP,2005,EXCISE ACT,0,0,0,0,0,0,0,0,0,0,0,0,0,0,0
LAKSHADWEEP,2005,PROHIBITION ACT,0,0,0,0,0,0,1,0,1,0,0,0,1,0,1
LAKSHADWEEP,2005,EXPLOSIVE & EXPLOSIVE SUBST. ACT,0,0,0,0,0,0,0,0,0,0,0,0,0,0,0
LAKSHADWEEP,2005,TERRORIST & DISRUPTIVE ACTIVITIES (TATA),0,0,0,0,0,0,0,0,0,0,0,0,0,0,0
LAKSHADWEEP,2005,IMMORAL TRAFFIC (PREVENTION) ACT,0,0,0,0,0,0,0,0,0,0,0,0,0,0,0
LAKSHADWEEP,2005,INDIAN RAILWAYS ACT,0,0,0,0,0,0,0,0,0,0,0,0,0,0,0
LAKSHADWEEP,2005,REGISTRATION OF FOREIGNERS ACT,0,0,0,0,0,0,0,0,0,0,0,0,0,0,0
LAKSHADWEEP,2005,PROTECTION OF CIVIL RIGHTS ACT,0,0,0,0,0,0,0,0,0,0,0,0,0,0,0
LAKSHADWEEP,2005,SC/ST (PREVENTION OF ATROCITIES) ACT,0,0,0,0,0,0,0,0,0,0,0,0,0,0,0
LAKSHADWEEP,2005,INDIAN PASSPORT ACT,0,0,0,0,0,0,0,0,0,0,0,0,0,0,0
LAKSHADWEEP,2005,ESSENTIAL COMMODITIES ACT,0,0,0,0,0,0,0,0,0,0,0,0,0,0,0
LAKSHADWEEP,2005,ANTIQUITIES AND ART TREASURE ACT,0,0,0,0,0,0,0,0,0,0,0,0,0,0,0
LAKSHADWEEP,2005,DOWRY PROHIBITION ACT,0,0,0,0,0,0,0,0,0,0,0,0,0,0,0
LAKSHADWEEP,2005,FOREIGN EXCHANGE REGULATION ACT-1973,0,0,0,0,0,0,0,0,0,0,0,0,0,0,0
LAKSHADWEEP,2005,PREVENTION OF CORRUPTION ACT-1988,0,0,0,0,0,0,0,0,0,0,0,0,0,0,0
LAKSHADWEEP,2005,CONSER.OF FORGN.EXCH.&PREV. OF SMUG.ACT,0,0,0,0,0,0,0,0,0,0,0,0,0,0,0
LAKSHADWEEP,2005,OTHER SLL OFFENCE,0,0,0,0,0,0,0,0,0,0,0,0,0,0,0
LAKSHADWEEP,2005,TOTAL,0,0,0,0,0,0,4,0,4,0,0,0,4,0,4
LAKSHADWEEP,2006,ARMS ACT,0,0,0,0,0,0,0,0,0,0,0,0,0,0,0
LAKSHADWEEP,2006,N.D.P.S. ACT,0,0,0,0,0,0,0,0,0,0,0,0,0,0,0
LAKSHADWEEP,2006,GAMBLING ACT,0,0,0,0,0,0,0,0,0,0,0,0,0,0,0
LAKSHADWEEP,2006,EXCISE ACT,0,0,0,0,0,0,0,0,0,0,0,0,0,0,0
LAKSHADWEEP,2006,PROHIBITION ACT,0,0,0,0,0,0,0,0,0,0,0,0,0,0,0
LAKSHADWEEP,2006,EXPLOSIVE & EXPLOSIVE SUBST. ACT,0,0,0,0,0,0,0,0,0,0,0,0,0,0,0
LAKSHADWEEP,2006,TERRORIST & DISRUPTIVE ACTIVITIES (TATA),0,0,0,0,0,0,0,0,0,0,0,0,0,0,0
LAKSHADWEEP,2006,IMMORAL TRAFFIC (PREVENTION) ACT,0,0,0,0,0,0,0,0,0,0,0,0,0,0,0
LAKSHADWEEP,2006,INDIAN RAILWAYS ACT,0,0,0,0,0,0,0,0,0,0,0,0,0,0,0
LAKSHADWEEP,2006,REGISTRATION OF FOREIGNERS ACT,0,0,0,0,0,0,0,0,0,0,0,0,0,0,0
LAKSHADWEEP,2006,PROTECTION OF CIVIL RIGHTS ACT,0,0,0,0,0,0,0,0,0,0,0,0,0,0,0
LAKSHADWEEP,2006,SC/ST (PREVENTION OF ATROCITIES) ACT,0,0,0,0,0,0,0,0,0,0,0,0,0,0,0
LAKSHADWEEP,2006,INDIAN PASSPORT ACT,0,0,0,0,0,0,0,0,0,0,0,0,0,0,0
LAKSHADWEEP,2006,ESSENTIAL COMMODITIES ACT,0,0,0,0,0,0,0,0,0,0,0,0,0,0,0
LAKSHADWEEP,2006,ANTIQUITIES AND ART TREASURE ACT,0,0,0,0,0,0,0,0,0,0,0,0,0,0,0
LAKSHADWEEP,2006,DOWRY PROHIBITION ACT,0,0,0,0,0,0,0,0,0,0,0,0,0,0,0
LAKSHADWEEP,2006,FOREIGN EXCHANGE REGULATION ACT-1973,0,0,0,0,0,0,0,0,0,0,0,0,0,0,0
LAKSHADWEEP,2006,PREVENTION OF CORRUPTION ACT-1988,0,0,0,0,0,0,0,0,0,0,0,0,0,0,0
LAKSHADWEEP,2006,CONSER.OF FORGN.EXCH.&PREV. OF SMUG.ACT,0,0,0,0,0,0,0,0,0,0,0,0,0,0,0
LAKSHADWEEP,2006,OTHER SLL OFFENCE,0,0,0,0,0,0,0,0,0,0,0,0,0,0,0
LAKSHADWEEP,2006,TOTAL,0,0,0,0,0,0,0,0,0,0,0,0,0,0,0
LAKSHADWEEP,2007,ARMS ACT,0,0,0,0,0,0,0,0,0,0,0,0,0,0,0
LAKSHADWEEP,2007,N.D.P.S. ACT,0,0,0,0,0,0,0,0,0,0,0,0,0,0,0
LAKSHADWEEP,2007,GAMBLING ACT,0,0,0,0,0,0,0,0,0,0,0,0,0,0,0
LAKSHADWEEP,2007,EXCISE ACT,0,0,0,0,0,0,0,0,0,0,0,0,0,0,0
LAKSHADWEEP,2007,PROHIBITION ACT,0,0,0,0,0,0,0,0,0,0,0,0,0,0,0
LAKSHADWEEP,2007,EXPLOSIVE & EXPLOSIVE SUBST. ACT,0,0,0,0,0,0,0,0,0,0,0,0,0,0,0
LAKSHADWEEP,2007,TERRORIST & DISRUPTIVE ACTIVITIES (TATA),0,0,0,0,0,0,0,0,0,0,0,0,0,0,0
LAKSHADWEEP,2007,IMMORAL TRAFFIC (PREVENTION) ACT,0,0,0,0,0,0,0,0,0,0,0,0,0,0,0
LAKSHADWEEP,2007,INDIAN RAILWAYS ACT,0,0,0,0,0,0,0,0,0,0,0,0,0,0,0
LAKSHADWEEP,2007,REGISTRATION OF FOREIGNERS ACT,0,0,0,0,0,0,0,0,0,0,0,0,0,0,0
LAKSHADWEEP,2007,PROTECTION OF CIVIL RIGHTS ACT,0,0,0,0,0,0,0,0,0,0,0,0,0,0,0
LAKSHADWEEP,2007,SC/ST (PREVENTION OF ATROCITIES) ACT,0,0,0,0,0,0,0,0,0,0,0,0,0,0,0
LAKSHADWEEP,2007,INDIAN PASSPORT ACT,0,0,0,0,0,0,0,0,0,0,0,0,0,0,0
LAKSHADWEEP,2007,ESSENTIAL COMMODITIES ACT,0,0,0,0,0,0,0,0,0,0,0,0,0,0,0
LAKSHADWEEP,2007,ANTIQUITIES AND ART TREASURE ACT,0,0,0,0,0,0,0,0,0,0,0,0,0,0,0
LAKSHADWEEP,2007,DOWRY PROHIBITION ACT,0,0,0,0,0,0,0,0,0,0,0,0,0,0,0
LAKSHADWEEP,2007,FOREIGN EXCHANGE REGULATION ACT-1973,0,0,0,0,0,0,0,0,0,0,0,0,0,0,0
LAKSHADWEEP,2007,PREVENTION OF CORRUPTION ACT-1988,0,0,0,0,0,0,0,0,0,0,0,0,0,0,0
LAKSHADWEEP,2007,CONSER.OF FORGN.EXCH.&PREV. OF SMUG.ACT,0,0,0,0,0,0,0,0,0,0,0,0,0,0,0
LAKSHADWEEP,2007,OTHER SLL OFFENCE,0,0,0,0,0,0,0,0,0,0,0,0,0,0,0
LAKSHADWEEP,2007,TOTAL,0,0,0,0,0,0,0,0,0,0,0,0,0,0,0
LAKSHADWEEP,2008,ARMS ACT,0,0,0,0,0,0,0,0,0,0,0,0,0,0,0
LAKSHADWEEP,2008,N.D.P.S. ACT,0,0,0,0,0,0,0,0,0,1,0,1,1,0,1
LAKSHADWEEP,2008,GAMBLING ACT,0,0,0,0,0,0,0,0,0,0,0,0,0,0,0
LAKSHADWEEP,2008,EXCISE ACT,0,0,0,0,0,0,0,0,0,0,0,0,0,0,0
LAKSHADWEEP,2008,PROHIBITION ACT,0,0,0,0,0,0,0,0,0,0,0,0,0,0,0
LAKSHADWEEP,2008,EXPLOSIVE & EXPLOSIVE SUBST. ACT,0,0,0,0,0,0,0,0,0,0,0,0,0,0,0
LAKSHADWEEP,2008,TERRORIST & DISRUPTIVE ACTIVITIES (TATA),0,0,0,0,0,0,0,0,0,0,0,0,0,0,0
LAKSHADWEEP,2008,IMMORAL TRAFFIC (PREVENTION) ACT,0,0,0,0,0,0,0,0,0,0,0,0,0,0,0
LAKSHADWEEP,2008,INDIAN RAILWAYS ACT,0,0,0,0,0,0,0,0,0,0,0,0,0,0,0
LAKSHADWEEP,2008,REGISTRATION OF FOREIGNERS ACT,0,0,0,0,0,0,0,0,0,0,0,0,0,0,0
LAKSHADWEEP,2008,PROTECTION OF CIVIL RIGHTS ACT,0,0,0,0,0,0,0,0,0,0,0,0,0,0,0
LAKSHADWEEP,2008,SC/ST (PREVENTION OF ATROCITIES) ACT,0,0,0,0,0,0,0,0,0,0,0,0,0,0,0
LAKSHADWEEP,2008,INDIAN PASSPORT ACT,0,0,0,0,0,0,0,0,0,0,0,0,0,0,0
LAKSHADWEEP,2008,ESSENTIAL COMMODITIES ACT,0,0,0,0,0,0,0,0,0,0,0,0,0,0,0
LAKSHADWEEP,2008,ANTIQUITIES AND ART TREASURE ACT,0,0,0,0,0,0,0,0,0,0,0,0,0,0,0
LAKSHADWEEP,2008,DOWRY PROHIBITION ACT,0,0,0,0,0,0,0,0,0,0,0,0,0,0,0
LAKSHADWEEP,2008,FOREIGN EXCHANGE REGULATION ACT-1973,0,0,0,0,0,0,0,0,0,0,0,0,0,0,0
LAKSHADWEEP,2008,PREVENTION OF CORRUPTION ACT-1988,0,0,0,0,0,0,0,0,0,0,0,0,0,0,0
LAKSHADWEEP,2008,CONSER.OF FORGN.EXCH.&PREV. OF SMUG.ACT,0,0,0,0,0,0,0,0,0,0,0,0,0,0,0
LAKSHADWEEP,2008,OTHER SLL OFFENCE,0,0,0,0,0,0,0,0,0,0,0,0,0,0,0
LAKSHADWEEP,2008,TOTAL,0,0,0,0,0,0,0,0,0,1,0,1,1,0,1
LAKSHADWEEP,2009,ARMS ACT,0,0,0,0,0,0,0,0,0,0,0,0,0,0,0
LAKSHADWEEP,2009,N.D.P.S. ACT,0,0,0,0,0,0,0,0,0,0,0,0,0,0,0
LAKSHADWEEP,2009,GAMBLING ACT,0,0,0,0,0,0,0,0,0,0,0,0,0,0,0
LAKSHADWEEP,2009,EXCISE ACT,0,0,0,0,0,0,0,0,0,0,0,0,0,0,0
LAKSHADWEEP,2009,PROHIBITION ACT,0,0,0,0,0,0,0,0,0,0,0,0,0,0,0
LAKSHADWEEP,2009,EXPLOSIVE & EXPLOSIVE SUBST. ACT,0,0,0,0,0,0,0,0,0,0,0,0,0,0,0
LAKSHADWEEP,2009,TERRORIST & DISRUPTIVE ACTIVITIES (TATA),0,0,0,0,0,0,0,0,0,0,0,0,0,0,0
LAKSHADWEEP,2009,IMMORAL TRAFFIC (PREVENTION) ACT,0,0,0,0,0,0,0,0,0,0,0,0,0,0,0
LAKSHADWEEP,2009,INDIAN RAILWAYS ACT,0,0,0,0,0,0,0,0,0,0,0,0,0,0,0
LAKSHADWEEP,2009,REGISTRATION OF FOREIGNERS ACT,0,0,0,0,0,0,0,0,0,0,0,0,0,0,0
LAKSHADWEEP,2009,PROTECTION OF CIVIL RIGHTS ACT,0,0,0,0,0,0,0,0,0,0,0,0,0,0,0
LAKSHADWEEP,2009,SC/ST (PREVENTION OF ATROCITIES) ACT,0,0,0,0,0,0,0,0,0,0,0,0,0,0,0
LAKSHADWEEP,2009,INDIAN PASSPORT ACT,0,0,0,0,0,0,0,0,0,0,0,0,0,0,0
LAKSHADWEEP,2009,ESSENTIAL COMMODITIES ACT,0,0,0,0,0,0,0,0,0,0,0,0,0,0,0
LAKSHADWEEP,2009,ANTIQUITIES AND ART TREASURE ACT,0,0,0,0,0,0,0,0,0,0,0,0,0,0,0
LAKSHADWEEP,2009,DOWRY PROHIBITION ACT,0,0,0,0,0,0,0,0,0,0,0,0,0,0,0
LAKSHADWEEP,2009,FOREIGN EXCHANGE REGULATION ACT-1973,0,0,0,0,0,0,0,0,0,0,0,0,0,0,0
LAKSHADWEEP,2009,PREVENTION OF CORRUPTION ACT-1988,0,0,0,0,0,0,0,0,0,0,0,0,0,0,0
LAKSHADWEEP,2009,CONSER.OF FORGN.EXCH.&PREV. OF SMUG.ACT,0,0,0,0,0,0,0,0,0,0,0,0,0,0,0
LAKSHADWEEP,2009,OTHER SLL OFFENCE,0,0,0,0,0,0,0,0,0,0,0,0,0,0,0
LAKSHADWEEP,2009,TOTAL,0,0,0,0,0,0,0,0,0,0,0,0,0,0,0
LAKSHADWEEP,2010,ARMS ACT,0,0,0,0,0,0,0,0,0,0,0,0,0,0,0
LAKSHADWEEP,2010,N.D.P.S. ACT,0,0,0,0,0,0,0,0,0,0,0,0,0,0,0
LAKSHADWEEP,2010,GAMBLING ACT,0,0,0,0,0,0,0,0,0,0,0,0,0,0,0
LAKSHADWEEP,2010,EXCISE ACT,0,0,0,0,0,0,0,0,0,0,0,0,0,0,0
LAKSHADWEEP,2010,PROHIBITION ACT,0,0,0,0,0,0,0,0,0,0,0,0,0,0,0
LAKSHADWEEP,2010,EXPLOSIVE & EXPLOSIVE SUBST. ACT,0,0,0,0,0,0,0,0,0,0,0,0,0,0,0
LAKSHADWEEP,2010,TERRORIST & DISRUPTIVE ACTIVITIES (TATA),0,0,0,0,0,0,0,0,0,0,0,0,0,0,0
LAKSHADWEEP,2010,IMMORAL TRAFFIC (PREVENTION) ACT,0,0,0,0,0,0,0,0,0,0,0,0,0,0,0
LAKSHADWEEP,2010,INDIAN RAILWAYS ACT,0,0,0,0,0,0,0,0,0,0,0,0,0,0,0
LAKSHADWEEP,2010,REGISTRATION OF FOREIGNERS ACT,0,0,0,0,0,0,0,0,0,0,0,0,0,0,0
LAKSHADWEEP,2010,PROTECTION OF CIVIL RIGHTS ACT,0,0,0,0,0,0,0,0,0,0,0,0,0,0,0
LAKSHADWEEP,2010,SC/ST (PREVENTION OF ATROCITIES) ACT,0,0,0,0,0,0,0,0,0,0,0,0,0,0,0
LAKSHADWEEP,2010,INDIAN PASSPORT ACT,0,0,0,0,0,0,0,0,0,0,0,0,0,0,0
LAKSHADWEEP,2010,ESSENTIAL COMMODITIES ACT,0,0,0,0,0,0,0,0,0,0,0,0,0,0,0
LAKSHADWEEP,2010,ANTIQUITIES AND ART TREASURE ACT,0,0,0,0,0,0,0,0,0,0,0,0,0,0,0
LAKSHADWEEP,2010,DOWRY PROHIBITION ACT,0,0,0,0,0,0,0,0,0,0,0,0,0,0,0
LAKSHADWEEP,2010,FOREIGN EXCHANGE REGULATION ACT-1973,0,0,0,0,0,0,0,0,0,0,0,0,0,0,0
LAKSHADWEEP,2010,PREVENTION OF CORRUPTION ACT-1988,0,0,0,0,0,0,0,0,0,0,0,0,0,0,0
LAKSHADWEEP,2010,CONSER.OF FORGN.EXCH.&PREV. OF SMUG.ACT,0,0,0,0,0,0,0,0,0,0,0,0,0,0,0
LAKSHADWEEP,2010,OTHER SLL OFFENCE,0,0,0,0,0,0,0,0,0,0,0,0,0,0,0
LAKSHADWEEP,2010,TOTAL,0,0,0,0,0,0,0,0,0,0,0,0,0,0,0
LAKSHADWEEP,2011,ARMS ACT,0,0,0,0,0,0,0,0,0,0,0,0,0,0,0
LAKSHADWEEP,2011,N.D.P.S. ACT,0,0,0,0,0,0,0,0,0,0,0,0,0,0,0
LAKSHADWEEP,2011,GAMBLING ACT,0,0,0,0,0,0,0,0,0,0,0,0,0,0,0
LAKSHADWEEP,2011,EXCISE ACT,0,0,0,0,0,0,0,0,0,0,0,0,0,0,0
LAKSHADWEEP,2011,PROHIBITION ACT,0,0,0,0,0,0,0,0,0,0,0,0,0,0,0
LAKSHADWEEP,2011,EXPLOSIVE & EXPLOSIVE SUBST. ACT,0,0,0,0,0,0,0,0,0,0,0,0,0,0,0
LAKSHADWEEP,2011,TERRORIST & DISRUPTIVE ACTIVITIES (TATA),0,0,0,0,0,0,0,0,0,0,0,0,0,0,0
LAKSHADWEEP,2011,IMMORAL TRAFFIC (PREVENTION) ACT,0,0,0,0,0,0,0,0,0,0,0,0,0,0,0
LAKSHADWEEP,2011,INDIAN RAILWAYS ACT,0,0,0,0,0,0,0,0,0,0,0,0,0,0,0
LAKSHADWEEP,2011,REGISTRATION OF FOREIGNERS ACT,0,0,0,0,0,0,0,0,0,0,0,0,0,0,0
LAKSHADWEEP,2011,PROTECTION OF CIVIL RIGHTS ACT,0,0,0,0,0,0,0,0,0,0,0,0,0,0,0
LAKSHADWEEP,2011,SC/ST (PREVENTION OF ATROCITIES) ACT,0,0,0,0,0,0,0,0,0,0,0,0,0,0,0
LAKSHADWEEP,2011,INDIAN PASSPORT ACT,0,0,0,0,0,0,0,0,0,0,0,0,0,0,0
LAKSHADWEEP,2011,ESSENTIAL COMMODITIES ACT,0,0,0,0,0,0,0,0,0,0,0,0,0,0,0
LAKSHADWEEP,2011,ANTIQUITIES AND ART TREASURE ACT,0,0,0,0,0,0,0,0,0,0,0,0,0,0,0
LAKSHADWEEP,2011,DOWRY PROHIBITION ACT,0,0,0,0,0,0,0,0,0,0,0,0,0,0,0
LAKSHADWEEP,2011,FOREIGN EXCHANGE REGULATION ACT-1973,0,0,0,0,0,0,0,0,0,0,0,0,0,0,0
LAKSHADWEEP,2011,PREVENTION OF CORRUPTION ACT-1988,0,0,0,0,0,0,0,0,0,0,0,0,0,0,0
LAKSHADWEEP,2011,CONSER.OF FORGN.EXCH.&PREV. OF SMUG.ACT,0,0,0,0,0,0,0,0,0,0,0,0,0,0,0
LAKSHADWEEP,2011,OTHER SLL OFFENCE,0,0,0,0,0,0,0,0,0,0,0,0,0,0,0
LAKSHADWEEP,2011,TOTAL,0,0,0,0,0,0,0,0,0,0,0,0,0,0,0
LAKSHADWEEP,2012,ARMS ACT,0,0,0,0,0,0,0,0,0,0,0,0,0,0,0
LAKSHADWEEP,2012,N.D.P.S. ACT,0,0,0,0,0,0,0,0,0,0,0,0,0,0,0
LAKSHADWEEP,2012,GAMBLING ACT,0,0,0,0,0,0,0,0,0,0,0,0,0,0,0
LAKSHADWEEP,2012,EXCISE ACT,0,0,0,0,0,0,0,0,0,0,0,0,0,0,0
LAKSHADWEEP,2012,PROHIBITION ACT,0,0,0,0,0,0,0,0,0,0,0,0,0,0,0
LAKSHADWEEP,2012,EXPLOSIVE & EXPLOSIVE SUBST. ACT,0,0,0,0,0,0,0,0,0,0,0,0,0,0,0
LAKSHADWEEP,2012,TERRORIST & DISRUPTIVE ACTIVITIES (TATA),0,0,0,0,0,0,0,0,0,0,0,0,0,0,0
LAKSHADWEEP,2012,IMMORAL TRAFFIC (PREVENTION) ACT,0,0,0,0,0,0,0,0,0,0,0,0,0,0,0
LAKSHADWEEP,2012,INDIAN RAILWAYS ACT,0,0,0,0,0,0,0,0,0,0,0,0,0,0,0
LAKSHADWEEP,2012,REGISTRATION OF FOREIGNERS ACT,0,0,0,0,0,0,0,0,0,0,0,0,0,0,0
LAKSHADWEEP,2012,PROTECTION OF CIVIL RIGHTS ACT,0,0,0,0,0,0,0,0,0,0,0,0,0,0,0
LAKSHADWEEP,2012,SC/ST (PREVENTION OF ATROCITIES) ACT,0,0,0,0,0,0,0,0,0,0,0,0,0,0,0
LAKSHADWEEP,2012,INDIAN PASSPORT ACT,0,0,0,0,0,0,0,0,0,0,0,0,0,0,0
LAKSHADWEEP,2012,ESSENTIAL COMMODITIES ACT,0,0,0,0,0,0,0,0,0,0,0,0,0,0,0
LAKSHADWEEP,2012,ANTIQUITIES AND ART TREASURE ACT,0,0,0,0,0,0,0,0,0,0,0,0,0,0,0
LAKSHADWEEP,2012,DOWRY PROHIBITION ACT,0,0,0,0,0,0,0,0,0,0,0,0,0,0,0
LAKSHADWEEP,2012,FOREIGN EXCHANGE REGULATION ACT-1973,0,0,0,0,0,0,0,0,0,0,0,0,0,0,0
LAKSHADWEEP,2012,PREVENTION OF CORRUPTION ACT-1988,0,0,0,0,0,0,0,0,0,0,0,0,0,0,0
LAKSHADWEEP,2012,CONSER.OF FORGN.EXCH.&PREV. OF SMUG.ACT,0,0,0,0,0,0,0,0,0,0,0,0,0,0,0
LAKSHADWEEP,2012,OTHER SLL OFFENCE,0,0,0,0,0,0,0,0,0,0,0,0,0,0,0
LAKSHADWEEP,2012,TOTAL,0,0,0,0,0,0,0,0,0,0,0,0,0,0,0
PONDICHERRY,2001,ARMS ACT,0,0,0,4,0,4,0,0,0,0,0,0,4,0,4
PONDICHERRY,2001,N.D.P.S. ACT,0,0,0,1,0,1,0,0,0,0,0,0,1,0,1
PONDICHERRY,2001,GAMBLING ACT,0,0,0,0,0,0,0,0,0,0,0,0,0,0,0
PONDICHERRY,2001,EXCISE ACT,0,0,0,2,0,2,0,0,0,3,0,3,5,0,5
PONDICHERRY,2001,PROHIBITION ACT,0,0,0,0,0,0,0,0,0,0,0,0,0,0,0
PONDICHERRY,2001,EXPLOSIVE & EXPLOSIVE SUBST. ACT,0,0,0,0,0,0,0,0,0,0,0,0,0,0,0
PONDICHERRY,2001,TERRORIST & DISRUPTIVE ACTIVITIES (TATA),0,0,0,0,0,0,0,0,0,0,0,0,0,0,0
PONDICHERRY,2001,IMMORAL TRAFFIC (PREVENTION) ACT,0,0,0,0,5,5,0,0,0,0,0,0,0,5,5
PONDICHERRY,2001,INDIAN RAILWAYS ACT,0,0,0,0,0,0,0,0,0,0,0,0,0,0,0
PONDICHERRY,2001,REGISTRATION OF FOREIGNERS ACT,0,0,0,0,0,0,0,0,0,0,0,0,0,0,0
PONDICHERRY,2001,PROTECTION OF CIVIL RIGHTS ACT,0,0,0,0,0,0,0,0,0,0,0,0,0,0,0
PONDICHERRY,2001,SC/ST (PREVENTION OF ATROCITIES) ACT,0,0,0,0,0,0,0,0,0,0,0,0,0,0,0
PONDICHERRY,2001,INDIAN PASSPORT ACT,0,0,0,0,0,0,0,0,0,0,0,0,0,0,0
PONDICHERRY,2001,ESSENTIAL COMMODITIES ACT,0,0,0,0,0,0,0,0,0,0,0,0,0,0,0
PONDICHERRY,2001,ANTIQUITIES AND ART TREASURE ACT,0,0,0,0,0,0,0,0,0,0,0,0,0,0,0
PONDICHERRY,2001,DOWRY PROHIBITION ACT,0,0,0,0,0,0,0,0,0,0,0,0,0,0,0
PONDICHERRY,2001,FOREIGN EXCHANGE REGULATION ACT-1973,0,0,0,0,0,0,0,0,0,0,0,0,0,0,0
PONDICHERRY,2001,PREVENTION OF CORRUPTION ACT-1988,0,0,0,0,0,0,0,0,0,0,0,0,0,0,0
PONDICHERRY,2001,CONSER.OF FORGN.EXCH.&PREV. OF SMUG.ACT,0,0,0,0,0,0,0,0,0,0,0,0,0,0,0
PONDICHERRY,2001,OTHER SLL OFFENCE,0,0,0,0,0,0,0,0,0,0,0,0,0,0,0
PONDICHERRY,2001,TOTAL,0,0,0,7,5,12,0,0,0,3,0,3,10,5,15
PONDICHERRY,2002,ARMS ACT,0,0,0,0,0,0,5,0,5,0,0,0,5,0,5
PONDICHERRY,2002,N.D.P.S. ACT,0,0,0,0,0,0,2,0,2,2,0,2,4,0,4
PONDICHERRY,2002,GAMBLING ACT,0,0,0,0,0,0,0,0,0,0,0,0,0,0,0
PONDICHERRY,2002,EXCISE ACT,0,0,0,0,0,0,0,0,0,4,0,4,4,0,4
PONDICHERRY,2002,PROHIBITION ACT,0,0,0,0,0,0,0,0,0,0,0,0,0,0,0
PONDICHERRY,2002,EXPLOSIVE & EXPLOSIVE SUBST. ACT,0,0,0,0,0,0,0,0,0,0,0,0,0,0,0
PONDICHERRY,2002,TERRORIST & DISRUPTIVE ACTIVITIES (TATA),0,0,0,0,0,0,0,0,0,0,0,0,0,0,0
PONDICHERRY,2002,IMMORAL TRAFFIC (PREVENTION) ACT,0,0,0,0,12,12,0,0,0,0,0,0,0,12,12
PONDICHERRY,2002,INDIAN RAILWAYS ACT,0,0,0,0,0,0,0,0,0,0,0,0,0,0,0
PONDICHERRY,2002,REGISTRATION OF FOREIGNERS ACT,0,0,0,0,0,0,0,0,0,0,0,0,0,0,0
PONDICHERRY,2002,PROTECTION OF CIVIL RIGHTS ACT,0,0,0,0,0,0,0,0,0,0,0,0,0,0,0
PONDICHERRY,2002,SC/ST (PREVENTION OF ATROCITIES) ACT,0,0,0,0,0,0,0,0,0,0,0,0,0,0,0
PONDICHERRY,2002,INDIAN PASSPORT ACT,0,0,0,0,0,0,0,0,0,0,0,0,0,0,0
PONDICHERRY,2002,ESSENTIAL COMMODITIES ACT,0,0,0,0,0,0,0,0,0,0,0,0,0,0,0
PONDICHERRY,2002,ANTIQUITIES AND ART TREASURE ACT,0,0,0,0,0,0,0,0,0,0,0,0,0,0,0
PONDICHERRY,2002,DOWRY PROHIBITION ACT,0,0,0,0,0,0,0,0,0,0,0,0,0,0,0
PONDICHERRY,2002,FOREIGN EXCHANGE REGULATION ACT-1973,0,0,0,0,0,0,0,0,0,0,0,0,0,0,0
PONDICHERRY,2002,PREVENTION OF CORRUPTION ACT-1988,0,0,0,0,0,0,0,0,0,0,0,0,0,0,0
PONDICHERRY,2002,CONSER.OF FORGN.EXCH.&PREV. OF SMUG.ACT,0,0,0,0,0,0,0,0,0,0,0,0,0,0,0
PONDICHERRY,2002,OTHER SLL OFFENCE,0,0,0,0,0,0,0,0,0,0,0,0,0,0,0
PONDICHERRY,2002,TOTAL,0,0,0,0,12,12,7,0,7,6,0,6,13,12,25
PONDICHERRY,2003,ARMS ACT,0,0,0,5,0,5,0,0,0,0,0,0,5,0,5
PONDICHERRY,2003,N.D.P.S. ACT,0,0,0,0,0,0,0,0,0,0,0,0,0,0,0
PONDICHERRY,2003,GAMBLING ACT,0,0,0,0,0,0,0,0,0,0,0,0,0,0,0
PONDICHERRY,2003,EXCISE ACT,0,0,0,0,0,0,0,0,0,0,0,0,0,0,0
PONDICHERRY,2003,PROHIBITION ACT,0,0,0,0,0,0,0,0,0,0,0,0,0,0,0
PONDICHERRY,2003,EXPLOSIVE & EXPLOSIVE SUBST. ACT,0,0,0,0,0,0,0,0,0,0,0,0,0,0,0
PONDICHERRY,2003,TERRORIST & DISRUPTIVE ACTIVITIES (TATA),0,0,0,0,0,0,0,0,0,0,0,0,0,0,0
PONDICHERRY,2003,IMMORAL TRAFFIC (PREVENTION) ACT,0,0,0,0,4,4,0,0,0,0,0,0,0,4,4
PONDICHERRY,2003,INDIAN RAILWAYS ACT,0,0,0,0,0,0,0,0,0,0,0,0,0,0,0
PONDICHERRY,2003,REGISTRATION OF FOREIGNERS ACT,0,0,0,0,0,0,0,0,0,0,0,0,0,0,0
PONDICHERRY,2003,PROTECTION OF CIVIL RIGHTS ACT,0,0,0,0,0,0,0,0,0,0,0,0,0,0,0
PONDICHERRY,2003,SC/ST (PREVENTION OF ATROCITIES) ACT,0,0,0,0,0,0,0,0,0,0,0,0,0,0,0
PONDICHERRY,2003,INDIAN PASSPORT ACT,0,0,0,0,0,0,0,0,0,0,0,0,0,0,0
PONDICHERRY,2003,ESSENTIAL COMMODITIES ACT,0,0,0,0,0,0,0,0,0,0,0,0,0,0,0
PONDICHERRY,2003,ANTIQUITIES AND ART TREASURE ACT,0,0,0,0,0,0,0,0,0,0,0,0,0,0,0
PONDICHERRY,2003,DOWRY PROHIBITION ACT,0,0,0,0,0,0,0,0,0,0,0,0,0,0,0
PONDICHERRY,2003,FOREIGN EXCHANGE REGULATION ACT-1973,0,0,0,0,0,0,0,0,0,0,0,0,0,0,0
PONDICHERRY,2003,PREVENTION OF CORRUPTION ACT-1988,0,0,0,0,0,0,0,0,0,0,0,0,0,0,0
PONDICHERRY,2003,CONSER.OF FORGN.EXCH.&PREV. OF SMUG.ACT,0,0,0,0,0,0,0,0,0,0,0,0,0,0,0
PONDICHERRY,2003,OTHER SLL OFFENCE,0,0,0,0,0,0,0,0,0,0,0,0,0,0,0
PONDICHERRY,2003,TOTAL,0,0,0,5,4,9,0,0,0,0,0,0,5,4,9
PONDICHERRY,2004,ARMS ACT,0,0,0,0,0,0,9,0,9,0,0,0,9,0,9
PONDICHERRY,2004,N.D.P.S. ACT,0,0,0,0,0,0,0,0,0,0,0,0,0,0,0
PONDICHERRY,2004,GAMBLING ACT,0,0,0,0,0,0,0,0,0,0,0,0,0,0,0
PONDICHERRY,2004,EXCISE ACT,0,0,0,0,0,0,0,0,0,0,0,0,0,0,0
PONDICHERRY,2004,PROHIBITION ACT,0,0,0,0,0,0,0,0,0,0,0,0,0,0,0
PONDICHERRY,2004,EXPLOSIVE & EXPLOSIVE SUBST. ACT,0,0,0,0,0,0,4,0,4,0,0,0,4,0,4
PONDICHERRY,2004,TERRORIST & DISRUPTIVE ACTIVITIES (TATA),0,0,0,0,0,0,0,0,0,0,0,0,0,0,0
PONDICHERRY,2004,IMMORAL TRAFFIC (PREVENTION) ACT,0,0,0,0,0,0,0,0,0,0,0,0,0,0,0
PONDICHERRY,2004,INDIAN RAILWAYS ACT,0,0,0,0,0,0,2,0,2,0,0,0,2,0,2
PONDICHERRY,2004,REGISTRATION OF FOREIGNERS ACT,0,0,0,0,0,0,0,0,0,0,0,0,0,0,0
PONDICHERRY,2004,PROTECTION OF CIVIL RIGHTS ACT,0,0,0,0,0,0,0,0,0,0,0,0,0,0,0
PONDICHERRY,2004,SC/ST (PREVENTION OF ATROCITIES) ACT,0,0,0,0,0,0,0,0,0,0,0,0,0,0,0
PONDICHERRY,2004,INDIAN PASSPORT ACT,0,0,0,0,0,0,0,0,0,0,0,0,0,0,0
PONDICHERRY,2004,ESSENTIAL COMMODITIES ACT,0,0,0,0,0,0,0,0,0,0,0,0,0,0,0
PONDICHERRY,2004,ANTIQUITIES AND ART TREASURE ACT,0,0,0,0,0,0,0,0,0,0,0,0,0,0,0
PONDICHERRY,2004,DOWRY PROHIBITION ACT,0,0,0,0,0,0,0,0,0,0,0,0,0,0,0
PONDICHERRY,2004,FOREIGN EXCHANGE REGULATION ACT-1973,0,0,0,0,0,0,0,0,0,0,0,0,0,0,0
PONDICHERRY,2004,PREVENTION OF CORRUPTION ACT-1988,0,0,0,0,0,0,0,0,0,0,0,0,0,0,0
PONDICHERRY,2004,CONSER.OF FORGN.EXCH.&PREV. OF SMUG.ACT,0,0,0,0,0,0,0,0,0,0,0,0,0,0,0
PONDICHERRY,2004,OTHER SLL OFFENCE,0,0,0,0,0,0,10,0,10,0,0,0,10,0,10
PONDICHERRY,2004,TOTAL,0,0,0,0,0,0,25,0,25,0,0,0,25,0,25
PONDICHERRY,2005,ARMS ACT,0,0,0,4,0,4,0,0,0,0,0,0,4,0,4
PONDICHERRY,2005,N.D.P.S. ACT,0,0,0,0,0,0,0,0,0,0,0,0,0,0,0
PONDICHERRY,2005,GAMBLING ACT,0,0,0,0,0,0,0,0,0,0,0,0,0,0,0
PONDICHERRY,2005,EXCISE ACT,0,0,0,0,0,0,4,0,4,0,0,0,4,0,4
PONDICHERRY,2005,PROHIBITION ACT,0,0,0,0,0,0,0,0,0,0,0,0,0,0,0
PONDICHERRY,2005,EXPLOSIVE & EXPLOSIVE SUBST. ACT,0,0,0,0,0,0,2,0,2,0,0,0,2,0,2
PONDICHERRY,2005,TERRORIST & DISRUPTIVE ACTIVITIES (TATA),0,0,0,0,0,0,0,0,0,0,0,0,0,0,0
PONDICHERRY,2005,IMMORAL TRAFFIC (PREVENTION) ACT,0,0,0,0,0,0,0,0,0,0,0,0,0,0,0
PONDICHERRY,2005,INDIAN RAILWAYS ACT,0,0,0,0,0,0,0,0,0,0,0,0,0,0,0
PONDICHERRY,2005,REGISTRATION OF FOREIGNERS ACT,0,0,0,0,0,0,0,0,0,0,0,0,0,0,0
PONDICHERRY,2005,PROTECTION OF CIVIL RIGHTS ACT,0,0,0,0,0,0,0,0,0,0,0,0,0,0,0
PONDICHERRY,2005,SC/ST (PREVENTION OF ATROCITIES) ACT,0,0,0,0,0,0,0,0,0,0,0,0,0,0,0
PONDICHERRY,2005,INDIAN PASSPORT ACT,0,0,0,0,0,0,0,0,0,0,0,0,0,0,0
PONDICHERRY,2005,ESSENTIAL COMMODITIES ACT,0,0,0,0,0,0,0,0,0,0,0,0,0,0,0
PONDICHERRY,2005,ANTIQUITIES AND ART TREASURE ACT,0,0,0,0,0,0,0,0,0,0,0,0,0,0,0
PONDICHERRY,2005,DOWRY PROHIBITION ACT,0,0,0,0,0,0,0,0,0,0,0,0,0,0,0
PONDICHERRY,2005,FOREIGN EXCHANGE REGULATION ACT-1973,0,0,0,0,0,0,0,0,0,0,0,0,0,0,0
PONDICHERRY,2005,PREVENTION OF CORRUPTION ACT-1988,0,0,0,0,0,0,0,0,0,0,0,0,0,0,0
PONDICHERRY,2005,CONSER.OF FORGN.EXCH.&PREV. OF SMUG.ACT,0,0,0,0,0,0,0,0,0,0,0,0,0,0,0
PONDICHERRY,2005,OTHER SLL OFFENCE,0,0,0,0,0,0,0,0,0,0,0,0,0,0,0
PONDICHERRY,2005,TOTAL,0,0,0,4,0,4,6,0,6,0,0,0,10,0,10
PONDICHERRY,2006,ARMS ACT,0,0,0,8,0,8,2,0,2,0,0,0,10,0,10
PONDICHERRY,2006,N.D.P.S. ACT,0,0,0,2,0,2,0,0,0,0,0,0,2,0,2
PONDICHERRY,2006,GAMBLING ACT,0,0,0,0,0,0,0,0,0,0,0,0,0,0,0
PONDICHERRY,2006,EXCISE ACT,0,0,0,0,0,0,2,0,2,1,0,1,3,0,3
PONDICHERRY,2006,PROHIBITION ACT,0,0,0,0,0,0,0,0,0,0,0,0,0,0,0
PONDICHERRY,2006,EXPLOSIVE & EXPLOSIVE SUBST. ACT,0,0,0,0,0,0,3,0,3,0,0,0,3,0,3
PONDICHERRY,2006,TERRORIST & DISRUPTIVE ACTIVITIES (TATA),0,0,0,0,0,0,0,0,0,0,0,0,0,0,0
PONDICHERRY,2006,IMMORAL TRAFFIC (PREVENTION) ACT,0,0,0,0,0,0,0,0,0,0,0,0,0,0,0
PONDICHERRY,2006,INDIAN RAILWAYS ACT,0,0,0,0,0,0,0,0,0,0,0,0,0,0,0
PONDICHERRY,2006,REGISTRATION OF FOREIGNERS ACT,0,0,0,0,0,0,0,0,0,0,0,0,0,0,0
PONDICHERRY,2006,PROTECTION OF CIVIL RIGHTS ACT,0,0,0,0,0,0,0,0,0,0,0,0,0,0,0
PONDICHERRY,2006,SC/ST (PREVENTION OF ATROCITIES) ACT,0,0,0,0,0,0,0,0,0,0,0,0,0,0,0
PONDICHERRY,2006,INDIAN PASSPORT ACT,0,0,0,0,0,0,0,0,0,0,0,0,0,0,0
PONDICHERRY,2006,ESSENTIAL COMMODITIES ACT,0,0,0,0,0,0,0,0,0,0,0,0,0,0,0
PONDICHERRY,2006,ANTIQUITIES AND ART TREASURE ACT,0,0,0,0,0,0,0,0,0,0,0,0,0,0,0
PONDICHERRY,2006,DOWRY PROHIBITION ACT,0,0,0,0,0,0,0,0,0,0,0,0,0,0,0
PONDICHERRY,2006,FOREIGN EXCHANGE REGULATION ACT-1973,0,0,0,0,0,0,0,0,0,0,0,0,0,0,0
PONDICHERRY,2006,PREVENTION OF CORRUPTION ACT-1988,0,0,0,0,0,0,0,0,0,0,0,0,0,0,0
PONDICHERRY,2006,CONSER.OF FORGN.EXCH.&PREV. OF SMUG.ACT,0,0,0,0,0,0,0,0,0,0,0,0,0,0,0
PONDICHERRY,2006,OTHER SLL OFFENCE,0,0,0,0,0,0,0,0,0,0,0,0,0,0,0
PONDICHERRY,2006,TOTAL,0,0,0,10,0,10,7,0,7,1,0,1,18,0,18
PONDICHERRY,2007,ARMS ACT,0,0,0,8,0,8,0,0,0,0,0,0,8,0,8
PONDICHERRY,2007,N.D.P.S. ACT,0,0,0,0,0,0,1,0,1,0,0,0,1,0,1
PONDICHERRY,2007,GAMBLING ACT,0,0,0,0,0,0,0,0,0,0,0,0,0,0,0
PONDICHERRY,2007,EXCISE ACT,0,0,0,6,0,6,1,0,1,0,0,0,7,0,7
PONDICHERRY,2007,PROHIBITION ACT,0,0,0,0,0,0,0,0,0,0,0,0,0,0,0
PONDICHERRY,2007,EXPLOSIVE & EXPLOSIVE SUBST. ACT,0,0,0,0,0,0,5,0,5,0,0,0,5,0,5
PONDICHERRY,2007,TERRORIST & DISRUPTIVE ACTIVITIES (TATA),0,0,0,0,0,0,0,0,0,0,0,0,0,0,0
PONDICHERRY,2007,IMMORAL TRAFFIC (PREVENTION) ACT,0,0,0,0,0,0,0,0,0,0,0,0,0,0,0
PONDICHERRY,2007,INDIAN RAILWAYS ACT,0,0,0,0,0,0,0,0,0,0,0,0,0,0,0
PONDICHERRY,2007,REGISTRATION OF FOREIGNERS ACT,0,0,0,0,0,0,0,0,0,0,0,0,0,0,0
PONDICHERRY,2007,PROTECTION OF CIVIL RIGHTS ACT,0,0,0,0,0,0,0,0,0,0,0,0,0,0,0
PONDICHERRY,2007,SC/ST (PREVENTION OF ATROCITIES) ACT,0,0,0,0,0,0,0,0,0,0,0,0,0,0,0
PONDICHERRY,2007,INDIAN PASSPORT ACT,0,0,0,0,0,0,0,0,0,0,0,0,0,0,0
PONDICHERRY,2007,ESSENTIAL COMMODITIES ACT,0,0,0,0,0,0,0,0,0,0,0,0,0,0,0
PONDICHERRY,2007,ANTIQUITIES AND ART TREASURE ACT,0,0,0,0,0,0,0,0,0,0,0,0,0,0,0
PONDICHERRY,2007,DOWRY PROHIBITION ACT,0,0,0,0,0,0,0,0,0,0,0,0,0,0,0
PONDICHERRY,2007,FOREIGN EXCHANGE REGULATION ACT-1973,0,0,0,0,0,0,0,0,0,0,0,0,0,0,0
PONDICHERRY,2007,PREVENTION OF CORRUPTION ACT-1988,0,0,0,0,0,0,0,0,0,0,0,0,0,0,0
PONDICHERRY,2007,CONSER.OF FORGN.EXCH.&PREV. OF SMUG.ACT,0,0,0,0,0,0,0,0,0,0,0,0,0,0,0
PONDICHERRY,2007,OTHER SLL OFFENCE,0,0,0,0,0,0,0,0,0,0,0,0,0,0,0
PONDICHERRY,2007,TOTAL,0,0,0,14,0,14,7,0,7,0,0,0,21,0,21
PONDICHERRY,2008,ARMS ACT,0,0,0,8,0,8,0,0,0,0,0,0,8,0,8
PONDICHERRY,2008,N.D.P.S. ACT,0,0,0,1,0,1,0,0,0,0,0,0,1,0,1
PONDICHERRY,2008,GAMBLING ACT,0,0,0,0,0,0,0,0,0,0,0,0,0,0,0
PONDICHERRY,2008,EXCISE ACT,0,0,0,4,0,4,0,0,0,0,0,0,4,0,4
PONDICHERRY,2008,PROHIBITION ACT,0,0,0,0,0,0,0,0,0,0,0,0,0,0,0
PONDICHERRY,2008,EXPLOSIVE & EXPLOSIVE SUBST. ACT,0,0,0,8,0,8,2,0,2,0,0,0,10,0,10
PONDICHERRY,2008,TERRORIST & DISRUPTIVE ACTIVITIES (TATA),0,0,0,0,0,0,0,0,0,0,0,0,0,0,0
PONDICHERRY,2008,IMMORAL TRAFFIC (PREVENTION) ACT,0,0,0,0,0,0,0,0,0,0,0,0,0,0,0
PONDICHERRY,2008,INDIAN RAILWAYS ACT,0,0,0,0,0,0,0,0,0,0,0,0,0,0,0
PONDICHERRY,2008,REGISTRATION OF FOREIGNERS ACT,0,0,0,0,0,0,0,0,0,0,0,0,0,0,0
PONDICHERRY,2008,PROTECTION OF CIVIL RIGHTS ACT,0,0,0,0,0,0,0,0,0,0,0,0,0,0,0
PONDICHERRY,2008,SC/ST (PREVENTION OF ATROCITIES) ACT,0,0,0,0,0,0,0,0,0,0,0,0,0,0,0
PONDICHERRY,2008,INDIAN PASSPORT ACT,0,0,0,0,0,0,0,0,0,0,0,0,0,0,0
PONDICHERRY,2008,ESSENTIAL COMMODITIES ACT,0,0,0,2,0,2,0,0,0,0,0,0,2,0,2
PONDICHERRY,2008,ANTIQUITIES AND ART TREASURE ACT,0,0,0,0,0,0,0,0,0,0,0,0,0,0,0
PONDICHERRY,2008,DOWRY PROHIBITION ACT,0,0,0,0,0,0,0,0,0,0,0,0,0,0,0
PONDICHERRY,2008,FOREIGN EXCHANGE REGULATION ACT-1973,0,0,0,0,0,0,0,0,0,0,0,0,0,0,0
PONDICHERRY,2008,PREVENTION OF CORRUPTION ACT-1988,0,0,0,0,0,0,0,0,0,0,0,0,0,0,0
PONDICHERRY,2008,CONSER.OF FORGN.EXCH.&PREV. OF SMUG.ACT,0,0,0,0,0,0,0,0,0,0,0,0,0,0,0
PONDICHERRY,2008,OTHER SLL OFFENCE,0,0,0,0,0,0,5,0,5,0,0,0,5,0,5
PONDICHERRY,2008,TOTAL,0,0,0,23,0,23,7,0,7,0,0,0,30,0,30
PONDICHERRY,2009,ARMS ACT,0,0,0,15,0,15,2,0,2,0,0,0,17,0,17
PONDICHERRY,2009,N.D.P.S. ACT,0,0,0,0,0,0,0,0,0,0,0,0,0,0,0
PONDICHERRY,2009,GAMBLING ACT,0,0,0,0,0,0,0,0,0,0,0,0,0,0,0
PONDICHERRY,2009,EXCISE ACT,0,0,0,1,0,1,0,0,0,0,0,0,1,0,1
PONDICHERRY,2009,PROHIBITION ACT,0,0,0,0,0,0,0,0,0,0,0,0,0,0,0
PONDICHERRY,2009,EXPLOSIVE & EXPLOSIVE SUBST. ACT,0,0,0,11,0,11,1,0,1,0,0,0,12,0,12
PONDICHERRY,2009,TERRORIST & DISRUPTIVE ACTIVITIES (TATA),0,0,0,0,0,0,0,0,0,0,0,0,0,0,0
PONDICHERRY,2009,IMMORAL TRAFFIC (PREVENTION) ACT,0,0,0,0,0,0,0,0,0,0,0,0,0,0,0
PONDICHERRY,2009,INDIAN RAILWAYS ACT,0,0,0,0,0,0,0,0,0,0,0,0,0,0,0
PONDICHERRY,2009,REGISTRATION OF FOREIGNERS ACT,0,0,0,0,0,0,0,0,0,0,0,0,0,0,0
PONDICHERRY,2009,PROTECTION OF CIVIL RIGHTS ACT,0,0,0,0,0,0,0,0,0,0,0,0,0,0,0
PONDICHERRY,2009,SC/ST (PREVENTION OF ATROCITIES) ACT,0,0,0,0,0,0,0,0,0,0,0,0,0,0,0
PONDICHERRY,2009,INDIAN PASSPORT ACT,0,0,0,0,0,0,1,0,1,0,0,0,1,0,1
PONDICHERRY,2009,ESSENTIAL COMMODITIES ACT,0,0,0,0,0,0,2,0,2,0,0,0,2,0,2
PONDICHERRY,2009,ANTIQUITIES AND ART TREASURE ACT,0,0,0,0,0,0,0,0,0,0,0,0,0,0,0
PONDICHERRY,2009,DOWRY PROHIBITION ACT,0,0,0,0,0,0,0,0,0,0,0,0,0,0,0
PONDICHERRY,2009,FOREIGN EXCHANGE REGULATION ACT-1973,0,0,0,0,0,0,0,0,0,0,0,0,0,0,0
PONDICHERRY,2009,PREVENTION OF CORRUPTION ACT-1988,0,0,0,0,0,0,0,0,0,0,0,0,0,0,0
PONDICHERRY,2009,CONSER.OF FORGN.EXCH.&PREV. OF SMUG.ACT,0,0,0,0,0,0,0,0,0,0,0,0,0,0,0
PONDICHERRY,2009,OTHER SLL OFFENCE,0,0,0,8,0,8,15,0,15,0,0,0,23,0,23
PONDICHERRY,2009,TOTAL,0,0,0,35,0,35,21,0,21,0,0,0,56,0,56
PONDICHERRY,2010,ARMS ACT,0,0,0,11,0,11,2,0,2,0,0,0,13,0,13
PONDICHERRY,2010,N.D.P.S. ACT,0,0,0,0,0,0,0,0,0,0,0,0,0,0,0
PONDICHERRY,2010,GAMBLING ACT,0,0,0,0,0,0,0,0,0,0,0,0,0,0,0
PONDICHERRY,2010,EXCISE ACT,0,0,0,0,0,0,0,0,0,0,0,0,0,0,0
PONDICHERRY,2010,PROHIBITION ACT,0,0,0,0,0,0,0,0,0,0,0,0,0,0,0
PONDICHERRY,2010,EXPLOSIVE & EXPLOSIVE SUBST. ACT,0,0,0,0,0,0,0,0,0,0,0,0,0,0,0
PONDICHERRY,2010,TERRORIST & DISRUPTIVE ACTIVITIES (TATA),0,0,0,0,0,0,0,0,0,0,0,0,0,0,0
PONDICHERRY,2010,IMMORAL TRAFFIC (PREVENTION) ACT,0,0,0,0,0,0,0,0,0,0,0,0,0,0,0
PONDICHERRY,2010,INDIAN RAILWAYS ACT,0,0,0,0,0,0,0,0,0,0,0,0,0,0,0
PONDICHERRY,2010,REGISTRATION OF FOREIGNERS ACT,0,0,0,0,0,0,0,0,0,0,0,0,0,0,0
PONDICHERRY,2010,PROTECTION OF CIVIL RIGHTS ACT,0,0,0,0,0,0,0,0,0,0,0,0,0,0,0
PONDICHERRY,2010,SC/ST (PREVENTION OF ATROCITIES) ACT,0,0,0,0,0,0,0,0,0,0,0,0,0,0,0
PONDICHERRY,2010,INDIAN PASSPORT ACT,0,0,0,0,0,0,0,0,0,0,0,0,0,0,0
PONDICHERRY,2010,ESSENTIAL COMMODITIES ACT,0,0,0,0,0,0,0,0,0,0,0,0,0,0,0
PONDICHERRY,2010,ANTIQUITIES AND ART TREASURE ACT,0,0,0,0,0,0,0,0,0,0,0,0,0,0,0
PONDICHERRY,2010,DOWRY PROHIBITION ACT,0,0,0,0,0,0,0,0,0,0,0,0,0,0,0
PONDICHERRY,2010,FOREIGN EXCHANGE REGULATION ACT-1973,0,0,0,0,0,0,0,0,0,0,0,0,0,0,0
PONDICHERRY,2010,PREVENTION OF CORRUPTION ACT-1988,0,0,0,0,0,0,0,0,0,0,0,0,0,0,0
PONDICHERRY,2010,CONSER.OF FORGN.EXCH.&PREV. OF SMUG.ACT,0,0,0,0,0,0,0,0,0,0,0,0,0,0,0
PONDICHERRY,2010,OTHER SLL OFFENCE,0,0,0,3,0,3,2,0,2,0,0,0,5,0,5
PONDICHERRY,2010,TOTAL,0,0,0,14,0,14,4,0,4,0,0,0,18,0,18
PONDICHERRY,2011,ARMS ACT,0,0,0,17,0,17,10,0,10,0,0,0,27,0,27
PONDICHERRY,2011,N.D.P.S. ACT,0,0,0,0,0,0,1,0,1,0,0,0,1,0,1
PONDICHERRY,2011,GAMBLING ACT,0,0,0,0,0,0,0,0,0,0,0,0,0,0,0
PONDICHERRY,2011,EXCISE ACT,0,0,0,0,0,0,0,0,0,0,0,0,0,0,0
PONDICHERRY,2011,PROHIBITION ACT,0,0,0,0,0,0,0,0,0,0,0,0,0,0,0
PONDICHERRY,2011,EXPLOSIVE & EXPLOSIVE SUBST. ACT,0,0,0,0,0,0,0,0,0,0,0,0,0,0,0
PONDICHERRY,2011,TERRORIST & DISRUPTIVE ACTIVITIES (TATA),0,0,0,0,0,0,0,0,0,0,0,0,0,0,0
PONDICHERRY,2011,IMMORAL TRAFFIC (PREVENTION) ACT,0,0,0,0,0,0,0,0,0,0,0,0,0,0,0
PONDICHERRY,2011,INDIAN RAILWAYS ACT,0,0,0,0,0,0,0,0,0,0,0,0,0,0,0
PONDICHERRY,2011,REGISTRATION OF FOREIGNERS ACT,0,0,0,0,0,0,0,0,0,0,0,0,0,0,0
PONDICHERRY,2011,PROTECTION OF CIVIL RIGHTS ACT,0,0,0,0,0,0,0,0,0,0,0,0,0,0,0
PONDICHERRY,2011,SC/ST (PREVENTION OF ATROCITIES) ACT,0,0,0,0,0,0,0,0,0,0,0,0,0,0,0
PONDICHERRY,2011,INDIAN PASSPORT ACT,0,0,0,0,0,0,0,0,0,0,0,0,0,0,0
PONDICHERRY,2011,ESSENTIAL COMMODITIES ACT,0,0,0,0,0,0,0,0,0,0,0,0,0,0,0
PONDICHERRY,2011,ANTIQUITIES AND ART TREASURE ACT,0,0,0,0,0,0,0,0,0,0,0,0,0,0,0
PONDICHERRY,2011,DOWRY PROHIBITION ACT,0,0,0,0,0,0,0,0,0,0,0,0,0,0,0
PONDICHERRY,2011,FOREIGN EXCHANGE REGULATION ACT-1973,0,0,0,0,0,0,0,0,0,0,0,0,0,0,0
PONDICHERRY,2011,PREVENTION OF CORRUPTION ACT-1988,0,0,0,0,0,0,0,0,0,0,0,0,0,0,0
PONDICHERRY,2011,CONSER.OF FORGN.EXCH.&PREV. OF SMUG.ACT,0,0,0,0,0,0,0,0,0,0,0,0,0,0,0
PONDICHERRY,2011,OTHER SLL OFFENCE,0,0,0,0,0,0,4,0,4,0,0,0,4,0,4
PONDICHERRY,2011,TOTAL,0,0,0,17,0,17,15,0,15,0,0,0,32,0,32
PONDICHERRY,2012,ARMS ACT,0,0,0,9,0,9,1,0,1,0,0,0,10,0,10
PONDICHERRY,2012,N.D.P.S. ACT,0,0,0,0,0,0,0,0,0,0,0,0,0,0,0
PONDICHERRY,2012,GAMBLING ACT,0,0,0,0,0,0,0,0,0,0,0,0,0,0,0
PONDICHERRY,2012,EXCISE ACT,0,0,0,0,0,0,0,0,0,0,0,0,0,0,0
PONDICHERRY,2012,PROHIBITION ACT,0,0,0,0,0,0,0,0,0,0,0,0,0,0,0
PONDICHERRY,2012,EXPLOSIVE & EXPLOSIVE SUBST. ACT,0,0,0,3,0,3,1,0,1,0,0,0,4,0,4
PONDICHERRY,2012,TERRORIST & DISRUPTIVE ACTIVITIES (TATA),0,0,0,0,0,0,0,0,0,0,0,0,0,0,0
PONDICHERRY,2012,IMMORAL TRAFFIC (PREVENTION) ACT,0,0,0,0,0,0,0,0,0,0,0,0,0,0,0
PONDICHERRY,2012,INDIAN RAILWAYS ACT,0,0,0,0,0,0,1,0,1,0,0,0,1,0,1
PONDICHERRY,2012,REGISTRATION OF FOREIGNERS ACT,0,0,0,0,0,0,0,0,0,0,0,0,0,0,0
PONDICHERRY,2012,PROTECTION OF CIVIL RIGHTS ACT,0,0,0,0,0,0,0,0,0,0,0,0,0,0,0
PONDICHERRY,2012,SC/ST (PREVENTION OF ATROCITIES) ACT,0,0,0,0,0,0,0,0,0,0,0,0,0,0,0
PONDICHERRY,2012,INDIAN PASSPORT ACT,0,0,0,0,0,0,0,0,0,0,0,0,0,0,0
PONDICHERRY,2012,ESSENTIAL COMMODITIES ACT,0,0,0,0,0,0,0,0,0,0,0,0,0,0,0
PONDICHERRY,2012,ANTIQUITIES AND ART TREASURE ACT,0,0,0,0,0,0,0,0,0,0,0,0,0,0,0
PONDICHERRY,2012,DOWRY PROHIBITION ACT,0,0,0,0,0,0,0,0,0,0,0,0,0,0,0
PONDICHERRY,2012,FOREIGN EXCHANGE REGULATION ACT-1973,0,0,0,0,0,0,0,0,0,0,0,0,0,0,0
PONDICHERRY,2012,PREVENTION OF CORRUPTION ACT-1988,0,0,0,0,0,0,0,0,0,0,0,0,0,0,0
PONDICHERRY,2012,CONSER.OF FORGN.EXCH.&PREV. OF SMUG.ACT,0,0,0,0,0,0,0,0,0,0,0,0,0,0,0
PONDICHERRY,2012,OTHER SLL OFFENCE,0,0,0,0,0,0,0,0,0,0,0,0,0,0,0
PONDICHERRY,2012,TOTAL,0,0,0,12,0,12,3,0,3,0,0,0,15,0,15
ANDHRA PRADESH,2013,ARMS ACT,0,0,0,16,1,17,35,1,36,0,0,0,51,2,53
ANDHRA PRADESH,2013,N.D.P.S. ACT,0,0,0,134,5,139,135,1,136,23,2,25,292,8,300
ANDHRA PRADESH,2013,GAMBLING ACT,0,0,0,23,0,23,11,1,12,2,0,2,36,1,37
ANDHRA PRADESH,2013,EXCISE ACT,0,0,0,92,10,102,92,30,122,34,6,40,218,46,264
ANDHRA PRADESH,2013,PROHIBITION ACT,0,0,0,28,6,34,64,26,90,15,6,21,107,38,145
ANDHRA PRADESH,2013,EXPLOSIVE & EXPLOSIVE SUBST. ACT,0,0,0,3,1,4,14,1,15,0,0,0,17,2,19
ANDHRA PRADESH,2013,TERRORIST & DISRUPTIVE ACTIVITIES (TATA),0,0,0,0,0,0,0,0,0,0,0,0,0,0,0
ANDHRA PRADESH,2013,IMMORAL TRAFFIC (PREVENTION) ACT,0,0,0,17,5,22,27,4,31,6,1,7,50,10,60
ANDHRA PRADESH,2013,INDIAN RAILWAYS ACT,0,0,0,27,1,28,18,1,19,27,0,27,72,2,74
ANDHRA PRADESH,2013,REGISTRATION OF FOREIGNERS ACT,0,0,0,2,0,2,0,0,0,0,0,0,2,0,2
ANDHRA PRADESH,2013,PROTECTION OF CIVIL RIGHTS ACT,0,0,0,12,1,13,1,6,7,0,0,0,13,7,20
ANDHRA PRADESH,2013,SC/ST (PREVENTION OF ATROCITIES) ACT,0,0,0,37,0,37,42,5,47,9,1,10,88,6,94
ANDHRA PRADESH,2013,INDIAN PASSPORT ACT,0,0,0,0,2,2,1,2,3,0,1,1,1,5,6
ANDHRA PRADESH,2013,ESSENTIAL COMMODITIES ACT,0,0,0,0,0,0,0,0,0,0,0,0,0,0,0
ANDHRA PRADESH,2013,ANTIQUITIES AND ART TREASURE ACT,0,0,0,0,0,0,0,0,0,0,0,0,0,0,0
ANDHRA PRADESH,2013,DOWRY PROHIBITION ACT,0,0,0,36,2,38,99,14,113,9,4,13,144,20,164
ANDHRA PRADESH,2013,FOREIGN EXCHANGE REGULATION ACT-1973,0,0,0,9,1,10,3,0,3,0,0,0,12,1,13
ANDHRA PRADESH,2013,PREVENTION OF CORRUPTION ACT-1988,0,0,0,1,0,1,1,0,1,1,0,1,3,0,3
ANDHRA PRADESH,2013,CONSER.OF FORGN.EXCH.&PREV. OF SMUG.ACT,0,0,0,0,0,0,0,0,0,0,0,0,0,0,0
ANDHRA PRADESH,2013,OTHER SLL OFFENCE,0,0,0,157,1,158,257,7,264,22,2,24,436,10,446
ANDHRA PRADESH,2013,TOTAL (B),0,0,0,594,36,630,800,99,899,148,23,171,1542,158,1700
ANDHRA PRADESH,2013,(C) CIVIL AND OTHER CASES,0,0,0,0,0,0,0,0,0,0,0,0,0,0,0
ANDHRA PRADESH,2013,TOTAL (A + B + C),0,0,0,4418,220,4638,4148,308,4456,526,81,607,9092,609,9701
ARUNACHAL PRADESH,2013,ARMS ACT,0,0,0,0,0,0,0,0,0,0,0,0,0,0,0
ARUNACHAL PRADESH,2013,N.D.P.S. ACT,0,0,0,2,0,2,2,0,2,0,0,0,4,0,4
ARUNACHAL PRADESH,2013,GAMBLING ACT,0,0,0,0,0,0,0,0,0,0,0,0,0,0,0
ARUNACHAL PRADESH,2013,EXCISE ACT,0,0,0,0,0,0,0,0,0,0,0,0,0,0,0
ARUNACHAL PRADESH,2013,PROHIBITION ACT,0,0,0,0,0,0,0,0,0,0,0,0,0,0,0
ARUNACHAL PRADESH,2013,EXPLOSIVE & EXPLOSIVE SUBST. ACT,0,0,0,0,0,0,0,0,0,0,0,0,0,0,0
ARUNACHAL PRADESH,2013,TERRORIST & DISRUPTIVE ACTIVITIES (TATA),0,0,0,0,0,0,0,0,0,0,0,0,0,0,0
ARUNACHAL PRADESH,2013,IMMORAL TRAFFIC (PREVENTION) ACT,0,0,0,0,0,0,0,0,0,0,0,0,0,0,0
ARUNACHAL PRADESH,2013,INDIAN RAILWAYS ACT,0,0,0,0,0,0,0,0,0,0,0,0,0,0,0
ARUNACHAL PRADESH,2013,REGISTRATION OF FOREIGNERS ACT,0,0,0,0,0,0,0,0,0,0,0,0,0,0,0
ARUNACHAL PRADESH,2013,PROTECTION OF CIVIL RIGHTS ACT,0,0,0,0,0,0,0,0,0,0,0,0,0,0,0
ARUNACHAL PRADESH,2013,SC/ST (PREVENTION OF ATROCITIES) ACT,0,0,0,0,0,0,0,0,0,0,0,0,0,0,0
ARUNACHAL PRADESH,2013,INDIAN PASSPORT ACT,0,0,0,0,0,0,0,0,0,0,0,0,0,0,0
ARUNACHAL PRADESH,2013,ESSENTIAL COMMODITIES ACT,0,0,0,0,0,0,0,0,0,0,0,0,0,0,0
ARUNACHAL PRADESH,2013,ANTIQUITIES AND ART TREASURE ACT,0,0,0,0,0,0,0,0,0,0,0,0,0,0,0
ARUNACHAL PRADESH,2013,DOWRY PROHIBITION ACT,0,0,0,0,0,0,0,0,0,0,0,0,0,0,0
ARUNACHAL PRADESH,2013,FOREIGN EXCHANGE REGULATION ACT-1973,0,0,0,0,0,0,0,0,0,0,0,0,0,0,0
ARUNACHAL PRADESH,2013,PREVENTION OF CORRUPTION ACT-1988,0,0,0,0,0,0,0,0,0,0,0,0,0,0,0
ARUNACHAL PRADESH,2013,CONSER.OF FORGN.EXCH.&PREV. OF SMUG.ACT,0,0,0,0,0,0,0,0,0,0,0,0,0,0,0
ARUNACHAL PRADESH,2013,OTHER SLL OFFENCE,0,0,0,0,0,0,0,0,0,0,0,0,0,0,0
ARUNACHAL PRADESH,2013,TOTAL (B),0,0,0,2,0,2,2,0,2,0,0,0,4,0,4
ARUNACHAL PRADESH,2013,(C) CIVIL AND OTHER CASES,0,0,0,0,0,0,0,0,0,0,0,0,0,0,0
ARUNACHAL PRADESH,2013,TOTAL (A + B + C),0,0,0,55,0,55,24,1,25,1,0,1,80,1,81
ASSAM,2013,ARMS ACT,0,0,0,80,7,87,65,2,67,20,0,20,165,9,174
ASSAM,2013,N.D.P.S. ACT,0,0,0,60,3,63,120,6,126,30,2,32,210,11,221
ASSAM,2013,GAMBLING ACT,0,0,0,22,0,22,16,0,16,4,0,4,42,0,42
ASSAM,2013,EXCISE ACT,0,0,0,4,0,4,5,0,5,3,0,3,12,0,12
ASSAM,2013,PROHIBITION ACT,0,0,0,12,0,12,2,0,2,0,0,0,14,0,14
ASSAM,2013,EXPLOSIVE & EXPLOSIVE SUBST. ACT,0,0,0,14,0,14,12,0,12,0,0,0,26,0,26
ASSAM,2013,TERRORIST & DISRUPTIVE ACTIVITIES (TATA),0,0,0,16,4,20,6,2,8,2,0,2,24,6,30
ASSAM,2013,IMMORAL TRAFFIC (PREVENTION) ACT,0,0,0,6,0,6,2,1,3,0,0,0,8,1,9
ASSAM,2013,INDIAN RAILWAYS ACT,0,0,0,0,0,0,2,0,2,0,0,0,2,0,2
ASSAM,2013,REGISTRATION OF FOREIGNERS ACT,0,0,0,0,0,0,0,0,0,0,0,0,0,0,0
ASSAM,2013,PROTECTION OF CIVIL RIGHTS ACT,0,0,0,0,0,0,0,0,0,0,0,0,0,0,0
ASSAM,2013,SC/ST (PREVENTION OF ATROCITIES) ACT,0,0,0,0,0,0,0,0,0,0,0,0,0,0,0
ASSAM,2013,INDIAN PASSPORT ACT,0,0,0,10,0,10,8,0,8,2,0,2,20,0,20
ASSAM,2013,ESSENTIAL COMMODITIES ACT,0,0,0,2,0,2,2,0,2,0,0,0,4,0,4
ASSAM,2013,ANTIQUITIES AND ART TREASURE ACT,0,0,0,0,0,0,0,0,0,0,0,0,0,0,0
ASSAM,2013,DOWRY PROHIBITION ACT,0,0,0,0,0,0,0,0,0,0,0,0,0,0,0
ASSAM,2013,FOREIGN EXCHANGE REGULATION ACT-1973,0,0,0,0,0,0,3,0,3,0,0,0,3,0,3
ASSAM,2013,PREVENTION OF CORRUPTION ACT-1988,0,0,0,0,0,0,0,0,0,0,0,0,0,0,0
ASSAM,2013,CONSER.OF FORGN.EXCH.&PREV. OF SMUG.ACT,0,0,0,0,0,0,0,0,0,0,0,0,0,0,0
ASSAM,2013,OTHER SLL OFFENCE,0,0,0,30,0,30,10,0,10,3,0,3,43,0,43
ASSAM,2013,TOTAL (B),0,0,0,256,14,270,253,11,264,64,2,66,573,27,600
ASSAM,2013,(C) CIVIL AND OTHER CASES,0,0,0,0,0,0,0,0,0,0,0,0,0,0,0
ASSAM,2013,TOTAL (A + B + C),0,0,0,2476,93,2569,2043,96,2139,439,16,455,4958,205,5163
BIHAR,2013,ARMS ACT,0,0,0,638,4,642,759,2,761,158,1,159,1555,7,1562
BIHAR,2013,N.D.P.S. ACT,0,0,0,355,20,375,521,19,540,125,8,133,1001,47,1048
BIHAR,2013,GAMBLING ACT,0,0,0,95,0,95,57,0,57,20,0,20,172,0,172
BIHAR,2013,EXCISE ACT,0,0,0,333,3,336,429,1,430,131,4,135,893,8,901
BIHAR,2013,PROHIBITION ACT,0,0,0,11,0,11,5,0,5,3,0,3,19,0,19
BIHAR,2013,EXPLOSIVE & EXPLOSIVE SUBST. ACT,0,0,0,108,0,108,113,1,114,13,0,13,234,1,235
BIHAR,2013,TERRORIST & DISRUPTIVE ACTIVITIES (TATA),0,0,0,0,0,0,2,0,2,0,0,0,2,0,2
BIHAR,2013,IMMORAL TRAFFIC (PREVENTION) ACT,0,0,0,50,15,65,34,15,49,0,0,0,84,30,114
BIHAR,2013,INDIAN RAILWAYS ACT,0,0,0,322,3,325,175,6,181,76,0,76,573,9,582
BIHAR,2013,REGISTRATION OF FOREIGNERS ACT,0,0,0,2,0,2,0,0,0,0,0,0,2,0,2
BIHAR,2013,PROTECTION OF CIVIL RIGHTS ACT,0,0,0,17,0,17,1,0,1,0,0,0,18,0,18
BIHAR,2013,SC/ST (PREVENTION OF ATROCITIES) ACT,0,0,0,134,0,134,190,0,190,83,0,83,407,0,407
BIHAR,2013,INDIAN PASSPORT ACT,0,0,0,1,0,1,0,0,0,0,0,0,1,0,1
BIHAR,2013,ESSENTIAL COMMODITIES ACT,0,0,0,1,0,1,4,0,4,3,0,3,8,0,8
BIHAR,2013,ANTIQUITIES AND ART TREASURE ACT,0,0,0,17,2,19,60,1,61,11,4,15,88,7,95
BIHAR,2013,DOWRY PROHIBITION ACT,0,0,0,78,0,78,74,10,84,11,1,12,163,11,174
BIHAR,2013,FOREIGN EXCHANGE REGULATION ACT-1973,0,0,0,0,0,0,8,1,9,0,0,0,8,1,9
BIHAR,2013,PREVENTION OF CORRUPTION ACT-1988,0,0,0,6,0,6,2,0,2,0,0,0,8,0,8
BIHAR,2013,CONSER.OF FORGN.EXCH.&PREV. OF SMUG.ACT,0,0,0,0,0,0,0,0,0,0,0,0,0,0,0
BIHAR,2013,OTHER SLL OFFENCE,0,0,0,0,0,0,21,0,21,1,0,1,22,0,22
BIHAR,2013,TOTAL (B),0,0,0,2168,47,2215,2455,56,2511,635,18,653,5258,121,5379
BIHAR,2013,(C) CIVIL AND OTHER CASES,0,0,0,1,0,1,0,0,0,0,0,0,1,0,1
BIHAR,2013,TOTAL (A + B + C),0,0,0,10794,352,11146,11321,494,11815,3521,127,3648,25636,973,26609
CHHATISGARH,2013,ARMS ACT,0,0,0,121,0,121,58,0,58,8,0,8,187,0,187
CHHATISGARH,2013,N.D.P.S. ACT,0,0,0,205,14,219,133,22,155,26,4,30,364,40,404
CHHATISGARH,2013,GAMBLING ACT,0,0,0,0,0,0,1,0,1,0,0,0,1,0,1
CHHATISGARH,2013,EXCISE ACT,0,0,0,222,5,227,170,12,182,50,6,56,442,23,465
CHHATISGARH,2013,PROHIBITION ACT,0,0,0,2,0,2,0,0,0,0,0,0,2,0,2
CHHATISGARH,2013,EXPLOSIVE & EXPLOSIVE SUBST. ACT,0,0,0,1,0,1,0,0,0,0,0,0,1,0,1
CHHATISGARH,2013,TERRORIST & DISRUPTIVE ACTIVITIES (TATA),0,0,0,0,0,0,0,0,0,0,0,0,0,0,0
CHHATISGARH,2013,IMMORAL TRAFFIC (PREVENTION) ACT,0,0,0,0,0,0,0,0,0,0,0,0,0,0,0
CHHATISGARH,2013,INDIAN RAILWAYS ACT,0,0,0,45,2,47,26,0,26,2,0,2,73,2,75
CHHATISGARH,2013,REGISTRATION OF FOREIGNERS ACT,0,0,0,0,0,0,1,0,1,0,0,0,1,0,1
CHHATISGARH,2013,PROTECTION OF CIVIL RIGHTS ACT,0,0,0,0,0,0,0,0,0,0,0,0,0,0,0
CHHATISGARH,2013,SC/ST (PREVENTION OF ATROCITIES) ACT,0,0,0,20,0,20,12,1,13,0,0,0,32,1,33
CHHATISGARH,2013,INDIAN PASSPORT ACT,0,0,0,0,0,0,0,0,0,0,0,0,0,0,0
CHHATISGARH,2013,ESSENTIAL COMMODITIES ACT,0,0,0,0,0,0,0,0,0,0,0,0,0,0,0
CHHATISGARH,2013,ANTIQUITIES AND ART TREASURE ACT,0,0,0,0,0,0,0,0,0,0,0,0,0,0,0
CHHATISGARH,2013,DOWRY PROHIBITION ACT,0,0,0,2,0,2,2,0,2,0,0,0,4,0,4
CHHATISGARH,2013,FOREIGN EXCHANGE REGULATION ACT-1973,0,0,0,0,0,0,0,0,0,0,0,0,0,0,0
CHHATISGARH,2013,PREVENTION OF CORRUPTION ACT-1988,0,0,0,4,0,4,7,0,7,1,0,1,12,0,12
CHHATISGARH,2013,CONSER.OF FORGN.EXCH.&PREV. OF SMUG.ACT,0,0,0,0,0,0,0,0,0,0,0,0,0,0,0
CHHATISGARH,2013,OTHER SLL OFFENCE,0,0,0,30,7,37,31,5,36,11,0,11,72,12,84
CHHATISGARH,2013,TOTAL (B),0,0,0,652,28,680,441,40,481,98,10,108,1191,78,1269
CHHATISGARH,2013,(C) CIVIL AND OTHER CASES,0,0,0,0,0,0,0,0,0,0,0,0,0,0,0
CHHATISGARH,2013,TOTAL (A + B + C),0,0,0,5047,207,5254,2996,228,3224,682,81,763,8725,516,9241
GOA,2013,ARMS ACT,0,0,0,19,0,19,12,0,12,0,0,0,31,0,31
GOA,2013,N.D.P.S. ACT,0,0,0,10,1,11,10,3,13,0,0,0,20,4,24
GOA,2013,GAMBLING ACT,0,0,0,0,0,0,0,0,0,0,0,0,0,0,0
GOA,2013,EXCISE ACT,0,0,0,0,0,0,0,0,0,0,0,0,0,0,0
GOA,2013,PROHIBITION ACT,0,0,0,0,0,0,0,0,0,0,0,0,0,0,0
GOA,2013,EXPLOSIVE & EXPLOSIVE SUBST. ACT,0,0,0,0,0,0,0,0,0,0,0,0,0,0,0
GOA,2013,TERRORIST & DISRUPTIVE ACTIVITIES (TATA),0,0,0,3,0,3,3,0,3,0,0,0,6,0,6
GOA,2013,IMMORAL TRAFFIC (PREVENTION) ACT,0,0,0,8,0,8,6,0,6,0,0,0,14,0,14
GOA,2013,INDIAN RAILWAYS ACT,0,0,0,0,0,0,0,0,0,0,0,0,0,0,0
GOA,2013,REGISTRATION OF FOREIGNERS ACT,0,0,0,4,0,4,0,0,0,0,0,0,4,0,4
GOA,2013,PROTECTION OF CIVIL RIGHTS ACT,0,0,0,0,0,0,0,0,0,0,0,0,0,0,0
GOA,2013,SC/ST (PREVENTION OF ATROCITIES) ACT,0,0,0,0,0,0,0,0,0,0,0,0,0,0,0
GOA,2013,INDIAN PASSPORT ACT,0,0,0,0,0,0,0,0,0,0,0,0,0,0,0
GOA,2013,ESSENTIAL COMMODITIES ACT,0,0,0,0,0,0,0,0,0,0,0,0,0,0,0
GOA,2013,ANTIQUITIES AND ART TREASURE ACT,0,0,0,0,0,0,0,0,0,0,0,0,0,0,0
GOA,2013,DOWRY PROHIBITION ACT,0,0,0,0,0,0,0,0,0,0,0,0,0,0,0
GOA,2013,FOREIGN EXCHANGE REGULATION ACT-1973,0,0,0,2,0,2,0,0,0,0,0,0,2,0,2
GOA,2013,PREVENTION OF CORRUPTION ACT-1988,0,0,0,0,0,0,0,0,0,0,0,0,0,0,0
GOA,2013,CONSER.OF FORGN.EXCH.&PREV. OF SMUG.ACT,0,0,0,0,0,0,0,0,0,0,0,0,0,0,0
GOA,2013,OTHER SLL OFFENCE,0,0,0,0,0,0,0,0,0,0,0,0,0,0,0
GOA,2013,TOTAL (B),0,0,0,46,1,47,31,3,34,0,0,0,77,4,81
GOA,2013,(C) CIVIL AND OTHER CASES,0,0,0,0,0,0,0,0,0,0,0,0,0,0,0
GOA,2013,TOTAL (A + B + C),0,0,0,287,8,295,86,11,97,2,2,4,375,21,396
GUJARAT,2013,ARMS ACT,0,0,0,25,0,25,30,0,30,8,0,8,63,0,63
GUJARAT,2013,N.D.P.S. ACT,0,0,0,83,2,85,66,6,72,20,0,20,169,8,177
GUJARAT,2013,GAMBLING ACT,0,0,0,8,0,8,2,0,2,1,0,1,11,0,11
GUJARAT,2013,EXCISE ACT,0,0,0,8,0,8,1,0,1,2,0,2,11,0,11
GUJARAT,2013,PROHIBITION ACT,0,0,0,91,0,91,187,7,194,36,0,36,314,7,321
GUJARAT,2013,EXPLOSIVE & EXPLOSIVE SUBST. ACT,0,0,0,22,0,22,33,0,33,0,0,0,55,0,55
GUJARAT,2013,TERRORIST & DISRUPTIVE ACTIVITIES (TATA),0,0,0,0,0,0,0,0,0,0,0,0,0,0,0
GUJARAT,2013,IMMORAL TRAFFIC (PREVENTION) ACT,0,0,0,2,1,3,3,0,3,1,0,1,6,1,7
GUJARAT,2013,INDIAN RAILWAYS ACT,0,0,0,8,0,8,1,0,1,5,0,5,14,0,14
GUJARAT,2013,REGISTRATION OF FOREIGNERS ACT,0,0,0,0,0,0,0,1,1,0,0,0,0,1,1
GUJARAT,2013,PROTECTION OF CIVIL RIGHTS ACT,0,0,0,0,0,0,0,0,0,0,0,0,0,0,0
GUJARAT,2013,SC/ST (PREVENTION OF ATROCITIES) ACT,0,0,0,5,0,5,7,1,8,0,0,0,12,1,13
GUJARAT,2013,INDIAN PASSPORT ACT,0,0,0,19,12,31,19,4,23,3,1,4,41,17,58
GUJARAT,2013,ESSENTIAL COMMODITIES ACT,0,0,0,0,0,0,0,0,0,0,0,0,0,0,0
GUJARAT,2013,ANTIQUITIES AND ART TREASURE ACT,0,0,0,0,0,0,0,0,0,0,0,0,0,0,0
GUJARAT,2013,DOWRY PROHIBITION ACT,0,0,0,5,0,5,19,1,20,3,2,5,27,3,30
GUJARAT,2013,FOREIGN EXCHANGE REGULATION ACT-1973,0,0,0,1,0,1,2,1,3,0,0,0,3,1,4
GUJARAT,2013,PREVENTION OF CORRUPTION ACT-1988,0,0,0,11,0,11,21,0,21,3,0,3,35,0,35
GUJARAT,2013,CONSER.OF FORGN.EXCH.&PREV. OF SMUG.ACT,0,0,0,0,0,0,2,0,2,0,0,0,2,0,2
GUJARAT,2013,OTHER SLL OFFENCE,0,0,0,55,4,59,60,3,63,19,2,21,134,9,143
GUJARAT,2013,TOTAL (B),0,0,0,343,19,362,453,24,477,101,5,106,897,48,945
GUJARAT,2013,(C) CIVIL AND OTHER CASES,0,0,0,0,0,0,0,0,0,0,0,0,0,0,0
GUJARAT,2013,TOTAL (A + B + C),0,0,0,3724,153,3877,2851,187,3038,650,39,689,7225,379,7604
HARYANA,2013,ARMS ACT,0,0,0,82,1,83,64,0,64,3,0,3,149,1,150
HARYANA,2013,N.D.P.S. ACT,0,0,0,180,5,185,173,8,181,54,1,55,407,14,421
HARYANA,2013,GAMBLING ACT,0,0,0,4,0,4,5,0,5,3,0,3,12,0,12
HARYANA,2013,EXCISE ACT,0,0,0,40,0,40,37,0,37,11,0,11,88,0,88
HARYANA,2013,PROHIBITION ACT,0,0,0,0,0,0,0,0,0,0,0,0,0,0,0
HARYANA,2013,EXPLOSIVE & EXPLOSIVE SUBST. ACT,0,0,0,7,0,7,4,0,4,1,0,1,12,0,12
HARYANA,2013,TERRORIST & DISRUPTIVE ACTIVITIES (TATA),0,0,0,0,0,0,0,0,0,0,0,0,0,0,0
HARYANA,2013,IMMORAL TRAFFIC (PREVENTION) ACT,0,0,0,8,1,9,14,1,15,2,0,2,24,2,26
HARYANA,2013,INDIAN RAILWAYS ACT,0,0,0,15,0,15,18,0,18,1,0,1,34,0,34
HARYANA,2013,REGISTRATION OF FOREIGNERS ACT,0,0,0,7,1,8,6,1,7,0,0,0,13,2,15
HARYANA,2013,PROTECTION OF CIVIL RIGHTS ACT,0,0,0,0,0,0,0,0,0,0,0,0,0,0,0
HARYANA,2013,SC/ST (PREVENTION OF ATROCITIES) ACT,0,0,0,3,0,3,0,0,0,2,0,2,5,0,5
HARYANA,2013,INDIAN PASSPORT ACT,0,0,0,0,0,0,0,0,0,0,0,0,0,0,0
HARYANA,2013,ESSENTIAL COMMODITIES ACT,0,0,0,3,0,3,5,0,5,0,0,0,8,0,8
HARYANA,2013,ANTIQUITIES AND ART TREASURE ACT,0,0,0,0,0,0,0,0,0,0,0,0,0,0,0
HARYANA,2013,DOWRY PROHIBITION ACT,0,0,0,0,0,0,0,0,0,0,0,0,0,0,0
HARYANA,2013,FOREIGN EXCHANGE REGULATION ACT-1973,0,0,0,0,0,0,0,0,0,0,0,0,0,0,0
HARYANA,2013,PREVENTION OF CORRUPTION ACT-1988,0,0,0,5,0,5,9,0,9,6,0,6,20,0,20
HARYANA,2013,CONSER.OF FORGN.EXCH.&PREV. OF SMUG.ACT,0,0,0,3,0,3,0,0,0,0,0,0,3,0,3
HARYANA,2013,OTHER SLL OFFENCE,0,0,0,37,0,37,31,0,31,6,0,6,74,0,74
HARYANA,2013,TOTAL (B),0,0,0,394,8,402,366,10,376,89,1,90,849,19,868
HARYANA,2013,(C) CIVIL AND OTHER CASES,0,0,0,0,0,0,0,0,0,0,0,0,0,0,0
HARYANA,2013,TOTAL (A + B + C),0,0,0,5803,169,5972,3472,183,3655,873,123,996,10148,475,10623
HIMACHAL PRADESH,2013,ARMS ACT,0,0,0,1,0,1,1,0,1,0,0,0,2,0,2
HIMACHAL PRADESH,2013,N.D.P.S. ACT,0,0,0,113,1,114,101,1,102,16,0,16,230,2,232
HIMACHAL PRADESH,2013,GAMBLING ACT,0,0,0,0,0,0,0,0,0,0,0,0,0,0,0
HIMACHAL PRADESH,2013,EXCISE ACT,0,0,0,0,0,0,0,0,0,0,0,0,0,0,0
HIMACHAL PRADESH,2013,PROHIBITION ACT,0,0,0,0,0,0,0,0,0,0,0,0,0,0,0
HIMACHAL PRADESH,2013,EXPLOSIVE & EXPLOSIVE SUBST. ACT,0,0,0,0,0,0,0,0,0,0,0,0,0,0,0
HIMACHAL PRADESH,2013,TERRORIST & DISRUPTIVE ACTIVITIES (TATA),0,0,0,0,0,0,0,0,0,0,0,0,0,0,0
HIMACHAL PRADESH,2013,IMMORAL TRAFFIC (PREVENTION) ACT,0,0,0,0,0,0,0,0,0,0,0,0,0,0,0
HIMACHAL PRADESH,2013,INDIAN RAILWAYS ACT,0,0,0,0,0,0,0,0,0,0,0,0,0,0,0
HIMACHAL PRADESH,2013,REGISTRATION OF FOREIGNERS ACT,0,0,0,0,0,0,0,0,0,0,0,0,0,0,0
HIMACHAL PRADESH,2013,PROTECTION OF CIVIL RIGHTS ACT,0,0,0,0,0,0,0,0,0,0,0,0,0,0,0
HIMACHAL PRADESH,2013,SC/ST (PREVENTION OF ATROCITIES) ACT,0,0,0,0,0,0,1,0,1,0,0,0,1,0,1
HIMACHAL PRADESH,2013,INDIAN PASSPORT ACT,0,0,0,0,0,0,0,0,0,0,0,0,0,0,0
HIMACHAL PRADESH,2013,ESSENTIAL COMMODITIES ACT,0,0,0,0,0,0,0,0,0,0,0,0,0,0,0
HIMACHAL PRADESH,2013,ANTIQUITIES AND ART TREASURE ACT,0,0,0,0,0,0,0,0,0,0,0,0,0,0,0
HIMACHAL PRADESH,2013,DOWRY PROHIBITION ACT,0,0,0,0,0,0,0,0,0,0,0,0,0,0,0
HIMACHAL PRADESH,2013,FOREIGN EXCHANGE REGULATION ACT-1973,0,0,0,0,0,0,0,0,0,0,0,0,0,0,0
HIMACHAL PRADESH,2013,PREVENTION OF CORRUPTION ACT-1988,0,0,0,0,0,0,0,0,0,0,0,0,0,0,0
HIMACHAL PRADESH,2013,CONSER.OF FORGN.EXCH.&PREV. OF SMUG.ACT,0,0,0,0,0,0,1,0,1,0,0,0,1,0,1
HIMACHAL PRADESH,2013,OTHER SLL OFFENCE,0,0,0,0,0,0,0,0,0,0,0,0,0,0,0
HIMACHAL PRADESH,2013,TOTAL (B),0,0,0,114,1,115,104,1,105,16,0,16,234,2,236
HIMACHAL PRADESH,2013,(C) CIVIL AND OTHER CASES,0,0,0,0,0,0,0,0,0,0,0,0,0,0,0
HIMACHAL PRADESH,2013,TOTAL (A + B + C),0,0,0,536,18,554,355,28,383,49,12,61,940,58,998
JAMMU & KASHMIR,2013,ARMS ACT,0,0,0,46,0,46,89,0,89,8,0,8,143,0,143
JAMMU & KASHMIR,2013,N.D.P.S. ACT,0,0,0,93,0,93,91,0,91,13,2,15,197,2,199
JAMMU & KASHMIR,2013,GAMBLING ACT,0,0,0,0,0,0,0,0,0,0,0,0,0,0,0
JAMMU & KASHMIR,2013,EXCISE ACT,0,0,0,0,0,0,0,0,0,0,0,0,0,0,0
JAMMU & KASHMIR,2013,PROHIBITION ACT,0,0,0,0,0,0,0,0,0,0,0,0,0,0,0
JAMMU & KASHMIR,2013,EXPLOSIVE & EXPLOSIVE SUBST. ACT,0,0,0,5,0,5,7,0,7,3,0,3,15,0,15
JAMMU & KASHMIR,2013,TERRORIST & DISRUPTIVE ACTIVITIES (TATA),0,0,0,0,0,0,1,0,1,0,0,0,1,0,1
JAMMU & KASHMIR,2013,IMMORAL TRAFFIC (PREVENTION) ACT,0,0,0,0,0,0,0,0,0,0,0,0,0,0,0
JAMMU & KASHMIR,2013,INDIAN RAILWAYS ACT,0,0,0,0,0,0,0,0,0,0,0,0,0,0,0
JAMMU & KASHMIR,2013,REGISTRATION OF FOREIGNERS ACT,0,0,0,24,0,24,14,1,15,0,0,0,38,1,39
JAMMU & KASHMIR,2013,PROTECTION OF CIVIL RIGHTS ACT,0,0,0,0,0,0,0,0,0,0,0,0,0,0,0
JAMMU & KASHMIR,2013,SC/ST (PREVENTION OF ATROCITIES) ACT,0,0,0,0,0,0,0,0,0,0,0,0,0,0,0
JAMMU & KASHMIR,2013,INDIAN PASSPORT ACT,0,0,0,0,0,0,0,0,0,0,0,0,0,0,0
JAMMU & KASHMIR,2013,ESSENTIAL COMMODITIES ACT,0,0,0,0,0,0,0,0,0,0,0,0,0,0,0
JAMMU & KASHMIR,2013,ANTIQUITIES AND ART TREASURE ACT,0,0,0,0,0,0,0,0,0,0,0,0,0,0,0
JAMMU & KASHMIR,2013,DOWRY PROHIBITION ACT,0,0,0,0,0,0,0,0,0,0,0,0,0,0,0
JAMMU & KASHMIR,2013,FOREIGN EXCHANGE REGULATION ACT-1973,0,0,0,3,0,3,1,0,1,0,0,0,4,0,4
JAMMU & KASHMIR,2013,PREVENTION OF CORRUPTION ACT-1988,0,0,0,0,0,0,2,0,2,1,0,1,3,0,3
JAMMU & KASHMIR,2013,CONSER.OF FORGN.EXCH.&PREV. OF SMUG.ACT,0,0,0,0,0,0,0,0,0,0,0,0,0,0,0
JAMMU & KASHMIR,2013,OTHER SLL OFFENCE,0,0,0,1,0,1,6,0,6,0,0,0,7,0,7
JAMMU & KASHMIR,2013,TOTAL (B),0,0,0,172,0,172,211,1,212,25,2,27,408,3,411
JAMMU & KASHMIR,2013,(C) CIVIL AND OTHER CASES,0,0,0,0,0,0,0,0,0,0,0,0,0,0,0
JAMMU & KASHMIR,2013,TOTAL (A + B + C),0,0,0,881,28,909,778,36,814,165,12,177,1824,76,1900
JHARKHAND,2013,ARMS ACT,0,0,0,520,15,535,379,7,386,66,3,69,965,25,990
JHARKHAND,2013,N.D.P.S. ACT,0,0,0,87,1,88,114,4,118,19,0,19,220,5,225
JHARKHAND,2013,GAMBLING ACT,0,0,0,22,0,22,21,2,23,11,0,11,54,2,56
JHARKHAND,2013,EXCISE ACT,0,0,0,122,0,122,149,2,151,36,0,36,307,2,309
JHARKHAND,2013,PROHIBITION ACT,0,0,0,19,0,19,33,0,33,5,2,7,57,2,59
JHARKHAND,2013,EXPLOSIVE & EXPLOSIVE SUBST. ACT,0,0,0,108,5,113,82,0,82,14,2,16,204,7,211
JHARKHAND,2013,TERRORIST & DISRUPTIVE ACTIVITIES (TATA),0,0,0,0,0,0,0,0,0,0,0,0,0,0,0
JHARKHAND,2013,IMMORAL TRAFFIC (PREVENTION) ACT,0,0,0,5,0,5,1,0,1,0,0,0,6,0,6
JHARKHAND,2013,INDIAN RAILWAYS ACT,0,0,0,107,0,107,100,4,104,18,0,18,225,4,229
JHARKHAND,2013,REGISTRATION OF FOREIGNERS ACT,0,0,0,0,0,0,0,0,0,0,0,0,0,0,0
JHARKHAND,2013,PROTECTION OF CIVIL RIGHTS ACT,0,0,0,0,0,0,0,2,2,0,0,0,0,2,2
JHARKHAND,2013,SC/ST (PREVENTION OF ATROCITIES) ACT,0,0,0,27,1,28,41,2,43,14,0,14,82,3,85
JHARKHAND,2013,INDIAN PASSPORT ACT,0,0,0,0,0,0,0,0,0,0,0,0,0,0,0
JHARKHAND,2013,ESSENTIAL COMMODITIES ACT,0,0,0,0,0,0,1,0,1,0,0,0,1,0,1
JHARKHAND,2013,ANTIQUITIES AND ART TREASURE ACT,0,0,0,0,0,0,0,0,0,0,0,0,0,0,0
JHARKHAND,2013,DOWRY PROHIBITION ACT,0,0,0,90,17,107,143,24,167,42,8,50,275,49,324
JHARKHAND,2013,FOREIGN EXCHANGE REGULATION ACT-1973,0,0,0,0,0,0,0,0,0,0,0,0,0,0,0
JHARKHAND,2013,PREVENTION OF CORRUPTION ACT-1988,0,0,0,8,0,8,18,0,18,6,0,6,32,0,32
JHARKHAND,2013,CONSER.OF FORGN.EXCH.&PREV. OF SMUG.ACT,0,0,0,0,0,0,0,0,0,0,0,0,0,0,0
JHARKHAND,2013,OTHER SLL OFFENCE,0,0,0,32,0,32,5,0,5,2,0,2,39,0,39
JHARKHAND,2013,TOTAL (B),0,0,0,1147,39,1186,1087,47,1134,233,15,248,2467,101,2568
JHARKHAND,2013,(C) CIVIL AND OTHER CASES,0,0,0,0,0,0,0,0,0,0,0,0,0,0,0
JHARKHAND,2013,TOTAL (A + B + C),0,0,0,6250,258,6508,5769,333,6102,1337,101,1438,13356,692,14048
KARNATAKA,2013,ARMS ACT,0,0,0,12,0,12,16,0,16,2,0,2,30,0,30
KARNATAKA,2013,N.D.P.S. ACT,0,0,0,59,1,60,47,6,53,2,0,2,108,7,115
KARNATAKA,2013,GAMBLING ACT,0,0,0,41,1,42,46,0,46,2,0,2,89,1,90
KARNATAKA,2013,EXCISE ACT,0,0,0,36,0,36,55,0,55,0,0,0,91,0,91
KARNATAKA,2013,PROHIBITION ACT,0,0,0,0,0,0,3,0,3,0,0,0,3,0,3
KARNATAKA,2013,EXPLOSIVE & EXPLOSIVE SUBST. ACT,0,0,0,0,0,0,27,0,27,1,0,1,28,0,28
KARNATAKA,2013,TERRORIST & DISRUPTIVE ACTIVITIES (TATA),0,0,0,0,0,0,2,0,2,0,0,0,2,0,2
KARNATAKA,2013,IMMORAL TRAFFIC (PREVENTION) ACT,0,0,0,19,12,31,9,24,33,2,0,2,30,36,66
KARNATAKA,2013,INDIAN RAILWAYS ACT,0,0,0,31,0,31,19,2,21,1,0,1,51,2,53
KARNATAKA,2013,REGISTRATION OF FOREIGNERS ACT,0,0,0,7,1,8,13,2,15,0,0,0,20,3,23
KARNATAKA,2013,PROTECTION OF CIVIL RIGHTS ACT,0,0,0,7,0,7,16,0,16,0,0,0,23,0,23
KARNATAKA,2013,SC/ST (PREVENTION OF ATROCITIES) ACT,0,0,0,5,0,5,11,0,11,1,0,1,17,0,17
KARNATAKA,2013,INDIAN PASSPORT ACT,0,0,0,4,0,4,11,0,11,1,0,1,16,0,16
KARNATAKA,2013,ESSENTIAL COMMODITIES ACT,0,0,0,0,0,0,4,0,4,0,0,0,4,0,4
KARNATAKA,2013,ANTIQUITIES AND ART TREASURE ACT,0,0,0,1,0,1,3,0,3,1,0,1,5,0,5
KARNATAKA,2013,DOWRY PROHIBITION ACT,0,0,0,34,4,38,54,17,71,9,0,9,97,21,118
KARNATAKA,2013,FOREIGN EXCHANGE REGULATION ACT-1973,0,0,0,1,0,1,4,0,4,0,0,0,5,0,5
KARNATAKA,2013,PREVENTION OF CORRUPTION ACT-1988,0,0,0,2,0,2,4,0,4,1,0,1,7,0,7
KARNATAKA,2013,CONSER.OF FORGN.EXCH.&PREV. OF SMUG.ACT,0,0,0,0,0,0,4,0,4,0,0,0,4,0,4
KARNATAKA,2013,OTHER SLL OFFENCE,0,0,0,0,0,0,0,0,0,0,0,0,0,0,0
KARNATAKA,2013,TOTAL (B),0,0,0,259,19,278,348,51,399,23,0,23,630,70,700
KARNATAKA,2013,(C) CIVIL AND OTHER CASES,0,0,0,0,0,0,0,0,0,0,0,0,0,0,0
KARNATAKA,2013,TOTAL (A + B + C),0,0,0,4514,172,4686,4269,191,4460,349,11,360,9132,374,9506
KERALA,2013,ARMS ACT,0,0,0,30,0,30,22,0,22,0,0,0,52,0,52
KERALA,2013,N.D.P.S. ACT,0,0,0,67,0,67,58,4,62,36,0,36,161,4,165
KERALA,2013,GAMBLING ACT,0,0,0,0,0,0,5,0,5,4,0,4,9,0,9
KERALA,2013,EXCISE ACT,0,0,0,210,0,210,185,8,193,72,5,77,467,13,480
KERALA,2013,PROHIBITION ACT,0,0,0,0,0,0,28,0,28,0,0,0,28,0,28
KERALA,2013,EXPLOSIVE & EXPLOSIVE SUBST. ACT,0,0,0,22,0,22,28,0,28,2,0,2,52,0,52
KERALA,2013,TERRORIST & DISRUPTIVE ACTIVITIES (TATA),0,0,0,0,0,0,0,0,0,0,0,0,0,0,0
KERALA,2013,IMMORAL TRAFFIC (PREVENTION) ACT,0,0,0,49,0,49,30,0,30,4,0,4,83,0,83
KERALA,2013,INDIAN RAILWAYS ACT,0,0,0,25,0,25,24,0,24,7,0,7,56,0,56
KERALA,2013,REGISTRATION OF FOREIGNERS ACT,0,0,0,4,0,4,2,0,2,0,0,0,6,0,6
KERALA,2013,PROTECTION OF CIVIL RIGHTS ACT,0,0,0,6,0,6,2,0,2,0,0,0,8,0,8
KERALA,2013,SC/ST (PREVENTION OF ATROCITIES) ACT,0,0,0,0,0,0,18,0,18,6,0,6,24,0,24
KERALA,2013,INDIAN PASSPORT ACT,0,0,0,28,0,28,20,0,20,6,0,6,54,0,54
KERALA,2013,ESSENTIAL COMMODITIES ACT,0,0,0,0,0,0,4,0,4,14,0,14,18,0,18
KERALA,2013,ANTIQUITIES AND ART TREASURE ACT,0,0,0,7,0,7,12,0,12,8,0,8,27,0,27
KERALA,2013,DOWRY PROHIBITION ACT,0,0,0,0,0,0,0,0,0,0,0,0,0,0,0
KERALA,2013,FOREIGN EXCHANGE REGULATION ACT-1973,0,0,0,8,0,8,30,0,30,0,0,0,38,0,38
KERALA,2013,PREVENTION OF CORRUPTION ACT-1988,0,0,0,0,0,0,8,0,8,10,0,10,18,0,18
KERALA,2013,CONSER.OF FORGN.EXCH.&PREV. OF SMUG.ACT,0,0,0,0,0,0,2,0,2,0,0,0,2,0,2
KERALA,2013,OTHER SLL OFFENCE,0,0,0,0,0,0,122,0,122,147,0,147,269,0,269
KERALA,2013,TOTAL (B),0,0,0,456,0,456,600,12,612,316,5,321,1372,17,1389
KERALA,2013,(C) CIVIL AND OTHER CASES,0,0,0,0,0,0,0,0,0,0,0,0,0,0,0
KERALA,2013,TOTAL (A + B + C),0,0,0,1543,58,1601,2008,70,2078,930,12,942,4481,140,4621
MADHYA PRADESH,2013,ARMS ACT,0,0,0,339,0,339,244,0,244,25,0,25,608,0,608
MADHYA PRADESH,2013,N.D.P.S. ACT,0,0,0,360,9,369,388,16,404,72,2,74,820,27,847
MADHYA PRADESH,2013,GAMBLING ACT,0,0,0,19,0,19,30,0,30,7,0,7,56,0,56
MADHYA PRADESH,2013,EXCISE ACT,0,0,0,151,1,152,109,5,114,18,0,18,278,6,284
MADHYA PRADESH,2013,PROHIBITION ACT,0,0,0,6,0,6,13,0,13,2,0,2,21,0,21
MADHYA PRADESH,2013,EXPLOSIVE & EXPLOSIVE SUBST. ACT,0,0,0,17,0,17,12,0,12,7,0,7,36,0,36
MADHYA PRADESH,2013,TERRORIST & DISRUPTIVE ACTIVITIES (TATA),0,0,0,0,0,0,0,1,1,0,0,0,0,1,1
MADHYA PRADESH,2013,IMMORAL TRAFFIC (PREVENTION) ACT,0,0,0,2,0,2,6,1,7,1,0,1,9,1,10
MADHYA PRADESH,2013,INDIAN RAILWAYS ACT,0,0,0,43,2,45,46,0,46,13,0,13,102,2,104
MADHYA PRADESH,2013,REGISTRATION OF FOREIGNERS ACT,0,0,0,0,0,0,2,0,2,0,0,0,2,0,2
MADHYA PRADESH,2013,PROTECTION OF CIVIL RIGHTS ACT,0,0,0,0,0,0,0,0,0,0,0,0,0,0,0
MADHYA PRADESH,2013,SC/ST (PREVENTION OF ATROCITIES) ACT,0,0,0,57,0,57,43,4,47,6,1,7,106,5,111
MADHYA PRADESH,2013,INDIAN PASSPORT ACT,0,0,0,0,0,0,1,0,1,0,0,0,1,0,1
MADHYA PRADESH,2013,ESSENTIAL COMMODITIES ACT,0,0,0,1,0,1,3,0,3,1,0,1,5,0,5
MADHYA PRADESH,2013,ANTIQUITIES AND ART TREASURE ACT,0,0,0,0,0,0,5,0,5,1,0,1,6,0,6
MADHYA PRADESH,2013,DOWRY PROHIBITION ACT,0,0,0,2,0,2,4,0,4,3,0,3,9,0,9
MADHYA PRADESH,2013,FOREIGN EXCHANGE REGULATION ACT-1973,0,0,0,0,0,0,0,0,0,0,0,0,0,0,0
MADHYA PRADESH,2013,PREVENTION OF CORRUPTION ACT-1988,0,0,0,1,0,1,8,0,8,1,0,1,10,0,10
MADHYA PRADESH,2013,CONSER.OF FORGN.EXCH.&PREV. OF SMUG.ACT,0,0,0,0,0,0,0,0,0,0,0,0,0,0,0
MADHYA PRADESH,2013,OTHER SLL OFFENCE,0,0,0,161,0,161,137,5,142,13,0,13,311,5,316
MADHYA PRADESH,2013,TOTAL (B),0,0,0,1159,12,1171,1051,32,1083,170,3,173,2380,47,2427
MADHYA PRADESH,2013,(C) CIVIL AND OTHER CASES,0,0,0,0,0,0,0,0,0,0,0,0,0,0,0
MADHYA PRADESH,2013,TOTAL (A + B + C),0,0,0,9162,203,9365,6441,277,6718,1398,87,1485,17001,567,17568
MAHARASHTRA,2013,ARMS ACT,0,0,0,7,0,7,14,0,14,8,0,8,29,0,29
MAHARASHTRA,2013,N.D.P.S. ACT,0,0,0,75,0,75,125,6,131,37,0,37,237,6,243
MAHARASHTRA,2013,GAMBLING ACT,0,0,0,7,0,7,10,0,10,3,0,3,20,0,20
MAHARASHTRA,2013,EXCISE ACT,0,0,0,0,0,0,0,0,0,0,0,0,0,0,0
MAHARASHTRA,2013,PROHIBITION ACT,0,0,0,100,0,100,109,2,111,21,0,21,230,2,232
MAHARASHTRA,2013,EXPLOSIVE & EXPLOSIVE SUBST. ACT,0,0,0,0,0,0,1,3,4,0,0,0,1,3,4
MAHARASHTRA,2013,TERRORIST & DISRUPTIVE ACTIVITIES (TATA),0,0,0,1,0,1,8,0,8,0,0,0,9,0,9
MAHARASHTRA,2013,IMMORAL TRAFFIC (PREVENTION) ACT,0,0,0,10,6,16,23,10,33,11,0,11,44,16,60
MAHARASHTRA,2013,INDIAN RAILWAYS ACT,0,0,0,68,8,76,93,5,98,6,0,6,167,13,180
MAHARASHTRA,2013,REGISTRATION OF FOREIGNERS ACT,0,0,0,0,0,0,0,0,0,0,0,0,0,0,0
MAHARASHTRA,2013,PROTECTION OF CIVIL RIGHTS ACT,0,0,0,5,0,5,0,0,0,0,0,0,5,0,5
MAHARASHTRA,2013,SC/ST (PREVENTION OF ATROCITIES) ACT,0,0,0,11,1,12,15,0,15,1,0,1,27,1,28
MAHARASHTRA,2013,INDIAN PASSPORT ACT,0,0,0,274,115,389,219,141,360,15,5,20,508,261,769
MAHARASHTRA,2013,ESSENTIAL COMMODITIES ACT,0,0,0,0,0,0,0,0,0,0,0,0,0,0,0
MAHARASHTRA,2013,ANTIQUITIES AND ART TREASURE ACT,0,0,0,0,0,0,0,0,0,0,0,0,0,0,0
MAHARASHTRA,2013,DOWRY PROHIBITION ACT,0,0,0,0,0,0,0,0,0,0,0,0,0,0,0
MAHARASHTRA,2013,FOREIGN EXCHANGE REGULATION ACT-1973,0,0,0,0,0,0,12,0,12,0,0,0,12,0,12
MAHARASHTRA,2013,PREVENTION OF CORRUPTION ACT-1988,0,0,0,24,0,24,60,0,60,1,0,1,85,0,85
MAHARASHTRA,2013,CONSER.OF FORGN.EXCH.&PREV. OF SMUG.ACT,0,0,0,5,0,5,0,0,0,0,0,0,5,0,5
MAHARASHTRA,2013,OTHER SLL OFFENCE,0,0,0,235,32,267,246,28,274,96,3,99,577,63,640
MAHARASHTRA,2013,TOTAL (B),0,0,0,822,162,984,935,195,1130,199,8,207,1956,365,2321
MAHARASHTRA,2013,(C) CIVIL AND OTHER CASES,0,0,0,1,0,1,5,0,5,0,0,0,6,0,6
MAHARASHTRA,2013,TOTAL (A + B + C),0,0,0,7456,433,7889,8394,622,9016,2360,66,2426,18210,1121,19331
MANIPUR,2013,ARMS ACT,0,0,0,70,4,74,26,10,36,1,1,2,97,15,112
MANIPUR,2013,N.D.P.S. ACT,0,0,0,31,0,31,35,6,41,1,0,1,67,6,73
MANIPUR,2013,GAMBLING ACT,0,0,0,0,0,0,0,0,0,0,0,0,0,0,0
MANIPUR,2013,EXCISE ACT,0,0,0,0,0,0,0,0,0,0,0,0,0,0,0
MANIPUR,2013,PROHIBITION ACT,0,0,0,0,0,0,0,0,0,0,0,0,0,0,0
MANIPUR,2013,EXPLOSIVE & EXPLOSIVE SUBST. ACT,0,0,0,24,0,24,17,0,17,3,0,3,44,0,44
MANIPUR,2013,TERRORIST & DISRUPTIVE ACTIVITIES (TATA),0,0,0,0,0,0,0,0,0,0,0,0,0,0,0
MANIPUR,2013,IMMORAL TRAFFIC (PREVENTION) ACT,0,0,0,0,0,0,0,0,0,0,0,0,0,0,0
MANIPUR,2013,INDIAN RAILWAYS ACT,0,0,0,0,0,0,0,0,0,0,0,0,0,0,0
MANIPUR,2013,REGISTRATION OF FOREIGNERS ACT,0,0,0,8,0,8,11,0,11,0,0,0,19,0,19
MANIPUR,2013,PROTECTION OF CIVIL RIGHTS ACT,0,0,0,0,0,0,0,0,0,0,0,0,0,0,0
MANIPUR,2013,SC/ST (PREVENTION OF ATROCITIES) ACT,0,0,0,0,0,0,0,0,0,0,0,0,0,0,0
MANIPUR,2013,INDIAN PASSPORT ACT,0,0,0,0,0,0,0,0,0,0,0,0,0,0,0
MANIPUR,2013,ESSENTIAL COMMODITIES ACT,0,0,0,0,0,0,0,0,0,0,0,0,0,0,0
MANIPUR,2013,ANTIQUITIES AND ART TREASURE ACT,0,0,0,0,0,0,0,0,0,0,0,0,0,0,0
MANIPUR,2013,DOWRY PROHIBITION ACT,0,0,0,0,0,0,0,0,0,0,0,0,0,0,0
MANIPUR,2013,FOREIGN EXCHANGE REGULATION ACT-1973,0,0,0,0,0,0,0,0,0,0,0,0,0,0,0
MANIPUR,2013,PREVENTION OF CORRUPTION ACT-1988,0,0,0,0,0,0,0,0,0,0,0,0,0,0,0
MANIPUR,2013,CONSER.OF FORGN.EXCH.&PREV. OF SMUG.ACT,0,0,0,0,0,0,0,0,0,0,0,0,0,0,0
MANIPUR,2013,OTHER SLL OFFENCE,0,0,0,0,0,0,0,0,0,0,0,0,0,0,0
MANIPUR,2013,TOTAL (B),0,0,0,133,4,137,89,16,105,5,1,6,227,21,248
MANIPUR,2013,(C) CIVIL AND OTHER CASES,0,0,0,0,0,0,0,0,0,0,0,0,0,0,0
MANIPUR,2013,TOTAL (A + B + C),0,0,0,278,6,284,212,22,234,18,2,20,508,30,538
MEGHALAYA,2013,ARMS ACT,0,0,0,31,0,31,16,0,16,0,0,0,47,0,47
MEGHALAYA,2013,N.D.P.S. ACT,0,0,0,31,0,31,5,0,5,0,0,0,36,0,36
MEGHALAYA,2013,GAMBLING ACT,0,0,0,0,0,0,0,0,0,0,0,0,0,0,0
MEGHALAYA,2013,EXCISE ACT,0,0,0,1,0,1,0,0,0,0,0,0,1,0,1
MEGHALAYA,2013,PROHIBITION ACT,0,0,0,0,0,0,0,0,0,0,0,0,0,0,0
MEGHALAYA,2013,EXPLOSIVE & EXPLOSIVE SUBST. ACT,0,0,0,16,0,16,5,0,5,1,0,1,22,0,22
MEGHALAYA,2013,TERRORIST & DISRUPTIVE ACTIVITIES (TATA),0,0,0,0,0,0,0,0,0,0,0,0,0,0,0
MEGHALAYA,2013,IMMORAL TRAFFIC (PREVENTION) ACT,0,0,0,0,0,0,0,0,0,0,0,0,0,0,0
MEGHALAYA,2013,INDIAN RAILWAYS ACT,0,0,0,0,0,0,0,0,0,0,0,0,0,0,0
MEGHALAYA,2013,REGISTRATION OF FOREIGNERS ACT,0,0,0,0,0,0,0,0,0,0,0,0,0,0,0
MEGHALAYA,2013,PROTECTION OF CIVIL RIGHTS ACT,0,0,0,0,0,0,0,0,0,0,0,0,0,0,0
MEGHALAYA,2013,SC/ST (PREVENTION OF ATROCITIES) ACT,0,0,0,0,0,0,0,0,0,0,0,0,0,0,0
MEGHALAYA,2013,INDIAN PASSPORT ACT,0,0,0,27,0,27,11,0,11,6,0,6,44,0,44
MEGHALAYA,2013,ESSENTIAL COMMODITIES ACT,0,0,0,0,0,0,0,0,0,0,0,0,0,0,0
MEGHALAYA,2013,ANTIQUITIES AND ART TREASURE ACT,0,0,0,0,0,0,0,0,0,0,0,0,0,0,0
MEGHALAYA,2013,DOWRY PROHIBITION ACT,0,0,0,0,0,0,2,0,2,0,0,0,2,0,2
MEGHALAYA,2013,FOREIGN EXCHANGE REGULATION ACT-1973,0,0,0,0,0,0,0,0,0,0,0,0,0,0,0
MEGHALAYA,2013,PREVENTION OF CORRUPTION ACT-1988,0,0,0,0,0,0,0,0,0,0,0,0,0,0,0
MEGHALAYA,2013,CONSER.OF FORGN.EXCH.&PREV. OF SMUG.ACT,0,0,0,0,0,0,0,0,0,0,0,0,0,0,0
MEGHALAYA,2013,OTHER SLL OFFENCE,0,0,0,10,3,13,4,0,4,1,0,1,15,3,18
MEGHALAYA,2013,TOTAL (B),0,0,0,116,3,119,43,0,43,8,0,8,167,3,170
MEGHALAYA,2013,(C) CIVIL AND OTHER CASES,0,0,0,0,0,0,0,0,0,0,0,0,0,0,0
MEGHALAYA,2013,TOTAL (A + B + C),0,0,0,507,11,518,186,0,186,41,0,41,734,11,745
MIZORAM,2013,ARMS ACT,0,0,0,0,0,0,5,0,5,0,0,0,5,0,5
MIZORAM,2013,N.D.P.S. ACT,0,0,0,18,4,22,15,10,25,4,0,4,37,14,51
MIZORAM,2013,GAMBLING ACT,0,0,0,0,0,0,0,0,0,0,0,0,0,0,0
MIZORAM,2013,EXCISE ACT,0,0,0,0,0,0,0,0,0,0,0,0,0,0,0
MIZORAM,2013,PROHIBITION ACT,0,0,0,23,11,34,30,16,46,8,2,10,61,29,90
MIZORAM,2013,EXPLOSIVE & EXPLOSIVE SUBST. ACT,0,0,0,0,0,0,0,0,0,0,0,0,0,0,0
MIZORAM,2013,TERRORIST & DISRUPTIVE ACTIVITIES (TATA),0,0,0,0,0,0,0,0,0,0,0,0,0,0,0
MIZORAM,2013,IMMORAL TRAFFIC (PREVENTION) ACT,0,0,0,0,0,0,0,0,0,0,0,0,0,0,0
MIZORAM,2013,INDIAN RAILWAYS ACT,0,0,0,0,0,0,0,0,0,0,0,0,0,0,0
MIZORAM,2013,REGISTRATION OF FOREIGNERS ACT,0,0,0,0,0,0,0,0,0,0,0,0,0,0,0
MIZORAM,2013,PROTECTION OF CIVIL RIGHTS ACT,0,0,0,0,0,0,0,0,0,0,0,0,0,0,0
MIZORAM,2013,SC/ST (PREVENTION OF ATROCITIES) ACT,0,0,0,0,0,0,0,0,0,0,0,0,0,0,0
MIZORAM,2013,INDIAN PASSPORT ACT,0,0,0,0,0,0,0,0,0,0,0,0,0,0,0
MIZORAM,2013,ESSENTIAL COMMODITIES ACT,0,0,0,0,0,0,0,0,0,0,0,0,0,0,0
MIZORAM,2013,ANTIQUITIES AND ART TREASURE ACT,0,0,0,0,0,0,0,0,0,0,0,0,0,0,0
MIZORAM,2013,DOWRY PROHIBITION ACT,0,0,0,0,0,0,0,0,0,0,0,0,0,0,0
MIZORAM,2013,FOREIGN EXCHANGE REGULATION ACT-1973,0,0,0,0,0,0,0,0,0,0,0,0,0,0,0
MIZORAM,2013,PREVENTION OF CORRUPTION ACT-1988,0,0,0,0,0,0,0,0,0,0,0,0,0,0,0
MIZORAM,2013,CONSER.OF FORGN.EXCH.&PREV. OF SMUG.ACT,0,0,0,0,0,0,0,0,0,0,0,0,0,0,0
MIZORAM,2013,OTHER SLL OFFENCE,0,0,0,7,3,10,13,1,14,7,2,9,27,6,33
MIZORAM,2013,TOTAL (B),0,0,0,48,18,66,63,27,90,19,4,23,130,49,179
MIZORAM,2013,(C) CIVIL AND OTHER CASES,0,0,0,0,0,0,0,0,0,0,0,0,0,0,0
MIZORAM,2013,TOTAL (A + B + C),0,0,0,187,23,210,179,31,210,36,4,40,402,58,460
NAGALAND,2013,ARMS ACT,1,0,1,17,0,17,2,0,2,1,0,1,21,0,21
NAGALAND,2013,N.D.P.S. ACT,0,0,0,11,0,11,7,0,7,0,0,0,18,0,18
NAGALAND,2013,GAMBLING ACT,0,0,0,0,0,0,0,0,0,0,0,0,0,0,0
NAGALAND,2013,EXCISE ACT,0,0,0,0,0,0,0,0,0,0,0,0,0,0,0
NAGALAND,2013,PROHIBITION ACT,0,0,0,0,0,0,0,0,0,0,0,0,0,0,0
NAGALAND,2013,EXPLOSIVE & EXPLOSIVE SUBST. ACT,0,0,0,3,0,3,2,2,4,0,0,0,5,2,7
NAGALAND,2013,TERRORIST & DISRUPTIVE ACTIVITIES (TATA),0,0,0,0,0,0,0,0,0,0,0,0,0,0,0
NAGALAND,2013,IMMORAL TRAFFIC (PREVENTION) ACT,0,0,0,0,0,0,0,0,0,0,0,0,0,0,0
NAGALAND,2013,INDIAN RAILWAYS ACT,0,0,0,0,0,0,0,0,0,0,0,0,0,0,0
NAGALAND,2013,REGISTRATION OF FOREIGNERS ACT,0,0,0,0,0,0,0,0,0,0,0,0,0,0,0
NAGALAND,2013,PROTECTION OF CIVIL RIGHTS ACT,0,0,0,0,0,0,0,0,0,0,0,0,0,0,0
NAGALAND,2013,SC/ST (PREVENTION OF ATROCITIES) ACT,0,0,0,0,0,0,0,0,0,0,0,0,0,0,0
NAGALAND,2013,INDIAN PASSPORT ACT,0,0,0,0,0,0,0,0,0,0,0,0,0,0,0
NAGALAND,2013,ESSENTIAL COMMODITIES ACT,0,0,0,0,0,0,0,0,0,0,0,0,0,0,0
NAGALAND,2013,ANTIQUITIES AND ART TREASURE ACT,0,0,0,0,0,0,0,0,0,0,0,0,0,0,0
NAGALAND,2013,DOWRY PROHIBITION ACT,0,0,0,0,0,0,0,0,0,0,0,0,0,0,0
NAGALAND,2013,FOREIGN EXCHANGE REGULATION ACT-1973,0,0,0,0,0,0,0,0,0,0,0,0,0,0,0
NAGALAND,2013,PREVENTION OF CORRUPTION ACT-1988,0,0,0,0,0,0,0,0,0,0,0,0,0,0,0
NAGALAND,2013,CONSER.OF FORGN.EXCH.&PREV. OF SMUG.ACT,0,0,0,0,0,0,0,0,0,0,0,0,0,0,0
NAGALAND,2013,OTHER SLL OFFENCE,0,0,0,1,0,1,0,0,0,0,0,0,1,0,1
NAGALAND,2013,TOTAL (B),1,0,1,32,0,32,11,2,13,1,0,1,45,2,47
NAGALAND,2013,(C) CIVIL AND OTHER CASES,0,0,0,0,0,0,0,0,0,0,0,0,0,0,0
NAGALAND,2013,TOTAL (A + B + C),3,0,3,236,2,238,87,5,92,7,1,8,333,8,341
ORISSA,2013,ARMS ACT,0,0,0,47,0,47,58,0,58,2,4,6,107,4,111
ORISSA,2013,N.D.P.S. ACT,0,0,0,110,0,110,88,0,88,3,3,6,201,3,204
ORISSA,2013,GAMBLING ACT,0,0,0,0,0,0,0,0,0,0,0,0,0,0,0
ORISSA,2013,EXCISE ACT,0,0,0,62,2,64,72,2,74,0,0,0,134,4,138
ORISSA,2013,PROHIBITION ACT,0,0,0,0,0,0,14,0,14,0,0,0,14,0,14
ORISSA,2013,EXPLOSIVE & EXPLOSIVE SUBST. ACT,0,0,0,32,0,32,17,0,17,0,0,0,49,0,49
ORISSA,2013,TERRORIST & DISRUPTIVE ACTIVITIES (TATA),0,0,0,0,0,0,0,0,0,0,0,0,0,0,0
ORISSA,2013,IMMORAL TRAFFIC (PREVENTION) ACT,0,0,0,0,0,0,1,0,1,0,0,0,1,0,1
ORISSA,2013,INDIAN RAILWAYS ACT,0,0,0,15,0,15,20,0,20,0,0,0,35,0,35
ORISSA,2013,REGISTRATION OF FOREIGNERS ACT,0,0,0,0,0,0,0,0,0,0,0,0,0,0,0
ORISSA,2013,PROTECTION OF CIVIL RIGHTS ACT,0,0,0,9,0,9,14,0,14,0,0,0,23,0,23
ORISSA,2013,SC/ST (PREVENTION OF ATROCITIES) ACT,0,0,0,6,0,6,1,3,4,0,0,0,7,3,10
ORISSA,2013,INDIAN PASSPORT ACT,0,0,0,0,0,0,0,0,0,0,0,0,0,0,0
ORISSA,2013,ESSENTIAL COMMODITIES ACT,0,0,0,1,0,1,3,0,3,0,0,0,4,0,4
ORISSA,2013,ANTIQUITIES AND ART TREASURE ACT,0,0,0,3,0,3,1,0,1,1,0,1,5,0,5
ORISSA,2013,DOWRY PROHIBITION ACT,0,0,0,38,0,38,23,1,24,0,2,2,61,3,64
ORISSA,2013,FOREIGN EXCHANGE REGULATION ACT-1973,0,0,0,0,0,0,0,0,0,0,0,0,0,0,0
ORISSA,2013,PREVENTION OF CORRUPTION ACT-1988,0,0,0,0,0,0,0,0,0,0,0,0,0,0,0
ORISSA,2013,CONSER.OF FORGN.EXCH.&PREV. OF SMUG.ACT,0,0,0,0,0,0,0,0,0,0,0,0,0,0,0
ORISSA,2013,OTHER SLL OFFENCE,0,0,0,30,2,32,24,3,27,1,2,3,55,7,62
ORISSA,2013,TOTAL (B),0,0,0,353,4,357,336,9,345,7,11,18,696,24,720
ORISSA,2013,(C) CIVIL AND OTHER CASES,0,0,0,0,0,0,0,0,0,0,0,0,0,0,0
ORISSA,2013,TOTAL (A + B + C),0,0,0,4838,179,5017,4542,268,4810,1066,72,1138,10446,519,10965
PUNJAB,2013,ARMS ACT,0,0,0,263,0,263,386,0,386,31,1,32,680,1,681
PUNJAB,2013,N.D.P.S. ACT,0,0,0,1640,36,1676,2418,102,2520,451,57,508,4509,195,4704
PUNJAB,2013,GAMBLING ACT,0,0,0,137,3,140,141,6,147,64,2,66,342,11,353
PUNJAB,2013,EXCISE ACT,0,0,0,135,4,139,215,6,221,83,2,85,433,12,445
PUNJAB,2013,PROHIBITION ACT,0,0,0,4,0,4,2,0,2,0,0,0,6,0,6
PUNJAB,2013,EXPLOSIVE & EXPLOSIVE SUBST. ACT,0,0,0,15,1,16,18,0,18,8,0,8,41,1,42
PUNJAB,2013,TERRORIST & DISRUPTIVE ACTIVITIES (TATA),0,0,0,0,0,0,6,0,6,0,0,0,6,0,6
PUNJAB,2013,IMMORAL TRAFFIC (PREVENTION) ACT,0,0,0,72,21,93,58,45,103,31,13,44,161,79,240
PUNJAB,2013,INDIAN RAILWAYS ACT,0,0,0,49,0,49,123,0,123,21,0,21,193,0,193
PUNJAB,2013,REGISTRATION OF FOREIGNERS ACT,0,0,0,18,3,21,41,1,42,17,0,17,76,4,80
PUNJAB,2013,PROTECTION OF CIVIL RIGHTS ACT,0,0,0,0,0,0,0,0,0,0,0,0,0,0,0
PUNJAB,2013,SC/ST (PREVENTION OF ATROCITIES) ACT,0,0,0,17,0,17,19,0,19,13,0,13,49,0,49
PUNJAB,2013,INDIAN PASSPORT ACT,0,0,0,22,1,23,32,3,35,9,2,11,63,6,69
PUNJAB,2013,ESSENTIAL COMMODITIES ACT,0,0,0,5,0,5,38,0,38,11,0,11,54,0,54
PUNJAB,2013,ANTIQUITIES AND ART TREASURE ACT,0,0,0,0,0,0,0,0,0,0,0,0,0,0,0
PUNJAB,2013,DOWRY PROHIBITION ACT,0,0,0,31,1,32,39,2,41,32,1,33,102,4,106
PUNJAB,2013,FOREIGN EXCHANGE REGULATION ACT-1973,0,0,0,27,0,27,53,0,53,20,0,20,100,0,100
PUNJAB,2013,PREVENTION OF CORRUPTION ACT-1988,0,0,0,27,0,27,65,0,65,15,0,15,107,0,107
PUNJAB,2013,CONSER.OF FORGN.EXCH.&PREV. OF SMUG.ACT,0,0,0,27,2,29,28,2,30,12,0,12,67,4,71
PUNJAB,2013,OTHER SLL OFFENCE,0,0,0,5,0,5,7,0,7,2,0,2,14,0,14
PUNJAB,2013,TOTAL (B),0,0,0,2494,72,2566,3689,167,3856,820,78,898,7003,317,7320
PUNJAB,2013,(C) CIVIL AND OTHER CASES,0,0,0,8,0,8,6,0,6,2,0,2,16,0,16
PUNJAB,2013,TOTAL (A + B + C),0,0,0,6896,299,7195,8476,431,8907,2158,246,2404,17530,976,18506
RAJASTHAN,2013,ARMS ACT,0,0,0,289,0,289,231,0,231,42,0,42,562,0,562
RAJASTHAN,2013,N.D.P.S. ACT,0,0,0,410,2,412,516,7,523,124,1,125,1050,10,1060
RAJASTHAN,2013,GAMBLING ACT,0,0,0,24,0,24,31,0,31,0,0,0,55,0,55
RAJASTHAN,2013,EXCISE ACT,0,0,0,198,3,201,241,3,244,69,2,71,508,8,516
RAJASTHAN,2013,PROHIBITION ACT,0,0,0,7,0,7,1,0,1,0,0,0,8,0,8
RAJASTHAN,2013,EXPLOSIVE & EXPLOSIVE SUBST. ACT,0,0,0,0,0,0,5,0,5,0,0,0,5,0,5
RAJASTHAN,2013,TERRORIST & DISRUPTIVE ACTIVITIES (TATA),0,0,0,4,0,4,1,0,1,0,0,0,5,0,5
RAJASTHAN,2013,IMMORAL TRAFFIC (PREVENTION) ACT,0,0,0,4,3,7,2,3,5,0,0,0,6,6,12
RAJASTHAN,2013,INDIAN RAILWAYS ACT,0,0,0,16,0,16,7,0,7,4,0,4,27,0,27
RAJASTHAN,2013,REGISTRATION OF FOREIGNERS ACT,0,0,0,2,0,2,4,0,4,0,0,0,6,0,6
RAJASTHAN,2013,PROTECTION OF CIVIL RIGHTS ACT,0,0,0,3,0,3,0,0,0,0,0,0,3,0,3
RAJASTHAN,2013,SC/ST (PREVENTION OF ATROCITIES) ACT,0,0,0,37,0,37,37,1,38,10,0,10,84,1,85
RAJASTHAN,2013,INDIAN PASSPORT ACT,0,0,0,4,0,4,6,0,6,4,0,4,14,0,14
RAJASTHAN,2013,ESSENTIAL COMMODITIES ACT,0,0,0,0,0,0,3,0,3,0,0,0,3,0,3
RAJASTHAN,2013,ANTIQUITIES AND ART TREASURE ACT,0,0,0,0,0,0,0,0,0,2,0,2,2,0,2
RAJASTHAN,2013,DOWRY PROHIBITION ACT,0,0,0,25,0,25,14,1,15,5,1,6,44,2,46
RAJASTHAN,2013,FOREIGN EXCHANGE REGULATION ACT-1973,0,0,0,2,0,2,0,0,0,0,0,0,2,0,2
RAJASTHAN,2013,PREVENTION OF CORRUPTION ACT-1988,0,0,0,4,0,4,10,1,11,6,0,6,20,1,21
RAJASTHAN,2013,CONSER.OF FORGN.EXCH.&PREV. OF SMUG.ACT,0,0,0,0,0,0,3,0,3,0,0,0,3,0,3
RAJASTHAN,2013,OTHER SLL OFFENCE,0,0,0,129,5,134,77,0,77,27,2,29,233,7,240
RAJASTHAN,2013,TOTAL (B),0,0,0,1158,13,1171,1189,16,1205,293,6,299,2640,35,2675
RAJASTHAN,2013,(C) CIVIL AND OTHER CASES,0,0,0,0,0,0,0,0,0,0,0,0,0,0,0
RAJASTHAN,2013,TOTAL (A + B + C),0,0,0,5839,153,5992,5540,210,5750,1424,80,1504,12803,443,13246
SIKKIM,2013,ARMS ACT,0,0,0,0,0,0,1,0,1,0,0,0,1,0,1
SIKKIM,2013,N.D.P.S. ACT,0,0,0,1,0,1,0,0,0,0,0,0,1,0,1
SIKKIM,2013,GAMBLING ACT,0,0,0,0,0,0,0,0,0,0,0,0,0,0,0
SIKKIM,2013,EXCISE ACT,0,0,0,0,0,0,0,0,0,0,0,0,0,0,0
SIKKIM,2013,PROHIBITION ACT,0,0,0,0,0,0,0,0,0,0,0,0,0,0,0
SIKKIM,2013,EXPLOSIVE & EXPLOSIVE SUBST. ACT,0,0,0,0,0,0,0,0,0,0,0,0,0,0,0
SIKKIM,2013,TERRORIST & DISRUPTIVE ACTIVITIES (TATA),0,0,0,0,0,0,0,0,0,0,0,0,0,0,0
SIKKIM,2013,IMMORAL TRAFFIC (PREVENTION) ACT,0,0,0,0,0,0,0,0,0,0,0,0,0,0,0
SIKKIM,2013,INDIAN RAILWAYS ACT,0,0,0,0,0,0,0,0,0,0,0,0,0,0,0
SIKKIM,2013,REGISTRATION OF FOREIGNERS ACT,0,0,0,0,0,0,0,0,0,0,0,0,0,0,0
SIKKIM,2013,PROTECTION OF CIVIL RIGHTS ACT,0,0,0,0,0,0,0,0,0,0,0,0,0,0,0
SIKKIM,2013,SC/ST (PREVENTION OF ATROCITIES) ACT,0,0,0,0,0,0,0,0,0,0,0,0,0,0,0
SIKKIM,2013,INDIAN PASSPORT ACT,0,0,0,0,0,0,0,0,0,0,0,0,0,0,0
SIKKIM,2013,ESSENTIAL COMMODITIES ACT,0,0,0,0,0,0,0,0,0,0,0,0,0,0,0
SIKKIM,2013,ANTIQUITIES AND ART TREASURE ACT,0,0,0,0,0,0,0,0,0,0,0,0,0,0,0
SIKKIM,2013,DOWRY PROHIBITION ACT,0,0,0,0,0,0,0,0,0,0,0,0,0,0,0
SIKKIM,2013,FOREIGN EXCHANGE REGULATION ACT-1973,0,0,0,0,0,0,0,0,0,0,0,0,0,0,0
SIKKIM,2013,PREVENTION OF CORRUPTION ACT-1988,0,0,0,0,0,0,0,0,0,0,0,0,0,0,0
SIKKIM,2013,CONSER.OF FORGN.EXCH.&PREV. OF SMUG.ACT,0,0,0,0,0,0,0,0,0,0,0,0,0,0,0
SIKKIM,2013,OTHER SLL OFFENCE,0,0,0,33,0,33,9,1,10,1,1,2,43,2,45
SIKKIM,2013,TOTAL (B),0,0,0,34,0,34,10,1,11,1,1,2,45,2,47
SIKKIM,2013,(C) CIVIL AND OTHER CASES,0,0,0,0,0,0,0,0,0,0,0,0,0,0,0
SIKKIM,2013,TOTAL (A + B + C),0,0,0,85,3,88,32,2,34,3,1,4,120,6,126
TAMILNADU,2013,ARMS ACT,0,0,0,31,0,31,28,0,28,11,0,11,70,0,70
TAMILNADU,2013,N.D.P.S. ACT,0,0,0,145,6,151,221,24,245,38,9,47,404,39,443
TAMILNADU,2013,GAMBLING ACT,0,0,0,2,0,2,12,0,12,0,0,0,14,0,14
TAMILNADU,2013,EXCISE ACT,0,0,0,0,20,20,0,29,29,0,17,17,0,66,66
TAMILNADU,2013,PROHIBITION ACT,0,0,0,20,15,35,30,21,51,0,7,7,50,43,93
TAMILNADU,2013,EXPLOSIVE & EXPLOSIVE SUBST. ACT,0,0,0,4,0,4,12,0,12,2,0,2,18,0,18
TAMILNADU,2013,TERRORIST & DISRUPTIVE ACTIVITIES (TATA),0,0,0,38,0,38,35,0,35,3,0,3,76,0,76
TAMILNADU,2013,IMMORAL TRAFFIC (PREVENTION) ACT,0,0,0,0,7,7,18,4,22,0,2,2,18,13,31
TAMILNADU,2013,INDIAN RAILWAYS ACT,0,0,0,81,0,81,68,1,69,0,0,0,149,1,150
TAMILNADU,2013,REGISTRATION OF FOREIGNERS ACT,0,0,0,116,0,116,100,0,100,0,0,0,216,0,216
TAMILNADU,2013,PROTECTION OF CIVIL RIGHTS ACT,0,0,0,0,0,0,0,0,0,0,0,0,0,0,0
TAMILNADU,2013,SC/ST (PREVENTION OF ATROCITIES) ACT,0,0,0,4,0,4,21,0,21,4,0,4,29,0,29
TAMILNADU,2013,INDIAN PASSPORT ACT,0,0,0,58,0,58,17,4,21,0,0,0,75,4,79
TAMILNADU,2013,ESSENTIAL COMMODITIES ACT,0,0,0,5,0,5,8,0,8,2,0,2,15,0,15
TAMILNADU,2013,ANTIQUITIES AND ART TREASURE ACT,0,0,0,0,0,0,0,0,0,0,0,0,0,0,0
TAMILNADU,2013,DOWRY PROHIBITION ACT,0,0,0,15,0,15,20,5,25,0,1,1,35,6,41
TAMILNADU,2013,FOREIGN EXCHANGE REGULATION ACT-1973,0,0,0,0,0,0,0,0,0,0,0,0,0,0,0
TAMILNADU,2013,PREVENTION OF CORRUPTION ACT-1988,0,0,0,3,0,3,14,0,14,0,0,0,17,0,17
TAMILNADU,2013,CONSER.OF FORGN.EXCH.&PREV. OF SMUG.ACT,0,0,0,0,0,0,0,0,0,0,0,0,0,0,0
TAMILNADU,2013,OTHER SLL OFFENCE,0,0,0,0,0,0,0,4,4,0,1,1,0,5,5
TAMILNADU,2013,TOTAL (B),0,0,0,522,48,570,604,92,696,60,37,97,1186,177,1363
TAMILNADU,2013,(C) CIVIL AND OTHER CASES,0,0,0,0,0,0,0,0,0,0,1,1,0,1,1
TAMILNADU,2013,TOTAL (A + B + C),0,0,0,3532,226,3758,3871,211,4082,392,60,452,7795,497,8292
TRIPURA,2013,ARMS ACT,0,0,0,4,0,4,10,0,10,0,0,0,14,0,14
TRIPURA,2013,N.D.P.S. ACT,0,0,0,8,0,8,4,0,4,0,0,0,12,0,12
TRIPURA,2013,GAMBLING ACT,0,0,0,0,0,0,0,0,0,0,0,0,0,0,0
TRIPURA,2013,EXCISE ACT,0,0,0,0,0,0,0,0,0,0,0,0,0,0,0
TRIPURA,2013,PROHIBITION ACT,0,0,0,0,0,0,0,0,0,0,0,0,0,0,0
TRIPURA,2013,EXPLOSIVE & EXPLOSIVE SUBST. ACT,0,0,0,0,0,0,0,0,0,0,0,0,0,0,0
TRIPURA,2013,TERRORIST & DISRUPTIVE ACTIVITIES (TATA),0,0,0,0,0,0,0,0,0,0,0,0,0,0,0
TRIPURA,2013,IMMORAL TRAFFIC (PREVENTION) ACT,0,0,0,0,0,0,0,0,0,0,0,0,0,0,0
TRIPURA,2013,INDIAN RAILWAYS ACT,0,0,0,2,0,2,0,0,0,0,0,0,2,0,2
TRIPURA,2013,REGISTRATION OF FOREIGNERS ACT,0,0,0,0,0,0,0,0,0,0,0,0,0,0,0
TRIPURA,2013,PROTECTION OF CIVIL RIGHTS ACT,0,0,0,0,0,0,0,0,0,0,0,0,0,0,0
TRIPURA,2013,SC/ST (PREVENTION OF ATROCITIES) ACT,0,0,0,0,0,0,0,0,0,0,0,0,0,0,0
TRIPURA,2013,INDIAN PASSPORT ACT,0,0,0,1,0,1,1,0,1,0,0,0,2,0,2
TRIPURA,2013,ESSENTIAL COMMODITIES ACT,0,0,0,0,0,0,0,0,0,0,0,0,0,0,0
TRIPURA,2013,ANTIQUITIES AND ART TREASURE ACT,0,0,0,0,0,0,0,0,0,0,0,0,0,0,0
TRIPURA,2013,DOWRY PROHIBITION ACT,0,0,0,0,0,0,0,0,0,0,0,0,0,0,0
TRIPURA,2013,FOREIGN EXCHANGE REGULATION ACT-1973,0,0,0,0,0,0,0,0,0,0,0,0,0,0,0
TRIPURA,2013,PREVENTION OF CORRUPTION ACT-1988,0,0,0,0,0,0,0,0,0,0,0,0,0,0,0
TRIPURA,2013,CONSER.OF FORGN.EXCH.&PREV. OF SMUG.ACT,0,0,0,0,0,0,0,0,0,0,0,0,0,0,0
TRIPURA,2013,OTHER SLL OFFENCE,0,0,0,0,0,0,0,0,0,0,0,0,0,0,0
TRIPURA,2013,TOTAL (B),0,0,0,15,0,15,15,0,15,0,0,0,30,0,30
TRIPURA,2013,(C) CIVIL AND OTHER CASES,0,0,0,0,0,0,0,0,0,0,0,0,0,0,0
TRIPURA,2013,TOTAL (A + B + C),0,0,0,229,1,230,136,8,144,23,2,25,388,11,399
UTTAR PRADESH,2013,ARMS ACT,0,0,0,1101,6,1107,1095,4,1099,306,1,307,2502,11,2513
UTTAR PRADESH,2013,N.D.P.S. ACT,0,0,0,1124,60,1184,1289,77,1366,392,34,426,2805,171,2976
UTTAR PRADESH,2013,GAMBLING ACT,0,0,0,179,1,180,175,0,175,45,0,45,399,1,400
UTTAR PRADESH,2013,EXCISE ACT,0,0,0,367,5,372,457,5,462,149,2,151,973,12,985
UTTAR PRADESH,2013,PROHIBITION ACT,0,0,0,12,0,12,2,0,2,2,0,2,16,0,16
UTTAR PRADESH,2013,EXPLOSIVE & EXPLOSIVE SUBST. ACT,0,0,0,75,0,75,104,0,104,26,0,26,205,0,205
UTTAR PRADESH,2013,TERRORIST & DISRUPTIVE ACTIVITIES (TATA),0,0,0,5,0,5,12,0,12,4,0,4,21,0,21
UTTAR PRADESH,2013,IMMORAL TRAFFIC (PREVENTION) ACT,0,0,0,21,0,21,6,0,6,21,0,21,48,0,48
UTTAR PRADESH,2013,INDIAN RAILWAYS ACT,0,0,0,293,0,293,291,1,292,102,0,102,686,1,687
UTTAR PRADESH,2013,REGISTRATION OF FOREIGNERS ACT,0,0,0,10,1,11,5,1,6,0,0,0,15,2,17
UTTAR PRADESH,2013,PROTECTION OF CIVIL RIGHTS ACT,0,0,0,0,0,0,0,0,0,7,0,7,7,0,7
UTTAR PRADESH,2013,SC/ST (PREVENTION OF ATROCITIES) ACT,0,0,0,435,7,442,419,3,422,157,1,158,1011,11,1022
UTTAR PRADESH,2013,INDIAN PASSPORT ACT,0,0,0,17,0,17,21,2,23,3,0,3,41,2,43
UTTAR PRADESH,2013,ESSENTIAL COMMODITIES ACT,0,0,0,94,0,94,104,0,104,21,0,21,219,0,219
UTTAR PRADESH,2013,ANTIQUITIES AND ART TREASURE ACT,0,0,0,3,0,3,2,0,2,3,0,3,8,0,8
UTTAR PRADESH,2013,DOWRY PROHIBITION ACT,0,0,0,340,32,372,445,37,482,103,13,116,888,82,970
UTTAR PRADESH,2013,FOREIGN EXCHANGE REGULATION ACT-1973,0,0,0,0,0,0,11,0,11,1,0,1,12,0,12
UTTAR PRADESH,2013,PREVENTION OF CORRUPTION ACT-1988,0,0,0,18,0,18,59,2,61,54,0,54,131,2,133
UTTAR PRADESH,2013,CONSER.OF FORGN.EXCH.&PREV. OF SMUG.ACT,0,0,0,4,0,4,6,0,6,6,0,6,16,0,16
UTTAR PRADESH,2013,OTHER SLL OFFENCE,0,0,0,518,3,521,457,11,468,150,1,151,1125,15,1140
UTTAR PRADESH,2013,TOTAL (B),0,0,0,4616,115,4731,4960,143,5103,1552,52,1604,11128,310,11438
UTTAR PRADESH,2013,(C) CIVIL AND OTHER CASES,0,0,0,16,0,16,0,0,0,26,0,26,42,0,42
UTTAR PRADESH,2013,TOTAL (A + B + C),0,0,0,24824,741,25565,23283,1144,24427,7644,464,8108,55751,2349,58100
UTTARANCHAL,2013,ARMS ACT,0,0,0,24,0,24,40,1,41,23,1,24,87,2,89
UTTARANCHAL,2013,N.D.P.S. ACT,0,0,0,84,0,84,16,0,16,25,1,26,125,1,126
UTTARANCHAL,2013,GAMBLING ACT,0,0,0,65,0,65,22,0,22,16,1,17,103,1,104
UTTARANCHAL,2013,EXCISE ACT,0,0,0,43,2,45,21,9,30,14,0,14,78,11,89
UTTARANCHAL,2013,PROHIBITION ACT,0,0,0,4,2,6,2,3,5,40,0,40,46,5,51
UTTARANCHAL,2013,EXPLOSIVE & EXPLOSIVE SUBST. ACT,0,0,0,5,0,5,0,0,0,0,0,0,5,0,5
UTTARANCHAL,2013,TERRORIST & DISRUPTIVE ACTIVITIES (TATA),0,0,0,0,0,0,0,0,0,0,0,0,0,0,0
UTTARANCHAL,2013,IMMORAL TRAFFIC (PREVENTION) ACT,0,0,0,6,0,6,0,0,0,0,0,0,6,0,6
UTTARANCHAL,2013,INDIAN RAILWAYS ACT,0,0,0,11,0,11,0,0,0,0,0,0,11,0,11
UTTARANCHAL,2013,REGISTRATION OF FOREIGNERS ACT,0,0,0,0,0,0,0,0,0,0,0,0,0,0,0
UTTARANCHAL,2013,PROTECTION OF CIVIL RIGHTS ACT,0,0,0,0,0,0,0,0,0,0,0,0,0,0,0
UTTARANCHAL,2013,SC/ST (PREVENTION OF ATROCITIES) ACT,0,0,0,21,0,21,0,0,0,0,0,0,21,0,21
UTTARANCHAL,2013,INDIAN PASSPORT ACT,0,0,0,3,0,3,0,0,0,0,0,0,3,0,3
UTTARANCHAL,2013,ESSENTIAL COMMODITIES ACT,0,0,0,0,0,0,0,0,0,0,0,0,0,0,0
UTTARANCHAL,2013,ANTIQUITIES AND ART TREASURE ACT,0,0,0,0,0,0,0,0,0,0,0,0,0,0,0
UTTARANCHAL,2013,DOWRY PROHIBITION ACT,0,0,0,31,2,33,16,1,17,24,0,24,71,3,74
UTTARANCHAL,2013,FOREIGN EXCHANGE REGULATION ACT-1973,0,0,0,0,0,0,0,0,0,0,0,0,0,0,0
UTTARANCHAL,2013,PREVENTION OF CORRUPTION ACT-1988,0,0,0,0,0,0,0,0,0,0,0,0,0,0,0
UTTARANCHAL,2013,CONSER.OF FORGN.EXCH.&PREV. OF SMUG.ACT,0,0,0,0,0,0,0,0,0,0,0,0,0,0,0
UTTARANCHAL,2013,OTHER SLL OFFENCE,0,0,0,5,0,5,0,0,0,4,0,4,9,0,9
UTTARANCHAL,2013,TOTAL (B),0,0,0,302,6,308,117,14,131,146,3,149,565,23,588
UTTARANCHAL,2013,(C) CIVIL AND OTHER CASES,0,0,0,0,0,0,0,0,0,0,0,0,0,0,0
UTTARANCHAL,2013,TOTAL (A + B + C),0,0,0,807,32,839,580,35,615,440,30,470,1827,97,1924
WEST BENGAL,2013,ARMS ACT,0,0,0,377,1,378,321,1,322,40,0,40,738,2,740
WEST BENGAL,2013,N.D.P.S. ACT,0,0,0,680,16,696,511,37,548,105,4,109,1296,57,1353
WEST BENGAL,2013,GAMBLING ACT,0,0,0,30,2,32,28,1,29,14,0,14,72,3,75
WEST BENGAL,2013,EXCISE ACT,0,0,0,47,1,48,43,0,43,13,1,14,103,2,105
WEST BENGAL,2013,PROHIBITION ACT,0,0,0,9,0,9,0,0,0,0,0,0,9,0,9
WEST BENGAL,2013,EXPLOSIVE & EXPLOSIVE SUBST. ACT,0,0,0,22,0,22,19,0,19,3,0,3,44,0,44
WEST BENGAL,2013,TERRORIST & DISRUPTIVE ACTIVITIES (TATA),0,0,0,0,1,1,7,0,7,5,0,5,12,1,13
WEST BENGAL,2013,IMMORAL TRAFFIC (PREVENTION) ACT,0,0,0,10,0,10,14,11,25,0,5,5,24,16,40
WEST BENGAL,2013,INDIAN RAILWAYS ACT,0,0,0,39,0,39,46,0,46,13,0,13,98,0,98
WEST BENGAL,2013,REGISTRATION OF FOREIGNERS ACT,0,0,0,751,117,868,361,90,451,90,26,116,1202,233,1435
WEST BENGAL,2013,PROTECTION OF CIVIL RIGHTS ACT,0,0,0,0,0,0,0,0,0,0,0,0,0,0,0
WEST BENGAL,2013,SC/ST (PREVENTION OF ATROCITIES) ACT,0,0,0,4,0,4,3,0,3,0,0,0,7,0,7
WEST BENGAL,2013,INDIAN PASSPORT ACT,0,0,0,111,0,111,43,0,43,10,0,10,164,0,164
WEST BENGAL,2013,ESSENTIAL COMMODITIES ACT,0,0,0,0,0,0,1,0,1,1,1,2,2,1,3
WEST BENGAL,2013,ANTIQUITIES AND ART TREASURE ACT,0,0,0,0,0,0,0,0,0,0,0,0,0,0,0
WEST BENGAL,2013,DOWRY PROHIBITION ACT,0,0,0,31,2,33,61,10,71,7,6,13,99,18,117
WEST BENGAL,2013,FOREIGN EXCHANGE REGULATION ACT-1973,0,0,0,0,0,0,0,0,0,0,0,0,0,0,0
WEST BENGAL,2013,PREVENTION OF CORRUPTION ACT-1988,0,0,0,0,0,0,0,0,0,0,0,0,0,0,0
WEST BENGAL,2013,CONSER.OF FORGN.EXCH.&PREV. OF SMUG.ACT,0,0,0,0,0,0,3,0,3,0,0,0,3,0,3
WEST BENGAL,2013,OTHER SLL OFFENCE,0,0,0,155,9,164,74,5,79,9,1,10,238,15,253
WEST BENGAL,2013,TOTAL (B),0,0,0,2266,149,2415,1535,155,1690,310,44,354,4111,348,4459
WEST BENGAL,2013,(C) CIVIL AND OTHER CASES,0,0,0,0,0,0,0,0,0,0,0,0,0,0,0
WEST BENGAL,2013,TOTAL (A + B + C),0,0,0,7818,408,8226,6171,419,6590,1504,151,1655,15493,978,16471
A & N ISLANDS,2013,ARMS ACT,0,0,0,0,0,0,0,0,0,0,0,0,0,0,0
A & N ISLANDS,2013,N.D.P.S. ACT,0,0,0,0,0,0,0,0,0,0,0,0,0,0,0
A & N ISLANDS,2013,GAMBLING ACT,0,0,0,0,0,0,0,0,0,0,0,0,0,0,0
A & N ISLANDS,2013,EXCISE ACT,0,0,0,0,0,0,0,0,0,0,0,0,0,0,0
A & N ISLANDS,2013,PROHIBITION ACT,0,0,0,0,0,0,0,0,0,0,0,0,0,0,0
A & N ISLANDS,2013,EXPLOSIVE & EXPLOSIVE SUBST. ACT,0,0,0,0,0,0,0,0,0,0,0,0,0,0,0
A & N ISLANDS,2013,TERRORIST & DISRUPTIVE ACTIVITIES (TATA),0,0,0,0,0,0,0,0,0,0,0,0,0,0,0
A & N ISLANDS,2013,IMMORAL TRAFFIC (PREVENTION) ACT,0,0,0,0,0,0,0,0,0,0,0,0,0,0,0
A & N ISLANDS,2013,INDIAN RAILWAYS ACT,0,0,0,0,0,0,0,0,0,0,0,0,0,0,0
A & N ISLANDS,2013,REGISTRATION OF FOREIGNERS ACT,0,0,0,41,0,41,57,1,58,11,0,11,109,1,110
A & N ISLANDS,2013,PROTECTION OF CIVIL RIGHTS ACT,0,0,0,0,0,0,0,0,0,0,0,0,0,0,0
A & N ISLANDS,2013,SC/ST (PREVENTION OF ATROCITIES) ACT,0,0,0,0,0,0,0,0,0,0,0,0,0,0,0
A & N ISLANDS,2013,INDIAN PASSPORT ACT,0,0,0,0,0,0,0,0,0,0,0,0,0,0,0
A & N ISLANDS,2013,ESSENTIAL COMMODITIES ACT,0,0,0,0,0,0,0,0,0,0,0,0,0,0,0
A & N ISLANDS,2013,ANTIQUITIES AND ART TREASURE ACT,0,0,0,0,0,0,0,0,0,0,0,0,0,0,0
A & N ISLANDS,2013,DOWRY PROHIBITION ACT,0,0,0,0,0,0,0,0,0,0,0,0,0,0,0
A & N ISLANDS,2013,FOREIGN EXCHANGE REGULATION ACT-1973,0,0,0,0,0,0,0,0,0,0,0,0,0,0,0
A & N ISLANDS,2013,PREVENTION OF CORRUPTION ACT-1988,0,0,0,0,0,0,0,0,0,0,0,0,0,0,0
A & N ISLANDS,2013,CONSER.OF FORGN.EXCH.&PREV. OF SMUG.ACT,0,0,0,0,0,0,0,0,0,0,0,0,0,0,0
A & N ISLANDS,2013,OTHER SLL OFFENCE,0,0,0,0,0,0,0,0,0,0,0,0,0,0,0
A & N ISLANDS,2013,TOTAL (B),0,0,0,41,0,41,57,1,58,11,0,11,109,1,110
A & N ISLANDS,2013,(C) CIVIL AND OTHER CASES,0,0,0,0,0,0,0,0,0,0,0,0,0,0,0
A & N ISLANDS,2013,TOTAL (A + B + C),0,0,0,82,6,88,83,1,84,21,0,21,186,7,193
CHANDIGARH,2013,ARMS ACT,0,0,0,4,0,4,2,0,2,2,0,2,8,0,8
CHANDIGARH,2013,N.D.P.S. ACT,0,0,0,20,0,20,17,0,17,9,0,9,46,0,46
CHANDIGARH,2013,GAMBLING ACT,0,0,0,0,0,0,0,0,0,0,0,0,0,0,0
CHANDIGARH,2013,EXCISE ACT,0,0,0,0,0,0,1,0,1,0,0,0,1,0,1
CHANDIGARH,2013,PROHIBITION ACT,0,0,0,0,0,0,0,0,0,0,0,0,0,0,0
CHANDIGARH,2013,EXPLOSIVE & EXPLOSIVE SUBST. ACT,0,0,0,0,0,0,0,0,0,0,0,0,0,0,0
CHANDIGARH,2013,TERRORIST & DISRUPTIVE ACTIVITIES (TATA),0,0,0,0,0,0,0,0,0,0,0,0,0,0,0
CHANDIGARH,2013,IMMORAL TRAFFIC (PREVENTION) ACT,0,0,0,1,0,1,0,0,0,0,0,0,1,0,1
CHANDIGARH,2013,INDIAN RAILWAYS ACT,0,0,0,0,0,0,0,0,0,0,0,0,0,0,0
CHANDIGARH,2013,REGISTRATION OF FOREIGNERS ACT,0,0,0,0,0,0,0,0,0,0,0,0,0,0,0
CHANDIGARH,2013,PROTECTION OF CIVIL RIGHTS ACT,0,0,0,0,0,0,0,0,0,0,0,0,0,0,0
CHANDIGARH,2013,SC/ST (PREVENTION OF ATROCITIES) ACT,0,0,0,0,0,0,0,0,0,0,0,0,0,0,0
CHANDIGARH,2013,INDIAN PASSPORT ACT,0,0,0,0,0,0,0,0,0,0,0,0,0,0,0
CHANDIGARH,2013,ESSENTIAL COMMODITIES ACT,0,0,0,0,0,0,1,0,1,0,0,0,1,0,1
CHANDIGARH,2013,ANTIQUITIES AND ART TREASURE ACT,0,0,0,0,0,0,0,0,0,0,0,0,0,0,0
CHANDIGARH,2013,DOWRY PROHIBITION ACT,0,0,0,0,0,0,0,0,0,0,0,0,0,0,0
CHANDIGARH,2013,FOREIGN EXCHANGE REGULATION ACT-1973,0,0,0,0,0,0,0,0,0,0,0,0,0,0,0
CHANDIGARH,2013,PREVENTION OF CORRUPTION ACT-1988,0,0,0,0,0,0,2,0,2,0,0,0,2,0,2
CHANDIGARH,2013,CONSER.OF FORGN.EXCH.&PREV. OF SMUG.ACT,0,0,0,0,0,0,0,0,0,0,0,0,0,0,0
CHANDIGARH,2013,OTHER SLL OFFENCE,0,0,0,0,0,0,0,0,0,0,0,0,0,0,0
CHANDIGARH,2013,TOTAL (B),0,0,0,25,0,25,23,0,23,11,0,11,59,0,59
CHANDIGARH,2013,(C) CIVIL AND OTHER CASES,0,0,0,0,0,0,0,0,0,0,0,0,0,0,0
CHANDIGARH,2013,TOTAL (A + B + C),0,0,0,150,6,156,128,3,131,101,3,104,379,12,391
D & N HAVELI,2013,ARMS ACT,0,0,0,0,0,0,0,0,0,0,0,0,0,0,0
D & N HAVELI,2013,N.D.P.S. ACT,0,0,0,0,0,0,0,0,0,0,0,0,0,0,0
D & N HAVELI,2013,GAMBLING ACT,0,0,0,0,0,0,0,0,0,0,0,0,0,0,0
D & N HAVELI,2013,EXCISE ACT,0,0,0,0,0,0,0,0,0,0,0,0,0,0,0
D & N HAVELI,2013,PROHIBITION ACT,0,0,0,0,0,0,0,0,0,0,0,0,0,0,0
D & N HAVELI,2013,EXPLOSIVE & EXPLOSIVE SUBST. ACT,0,0,0,0,0,0,0,0,0,0,0,0,0,0,0
D & N HAVELI,2013,TERRORIST & DISRUPTIVE ACTIVITIES (TATA),0,0,0,0,0,0,0,0,0,0,0,0,0,0,0
D & N HAVELI,2013,IMMORAL TRAFFIC (PREVENTION) ACT,0,0,0,0,0,0,2,0,2,0,0,0,2,0,2
D & N HAVELI,2013,INDIAN RAILWAYS ACT,0,0,0,0,0,0,0,0,0,0,0,0,0,0,0
D & N HAVELI,2013,REGISTRATION OF FOREIGNERS ACT,0,0,0,0,0,0,0,0,0,0,0,0,0,0,0
D & N HAVELI,2013,PROTECTION OF CIVIL RIGHTS ACT,0,0,0,0,0,0,0,0,0,0,0,0,0,0,0
D & N HAVELI,2013,SC/ST (PREVENTION OF ATROCITIES) ACT,0,0,0,0,0,0,0,0,0,0,0,0,0,0,0
D & N HAVELI,2013,INDIAN PASSPORT ACT,0,0,0,0,0,0,0,0,0,0,0,0,0,0,0
D & N HAVELI,2013,ESSENTIAL COMMODITIES ACT,0,0,0,0,0,0,0,0,0,0,0,0,0,0,0
D & N HAVELI,2013,ANTIQUITIES AND ART TREASURE ACT,0,0,0,0,0,0,0,0,0,0,0,0,0,0,0
D & N HAVELI,2013,DOWRY PROHIBITION ACT,0,0,0,0,0,0,0,0,0,0,0,0,0,0,0
D & N HAVELI,2013,FOREIGN EXCHANGE REGULATION ACT-1973,0,0,0,0,0,0,0,0,0,0,0,0,0,0,0
D & N HAVELI,2013,PREVENTION OF CORRUPTION ACT-1988,0,0,0,0,0,0,0,0,0,0,0,0,0,0,0
D & N HAVELI,2013,CONSER.OF FORGN.EXCH.&PREV. OF SMUG.ACT,0,0,0,0,0,0,0,0,0,0,0,0,0,0,0
D & N HAVELI,2013,OTHER SLL OFFENCE,0,0,0,0,0,0,0,0,0,0,0,0,0,0,0
D & N HAVELI,2013,TOTAL (B),0,0,0,0,0,0,2,0,2,0,0,0,2,0,2
D & N HAVELI,2013,(C) CIVIL AND OTHER CASES,0,0,0,0,0,0,0,0,0,0,0,0,0,0,0
D & N HAVELI,2013,TOTAL (A + B + C),0,0,0,21,0,21,12,0,12,2,0,2,35,0,35
DAMAN & DIU,2013,ARMS ACT,0,0,0,0,0,0,0,0,0,0,0,0,0,0,0
DAMAN & DIU,2013,N.D.P.S. ACT,0,0,0,0,0,0,0,0,0,0,0,0,0,0,0
DAMAN & DIU,2013,GAMBLING ACT,0,0,0,0,0,0,0,0,0,0,0,0,0,0,0
DAMAN & DIU,2013,EXCISE ACT,0,0,0,0,0,0,0,0,0,0,0,0,0,0,0
DAMAN & DIU,2013,PROHIBITION ACT,0,0,0,0,0,0,0,0,0,0,0,0,0,0,0
DAMAN & DIU,2013,EXPLOSIVE & EXPLOSIVE SUBST. ACT,0,0,0,0,0,0,0,0,0,0,0,0,0,0,0
DAMAN & DIU,2013,TERRORIST & DISRUPTIVE ACTIVITIES (TATA),0,0,0,0,0,0,0,0,0,0,0,0,0,0,0
DAMAN & DIU,2013,IMMORAL TRAFFIC (PREVENTION) ACT,0,0,0,0,0,0,0,0,0,0,0,0,0,0,0
DAMAN & DIU,2013,INDIAN RAILWAYS ACT,0,0,0,0,0,0,0,0,0,0,0,0,0,0,0
DAMAN & DIU,2013,REGISTRATION OF FOREIGNERS ACT,0,0,0,0,0,0,0,0,0,0,0,0,0,0,0
DAMAN & DIU,2013,PROTECTION OF CIVIL RIGHTS ACT,0,0,0,0,0,0,0,0,0,0,0,0,0,0,0
DAMAN & DIU,2013,SC/ST (PREVENTION OF ATROCITIES) ACT,0,0,0,0,0,0,0,0,0,0,0,0,0,0,0
DAMAN & DIU,2013,INDIAN PASSPORT ACT,0,0,0,0,0,0,0,0,0,0,0,0,0,0,0
DAMAN & DIU,2013,ESSENTIAL COMMODITIES ACT,0,0,0,0,0,0,0,0,0,0,0,0,0,0,0
DAMAN & DIU,2013,ANTIQUITIES AND ART TREASURE ACT,0,0,0,0,0,0,0,0,0,0,0,0,0,0,0
DAMAN & DIU,2013,DOWRY PROHIBITION ACT,0,0,0,0,0,0,0,0,0,0,0,0,0,0,0
DAMAN & DIU,2013,FOREIGN EXCHANGE REGULATION ACT-1973,0,0,0,0,0,0,0,0,0,0,0,0,0,0,0
DAMAN & DIU,2013,PREVENTION OF CORRUPTION ACT-1988,0,0,0,0,0,0,0,0,0,0,0,0,0,0,0
DAMAN & DIU,2013,CONSER.OF FORGN.EXCH.&PREV. OF SMUG.ACT,0,0,0,0,0,0,0,0,0,0,0,0,0,0,0
DAMAN & DIU,2013,OTHER SLL OFFENCE,0,0,0,0,0,0,0,0,0,0,0,0,0,0,0
DAMAN & DIU,2013,TOTAL (B),0,0,0,0,0,0,0,0,0,0,0,0,0,0,0
DAMAN & DIU,2013,(C) CIVIL AND OTHER CASES,0,0,0,0,0,0,0,0,0,0,0,0,0,0,0
DAMAN & DIU,2013,TOTAL (A + B + C),0,0,0,23,0,23,14,0,14,1,0,1,38,0,38
DELHI,2013,ARMS ACT,0,0,0,198,0,198,120,0,120,6,0,6,324,0,324
DELHI,2013,N.D.P.S. ACT,0,0,0,374,24,398,201,37,238,31,8,39,606,69,675
DELHI,2013,GAMBLING ACT,0,0,0,2,0,2,3,0,3,0,0,0,5,0,5
DELHI,2013,EXCISE ACT,0,0,0,56,0,56,53,4,57,9,6,15,118,10,128
DELHI,2013,PROHIBITION ACT,0,0,0,1,0,1,3,0,3,2,0,2,6,0,6
DELHI,2013,EXPLOSIVE & EXPLOSIVE SUBST. ACT,0,0,0,13,0,13,21,0,21,3,0,3,37,0,37
DELHI,2013,TERRORIST & DISRUPTIVE ACTIVITIES (TATA),0,0,0,0,0,0,0,0,0,0,0,0,0,0,0
DELHI,2013,IMMORAL TRAFFIC (PREVENTION) ACT,0,0,0,2,10,12,1,0,1,0,0,0,3,10,13
DELHI,2013,INDIAN RAILWAYS ACT,0,0,0,39,0,39,35,0,35,2,0,2,76,0,76
DELHI,2013,REGISTRATION OF FOREIGNERS ACT,0,0,0,4,2,6,1,0,1,0,0,0,5,2,7
DELHI,2013,PROTECTION OF CIVIL RIGHTS ACT,0,0,0,0,0,0,0,0,0,0,0,0,0,0,0
DELHI,2013,SC/ST (PREVENTION OF ATROCITIES) ACT,0,0,0,1,0,1,1,0,1,0,0,0,2,0,2
DELHI,2013,INDIAN PASSPORT ACT,0,0,0,4,0,4,3,0,3,0,0,0,7,0,7
DELHI,2013,ESSENTIAL COMMODITIES ACT,0,0,0,0,0,0,0,0,0,0,0,0,0,0,0
DELHI,2013,ANTIQUITIES AND ART TREASURE ACT,0,0,0,0,0,0,0,0,0,0,0,0,0,0,0
DELHI,2013,DOWRY PROHIBITION ACT,0,0,0,90,0,90,25,3,28,7,3,10,122,6,128
DELHI,2013,FOREIGN EXCHANGE REGULATION ACT-1973,0,0,0,0,0,0,0,0,0,0,0,0,0,0,0
DELHI,2013,PREVENTION OF CORRUPTION ACT-1988,0,0,0,7,0,7,7,5,12,5,5,10,19,10,29
DELHI,2013,CONSER.OF FORGN.EXCH.&PREV. OF SMUG.ACT,0,0,0,0,0,0,0,0,0,0,0,0,0,0,0
DELHI,2013,OTHER SLL OFFENCE,0,0,0,30,2,32,39,5,44,9,1,10,78,8,86
DELHI,2013,TOTAL (B),0,0,0,821,38,859,513,54,567,74,23,97,1408,115,1523
DELHI,2013,(C) CIVIL AND OTHER CASES,0,0,0,0,0,0,0,0,0,0,0,0,0,0,0
DELHI,2013,TOTAL (A + B + C),0,0,0,6317,169,6486,2922,233,3155,441,72,513,9680,474,10154
LAKSHADWEEP,2013,ARMS ACT,0,0,0,0,0,0,0,0,0,0,0,0,0,0,0
LAKSHADWEEP,2013,N.D.P.S. ACT,0,0,0,0,0,0,0,0,0,0,0,0,0,0,0
LAKSHADWEEP,2013,GAMBLING ACT,0,0,0,0,0,0,0,0,0,0,0,0,0,0,0
LAKSHADWEEP,2013,EXCISE ACT,0,0,0,0,0,0,0,0,0,0,0,0,0,0,0
LAKSHADWEEP,2013,PROHIBITION ACT,0,0,0,0,0,0,0,0,0,0,0,0,0,0,0
LAKSHADWEEP,2013,EXPLOSIVE & EXPLOSIVE SUBST. ACT,0,0,0,0,0,0,0,0,0,0,0,0,0,0,0
LAKSHADWEEP,2013,TERRORIST & DISRUPTIVE ACTIVITIES (TATA),0,0,0,0,0,0,0,0,0,0,0,0,0,0,0
LAKSHADWEEP,2013,IMMORAL TRAFFIC (PREVENTION) ACT,0,0,0,0,0,0,0,0,0,0,0,0,0,0,0
LAKSHADWEEP,2013,INDIAN RAILWAYS ACT,0,0,0,0,0,0,0,0,0,0,0,0,0,0,0
LAKSHADWEEP,2013,REGISTRATION OF FOREIGNERS ACT,0,0,0,0,0,0,0,0,0,0,0,0,0,0,0
LAKSHADWEEP,2013,PROTECTION OF CIVIL RIGHTS ACT,0,0,0,0,0,0,0,0,0,0,0,0,0,0,0
LAKSHADWEEP,2013,SC/ST (PREVENTION OF ATROCITIES) ACT,0,0,0,0,0,0,0,0,0,0,0,0,0,0,0
LAKSHADWEEP,2013,INDIAN PASSPORT ACT,0,0,0,0,0,0,0,0,0,0,0,0,0,0,0
LAKSHADWEEP,2013,ESSENTIAL COMMODITIES ACT,0,0,0,0,0,0,0,0,0,0,0,0,0,0,0
LAKSHADWEEP,2013,ANTIQUITIES AND ART TREASURE ACT,0,0,0,0,0,0,0,0,0,0,0,0,0,0,0
LAKSHADWEEP,2013,DOWRY PROHIBITION ACT,0,0,0,0,0,0,0,0,0,0,0,0,0,0,0
LAKSHADWEEP,2013,FOREIGN EXCHANGE REGULATION ACT-1973,0,0,0,0,0,0,0,0,0,0,0,0,0,0,0
LAKSHADWEEP,2013,PREVENTION OF CORRUPTION ACT-1988,0,0,0,0,0,0,0,0,0,0,0,0,0,0,0
LAKSHADWEEP,2013,CONSER.OF FORGN.EXCH.&PREV. OF SMUG.ACT,0,0,0,0,0,0,0,0,0,0,0,0,0,0,0
LAKSHADWEEP,2013,OTHER SLL OFFENCE,0,0,0,0,0,0,0,0,0,0,0,0,0,0,0
LAKSHADWEEP,2013,TOTAL (B),0,0,0,0,0,0,0,0,0,0,0,0,0,0,0
LAKSHADWEEP,2013,(C) CIVIL AND OTHER CASES,0,0,0,0,0,0,0,0,0,0,0,0,0,0,0
LAKSHADWEEP,2013,TOTAL (A + B + C),0,0,0,0,0,0,0,0,0,0,0,0,0,0,0
PONDICHERRY,2013,ARMS ACT,0,0,0,9,0,9,5,0,5,0,0,0,14,0,14
PONDICHERRY,2013,N.D.P.S. ACT,0,0,0,0,0,0,0,0,0,0,0,0,0,0,0
PONDICHERRY,2013,GAMBLING ACT,0,0,0,0,0,0,0,0,0,0,0,0,0,0,0
PONDICHERRY,2013,EXCISE ACT,0,0,0,0,0,0,0,0,0,0,0,0,0,0,0
PONDICHERRY,2013,PROHIBITION ACT,0,0,0,0,0,0,0,0,0,0,0,0,0,0,0
PONDICHERRY,2013,EXPLOSIVE & EXPLOSIVE SUBST. ACT,0,0,0,3,0,3,1,0,1,0,0,0,4,0,4
PONDICHERRY,2013,TERRORIST & DISRUPTIVE ACTIVITIES (TATA),0,0,0,0,0,0,0,0,0,0,0,0,0,0,0
PONDICHERRY,2013,IMMORAL TRAFFIC (PREVENTION) ACT,0,0,0,0,0,0,0,0,0,0,0,0,0,0,0
PONDICHERRY,2013,INDIAN RAILWAYS ACT,0,0,0,0,0,0,1,0,1,0,0,0,1,0,1
PONDICHERRY,2013,REGISTRATION OF FOREIGNERS ACT,0,0,0,0,0,0,0,0,0,0,0,0,0,0,0
PONDICHERRY,2013,PROTECTION OF CIVIL RIGHTS ACT,0,0,0,0,0,0,0,0,0,0,0,0,0,0,0
PONDICHERRY,2013,SC/ST (PREVENTION OF ATROCITIES) ACT,0,0,0,0,0,0,0,0,0,0,0,0,0,0,0
PONDICHERRY,2013,INDIAN PASSPORT ACT,0,0,0,0,0,0,0,0,0,0,0,0,0,0,0
PONDICHERRY,2013,ESSENTIAL COMMODITIES ACT,0,0,0,0,0,0,0,0,0,0,0,0,0,0,0
PONDICHERRY,2013,ANTIQUITIES AND ART TREASURE ACT,0,0,0,0,0,0,0,0,0,0,0,0,0,0,0
PONDICHERRY,2013,DOWRY PROHIBITION ACT,0,0,0,0,0,0,0,0,0,0,0,0,0,0,0
PONDICHERRY,2013,FOREIGN EXCHANGE REGULATION ACT-1973,0,0,0,0,0,0,0,0,0,0,0,0,0,0,0
PONDICHERRY,2013,PREVENTION OF CORRUPTION ACT-1988,0,0,0,0,0,0,0,0,0,0,0,0,0,0,0
PONDICHERRY,2013,CONSER.OF FORGN.EXCH.&PREV. OF SMUG.ACT,0,0,0,0,0,0,0,0,0,0,0,0,0,0,0
PONDICHERRY,2013,OTHER SLL OFFENCE,0,0,0,0,0,0,0,0,0,0,0,0,0,0,0
PONDICHERRY,2013,TOTAL (B),0,0,0,12,0,12,7,0,7,0,0,0,19,0,19
PONDICHERRY,2013,(C) CIVIL AND OTHER CASES,0,0,0,0,0,0,0,0,0,0,0,0,0,0,0
PONDICHERRY,2013,TOTAL (A + B + C),0,0,0,119,0,119,54,4,58,11,1,12,184,5,189
