STATE/UT,YEAR,CRIME HEAD,Male 16-18 years,Female 16-18 years,Total 16-18 years,Male 18-30 years,Female 18-30 years,Total 18-30 years,Male 30-50 years,Female 30-50 years,Total 30-50 years,Male Above 50 years,Female Above 50 years,Total Above 50 years,Total Male,Total Female,Grand Total
Andhra Pradesh,2001,Murder,1,0,1,688,21,709,1221,29,1250,249,10,259,2159,60,2219
Andhra Pradesh,2001,Attempt To Commit Murder,0,0,0,38,0,38,71,0,71,12,0,12,121,0,121
Andhra Pradesh,2001,C.H. Not Amounting To Murder,0,0,0,78,1,79,121,3,124,23,0,23,222,4,226
Andhra Pradesh,2001,Rape,0,0,0,97,0,97,64,0,64,5,0,5,166,0,166
Andhra Pradesh,2001,Kidnapping And Abduction,0,0,0,9,0,9,5,2,7,0,1,1,14,3,17
Andhra Pradesh,2001,Dacoity,1,0,1,85,0,85,90,0,90,14,0,14,190,0,190
Andhra Pradesh,2001,Prep. And Assembly For Dacoity,0,0,0,11,0,11,5,0,5,0,0,0,16,0,16
Andhra Pradesh,2001,Robbery,0,0,0,40,0,40,22,0,22,3,0,3,65,0,65
Andhra Pradesh,2001,Burglary,1,0,1,25,0,25,9,0,9,3,0,3,38,0,38
Andhra Pradesh,2001,Thefts,1,0,1,185,0,185,80,0,80,18,0,18,284,0,284
Andhra Pradesh,2001,Extortion,0,0,0,1,0,1,0,0,0,0,0,0,1,0,1
Andhra Pradesh,2001,Riots,0,0,0,0,0,0,6,0,6,4,0,4,10,0,10
Andhra Pradesh,2001,Arson,0,0,0,2,0,2,2,0,2,0,0,0,4,0,4
Andhra Pradesh,2001,Criminal Breach Of Trust,0,0,0,1,0,1,5,0,5,1,0,1,7,0,7
Andhra Pradesh,2001,Cheating,0,0,0,16,0,16,6,0,6,1,1,2,23,1,24
Andhra Pradesh,2001,Counter Feiting,0,0,0,0,0,0,0,0,0,0,0,0,0,0,0
Andhra Pradesh,2001,Dowry Deaths,0,0,0,23,0,23,13,1,14,0,9,9,36,10,46
Andhra Pradesh,2001,Molestation,0,0,0,7,0,7,16,0,16,0,0,0,23,0,23
Andhra Pradesh,2001,Eve-Teasing,0,0,0,2,0,2,0,0,0,0,0,0,2,0,2
Andhra Pradesh,2001,Cruelty By Husband Or Relative Of Husband,0,0,0,13,0,13,9,0,9,3,0,3,25,0,25
Andhra Pradesh,2001,Other Ipc Crimes,1,0,1,184,4,188,154,4,158,8,1,9,347,9,356
Andhra Pradesh,2002,Murder,0,0,0,897,27,924,1269,38,1307,229,18,247,2395,83,2478
Andhra Pradesh,2002,Attempt To Commit Murder,0,0,0,40,0,40,41,1,42,8,0,8,89,1,90
Andhra Pradesh,2002,C.H. Not Amounting To Murder,0,0,0,103,1,104,135,1,136,33,4,37,271,6,277
Andhra Pradesh,2002,Rape,0,0,0,99,0,99,64,0,64,23,0,23,186,0,186
Andhra Pradesh,2002,Kidnapping And Abduction,0,0,0,24,0,24,7,2,9,2,1,3,33,3,36
Andhra Pradesh,2002,Dacoity,0,0,0,88,0,88,85,1,86,10,0,10,183,1,184
Andhra Pradesh,2002,Prep. And Assembly For Dacoity,0,0,0,7,0,7,7,1,8,2,0,2,16,1,17
Andhra Pradesh,2002,Robbery,0,0,0,73,0,73,53,0,53,3,0,3,129,0,129
Andhra Pradesh,2002,Burglary,1,0,1,46,0,46,32,0,32,13,0,13,92,0,92
Andhra Pradesh,2002,Thefts,2,0,2,231,2,233,117,1,118,17,0,17,367,3,370
Andhra Pradesh,2002,Extortion,0,0,0,24,0,24,9,0,9,0,0,0,33,0,33
Andhra Pradesh,2002,Riots,0,0,0,4,1,5,0,2,2,0,0,0,4,3,7
Andhra Pradesh,2002,Arson,0,0,0,0,0,0,3,0,3,0,0,0,3,0,3
Andhra Pradesh,2002,Criminal Breach Of Trust,0,0,0,0,0,0,3,0,3,1,0,1,4,0,4
Andhra Pradesh,2002,Cheating,0,0,0,11,1,12,17,1,18,12,0,12,40,2,42
Andhra Pradesh,2002,Counter Feiting,0,0,0,0,0,0,4,0,4,1,0,1,5,0,5
Andhra Pradesh,2002,Dowry Deaths,0,0,0,19,1,20,19,2,21,6,3,9,44,6,50
Andhra Pradesh,2002,Molestation,0,0,0,19,0,19,41,0,41,2,0,2,62,0,62
Andhra Pradesh,2002,Eve-Teasing,0,0,0,1,0,1,0,0,0,0,0,0,1,0,1
Andhra Pradesh,2002,Cruelty By Husband Or Relative Of Husband,0,0,0,43,2,45,40,2,42,6,5,11,89,9,98
Andhra Pradesh,2002,Other Ipc Crimes,0,0,0,130,0,130,126,3,129,14,1,15,270,4,274
Andhra Pradesh,2003,Murder,0,0,0,902,28,930,1272,38,1310,285,19,304,2459,85,2544
Andhra Pradesh,2003,Attempt To Commit Murder,0,0,0,42,1,43,44,2,46,9,0,9,95,3,98
Andhra Pradesh,2003,C.H. Not Amounting To Murder,0,0,0,105,0,105,144,1,145,34,5,39,283,6,289
Andhra Pradesh,2003,Rape,0,0,0,82,0,82,65,0,65,44,0,44,191,0,191
Andhra Pradesh,2003,Kidnapping And Abduction,0,0,0,26,1,27,8,0,8,3,0,3,37,1,38
Andhra Pradesh,2003,Dacoity,0,0,0,75,0,75,102,0,102,13,0,13,190,0,190
Andhra Pradesh,2003,Prep. And Assembly For Dacoity,0,0,0,9,0,9,18,0,18,2,0,2,29,0,29
Andhra Pradesh,2003,Robbery,0,0,0,78,0,78,57,0,57,26,0,26,161,0,161
Andhra Pradesh,2003,Burglary,0,0,0,48,0,48,34,0,34,25,0,25,107,0,107
Andhra Pradesh,2003,Thefts,0,0,0,222,12,234,120,3,123,16,0,16,358,15,373
Andhra Pradesh,2003,Extortion,0,0,0,23,0,23,18,0,18,2,0,2,43,0,43
Andhra Pradesh,2003,Riots,0,0,0,14,2,16,2,2,4,0,0,0,16,4,20
Andhra Pradesh,2003,Arson,0,0,0,0,0,0,3,0,3,1,0,1,4,0,4
Andhra Pradesh,2003,Criminal Breach Of Trust,0,0,0,0,0,0,2,0,2,2,1,3,4,1,5
Andhra Pradesh,2003,Cheating,0,0,0,12,1,13,28,2,30,9,2,11,49,5,54
Andhra Pradesh,2003,Counter Feiting,0,0,0,0,0,0,5,0,5,2,0,2,7,0,7
Andhra Pradesh,2003,Dowry Deaths,0,0,0,21,2,23,21,1,22,5,4,9,47,7,54
Andhra Pradesh,2003,Molestation,0,0,0,20,0,20,18,2,20,5,0,5,43,2,45
Andhra Pradesh,2003,Eve-Teasing,0,0,0,2,0,2,0,0,0,0,0,0,2,0,2
Andhra Pradesh,2003,Cruelty By Husband Or Relative Of Husband,0,0,0,24,3,27,46,2,48,7,8,15,77,13,90
Andhra Pradesh,2003,Other Ipc Crimes,0,0,0,93,3,96,129,1,130,36,2,38,258,6,264
Andhra Pradesh,2004,Murder,0,0,0,953,25,978,1453,64,1517,181,30,211,2587,119,2706
Andhra Pradesh,2004,Attempt To Commit Murder,0,0,0,43,0,43,73,0,73,26,0,26,142,0,142
Andhra Pradesh,2004,C.H. Not Amounting To Murder,0,0,0,33,0,33,74,3,77,24,0,24,131,3,134
Andhra Pradesh,2004,Rape,0,0,0,89,1,90,89,0,89,21,0,21,199,1,200
Andhra Pradesh,2004,Kidnapping And Abduction,0,0,0,21,2,23,21,4,25,1,0,1,43,6,49
Andhra Pradesh,2004,Dacoity,0,0,0,75,0,75,71,0,71,16,0,16,162,0,162
Andhra Pradesh,2004,Prep. And Assembly For Dacoity,0,0,0,9,0,9,3,0,3,1,0,1,13,0,13
Andhra Pradesh,2004,Robbery,0,0,0,33,0,33,38,0,38,12,0,12,83,0,83
Andhra Pradesh,2004,Burglary,0,0,0,32,0,32,14,0,14,4,0,4,50,0,50
Andhra Pradesh,2004,Thefts,0,0,0,143,5,148,119,2,121,25,0,25,287,7,294
Andhra Pradesh,2004,Extortion,0,0,0,2,0,2,1,0,1,0,0,0,3,0,3
Andhra Pradesh,2004,Riots,0,0,0,7,0,7,3,0,3,0,1,1,10,1,11
Andhra Pradesh,2004,Arson,0,0,0,3,0,3,1,0,1,1,0,1,5,0,5
Andhra Pradesh,2004,Criminal Breach Of Trust,0,0,0,0,0,0,2,0,2,0,0,0,2,0,2
Andhra Pradesh,2004,Cheating,0,0,0,8,0,8,20,4,24,4,0,4,32,4,36
Andhra Pradesh,2004,Counter Feiting,0,0,0,4,0,4,3,1,4,0,0,0,7,1,8
Andhra Pradesh,2004,Dowry Deaths,0,0,0,23,4,27,42,1,43,6,8,14,71,13,84
Andhra Pradesh,2004,Molestation,0,0,0,33,0,33,46,0,46,5,0,5,84,0,84
Andhra Pradesh,2004,Eve-Teasing,0,0,0,1,0,1,1,0,1,0,0,0,2,0,2
Andhra Pradesh,2004,Cruelty By Husband Or Relative Of Husband,0,0,0,36,0,36,37,0,37,7,0,7,80,0,80
Andhra Pradesh,2004,Other Ipc Crimes,0,0,0,55,1,56,60,7,67,14,1,15,129,9,138
Andhra Pradesh,2005,Murder,0,0,0,817,8,825,1796,66,1862,252,18,270,2865,92,2957
Andhra Pradesh,2005,Attempt To Commit Murder,0,0,0,61,0,61,114,3,117,22,0,22,197,3,200
Andhra Pradesh,2005,C.H. Not Amounting To Murder,0,0,0,30,0,30,58,0,58,9,0,9,97,0,97
Andhra Pradesh,2005,Rape,0,0,0,71,1,72,82,4,86,7,0,7,160,5,165
Andhra Pradesh,2005,Kidnapping And Abduction,0,0,0,16,0,16,18,1,19,1,0,1,35,1,36
Andhra Pradesh,2005,Dacoity,0,0,0,53,0,53,63,0,63,12,0,12,128,0,128
Andhra Pradesh,2005,Prep. And Assembly For Dacoity,0,0,0,4,0,4,4,0,4,0,0,0,8,0,8
Andhra Pradesh,2005,Robbery,0,0,0,59,0,59,41,0,41,4,0,4,104,0,104
Andhra Pradesh,2005,Burglary,2,0,2,38,0,38,16,0,16,2,0,2,58,0,58
Andhra Pradesh,2005,Thefts,0,0,0,223,10,233,126,5,131,10,0,10,359,15,374
Andhra Pradesh,2005,Extortion,0,0,0,3,0,3,2,0,2,0,0,0,5,0,5
Andhra Pradesh,2005,Riots,0,0,0,0,0,0,1,0,1,0,0,0,1,0,1
Andhra Pradesh,2005,Arson,0,0,0,0,0,0,2,0,2,0,0,0,2,0,2
Andhra Pradesh,2005,Criminal Breach Of Trust,0,0,0,1,0,1,1,0,1,0,0,0,2,0,2
Andhra Pradesh,2005,Cheating,0,0,0,6,0,6,16,3,19,3,0,3,25,3,28
Andhra Pradesh,2005,Counter Feiting,0,0,0,0,0,0,0,0,0,0,0,0,0,0,0
Andhra Pradesh,2005,Dowry Deaths,0,0,0,19,2,21,35,3,38,9,10,19,63,15,78
Andhra Pradesh,2005,Molestation,0,0,0,26,0,26,39,24,63,6,2,8,71,26,97
Andhra Pradesh,2005,Eve-Teasing,0,0,0,1,0,1,0,0,0,0,0,0,1,0,1
Andhra Pradesh,2005,Cruelty By Husband Or Relative Of Husband,0,0,0,27,0,27,50,0,50,7,1,8,84,1,85
Andhra Pradesh,2005,Other Ipc Crimes,0,0,0,85,1,86,77,5,82,11,1,12,173,7,180
Andhra Pradesh,2006,Murder,0,0,0,809,39,848,1875,36,1911,333,12,345,3017,87,3104
Andhra Pradesh,2006,Attempt To Commit Murder,0,0,0,31,8,39,52,0,52,13,0,13,96,8,104
Andhra Pradesh,2006,C.H. Not Amounting To Murder,0,0,0,34,0,34,92,4,96,11,0,11,137,4,141
Andhra Pradesh,2006,Rape,0,0,0,55,0,55,80,0,80,25,1,26,160,1,161
Andhra Pradesh,2006,Kidnapping And Abduction,0,0,0,17,3,20,24,2,26,0,0,0,41,5,46
Andhra Pradesh,2006,Dacoity,0,0,0,47,1,48,56,1,57,7,1,8,110,3,113
Andhra Pradesh,2006,Prep. And Assembly For Dacoity,0,0,0,4,0,4,4,2,6,0,0,0,8,2,10
Andhra Pradesh,2006,Robbery,0,0,0,29,0,29,27,0,27,5,0,5,61,0,61
Andhra Pradesh,2006,Burglary,0,0,0,38,0,38,24,0,24,0,0,0,62,0,62
Andhra Pradesh,2006,Thefts,0,0,0,207,2,209,143,4,147,12,1,13,362,7,369
Andhra Pradesh,2006,Extortion,0,0,0,0,0,0,0,0,0,0,0,0,0,0,0
Andhra Pradesh,2006,Riots,0,0,0,1,0,1,5,0,5,1,0,1,7,0,7
Andhra Pradesh,2006,Arson,0,0,0,0,0,0,3,0,3,0,0,0,3,0,3
Andhra Pradesh,2006,Criminal Breach Of Trust,0,0,0,0,0,0,1,0,1,0,0,0,1,0,1
Andhra Pradesh,2006,Cheating,0,0,0,5,0,5,11,2,13,7,0,7,23,2,25
Andhra Pradesh,2006,Counter Feiting,0,0,0,3,0,3,3,0,3,0,0,0,6,0,6
Andhra Pradesh,2006,Dowry Deaths,0,0,0,28,3,31,55,13,68,13,8,21,96,24,120
Andhra Pradesh,2006,Molestation,0,0,0,36,0,36,41,0,41,2,0,2,79,0,79
Andhra Pradesh,2006,Eve-Teasing,0,0,0,0,0,0,1,0,1,0,0,0,1,0,1
Andhra Pradesh,2006,Cruelty By Husband Or Relative Of Husband,0,0,0,43,0,43,83,29,112,3,7,10,129,36,165
Andhra Pradesh,2006,Other Ipc Crimes,0,0,0,88,4,92,145,1,146,23,0,23,256,5,261
Andhra Pradesh,2007,Murder,0,0,0,1046,41,1087,1715,81,1796,356,30,386,3117,152,3269
Andhra Pradesh,2007,Attempt To Commit Murder,0,0,0,48,2,50,69,5,74,13,2,15,130,9,139
Andhra Pradesh,2007,C.H. Not Amounting To Murder,0,0,0,51,1,52,92,2,94,19,1,20,162,4,166
Andhra Pradesh,2007,Rape,0,0,0,96,1,97,93,0,93,27,0,27,216,1,217
Andhra Pradesh,2007,Kidnapping And Abduction,0,0,0,19,0,19,26,0,26,0,7,7,45,7,52
Andhra Pradesh,2007,Dacoity,0,0,0,67,0,67,59,2,61,10,1,11,136,3,139
Andhra Pradesh,2007,Prep. And Assembly For Dacoity,0,0,0,1,1,2,5,1,6,0,2,2,6,4,10
Andhra Pradesh,2007,Robbery,0,0,0,43,0,43,35,4,39,7,0,7,85,4,89
Andhra Pradesh,2007,Burglary,0,0,0,27,0,27,16,0,16,8,0,8,51,0,51
Andhra Pradesh,2007,Thefts,0,0,0,206,2,208,178,5,183,26,1,27,410,8,418
Andhra Pradesh,2007,Extortion,0,0,0,7,0,7,5,0,5,0,0,0,12,0,12
Andhra Pradesh,2007,Riots,0,0,0,0,0,0,3,3,6,0,0,0,3,3,6
Andhra Pradesh,2007,Arson,0,0,0,1,0,1,4,0,4,1,0,1,6,0,6
Andhra Pradesh,2007,Criminal Breach Of Trust,0,0,0,1,0,1,0,0,0,4,0,4,5,0,5
Andhra Pradesh,2007,Cheating,0,0,0,10,0,10,11,4,15,5,0,5,26,4,30
Andhra Pradesh,2007,Counter Feiting,0,0,0,6,1,7,5,0,5,1,0,1,12,1,13
Andhra Pradesh,2007,Dowry Deaths,0,0,0,34,8,42,51,5,56,8,0,8,93,13,106
Andhra Pradesh,2007,Molestation,0,0,0,28,0,28,28,0,28,11,0,11,67,0,67
Andhra Pradesh,2007,Eve-Teasing,0,0,0,1,0,1,0,0,0,0,0,0,1,0,1
Andhra Pradesh,2007,Cruelty By Husband Or Relative Of Husband,0,0,0,37,0,37,83,2,85,8,0,8,128,2,130
Andhra Pradesh,2007,Other Ipc Crimes,0,0,0,83,4,87,97,0,97,30,0,30,210,4,214
Andhra Pradesh,2008,Murder,0,0,0,912,25,937,1854,89,1943,414,24,438,3180,138,3318
Andhra Pradesh,2008,Attempt To Commit Murder,0,0,0,50,2,52,57,1,58,10,0,10,117,3,120
Andhra Pradesh,2008,C.H. Not Amounting To Murder,0,0,0,50,1,51,45,6,51,6,3,9,101,10,111
Andhra Pradesh,2008,Rape,0,0,0,82,0,82,70,0,70,18,1,19,170,1,171
Andhra Pradesh,2008,Kidnapping And Abduction,0,0,0,15,1,16,11,4,15,0,1,1,26,6,32
Andhra Pradesh,2008,Dacoity,0,0,0,74,0,74,37,0,37,9,0,9,120,0,120
Andhra Pradesh,2008,Prep. And Assembly For Dacoity,0,0,0,2,0,2,6,0,6,0,0,0,8,0,8
Andhra Pradesh,2008,Robbery,0,0,0,30,1,31,49,1,50,13,0,13,92,2,94
Andhra Pradesh,2008,Burglary,0,0,0,18,0,18,24,0,24,5,0,5,47,0,47
Andhra Pradesh,2008,Thefts,0,0,0,188,3,191,176,5,181,8,0,8,372,8,380
Andhra Pradesh,2008,Extortion,0,0,0,4,0,4,5,1,6,0,0,0,9,1,10
Andhra Pradesh,2008,Riots,0,0,0,0,0,0,0,0,0,0,0,0,0,0,0
Andhra Pradesh,2008,Arson,0,0,0,2,0,2,0,0,0,0,0,0,2,0,2
Andhra Pradesh,2008,Criminal Breach Of Trust,0,0,0,3,0,3,0,0,0,0,0,0,3,0,3
Andhra Pradesh,2008,Cheating,0,0,0,14,0,14,19,0,19,3,0,3,36,0,36
Andhra Pradesh,2008,Counter Feiting,0,0,0,4,0,4,6,1,7,0,0,0,10,1,11
Andhra Pradesh,2008,Dowry Deaths,0,0,0,37,1,38,39,19,58,8,0,8,84,20,104
Andhra Pradesh,2008,Molestation,0,0,0,18,2,20,17,0,17,2,0,2,37,2,39
Andhra Pradesh,2008,Eve-Teasing,0,0,0,2,0,2,0,0,0,1,0,1,3,0,3
Andhra Pradesh,2008,Cruelty By Husband Or Relative Of Husband,0,0,0,38,0,38,53,3,56,0,2,2,91,5,96
Andhra Pradesh,2008,Other Ipc Crimes,0,0,0,53,0,53,71,6,77,20,1,21,144,7,151
Andhra Pradesh,2009,Murder,0,0,0,785,52,837,1415,55,1470,199,18,217,2399,125,2524
Andhra Pradesh,2009,Attempt To Commit Murder,0,0,0,61,2,63,91,0,91,6,0,6,158,2,160
Andhra Pradesh,2009,C.H. Not Amounting To Murder,0,0,0,49,5,54,43,3,46,3,1,4,95,9,104
Andhra Pradesh,2009,Rape,0,0,0,58,2,60,84,1,85,11,0,11,153,3,156
Andhra Pradesh,2009,Kidnapping And Abduction,0,0,0,38,0,38,27,5,32,1,2,3,66,7,73
Andhra Pradesh,2009,Dacoity,0,0,0,55,3,58,67,1,68,2,0,2,124,4,128
Andhra Pradesh,2009,Prep. And Assembly For Dacoity,0,0,0,1,0,1,8,0,8,0,0,0,9,0,9
Andhra Pradesh,2009,Robbery,0,0,0,53,3,56,53,0,53,7,0,7,113,3,116
Andhra Pradesh,2009,Burglary,0,0,0,21,0,21,15,0,15,4,0,4,40,0,40
Andhra Pradesh,2009,Thefts,0,0,0,217,4,221,158,4,162,9,0,9,384,8,392
Andhra Pradesh,2009,Extortion,0,0,0,7,0,7,6,0,6,1,0,1,14,0,14
Andhra Pradesh,2009,Riots,0,0,0,8,0,8,5,0,5,1,0,1,14,0,14
Andhra Pradesh,2009,Arson,0,0,0,2,0,2,4,0,4,1,0,1,7,0,7
Andhra Pradesh,2009,Criminal Breach Of Trust,0,0,0,0,0,0,4,0,4,2,0,2,6,0,6
Andhra Pradesh,2009,Cheating,0,0,0,14,0,14,13,0,13,7,1,8,34,1,35
Andhra Pradesh,2009,Counter Feiting,0,0,0,32,0,32,21,0,21,1,0,1,54,0,54
Andhra Pradesh,2009,Dowry Deaths,0,0,0,24,2,26,51,8,59,11,0,11,86,10,96
Andhra Pradesh,2009,Molestation,0,0,0,19,0,19,14,0,14,5,0,5,38,0,38
Andhra Pradesh,2009,Eve-Teasing,0,0,0,4,0,4,3,0,3,0,0,0,7,0,7
Andhra Pradesh,2009,Cruelty By Husband Or Relative Of Husband,0,0,0,40,2,42,70,3,73,4,2,6,114,7,121
Andhra Pradesh,2009,Other Ipc Crimes,0,0,0,61,0,61,40,8,48,19,1,20,120,9,129
Andhra Pradesh,2010,Murder,0,0,0,939,40,979,1565,68,1633,270,40,310,2774,148,2922
Andhra Pradesh,2010,Attempt To Commit Murder,0,0,0,86,2,88,48,1,49,11,0,11,145,3,148
Andhra Pradesh,2010,C.H. Not Amounting To Murder,0,0,0,40,2,42,67,4,71,17,1,18,124,7,131
Andhra Pradesh,2010,Rape,0,0,0,68,1,69,54,1,55,5,0,5,127,2,129
Andhra Pradesh,2010,Kidnapping And Abduction,0,0,0,59,0,59,22,1,23,3,0,3,84,1,85
Andhra Pradesh,2010,Dacoity,0,0,0,56,2,58,42,4,46,3,0,3,101,6,107
Andhra Pradesh,2010,Prep. And Assembly For Dacoity,0,0,0,18,0,18,6,0,6,3,0,3,27,0,27
Andhra Pradesh,2010,Robbery,0,0,0,40,0,40,21,0,21,0,0,0,61,0,61
Andhra Pradesh,2010,Burglary,0,0,0,42,0,42,23,1,24,5,0,5,70,1,71
Andhra Pradesh,2010,Thefts,0,0,0,177,9,186,110,9,119,7,0,7,294,18,312
Andhra Pradesh,2010,Extortion,0,0,0,5,0,5,0,0,0,0,0,0,5,0,5
Andhra Pradesh,2010,Riots,0,0,0,4,0,4,8,0,8,2,0,2,14,0,14
Andhra Pradesh,2010,Arson,0,0,0,1,0,1,0,0,0,0,0,0,1,0,1
Andhra Pradesh,2010,Criminal Breach Of Trust,0,0,0,2,0,2,1,0,1,0,0,0,3,0,3
Andhra Pradesh,2010,Cheating,0,0,0,18,0,18,7,3,10,2,1,3,27,4,31
Andhra Pradesh,2010,Counter Feiting,0,0,0,6,0,6,11,0,11,0,0,0,17,0,17
Andhra Pradesh,2010,Dowry Deaths,0,0,0,20,0,20,16,6,22,2,12,14,38,18,56
Andhra Pradesh,2010,Molestation,0,0,0,27,0,27,20,2,22,2,0,2,49,2,51
Andhra Pradesh,2010,Eve-Teasing,0,0,0,4,0,4,5,0,5,0,0,0,9,0,9
Andhra Pradesh,2010,Cruelty By Husband Or Relative Of Husband,0,0,0,50,1,51,58,0,58,3,1,4,111,2,113
Andhra Pradesh,2010,Other Ipc Crimes,0,0,0,90,1,91,111,6,117,22,0,22,223,7,230
Andhra Pradesh,2011,Murder,0,0,0,833,19,852,1575,105,1680,428,39,467,2836,163,2999
Andhra Pradesh,2011,Attempt To Commit Murder,0,0,0,57,0,57,51,9,60,19,8,27,127,17,144
Andhra Pradesh,2011,C.H. Not Amounting To Murder,0,0,0,32,3,35,59,4,63,14,3,17,105,10,115
Andhra Pradesh,2011,Rape,0,0,0,45,0,45,43,2,45,16,0,16,104,2,106
Andhra Pradesh,2011,Kidnapping And Abduction,0,0,0,17,1,18,13,4,17,1,0,1,31,5,36
Andhra Pradesh,2011,Dacoity,0,0,0,41,3,44,45,2,47,8,0,8,94,5,99
Andhra Pradesh,2011,Prep. And Assembly For Dacoity,0,0,0,4,1,5,2,0,2,0,0,0,6,1,7
Andhra Pradesh,2011,Robbery,0,0,0,34,1,35,17,0,17,10,0,10,61,1,62
Andhra Pradesh,2011,Burglary,0,0,0,26,0,26,12,0,12,9,0,9,47,0,47
Andhra Pradesh,2011,Thefts,0,0,0,230,8,238,162,6,168,42,0,42,434,14,448
Andhra Pradesh,2011,Extortion,0,0,0,4,0,4,6,0,6,4,0,4,14,0,14
Andhra Pradesh,2011,Riots,0,0,0,0,0,0,1,0,1,0,0,0,1,0,1
Andhra Pradesh,2011,Arson,0,0,0,0,0,0,0,0,0,0,0,0,0,0,0
Andhra Pradesh,2011,Criminal Breach Of Trust,0,0,0,4,0,4,0,0,0,0,0,0,4,0,4
Andhra Pradesh,2011,Cheating,0,0,0,15,1,16,16,1,17,7,1,8,38,3,41
Andhra Pradesh,2011,Counter Feiting,0,0,0,1,0,1,2,0,2,0,0,0,3,0,3
Andhra Pradesh,2011,Dowry Deaths,0,0,0,13,0,13,32,10,42,12,15,27,57,25,82
Andhra Pradesh,2011,Molestation,0,0,0,7,0,7,4,0,4,1,0,1,12,0,12
Andhra Pradesh,2011,Eve-Teasing,0,0,0,1,0,1,2,0,2,0,0,0,3,0,3
Andhra Pradesh,2011,Cruelty By Husband Or Relative Of Husband,0,0,0,28,1,29,27,0,27,14,0,14,69,1,70
Andhra Pradesh,2011,Other Ipc Crimes,0,0,0,31,2,33,87,1,88,23,0,23,141,3,144
Andhra Pradesh,2012,Murder,0,0,0,851,28,879,1662,99,1761,423,0,423,2936,127,3063
Andhra Pradesh,2012,Attempt To Commit Murder,0,0,0,28,0,28,38,2,40,11,0,11,77,2,79
Andhra Pradesh,2012,C.H. Not Amounting To Murder,0,0,0,42,0,42,67,10,77,11,0,11,120,10,130
Andhra Pradesh,2012,Rape,0,0,0,76,0,76,73,2,75,19,0,19,168,2,170
Andhra Pradesh,2012,Kidnapping And Abduction,0,0,0,16,0,16,16,3,19,5,0,5,37,3,40
Andhra Pradesh,2012,Dacoity,0,0,0,50,2,52,37,1,38,2,0,2,89,3,92
Andhra Pradesh,2012,Prep. And Assembly For Dacoity,0,0,0,1,0,1,0,1,1,0,0,0,1,1,2
Andhra Pradesh,2012,Robbery,0,0,0,29,0,29,20,3,23,6,0,6,55,3,58
Andhra Pradesh,2012,Burglary,0,0,0,36,0,36,8,0,8,3,52,55,47,52,99
Andhra Pradesh,2012,Thefts,0,0,0,173,1,174,84,8,92,19,0,19,276,9,285
Andhra Pradesh,2012,Extortion,0,0,0,12,0,12,6,0,6,0,0,0,18,0,18
Andhra Pradesh,2012,Riots,0,0,0,0,0,0,0,0,0,0,0,0,0,0,0
Andhra Pradesh,2012,Arson,0,0,0,0,0,0,0,0,0,0,0,0,0,0,0
Andhra Pradesh,2012,Criminal Breach Of Trust,0,0,0,6,0,6,6,2,8,2,0,2,14,2,16
Andhra Pradesh,2012,Cheating,0,0,0,12,0,12,11,2,13,3,0,3,26,2,28
Andhra Pradesh,2012,Counter Feiting,0,0,0,3,0,3,8,0,8,2,0,2,13,0,13
Andhra Pradesh,2012,Dowry Deaths,0,0,0,29,0,29,35,16,51,7,3,10,71,19,90
Andhra Pradesh,2012,Molestation,0,0,0,5,0,5,20,1,21,5,0,5,30,1,31
Andhra Pradesh,2012,Eve-Teasing,0,0,0,4,0,4,2,0,2,0,0,0,6,0,6
Andhra Pradesh,2012,Cruelty By Husband Or Relative Of Husband,0,0,0,24,0,24,23,3,26,5,0,5,52,3,55
Andhra Pradesh,2012,Other Ipc Crimes,0,0,0,43,0,43,72,0,72,18,0,18,133,0,133
Arunachal Pradesh,2009,Murder,0,0,0,0,0,0,0,0,0,0,0,0,0,0,0
Arunachal Pradesh,2009,Attempt To Commit Murder,0,0,0,0,0,0,0,0,0,0,0,0,0,0,0
Arunachal Pradesh,2009,C.H. Not Amounting To Murder,0,0,0,0,0,0,0,0,0,0,0,0,0,0,0
Arunachal Pradesh,2009,Rape,0,0,0,1,0,1,0,0,0,1,0,1,2,0,2
Arunachal Pradesh,2009,Kidnapping And Abduction,0,0,0,0,0,0,0,0,0,0,0,0,0,0,0
Arunachal Pradesh,2009,Dacoity,0,0,0,0,0,0,0,0,0,0,0,0,0,0,0
Arunachal Pradesh,2009,Prep. And Assembly For Dacoity,0,0,0,0,0,0,0,0,0,0,0,0,0,0,0
Arunachal Pradesh,2009,Robbery,0,0,0,0,0,0,0,0,0,0,0,0,0,0,0
Arunachal Pradesh,2009,Burglary,0,0,0,0,0,0,0,0,0,0,0,0,0,0,0
Arunachal Pradesh,2009,Thefts,0,0,0,0,0,0,0,0,0,0,0,0,0,0,0
Arunachal Pradesh,2009,Extortion,0,0,0,0,0,0,0,0,0,0,0,0,0,0,0
Arunachal Pradesh,2009,Riots,0,0,0,0,0,0,0,0,0,0,0,0,0,0,0
Arunachal Pradesh,2009,Arson,0,0,0,0,0,0,0,0,0,0,0,0,0,0,0
Arunachal Pradesh,2009,Criminal Breach Of Trust,0,0,0,0,0,0,0,0,0,0,0,0,0,0,0
Arunachal Pradesh,2009,Cheating,0,0,0,0,0,0,0,0,0,0,0,0,0,0,0
Arunachal Pradesh,2009,Counter Feiting,0,0,0,0,0,0,0,0,0,0,0,0,0,0,0
Arunachal Pradesh,2009,Dowry Deaths,0,0,0,0,0,0,0,0,0,0,0,0,0,0,0
Arunachal Pradesh,2009,Molestation,0,0,0,0,0,0,0,0,0,0,0,0,0,0,0
Arunachal Pradesh,2009,Eve-Teasing,0,0,0,0,0,0,0,0,0,0,0,0,0,0,0
Arunachal Pradesh,2009,Cruelty By Husband Or Relative Of Husband,0,0,0,0,0,0,0,0,0,0,0,0,0,0,0
Arunachal Pradesh,2009,Other Ipc Crimes,0,0,0,0,0,0,0,0,0,0,0,0,0,0,0
Arunachal Pradesh,2010,Murder,0,0,0,0,0,0,0,0,0,0,0,0,0,0,0
Arunachal Pradesh,2010,Attempt To Commit Murder,0,0,0,0,0,0,0,0,0,0,0,0,0,0,0
Arunachal Pradesh,2010,C.H. Not Amounting To Murder,0,0,0,0,0,0,0,0,0,0,0,0,0,0,0
Arunachal Pradesh,2010,Rape,0,0,0,0,0,0,0,0,0,1,0,1,1,0,1
Arunachal Pradesh,2010,Kidnapping And Abduction,0,0,0,0,0,0,0,0,0,0,0,0,0,0,0
Arunachal Pradesh,2010,Dacoity,0,0,0,0,0,0,0,0,0,0,0,0,0,0,0
Arunachal Pradesh,2010,Prep. And Assembly For Dacoity,0,0,0,0,0,0,0,0,0,0,0,0,0,0,0
Arunachal Pradesh,2010,Robbery,0,0,0,0,0,0,0,0,0,0,0,0,0,0,0
Arunachal Pradesh,2010,Burglary,0,0,0,2,0,2,0,0,0,0,0,0,2,0,2
Arunachal Pradesh,2010,Thefts,0,0,0,1,0,1,0,0,0,0,0,0,1,0,1
Arunachal Pradesh,2010,Extortion,0,0,0,0,0,0,0,0,0,0,0,0,0,0,0
Arunachal Pradesh,2010,Riots,0,0,0,0,0,0,0,0,0,0,0,0,0,0,0
Arunachal Pradesh,2010,Arson,0,0,0,0,0,0,0,0,0,0,0,0,0,0,0
Arunachal Pradesh,2010,Criminal Breach Of Trust,0,0,0,0,0,0,0,0,0,0,0,0,0,0,0
Arunachal Pradesh,2010,Cheating,0,0,0,0,0,0,0,0,0,0,0,0,0,0,0
Arunachal Pradesh,2010,Counter Feiting,0,0,0,0,0,0,0,0,0,0,0,0,0,0,0
Arunachal Pradesh,2010,Dowry Deaths,0,0,0,0,0,0,0,0,0,0,0,0,0,0,0
Arunachal Pradesh,2010,Molestation,0,0,0,0,0,0,0,0,0,0,0,0,0,0,0
Arunachal Pradesh,2010,Eve-Teasing,0,0,0,0,0,0,0,0,0,0,0,0,0,0,0
Arunachal Pradesh,2010,Cruelty By Husband Or Relative Of Husband,0,0,0,0,0,0,0,0,0,0,0,0,0,0,0
Arunachal Pradesh,2010,Other Ipc Crimes,0,0,0,0,0,0,0,0,0,0,0,0,0,0,0
Arunachal Pradesh,2011,Murder,0,0,0,0,0,0,1,0,1,0,0,0,1,0,1
Arunachal Pradesh,2011,Attempt To Commit Murder,0,0,0,0,0,0,0,0,0,0,0,0,0,0,0
Arunachal Pradesh,2011,C.H. Not Amounting To Murder,0,0,0,0,0,0,0,0,0,0,0,0,0,0,0
Arunachal Pradesh,2011,Rape,0,0,0,1,0,1,1,0,1,1,0,1,3,0,3
Arunachal Pradesh,2011,Kidnapping And Abduction,0,0,0,0,0,0,0,0,0,0,0,0,0,0,0
Arunachal Pradesh,2011,Dacoity,0,0,0,0,0,0,0,0,0,0,0,0,0,0,0
Arunachal Pradesh,2011,Prep. And Assembly For Dacoity,0,0,0,0,0,0,0,0,0,0,0,0,0,0,0
Arunachal Pradesh,2011,Robbery,0,0,0,0,0,0,0,0,0,0,0,0,0,0,0
Arunachal Pradesh,2011,Burglary,0,0,0,0,0,0,0,0,0,0,0,0,0,0,0
Arunachal Pradesh,2011,Thefts,0,0,0,1,0,1,0,0,0,0,0,0,1,0,1
Arunachal Pradesh,2011,Extortion,0,0,0,0,0,0,0,0,0,0,0,0,0,0,0
Arunachal Pradesh,2011,Riots,0,0,0,0,0,0,0,0,0,0,0,0,0,0,0
Arunachal Pradesh,2011,Arson,0,0,0,0,0,0,0,0,0,0,0,0,0,0,0
Arunachal Pradesh,2011,Criminal Breach Of Trust,0,0,0,0,0,0,0,0,0,0,0,0,0,0,0
Arunachal Pradesh,2011,Cheating,0,0,0,0,0,0,0,0,0,0,0,0,0,0,0
Arunachal Pradesh,2011,Counter Feiting,0,0,0,0,0,0,0,0,0,0,0,0,0,0,0
Arunachal Pradesh,2011,Dowry Deaths,0,0,0,0,0,0,0,0,0,0,0,0,0,0,0
Arunachal Pradesh,2011,Molestation,0,0,0,0,0,0,0,0,0,0,0,0,0,0,0
Arunachal Pradesh,2011,Eve-Teasing,0,0,0,0,0,0,0,0,0,0,0,0,0,0,0
Arunachal Pradesh,2011,Cruelty By Husband Or Relative Of Husband,0,0,0,0,0,0,0,0,0,0,0,0,0,0,0
Arunachal Pradesh,2011,Other Ipc Crimes,0,0,0,0,0,0,0,0,0,0,0,0,0,0,0
Arunachal Pradesh,2012,Murder,0,0,0,0,0,0,0,0,0,0,0,0,0,0,0
Arunachal Pradesh,2012,Attempt To Commit Murder,0,0,0,0,0,0,0,0,0,0,0,0,0,0,0
Arunachal Pradesh,2012,C.H. Not Amounting To Murder,0,0,0,0,0,0,0,0,0,0,0,0,0,0,0
Arunachal Pradesh,2012,Rape,0,0,0,3,0,3,1,0,1,0,0,0,4,0,4
Arunachal Pradesh,2012,Kidnapping And Abduction,0,0,0,0,0,0,0,0,0,0,0,0,0,0,0
Arunachal Pradesh,2012,Dacoity,0,0,0,0,0,0,0,0,0,0,0,0,0,0,0
Arunachal Pradesh,2012,Prep. And Assembly For Dacoity,0,0,0,0,0,0,0,0,0,0,0,0,0,0,0
Arunachal Pradesh,2012,Robbery,0,0,0,0,0,0,0,0,0,0,0,0,0,0,0
Arunachal Pradesh,2012,Burglary,0,0,0,0,0,0,0,0,0,0,0,0,0,0,0
Arunachal Pradesh,2012,Thefts,0,0,0,0,0,0,0,0,0,0,0,0,0,0,0
Arunachal Pradesh,2012,Extortion,0,0,0,0,0,0,0,0,0,0,0,0,0,0,0
Arunachal Pradesh,2012,Riots,0,0,0,0,0,0,0,0,0,0,0,0,0,0,0
Arunachal Pradesh,2012,Arson,0,0,0,0,0,0,0,0,0,0,0,0,0,0,0
Arunachal Pradesh,2012,Criminal Breach Of Trust,0,0,0,0,0,0,0,0,0,0,0,0,0,0,0
Arunachal Pradesh,2012,Cheating,0,0,0,0,0,0,0,0,0,0,0,0,0,0,0
Arunachal Pradesh,2012,Counter Feiting,0,0,0,0,0,0,0,0,0,0,0,0,0,0,0
Arunachal Pradesh,2012,Dowry Deaths,0,0,0,0,0,0,0,0,0,0,0,0,0,0,0
Arunachal Pradesh,2012,Molestation,0,0,0,0,0,0,0,0,0,0,0,0,0,0,0
Arunachal Pradesh,2012,Eve-Teasing,0,0,0,0,0,0,0,0,0,0,0,0,0,0,0
Arunachal Pradesh,2012,Cruelty By Husband Or Relative Of Husband,0,0,0,0,0,0,0,0,0,0,0,0,0,0,0
Arunachal Pradesh,2012,Other Ipc Crimes,0,0,0,0,0,0,0,0,0,0,0,0,0,0,0
Assam,2001,Murder,6,0,6,271,10,281,1108,23,1131,207,0,207,1592,33,1625
Assam,2001,Attempt To Commit Murder,1,0,1,25,2,27,14,0,14,3,0,3,43,2,45
Assam,2001,C.H. Not Amounting To Murder,0,0,0,50,1,51,114,2,116,12,0,12,176,3,179
Assam,2001,Rape,1,0,1,62,0,62,71,0,71,5,0,5,139,0,139
Assam,2001,Kidnapping And Abduction,0,0,0,7,1,8,14,0,14,0,0,0,21,1,22
Assam,2001,Dacoity,0,0,0,16,0,16,22,2,24,5,0,5,43,2,45
Assam,2001,Prep. And Assembly For Dacoity,0,0,0,1,0,1,2,0,2,0,0,0,3,0,3
Assam,2001,Robbery,0,0,0,9,2,11,12,0,12,0,0,0,21,2,23
Assam,2001,Burglary,0,0,0,10,0,10,10,0,10,0,0,0,20,0,20
Assam,2001,Thefts,1,0,1,32,0,32,57,1,58,2,0,2,92,1,93
Assam,2001,Extortion,0,0,0,3,0,3,6,0,6,0,0,0,9,0,9
Assam,2001,Riots,0,0,0,2,0,2,6,0,6,0,0,0,8,0,8
Assam,2001,Arson,0,0,0,1,0,1,0,0,0,0,0,0,1,0,1
Assam,2001,Criminal Breach Of Trust,0,0,0,2,0,2,2,0,2,1,0,1,5,0,5
Assam,2001,Cheating,0,0,0,1,0,1,4,0,4,0,0,0,5,0,5
Assam,2001,Counter Feiting,0,0,0,0,0,0,1,0,1,0,0,0,1,0,1
Assam,2001,Dowry Deaths,0,0,0,2,0,2,4,0,4,1,0,1,7,0,7
Assam,2001,Molestation,0,0,0,0,0,0,0,0,0,0,0,0,0,0,0
Assam,2001,Eve-Teasing,0,0,0,0,0,0,0,0,0,0,0,0,0,0,0
Assam,2001,Cruelty By Husband Or Relative Of Husband,0,0,0,5,0,5,2,0,2,1,0,1,8,0,8
Assam,2001,Other Ipc Crimes,0,0,0,33,0,33,52,1,53,11,0,11,96,1,97
Assam,2002,Murder,0,0,0,488,5,493,1046,34,1080,179,1,180,1713,40,1753
Assam,2002,Attempt To Commit Murder,3,0,3,44,2,46,29,3,32,7,0,7,83,5,88
Assam,2002,C.H. Not Amounting To Murder,3,0,3,80,0,80,93,6,99,19,0,19,195,6,201
Assam,2002,Rape,2,0,2,77,0,77,92,0,92,5,0,5,176,0,176
Assam,2002,Kidnapping And Abduction,0,0,0,14,0,14,24,0,24,2,0,2,40,0,40
Assam,2002,Dacoity,0,0,0,27,0,27,51,0,51,9,0,9,87,0,87
Assam,2002,Prep. And Assembly For Dacoity,0,0,0,0,0,0,3,0,3,0,0,0,3,0,3
Assam,2002,Robbery,0,0,0,11,0,11,14,0,14,2,0,2,27,0,27
Assam,2002,Burglary,5,0,5,7,0,7,7,0,7,2,0,2,21,0,21
Assam,2002,Thefts,14,0,14,42,0,42,62,0,62,5,0,5,123,0,123
Assam,2002,Extortion,0,0,0,4,0,4,23,1,24,7,0,7,34,1,35
Assam,2002,Riots,0,0,0,3,0,3,4,0,4,0,0,0,7,0,7
Assam,2002,Arson,0,0,0,3,0,3,10,0,10,0,0,0,13,0,13
Assam,2002,Criminal Breach Of Trust,0,0,0,0,0,0,0,0,0,0,0,0,0,0,0
Assam,2002,Cheating,0,0,0,2,0,2,3,0,3,0,0,0,5,0,5
Assam,2002,Counter Feiting,0,0,0,0,0,0,2,0,2,0,0,0,2,0,2
Assam,2002,Dowry Deaths,0,0,0,7,0,7,13,0,13,8,1,9,28,1,29
Assam,2002,Molestation,0,0,0,2,0,2,0,0,0,0,0,0,2,0,2
Assam,2002,Eve-Teasing,0,0,0,0,0,0,0,0,0,0,0,0,0,0,0
Assam,2002,Cruelty By Husband Or Relative Of Husband,0,0,0,1,0,1,18,0,18,0,0,0,19,0,19
Assam,2002,Other Ipc Crimes,0,0,0,14,0,14,21,0,21,3,0,3,38,0,38
Assam,2003,Murder,0,0,0,456,6,462,870,39,909,238,3,241,1564,48,1612
Assam,2003,Attempt To Commit Murder,7,0,7,65,2,67,206,3,209,42,2,44,320,7,327
Assam,2003,C.H. Not Amounting To Murder,1,0,1,63,1,64,120,4,124,27,1,28,211,6,217
Assam,2003,Rape,2,0,2,73,0,73,139,0,139,8,0,8,222,0,222
Assam,2003,Kidnapping And Abduction,0,0,0,29,0,29,35,0,35,0,0,0,64,0,64
Assam,2003,Dacoity,0,0,0,30,0,30,76,0,76,6,0,6,112,0,112
Assam,2003,Prep. And Assembly For Dacoity,0,0,0,10,0,10,2,0,2,2,0,2,14,0,14
Assam,2003,Robbery,2,0,2,23,0,23,27,0,27,0,0,0,52,0,52
Assam,2003,Burglary,0,0,0,0,0,0,6,0,6,0,0,0,6,0,6
Assam,2003,Thefts,5,0,5,56,0,56,139,0,139,5,0,5,205,0,205
Assam,2003,Extortion,0,0,0,1,0,1,17,0,17,0,0,0,18,0,18
Assam,2003,Riots,0,0,0,10,0,10,0,0,0,3,0,3,13,0,13
Assam,2003,Arson,0,0,0,1,0,1,22,0,22,0,0,0,23,0,23
Assam,2003,Criminal Breach Of Trust,0,0,0,0,0,0,0,0,0,0,0,0,0,0,0
Assam,2003,Cheating,0,0,0,0,0,0,0,0,0,0,0,0,0,0,0
Assam,2003,Counter Feiting,0,0,0,1,0,1,1,0,1,0,0,0,2,0,2
Assam,2003,Dowry Deaths,0,0,0,4,2,6,17,5,22,0,0,0,21,7,28
Assam,2003,Molestation,0,0,0,0,0,0,1,0,1,0,0,0,1,0,1
Assam,2003,Eve-Teasing,0,0,0,0,0,0,0,0,0,0,0,0,0,0,0
Assam,2003,Cruelty By Husband Or Relative Of Husband,0,0,0,17,1,18,35,1,36,12,0,12,64,2,66
Assam,2003,Other Ipc Crimes,0,0,0,16,0,16,28,0,28,9,0,9,53,0,53
Assam,2004,Murder,0,0,0,460,11,471,749,37,786,476,5,481,1685,53,1738
Assam,2004,Attempt To Commit Murder,0,0,0,43,0,43,144,2,146,35,0,35,222,2,224
Assam,2004,C.H. Not Amounting To Murder,0,0,0,51,0,51,127,5,132,36,0,36,214,5,219
Assam,2004,Rape,1,0,1,105,0,105,172,0,172,20,0,20,298,0,298
Assam,2004,Kidnapping And Abduction,0,0,0,13,0,13,51,4,55,0,0,0,64,4,68
Assam,2004,Dacoity,0,0,0,33,0,33,48,1,49,14,0,14,95,1,96
Assam,2004,Prep. And Assembly For Dacoity,0,0,0,0,0,0,14,0,14,0,0,0,14,0,14
Assam,2004,Robbery,0,0,0,9,0,9,14,0,14,1,0,1,24,0,24
Assam,2004,Burglary,0,0,0,5,0,5,14,0,14,2,0,2,21,0,21
Assam,2004,Thefts,4,0,4,45,0,45,108,0,108,17,0,17,174,0,174
Assam,2004,Extortion,0,0,0,4,0,4,15,0,15,0,0,0,19,0,19
Assam,2004,Riots,0,0,0,0,0,0,0,0,0,0,0,0,0,0,0
Assam,2004,Arson,0,0,0,2,0,2,7,0,7,4,0,4,13,0,13
Assam,2004,Criminal Breach Of Trust,0,0,0,0,0,0,0,0,0,0,0,0,0,0,0
Assam,2004,Cheating,0,0,0,3,0,3,12,0,12,4,0,4,19,0,19
Assam,2004,Counter Feiting,0,0,0,28,2,30,66,5,71,45,0,45,139,7,146
Assam,2004,Dowry Deaths,0,0,0,8,0,8,6,0,6,4,1,5,18,1,19
Assam,2004,Molestation,0,0,0,0,0,0,1,0,1,0,0,0,1,0,1
Assam,2004,Eve-Teasing,0,0,0,0,0,0,0,0,0,0,0,0,0,0,0
Assam,2004,Cruelty By Husband Or Relative Of Husband,0,0,0,2,0,2,1,0,1,0,0,0,3,0,3
Assam,2004,Other Ipc Crimes,0,0,0,16,0,16,33,0,33,6,0,6,55,0,55
Assam,2005,Murder,4,0,4,502,15,517,1128,30,1158,406,6,412,2040,51,2091
Assam,2005,Murder,0,0,0,0,0,0,0,0,0,0,0,0,0,0,0
Assam,2005,Murder,0,0,0,0,0,0,0,0,0,0,0,0,0,0,0
Assam,2005,Attempt To Commit Murder,3,0,3,56,1,57,76,2,78,16,0,16,151,3,154
Assam,2005,C.H. Not Amounting To Murder,0,0,0,57,4,61,131,7,138,27,0,27,215,11,226
Assam,2005,Rape,1,0,1,128,0,128,169,0,169,17,2,19,315,2,317
Assam,2005,Kidnapping And Abduction,0,0,0,25,1,26,46,2,48,9,0,9,80,3,83
Assam,2005,Dacoity,0,0,0,28,0,28,59,0,59,16,0,16,103,0,103
Assam,2005,Prep. And Assembly For Dacoity,0,0,0,0,0,0,5,0,5,2,0,2,7,0,7
Assam,2005,Robbery,0,0,0,11,0,11,8,0,8,0,0,0,19,0,19
Assam,2005,Burglary,0,0,0,6,0,6,28,0,28,1,0,1,35,0,35
Assam,2005,Thefts,0,0,0,69,0,69,87,1,88,12,0,12,168,1,169
Assam,2005,Extortion,0,0,0,1,0,1,8,0,8,0,0,0,9,0,9
Assam,2005,Riots,0,0,0,5,0,5,11,1,12,0,0,0,16,1,17
Assam,2005,Arson,0,0,0,10,0,10,4,0,4,0,0,0,14,0,14
Assam,2005,Criminal Breach Of Trust,0,0,0,0,0,0,3,0,3,0,0,0,3,0,3
Assam,2005,Cheating,0,0,0,3,0,3,3,0,3,0,0,0,6,0,6
Assam,2005,Counter Feiting,0,0,0,0,0,0,2,1,3,0,0,0,2,1,3
Assam,2005,Dowry Deaths,0,0,0,2,0,2,11,1,12,0,0,0,13,1,14
Assam,2005,Molestation,0,0,0,1,0,1,1,0,1,0,0,0,2,0,2
Assam,2005,Eve-Teasing,0,0,0,0,0,0,0,0,0,0,0,0,0,0,0
Assam,2005,Cruelty By Husband Or Relative Of Husband,0,0,0,6,0,6,6,0,6,4,0,4,16,0,16
Assam,2005,Other Ipc Crimes,0,0,0,10,0,10,15,0,15,0,0,0,25,0,25
Assam,2006,Murder,0,0,0,553,21,574,1102,27,1129,320,6,326,1975,54,2029
Assam,2006,Attempt To Commit Murder,0,0,0,52,9,61,75,0,75,42,0,42,169,9,178
Assam,2006,C.H. Not Amounting To Murder,0,0,0,127,2,129,92,7,99,22,1,23,241,10,251
Assam,2006,Rape,0,0,0,157,0,157,173,0,173,13,0,13,343,0,343
Assam,2006,Kidnapping And Abduction,0,0,0,34,0,34,47,3,50,0,0,0,81,3,84
Assam,2006,Dacoity,0,0,0,53,0,53,62,0,62,10,0,10,125,0,125
Assam,2006,Prep. And Assembly For Dacoity,0,0,0,0,0,0,1,0,1,0,0,0,1,0,1
Assam,2006,Robbery,0,0,0,15,0,15,15,0,15,4,0,4,34,0,34
Assam,2006,Burglary,0,0,0,7,1,8,7,1,8,2,0,2,16,2,18
Assam,2006,Thefts,0,0,0,46,1,47,72,0,72,4,0,4,122,1,123
Assam,2006,Extortion,0,0,0,3,0,3,0,0,0,0,0,0,3,0,3
Assam,2006,Riots,0,0,0,1,0,1,3,0,3,5,0,5,9,0,9
Assam,2006,Arson,0,0,0,11,0,11,9,0,9,3,0,3,23,0,23
Assam,2006,Criminal Breach Of Trust,0,0,0,0,0,0,3,0,3,1,0,1,4,0,4
Assam,2006,Cheating,0,0,0,5,0,5,9,0,9,0,0,0,14,0,14
Assam,2006,Counter Feiting,0,0,0,0,0,0,0,0,0,0,0,0,0,0,0
Assam,2006,Dowry Deaths,0,0,0,12,0,12,8,0,8,6,0,6,26,0,26
Assam,2006,Molestation,0,0,0,1,0,1,0,0,0,0,0,0,1,0,1
Assam,2006,Eve-Teasing,0,0,0,0,0,0,0,0,0,0,0,0,0,0,0
Assam,2006,Cruelty By Husband Or Relative Of Husband,0,0,0,12,0,12,7,0,7,0,0,0,19,0,19
Assam,2006,Other Ipc Crimes,0,0,0,54,1,55,83,2,85,13,0,13,150,3,153
Assam,2007,Murder,0,0,0,640,19,659,1264,38,1302,303,14,317,2207,71,2278
Assam,2007,Attempt To Commit Murder,0,0,0,70,5,75,85,1,86,20,0,20,175,6,181
Assam,2007,C.H. Not Amounting To Murder,0,0,0,67,0,67,137,6,143,34,0,34,238,6,244
Assam,2007,Rape,0,0,0,171,1,172,153,0,153,35,0,35,359,1,360
Assam,2007,Kidnapping And Abduction,0,0,0,37,2,39,29,1,30,3,0,3,69,3,72
Assam,2007,Dacoity,0,0,0,29,0,29,37,0,37,15,0,15,81,0,81
Assam,2007,Prep. And Assembly For Dacoity,0,0,0,0,0,0,1,0,1,0,0,0,1,0,1
Assam,2007,Robbery,0,0,0,7,0,7,10,0,10,4,0,4,21,0,21
Assam,2007,Burglary,0,0,0,3,0,3,3,0,3,0,0,0,6,0,6
Assam,2007,Thefts,0,0,0,26,0,26,29,0,29,8,0,8,63,0,63
Assam,2007,Extortion,0,0,0,2,0,2,10,0,10,2,0,2,14,0,14
Assam,2007,Riots,0,0,0,0,0,0,2,0,2,1,0,1,3,0,3
Assam,2007,Arson,0,0,0,4,0,4,12,0,12,2,0,2,18,0,18
Assam,2007,Criminal Breach Of Trust,0,0,0,5,0,5,2,0,2,0,0,0,7,0,7
Assam,2007,Cheating,0,0,0,3,0,3,8,0,8,2,0,2,13,0,13
Assam,2007,Counter Feiting,0,0,0,10,0,10,3,0,3,0,0,0,13,0,13
Assam,2007,Dowry Deaths,0,0,0,2,0,2,24,4,28,3,0,3,29,4,33
Assam,2007,Molestation,0,0,0,0,0,0,1,0,1,0,0,0,1,0,1
Assam,2007,Eve-Teasing,0,0,0,0,0,0,0,0,0,0,0,0,0,0,0
Assam,2007,Cruelty By Husband Or Relative Of Husband,0,0,0,14,1,15,16,1,17,1,1,2,31,3,34
Assam,2007,Other Ipc Crimes,0,0,0,8,0,8,33,0,33,4,0,4,45,0,45
Assam,2008,Murder,0,0,0,648,15,663,1135,27,1162,290,20,310,2073,62,2135
Assam,2008,Attempt To Commit Murder,0,0,0,48,4,52,87,2,89,27,2,29,162,8,170
Assam,2008,C.H. Not Amounting To Murder,0,0,0,62,2,64,120,1,121,31,0,31,213,3,216
Assam,2008,Rape,0,0,0,136,1,137,194,0,194,41,0,41,371,1,372
Assam,2008,Kidnapping And Abduction,0,0,0,51,3,54,30,1,31,5,2,7,86,6,92
Assam,2008,Dacoity,0,0,0,12,2,14,31,0,31,9,0,9,52,2,54
Assam,2008,Prep. And Assembly For Dacoity,0,0,0,0,0,0,0,0,0,0,0,0,0,0,0
Assam,2008,Robbery,0,0,0,14,2,16,10,0,10,7,0,7,31,2,33
Assam,2008,Burglary,0,0,0,7,0,7,7,0,7,0,0,0,14,0,14
Assam,2008,Thefts,0,0,0,34,0,34,43,0,43,13,0,13,90,0,90
Assam,2008,Extortion,0,0,0,3,0,3,10,0,10,4,0,4,17,0,17
Assam,2008,Riots,0,0,0,6,0,6,1,0,1,0,0,0,7,0,7
Assam,2008,Arson,0,0,0,8,0,8,10,0,10,3,0,3,21,0,21
Assam,2008,Criminal Breach Of Trust,0,0,0,4,0,4,3,0,3,0,0,0,7,0,7
Assam,2008,Cheating,0,0,0,4,0,4,10,0,10,3,0,3,17,0,17
Assam,2008,Counter Feiting,0,0,0,12,0,12,9,0,9,0,0,0,21,0,21
Assam,2008,Dowry Deaths,0,0,0,2,0,2,24,0,24,4,1,5,30,1,31
Assam,2008,Molestation,0,0,0,0,0,0,3,0,3,0,0,0,3,0,3
Assam,2008,Eve-Teasing,0,0,0,0,0,0,1,0,1,0,0,0,1,0,1
Assam,2008,Cruelty By Husband Or Relative Of Husband,0,0,0,16,2,18,20,1,21,2,0,2,38,3,41
Assam,2008,Other Ipc Crimes,0,0,0,10,1,11,30,3,33,7,0,7,47,4,51
Assam,2009,Murder,0,0,0,497,18,515,1035,30,1065,386,12,398,1918,60,1978
Assam,2009,Attempt To Commit Murder,0,0,0,62,2,64,89,6,95,56,1,57,207,9,216
Assam,2009,C.H. Not Amounting To Murder,0,0,0,57,2,59,110,8,118,26,1,27,193,11,204
Assam,2009,Rape,0,0,0,150,0,150,169,0,169,28,0,28,347,0,347
Assam,2009,Kidnapping And Abduction,0,0,0,32,2,34,50,1,51,0,0,0,82,3,85
Assam,2009,Dacoity,0,0,0,11,0,11,38,0,38,7,0,7,56,0,56
Assam,2009,Prep. And Assembly For Dacoity,0,0,0,0,0,0,1,0,1,0,0,0,1,0,1
Assam,2009,Robbery,0,0,0,17,0,17,18,0,18,0,0,0,35,0,35
Assam,2009,Burglary,0,0,0,4,0,4,10,0,10,0,0,0,14,0,14
Assam,2009,Thefts,0,0,0,31,0,31,57,2,59,1,0,1,89,2,91
Assam,2009,Extortion,0,0,0,5,0,5,11,0,11,2,0,2,18,0,18
Assam,2009,Riots,0,0,0,5,0,5,3,0,3,0,0,0,8,0,8
Assam,2009,Arson,0,0,0,9,0,9,13,0,13,3,0,3,25,0,25
Assam,2009,Criminal Breach Of Trust,0,0,0,4,0,4,3,0,3,0,0,0,7,0,7
Assam,2009,Cheating,0,0,0,5,0,5,2,0,2,0,0,0,7,0,7
Assam,2009,Counter Feiting,0,0,0,8,0,8,6,0,6,0,0,0,14,0,14
Assam,2009,Dowry Deaths,0,0,0,3,0,3,17,0,17,10,0,10,30,0,30
Assam,2009,Molestation,0,0,0,0,0,0,2,0,2,0,0,0,2,0,2
Assam,2009,Eve-Teasing,0,0,0,0,0,0,0,0,0,0,0,0,0,0,0
Assam,2009,Cruelty By Husband Or Relative Of Husband,0,0,0,10,0,10,23,0,23,0,0,0,33,0,33
Assam,2009,Other Ipc Crimes,0,0,0,0,0,0,0,0,0,0,0,0,0,0,0
Assam,2010,Murder,0,0,0,494,16,510,1065,42,1107,396,8,404,1955,66,2021
Assam,2010,Attempt To Commit Murder,0,0,0,43,3,46,93,6,99,61,0,61,197,9,206
Assam,2010,C.H. Not Amounting To Murder,0,0,0,65,2,67,106,9,115,26,0,26,197,11,208
Assam,2010,Rape,0,0,0,70,0,70,165,1,166,30,0,30,265,1,266
Assam,2010,Kidnapping And Abduction,0,0,0,26,2,28,45,0,45,0,0,0,71,2,73
Assam,2010,Dacoity,0,0,0,18,0,18,32,0,32,5,0,5,55,0,55
Assam,2010,Prep. And Assembly For Dacoity,0,0,0,2,0,2,0,0,0,1,0,1,3,0,3
Assam,2010,Robbery,0,0,0,14,0,14,16,0,16,0,0,0,30,0,30
Assam,2010,Burglary,0,0,0,3,0,3,8,0,8,0,1,1,11,1,12
Assam,2010,Thefts,0,0,0,23,0,23,71,1,72,12,0,12,106,1,107
Assam,2010,Extortion,0,0,0,3,0,3,4,0,4,1,0,1,8,0,8
Assam,2010,Riots,0,0,0,6,0,6,3,0,3,0,0,0,9,0,9
Assam,2010,Arson,0,0,0,7,0,7,12,0,12,2,0,2,21,0,21
Assam,2010,Criminal Breach Of Trust,0,0,0,2,0,2,1,0,1,0,0,0,3,0,3
Assam,2010,Cheating,0,0,0,4,0,4,2,0,2,0,0,0,6,0,6
Assam,2010,Counter Feiting,0,0,0,7,0,7,5,0,5,0,0,0,12,0,12
Assam,2010,Dowry Deaths,0,0,0,3,0,3,20,0,20,3,2,5,26,2,28
Assam,2010,Molestation,0,0,0,0,0,0,2,0,2,0,0,0,2,0,2
Assam,2010,Eve-Teasing,0,0,0,0,0,0,0,0,0,0,0,0,0,0,0
Assam,2010,Cruelty By Husband Or Relative Of Husband,0,0,0,6,0,6,17,0,17,1,0,1,24,0,24
Assam,2010,Other Ipc Crimes,0,0,0,11,0,11,19,3,22,4,0,4,34,3,37
Assam,2011,Murder,0,0,0,482,17,499,984,34,1018,385,6,391,1851,57,1908
Assam,2011,Attempt To Commit Murder,0,0,0,40,2,42,110,7,117,57,0,57,207,9,216
Assam,2011,C.H. Not Amounting To Murder,0,0,0,50,2,52,99,8,107,25,0,25,174,10,184
Assam,2011,Rape,0,0,0,82,0,82,155,2,157,20,0,20,257,2,259
Assam,2011,Kidnapping And Abduction,0,0,0,23,1,24,37,0,37,2,2,4,62,3,65
Assam,2011,Dacoity,0,0,0,15,0,15,33,0,33,6,1,7,54,1,55
Assam,2011,Prep. And Assembly For Dacoity,0,0,0,1,0,1,0,0,0,2,0,2,3,0,3
Assam,2011,Robbery,0,0,0,12,0,12,17,1,18,0,0,0,29,1,30
Assam,2011,Burglary,0,0,0,2,0,2,9,0,9,0,0,0,11,0,11
Assam,2011,Thefts,0,0,0,24,0,24,69,1,70,13,1,14,106,2,108
Assam,2011,Extortion,0,0,0,2,0,2,5,0,5,2,0,2,9,0,9
Assam,2011,Riots,0,0,0,8,0,8,3,0,3,0,0,0,11,0,11
Assam,2011,Arson,0,0,0,6,0,6,10,0,10,2,0,2,18,0,18
Assam,2011,Criminal Breach Of Trust,0,0,0,1,0,1,1,0,1,0,0,0,2,0,2
Assam,2011,Cheating,0,0,0,2,0,2,1,0,1,0,0,0,3,0,3
Assam,2011,Counter Feiting,0,0,0,9,0,9,4,0,4,0,0,0,13,0,13
Assam,2011,Dowry Deaths,0,0,0,2,0,2,21,0,21,2,0,2,25,0,25
Assam,2011,Molestation,0,0,0,0,0,0,2,0,2,0,0,0,2,0,2
Assam,2011,Eve-Teasing,0,0,0,0,0,0,0,0,0,0,0,0,0,0,0
Assam,2011,Cruelty By Husband Or Relative Of Husband,0,0,0,5,0,5,18,0,18,1,0,1,24,0,24
Assam,2011,Other Ipc Crimes,0,0,0,10,0,10,20,4,24,3,0,3,33,4,37
Assam,2012,Murder,0,0,0,484,17,501,986,35,1021,375,7,382,1845,59,1904
Assam,2012,Attempt To Commit Murder,0,0,0,42,2,44,110,7,117,57,0,57,209,9,218
Assam,2012,C.H. Not Amounting To Murder,0,0,0,48,2,50,98,7,105,25,0,25,171,9,180
Assam,2012,Rape,0,0,0,84,0,84,155,2,157,20,0,20,259,2,261
Assam,2012,Kidnapping And Abduction,0,0,0,23,1,24,37,0,37,2,2,4,62,3,65
Assam,2012,Dacoity,0,0,0,16,0,16,34,0,34,6,1,7,56,1,57
Assam,2012,Prep. And Assembly For Dacoity,0,0,0,1,0,1,0,0,0,2,0,2,3,0,3
Assam,2012,Robbery,0,0,0,13,0,13,16,1,17,0,0,0,29,1,30
Assam,2012,Burglary,0,0,0,2,0,2,9,0,9,0,0,0,11,0,11
Assam,2012,Thefts,0,0,0,25,0,25,70,1,71,13,1,14,108,2,110
Assam,2012,Extortion,0,0,0,2,0,2,5,0,5,2,0,2,9,0,9
Assam,2012,Riots,0,0,0,9,0,9,2,0,2,0,0,0,11,0,11
Assam,2012,Arson,0,0,0,5,0,5,11,0,11,2,0,2,18,0,18
Assam,2012,Criminal Breach Of Trust,0,0,0,1,0,1,1,0,1,0,0,0,2,0,2
Assam,2012,Cheating,0,0,0,2,0,2,1,0,1,0,0,0,3,0,3
Assam,2012,Counter Feiting,0,0,0,9,0,9,4,0,4,0,0,0,13,0,13
Assam,2012,Dowry Deaths,0,0,0,2,0,2,22,0,22,2,0,2,26,0,26
Assam,2012,Molestation,0,0,0,0,0,0,2,0,2,0,0,0,2,0,2
Assam,2012,Eve-Teasing,0,0,0,0,0,0,0,0,0,0,0,0,0,0,0
Assam,2012,Cruelty By Husband Or Relative Of Husband,0,0,0,6,0,6,18,0,18,1,0,1,25,0,25
Assam,2012,Other Ipc Crimes,0,0,0,11,0,11,21,4,25,3,0,3,35,4,39
Bihar,2001,Murder,1,0,1,385,4,389,1468,10,1478,935,24,959,2789,38,2827
Bihar,2001,Attempt To Commit Murder,0,0,0,132,1,133,230,3,233,156,0,156,518,4,522
Bihar,2001,C.H. Not Amounting To Murder,0,0,0,15,2,17,65,0,65,25,0,25,105,2,107
Bihar,2001,Rape,2,0,2,44,0,44,75,0,75,26,0,26,147,0,147
Bihar,2001,Kidnapping And Abduction,0,0,0,75,0,75,65,0,65,31,0,31,171,0,171
Bihar,2001,Dacoity,0,0,0,58,0,58,91,0,91,51,0,51,200,0,200
Bihar,2001,Prep. And Assembly For Dacoity,0,0,0,5,0,5,18,0,18,12,0,12,35,0,35
Bihar,2001,Robbery,4,0,4,60,0,60,35,0,35,25,0,25,124,0,124
Bihar,2001,Burglary,0,0,0,21,0,21,5,6,11,10,0,10,36,6,42
Bihar,2001,Thefts,4,0,4,45,0,45,31,0,31,14,0,14,94,0,94
Bihar,2001,Extortion,0,0,0,0,0,0,0,0,0,0,0,0,0,0,0
Bihar,2001,Riots,0,0,0,0,0,0,0,0,0,0,0,0,0,0,0
Bihar,2001,Arson,0,0,0,0,0,0,0,0,0,0,0,0,0,0,0
Bihar,2001,Criminal Breach Of Trust,0,0,0,0,0,0,0,0,0,0,0,0,0,0,0
Bihar,2001,Cheating,0,0,0,35,0,35,18,0,18,17,0,17,70,0,70
Bihar,2001,Counter Feiting,0,0,0,0,0,0,0,0,0,0,0,0,0,0,0
Bihar,2001,Dowry Deaths,0,0,0,0,0,0,0,0,0,0,0,0,0,0,0
Bihar,2001,Molestation,0,0,0,0,0,0,0,0,0,0,0,0,0,0,0
Bihar,2001,Eve-Teasing,0,0,0,0,0,0,0,0,0,0,0,0,0,0,0
Bihar,2001,Cruelty By Husband Or Relative Of Husband,0,0,0,0,0,0,0,0,0,0,0,0,0,0,0
Bihar,2001,Other Ipc Crimes,0,0,0,9,0,9,5,0,5,11,0,11,25,0,25
Bihar,2002,Murder,4,0,4,387,9,396,1529,35,1564,1105,7,1112,3025,51,3076
Bihar,2002,Attempt To Commit Murder,0,0,0,113,0,113,75,1,76,33,0,33,221,1,222
Bihar,2002,C.H. Not Amounting To Murder,2,0,2,32,0,32,54,8,62,36,1,37,124,9,133
Bihar,2002,Rape,0,0,0,75,0,75,33,0,33,10,0,10,118,0,118
Bihar,2002,Kidnapping And Abduction,0,0,0,28,0,28,67,1,68,21,0,21,116,1,117
Bihar,2002,Dacoity,0,0,0,59,0,59,173,3,176,41,0,41,273,3,276
Bihar,2002,Prep. And Assembly For Dacoity,0,0,0,7,0,7,7,0,7,0,0,0,14,0,14
Bihar,2002,Robbery,2,0,2,21,0,21,28,0,28,0,0,0,51,0,51
Bihar,2002,Burglary,0,0,0,7,0,7,1,0,1,4,0,4,12,0,12
Bihar,2002,Thefts,4,0,4,54,2,56,62,1,63,7,0,7,127,3,130
Bihar,2002,Extortion,0,0,0,0,0,0,2,0,2,1,0,1,3,0,3
Bihar,2002,Riots,10,0,10,18,0,18,12,0,12,4,0,4,44,0,44
Bihar,2002,Arson,0,0,0,2,0,2,1,0,1,0,0,0,3,0,3
Bihar,2002,Criminal Breach Of Trust,0,0,0,0,0,0,0,0,0,1,0,1,1,0,1
Bihar,2002,Cheating,0,0,0,0,0,0,5,0,5,1,0,1,6,0,6
Bihar,2002,Counter Feiting,0,0,0,0,0,0,15,0,15,0,0,0,15,0,15
Bihar,2002,Dowry Deaths,0,0,0,55,11,66,65,4,69,33,3,36,153,18,171
Bihar,2002,Molestation,0,0,0,1,0,1,1,0,1,0,0,0,2,0,2
Bihar,2002,Eve-Teasing,0,0,0,0,0,0,0,0,0,0,0,0,0,0,0
Bihar,2002,Cruelty By Husband Or Relative Of Husband,2,0,2,4,0,4,6,2,8,6,0,6,18,2,20
Bihar,2002,Other Ipc Crimes,0,0,0,1,0,1,36,4,40,0,1,1,37,5,42
Bihar,2003,Murder,0,0,0,329,6,335,1851,29,1880,850,22,872,3030,57,3087
Bihar,2003,Attempt To Commit Murder,0,0,0,96,0,96,137,1,138,62,0,62,295,1,296
Bihar,2003,C.H. Not Amounting To Murder,0,0,0,24,0,24,57,0,57,38,1,39,119,1,120
Bihar,2003,Rape,0,0,0,77,0,77,75,0,75,22,0,22,174,0,174
Bihar,2003,Kidnapping And Abduction,0,0,0,23,0,23,61,3,64,34,0,34,118,3,121
Bihar,2003,Dacoity,0,0,0,69,0,69,139,0,139,53,0,53,261,0,261
Bihar,2003,Prep. And Assembly For Dacoity,0,0,0,8,0,8,19,0,19,9,0,9,36,0,36
Bihar,2003,Robbery,0,0,0,14,0,14,32,0,32,0,0,0,46,0,46
Bihar,2003,Burglary,0,0,0,4,0,4,19,0,19,6,0,6,29,0,29
Bihar,2003,Thefts,0,0,0,59,0,59,73,0,73,12,0,12,144,0,144
Bihar,2003,Extortion,0,0,0,2,0,2,3,0,3,0,0,0,5,0,5
Bihar,2003,Riots,0,0,0,0,0,0,0,0,0,0,0,0,0,0,0
Bihar,2003,Arson,0,0,0,1,0,1,3,0,3,0,0,0,4,0,4
Bihar,2003,Criminal Breach Of Trust,0,0,0,0,0,0,0,0,0,1,0,1,1,0,1
Bihar,2003,Cheating,0,0,0,1,0,1,2,0,2,0,0,0,3,0,3
Bihar,2003,Counter Feiting,0,0,0,0,0,0,3,0,3,2,0,2,5,0,5
Bihar,2003,Dowry Deaths,0,0,0,64,8,72,97,14,111,52,6,58,213,28,241
Bihar,2003,Molestation,0,0,0,0,0,0,1,5,6,1,0,1,2,5,7
Bihar,2003,Eve-Teasing,0,0,0,0,0,0,0,0,0,0,0,0,0,0,0
Bihar,2003,Cruelty By Husband Or Relative Of Husband,0,0,0,0,0,0,7,0,7,0,0,0,7,0,7
Bihar,2003,Other Ipc Crimes,0,0,0,9,0,9,12,0,12,5,0,5,26,0,26
Bihar,2004,Murder,0,0,0,431,14,445,2087,40,2127,1017,27,1044,3535,81,3616
Bihar,2004,Attempt To Commit Murder,0,0,0,118,0,118,162,3,165,59,0,59,339,3,342
Bihar,2004,C.H. Not Amounting To Murder,0,0,0,19,0,19,76,4,80,15,1,16,110,5,115
Bihar,2004,Rape,0,0,0,69,0,69,71,0,71,19,0,19,159,0,159
Bihar,2004,Kidnapping And Abduction,0,0,0,44,1,45,94,1,95,31,1,32,169,3,172
Bihar,2004,Dacoity,0,0,0,68,0,68,115,0,115,43,0,43,226,0,226
Bihar,2004,Prep. And Assembly For Dacoity,0,0,0,6,0,6,17,0,17,6,0,6,29,0,29
Bihar,2004,Robbery,0,0,0,19,0,19,18,0,18,3,0,3,40,0,40
Bihar,2004,Burglary,0,0,0,15,0,15,19,0,19,5,0,5,39,0,39
Bihar,2004,Thefts,0,0,0,77,0,77,108,1,109,22,0,22,207,1,208
Bihar,2004,Extortion,0,0,0,0,0,0,6,0,6,2,0,2,8,0,8
Bihar,2004,Riots,0,0,0,6,0,6,2,0,2,0,0,0,8,0,8
Bihar,2004,Arson,0,0,0,0,0,0,3,0,3,0,0,0,3,0,3
Bihar,2004,Criminal Breach Of Trust,0,0,0,0,0,0,0,0,0,1,0,1,1,0,1
Bihar,2004,Cheating,0,0,0,1,0,1,4,0,4,2,0,2,7,0,7
Bihar,2004,Counter Feiting,0,0,0,10,0,10,10,0,10,4,0,4,24,0,24
Bihar,2004,Dowry Deaths,0,0,0,50,2,52,77,11,88,46,9,55,173,22,195
Bihar,2004,Molestation,0,0,0,0,0,0,2,0,2,0,0,0,2,0,2
Bihar,2004,Eve-Teasing,0,0,0,0,0,0,0,0,0,0,0,0,0,0,0
Bihar,2004,Cruelty By Husband Or Relative Of Husband,0,0,0,16,0,16,10,2,12,6,0,6,32,2,34
Bihar,2004,Other Ipc Crimes,0,0,0,3,0,3,11,0,11,0,0,0,14,0,14
Bihar,2005,Murder,0,0,0,704,10,714,1858,25,1883,945,5,950,3507,40,3547
Bihar,2005,Attempt To Commit Murder,0,0,0,106,1,107,226,3,229,92,0,92,424,4,428
Bihar,2005,C.H. Not Amounting To Murder,0,0,0,39,5,44,84,3,87,17,0,17,140,8,148
Bihar,2005,Rape,0,0,0,71,1,72,75,0,75,15,0,15,161,1,162
Bihar,2005,Kidnapping And Abduction,0,0,0,91,5,96,101,4,105,29,0,29,221,9,230
Bihar,2005,Dacoity,0,0,0,68,0,68,123,0,123,41,0,41,232,0,232
Bihar,2005,Prep. And Assembly For Dacoity,0,0,0,13,0,13,18,0,18,5,0,5,36,0,36
Bihar,2005,Robbery,0,0,0,64,0,64,58,0,58,14,0,14,136,0,136
Bihar,2005,Burglary,0,0,0,2,0,2,9,0,9,9,0,9,20,0,20
Bihar,2005,Thefts,0,0,0,99,0,99,12,0,12,35,0,35,146,0,146
Bihar,2005,Extortion,0,0,0,4,0,4,9,0,9,2,0,2,15,0,15
Bihar,2005,Riots,0,0,0,8,0,8,5,0,5,5,0,5,18,0,18
Bihar,2005,Arson,0,0,0,1,0,1,3,0,3,0,0,0,4,0,4
Bihar,2005,Criminal Breach Of Trust,0,0,0,0,0,0,0,0,0,0,0,0,0,0,0
Bihar,2005,Cheating,0,0,0,7,0,7,14,0,14,1,0,1,22,0,22
Bihar,2005,Counter Feiting,0,0,0,3,0,3,10,0,10,0,0,0,13,0,13
Bihar,2005,Dowry Deaths,0,0,0,26,10,36,84,20,104,43,12,55,153,42,195
Bihar,2005,Molestation,0,0,0,3,0,3,6,0,6,2,0,2,11,0,11
Bihar,2005,Eve-Teasing,0,0,0,0,0,0,0,0,0,0,0,0,0,0,0
Bihar,2005,Cruelty By Husband Or Relative Of Husband,0,0,0,3,0,3,5,0,5,5,0,5,13,0,13
Bihar,2005,Other Ipc Crimes,0,0,0,2,0,2,8,0,8,3,0,3,13,0,13
Bihar,2006,Murder,0,0,0,2518,30,2548,593,27,620,257,8,265,3368,65,3433
Bihar,2006,Attempt To Commit Murder,0,0,0,339,4,343,197,5,202,18,0,18,554,9,563
Bihar,2006,C.H. Not Amounting To Murder,0,0,0,94,4,98,70,0,70,13,0,13,177,4,181
Bihar,2006,Rape,0,0,0,112,0,112,82,0,82,12,0,12,206,0,206
Bihar,2006,Kidnapping And Abduction,0,0,0,125,1,126,82,13,95,21,0,21,228,14,242
Bihar,2006,Dacoity,0,0,0,150,0,150,77,4,81,22,0,22,249,4,253
Bihar,2006,Prep. And Assembly For Dacoity,0,0,0,34,0,34,9,0,9,4,0,4,47,0,47
Bihar,2006,Robbery,0,0,0,95,0,95,46,0,46,19,0,19,160,0,160
Bihar,2006,Burglary,0,0,0,23,0,23,18,2,20,5,0,5,46,2,48
Bihar,2006,Thefts,0,0,0,125,1,126,25,1,26,5,0,5,155,2,157
Bihar,2006,Extortion,0,0,0,14,0,14,8,0,8,6,0,6,28,0,28
Bihar,2006,Riots,0,0,0,22,0,22,16,0,16,3,0,3,41,0,41
Bihar,2006,Arson,0,0,0,18,0,18,10,0,10,3,0,3,31,0,31
Bihar,2006,Criminal Breach Of Trust,0,0,0,17,0,17,7,0,7,0,0,0,24,0,24
Bihar,2006,Cheating,0,0,0,21,1,22,11,0,11,6,0,6,38,1,39
Bihar,2006,Counter Feiting,0,0,0,15,1,16,5,2,7,0,0,0,20,3,23
Bihar,2006,Dowry Deaths,0,0,0,113,11,124,44,22,66,23,2,25,180,35,215
Bihar,2006,Molestation,0,0,0,25,0,25,7,0,7,8,0,8,40,0,40
Bihar,2006,Eve-Teasing,0,0,0,12,0,12,10,0,10,7,0,7,29,0,29
Bihar,2006,Cruelty By Husband Or Relative Of Husband,0,0,0,29,0,29,23,0,23,9,0,9,61,0,61
Bihar,2006,Other Ipc Crimes,0,0,0,21,0,21,1,0,1,10,0,10,32,0,32
Bihar,2007,Murder,0,0,0,956,32,988,1657,10,1667,427,8,435,3040,50,3090
Bihar,2007,Attempt To Commit Murder,0,0,0,340,6,346,296,5,301,78,2,80,714,13,727
Bihar,2007,C.H. Not Amounting To Murder,0,0,0,60,3,63,78,0,78,23,0,23,161,3,164
Bihar,2007,Rape,0,0,0,72,0,72,85,0,85,15,0,15,172,0,172
Bihar,2007,Kidnapping And Abduction,0,0,0,105,1,106,102,13,115,30,2,32,237,16,253
Bihar,2007,Dacoity,0,0,0,146,0,146,91,4,95,23,0,23,260,4,264
Bihar,2007,Prep. And Assembly For Dacoity,0,0,0,34,0,34,9,0,9,1,0,1,44,0,44
Bihar,2007,Robbery,0,0,0,95,0,95,66,0,66,21,0,21,182,0,182
Bihar,2007,Burglary,0,0,0,20,0,20,18,2,20,3,0,3,41,2,43
Bihar,2007,Thefts,0,0,0,90,1,91,26,1,27,7,0,7,123,2,125
Bihar,2007,Extortion,0,0,0,14,0,14,12,0,12,8,0,8,34,0,34
Bihar,2007,Riots,0,0,0,17,0,17,17,0,17,4,0,4,38,0,38
Bihar,2007,Arson,0,0,0,15,0,15,16,0,16,6,0,6,37,0,37
Bihar,2007,Criminal Breach Of Trust,0,0,0,14,0,14,10,0,10,1,0,1,25,0,25
Bihar,2007,Cheating,0,0,0,12,1,13,11,1,12,4,0,4,27,2,29
Bihar,2007,Counter Feiting,0,0,0,10,1,11,3,1,4,0,0,0,13,2,15
Bihar,2007,Dowry Deaths,0,0,0,53,10,63,60,8,68,12,2,14,125,20,145
Bihar,2007,Molestation,0,0,0,12,0,12,6,0,6,6,0,6,24,0,24
Bihar,2007,Eve-Teasing,0,0,0,6,0,6,4,0,4,0,0,0,10,0,10
Bihar,2007,Cruelty By Husband Or Relative Of Husband,0,0,0,25,1,26,19,1,20,8,1,9,52,3,55
Bihar,2007,Other Ipc Crimes,0,0,0,11,0,11,0,0,0,0,0,0,11,0,11
Bihar,2008,Murder,0,0,0,936,24,960,1674,11,1685,601,14,615,3211,49,3260
Bihar,2008,Attempt To Commit Murder,0,0,0,195,4,199,186,3,189,56,0,56,437,7,444
Bihar,2008,C.H. Not Amounting To Murder,0,0,0,64,2,66,70,0,70,23,0,23,157,2,159
Bihar,2008,Rape,0,0,0,56,0,56,82,0,82,16,0,16,154,0,154
Bihar,2008,Kidnapping And Abduction,0,0,0,95,1,96,82,8,90,43,0,43,220,9,229
Bihar,2008,Dacoity,0,0,0,98,0,98,87,3,90,32,0,32,217,3,220
Bihar,2008,Prep. And Assembly For Dacoity,0,0,0,34,0,34,9,0,9,4,0,4,47,0,47
Bihar,2008,Robbery,0,0,0,80,0,80,56,0,56,31,0,31,167,0,167
Bihar,2008,Burglary,0,0,0,19,0,19,18,2,20,5,0,5,42,2,44
Bihar,2008,Thefts,0,0,0,85,1,86,25,1,26,5,0,5,115,2,117
Bihar,2008,Extortion,0,0,0,11,0,11,8,0,8,7,0,7,26,0,26
Bihar,2008,Riots,0,0,0,15,0,15,16,0,16,3,0,3,34,0,34
Bihar,2008,Arson,0,0,0,18,0,18,10,0,10,5,0,5,33,0,33
Bihar,2008,Criminal Breach Of Trust,0,0,0,14,0,14,7,0,7,0,0,0,21,0,21
Bihar,2008,Cheating,0,0,0,16,1,17,11,0,11,8,0,8,35,1,36
Bihar,2008,Counter Feiting,0,0,0,15,1,16,5,2,7,0,0,0,20,3,23
Bihar,2008,Dowry Deaths,0,0,0,51,11,62,46,8,54,24,8,32,121,27,148
Bihar,2008,Molestation,0,0,0,0,0,0,7,0,7,8,0,8,15,0,15
Bihar,2008,Eve-Teasing,0,0,0,6,0,6,10,0,10,9,0,9,25,0,25
Bihar,2008,Cruelty By Husband Or Relative Of Husband,0,0,0,10,0,10,23,0,23,10,0,10,43,0,43
Bihar,2008,Other Ipc Crimes,0,0,0,11,0,11,12,0,12,11,0,11,34,0,34
Bihar,2009,Murder,0,0,0,902,19,921,1562,10,1572,542,8,550,3006,37,3043
Bihar,2009,Attempt To Commit Murder,0,0,0,184,4,188,161,4,165,44,0,44,389,8,397
Bihar,2009,C.H. Not Amounting To Murder,0,0,0,58,1,59,61,0,61,18,0,18,137,1,138
Bihar,2009,Rape,0,0,0,51,0,51,70,0,70,15,0,15,136,0,136
Bihar,2009,Kidnapping And Abduction,0,0,0,89,1,90,78,7,85,37,0,37,204,8,212
Bihar,2009,Dacoity,0,0,0,91,0,91,86,2,88,23,0,23,200,2,202
Bihar,2009,Prep. And Assembly For Dacoity,0,0,0,34,0,34,10,0,10,4,0,4,48,0,48
Bihar,2009,Robbery,0,0,0,74,0,74,52,0,52,28,0,28,154,0,154
Bihar,2009,Burglary,0,0,0,18,0,18,17,2,19,5,0,5,40,2,42
Bihar,2009,Thefts,0,0,0,81,1,82,25,1,26,5,0,5,111,2,113
Bihar,2009,Extortion,0,0,0,11,0,11,8,0,8,6,0,6,25,0,25
Bihar,2009,Riots,0,0,0,14,0,14,15,0,15,3,0,3,32,0,32
Bihar,2009,Arson,0,0,0,19,0,19,9,0,9,4,0,4,32,0,32
Bihar,2009,Criminal Breach Of Trust,0,0,0,14,0,14,8,0,8,0,0,0,22,0,22
Bihar,2009,Cheating,0,0,0,15,0,15,12,0,12,7,0,7,34,0,34
Bihar,2009,Counter Feiting,0,0,0,13,1,14,5,1,6,0,0,0,18,2,20
Bihar,2009,Dowry Deaths,0,0,0,49,8,57,47,8,55,21,6,27,117,22,139
Bihar,2009,Molestation,0,0,0,0,0,0,9,0,9,7,0,7,16,0,16
Bihar,2009,Eve-Teasing,0,0,0,6,0,6,11,0,11,9,0,9,26,0,26
Bihar,2009,Cruelty By Husband Or Relative Of Husband,0,0,0,11,0,11,21,0,21,8,0,8,40,0,40
Bihar,2009,Other Ipc Crimes,0,0,0,10,0,10,11,0,11,10,0,10,31,0,31
Bihar,2010,Murder,0,0,0,841,18,859,1512,11,1523,543,8,551,2896,37,2933
Bihar,2010,Attempt To Commit Murder,0,0,0,163,6,169,147,5,152,44,1,45,354,12,366
Bihar,2010,C.H. Not Amounting To Murder,0,0,0,47,1,48,57,0,57,18,0,18,122,1,123
Bihar,2010,Rape,0,0,0,45,0,45,68,0,68,15,0,15,128,0,128
Bihar,2010,Kidnapping And Abduction,0,0,0,72,1,73,73,8,81,39,0,39,184,9,193
Bihar,2010,Dacoity,0,0,0,84,0,84,81,2,83,24,0,24,189,2,191
Bihar,2010,Prep. And Assembly For Dacoity,0,0,0,33,0,33,11,0,11,4,0,4,48,0,48
Bihar,2010,Robbery,0,0,0,69,0,69,48,0,48,29,0,29,146,0,146
Bihar,2010,Burglary,0,0,0,18,0,18,17,3,20,5,0,5,40,3,43
Bihar,2010,Thefts,0,0,0,77,2,79,23,2,25,6,0,6,106,4,110
Bihar,2010,Extortion,0,0,0,10,0,10,9,0,9,7,0,7,26,0,26
Bihar,2010,Riots,0,0,0,13,0,13,14,0,14,3,0,3,30,0,30
Bihar,2010,Arson,0,0,0,17,0,17,7,0,7,5,0,5,29,0,29
Bihar,2010,Criminal Breach Of Trust,0,0,0,14,0,14,9,0,9,0,0,0,23,0,23
Bihar,2010,Cheating,0,0,0,12,0,12,11,0,11,6,0,6,29,0,29
Bihar,2010,Counter Feiting,0,0,0,12,1,13,5,1,6,0,0,0,17,2,19
Bihar,2010,Dowry Deaths,0,0,0,45,8,53,45,10,55,20,7,27,110,25,135
Bihar,2010,Molestation,0,0,0,0,0,0,9,0,9,7,0,7,16,0,16
Bihar,2010,Eve-Teasing,0,0,0,6,0,6,9,0,9,8,0,8,23,0,23
Bihar,2010,Cruelty By Husband Or Relative Of Husband,0,0,0,11,0,11,20,0,20,8,0,8,39,0,39
Bihar,2010,Other Ipc Crimes,0,0,0,9,0,9,9,0,9,10,0,10,28,0,28
Bihar,2011,Murder,0,0,0,658,8,666,1124,26,1150,783,4,787,2565,38,2603
Bihar,2011,Attempt To Commit Murder,0,0,0,89,0,89,153,9,162,54,2,56,296,11,307
Bihar,2011,C.H. Not Amounting To Murder,0,0,0,17,1,18,57,4,61,25,0,25,99,5,104
Bihar,2011,Rape,0,0,0,65,0,65,68,0,68,8,0,8,141,0,141
Bihar,2011,Kidnapping And Abduction,0,0,0,80,1,81,90,2,92,18,0,18,188,3,191
Bihar,2011,Dacoity,0,0,0,54,0,54,95,0,95,26,0,26,175,0,175
Bihar,2011,Prep. And Assembly For Dacoity,0,0,0,8,0,8,9,0,9,4,1,5,21,1,22
Bihar,2011,Robbery,0,0,0,44,0,44,32,0,32,4,0,4,80,0,80
Bihar,2011,Burglary,0,0,0,14,0,14,4,0,4,0,0,0,18,0,18
Bihar,2011,Thefts,0,0,0,73,0,73,62,1,63,17,0,17,152,1,153
Bihar,2011,Extortion,0,0,0,4,0,4,6,0,6,2,0,2,12,0,12
Bihar,2011,Riots,0,0,0,0,0,0,10,0,10,5,0,5,15,0,15
Bihar,2011,Arson,0,0,0,4,0,4,17,0,17,6,0,6,27,0,27
Bihar,2011,Criminal Breach Of Trust,0,0,0,1,0,1,3,0,3,1,0,1,5,0,5
Bihar,2011,Cheating,0,0,0,4,0,4,3,0,3,2,0,2,9,0,9
Bihar,2011,Counter Feiting,0,0,0,0,0,0,0,0,0,0,0,0,0,0,0
Bihar,2011,Dowry Deaths,0,0,0,64,4,68,86,9,95,42,8,50,192,21,213
Bihar,2011,Molestation,0,0,0,0,0,0,0,0,0,0,0,0,0,0,0
Bihar,2011,Eve-Teasing,0,0,0,1,0,1,2,0,2,0,0,0,3,0,3
Bihar,2011,Cruelty By Husband Or Relative Of Husband,0,0,0,7,0,7,14,0,14,2,0,2,23,0,23
Bihar,2011,Other Ipc Crimes,0,0,0,5,0,5,16,0,16,0,0,0,21,0,21
Bihar,2012,Murder,0,0,0,428,7,435,1105,32,1137,568,7,575,2101,46,2147
Bihar,2012,Attempt To Commit Murder,0,0,0,67,0,67,117,7,124,35,1,36,219,8,227
Bihar,2012,C.H. Not Amounting To Murder,0,0,0,17,1,18,48,7,55,13,1,14,78,9,87
Bihar,2012,Rape,0,0,0,54,0,54,81,0,81,12,0,12,147,0,147
Bihar,2012,Kidnapping And Abduction,0,0,0,66,0,66,105,6,111,61,0,61,232,6,238
Bihar,2012,Dacoity,0,0,0,47,0,47,75,0,75,24,0,24,146,0,146
Bihar,2012,Prep. And Assembly For Dacoity,0,0,0,20,0,20,13,0,13,10,0,10,43,0,43
Bihar,2012,Robbery,0,0,0,34,0,34,39,0,39,9,0,9,82,0,82
Bihar,2012,Burglary,0,0,0,1,0,1,2,0,2,0,0,0,3,0,3
Bihar,2012,Thefts,0,0,0,64,0,64,78,0,78,13,0,13,155,0,155
Bihar,2012,Extortion,0,0,0,4,0,4,10,0,10,4,0,4,18,0,18
Bihar,2012,Riots,0,0,0,0,0,0,0,0,0,0,0,0,0,0,0
Bihar,2012,Arson,0,0,0,1,0,1,9,0,9,3,0,3,13,0,13
Bihar,2012,Criminal Breach Of Trust,0,0,0,1,0,1,3,0,3,0,0,0,4,0,4
Bihar,2012,Cheating,0,0,0,1,0,1,5,0,5,0,0,0,6,0,6
Bihar,2012,Counter Feiting,0,0,0,0,0,0,3,0,3,0,0,0,3,0,3
Bihar,2012,Dowry Deaths,0,0,0,71,3,74,137,8,145,48,11,59,256,22,278
Bihar,2012,Molestation,0,0,0,0,0,0,0,0,0,0,0,0,0,0,0
Bihar,2012,Eve-Teasing,0,0,0,0,0,0,0,0,0,0,0,0,0,0,0
Bihar,2012,Cruelty By Husband Or Relative Of Husband,0,0,0,3,0,3,4,0,4,2,0,2,9,0,9
Bihar,2012,Other Ipc Crimes,0,0,0,9,0,9,5,0,5,2,0,2,16,0,16
Chhattisgarh,2012,Murder,0,0,0,1485,56,1541,1701,95,1796,668,25,693,3854,176,4030
Chhattisgarh,2012,Attempt To Commit Murder,0,0,0,118,1,119,59,0,59,18,1,19,195,2,197
Chhattisgarh,2012,C.H. Not Amounting To Murder,0,0,0,60,7,67,53,4,57,19,0,19,132,11,143
Chhattisgarh,2012,Rape,0,0,0,211,0,211,146,3,149,28,0,28,385,3,388
Chhattisgarh,2012,Kidnapping And Abduction,0,0,0,33,0,33,10,0,10,1,0,1,44,0,44
Chhattisgarh,2012,Dacoity,0,0,0,47,0,47,38,0,38,6,0,6,91,0,91
Chhattisgarh,2012,Prep. And Assembly For Dacoity,0,0,0,0,0,0,0,0,0,0,0,0,0,0,0
Chhattisgarh,2012,Robbery,0,0,0,38,0,38,35,0,35,0,0,0,73,0,73
Chhattisgarh,2012,Burglary,0,0,0,15,0,15,12,0,12,3,0,3,30,0,30
Chhattisgarh,2012,Thefts,0,0,0,97,0,97,42,0,42,21,0,21,160,0,160
Chhattisgarh,2012,Extortion,0,0,0,2,0,2,0,0,0,0,0,0,2,0,2
Chhattisgarh,2012,Riots,0,0,0,2,0,2,1,0,1,0,0,0,3,0,3
Chhattisgarh,2012,Arson,0,0,0,5,0,5,5,0,5,2,0,2,12,0,12
Chhattisgarh,2012,Criminal Breach Of Trust,0,0,0,0,0,0,2,0,2,0,0,0,2,0,2
Chhattisgarh,2012,Cheating,0,0,0,2,0,2,13,0,13,6,0,6,21,0,21
Chhattisgarh,2012,Counter Feiting,0,0,0,11,0,11,10,0,10,1,0,1,22,0,22
Chhattisgarh,2012,Dowry Deaths,0,0,0,63,5,68,31,14,45,10,6,16,104,25,129
Chhattisgarh,2012,Molestation,0,0,0,12,0,12,6,0,6,0,0,0,18,0,18
Chhattisgarh,2012,Eve-Teasing,0,0,0,0,0,0,0,0,0,0,0,0,0,0,0
Chhattisgarh,2012,Cruelty By Husband Or Relative Of Husband,0,0,0,1,0,1,6,1,7,0,0,0,7,1,8
Chhattisgarh,2012,Other Ipc Crimes,0,0,0,69,0,69,48,1,49,20,0,20,137,1,138
Chhattisgarh,2001,Murder,6,0,6,1267,47,1314,1303,66,1369,447,25,472,3023,138,3161
Chhattisgarh,2001,Attempt To Commit Murder,0,0,0,82,1,83,81,1,82,24,0,24,187,2,189
Chhattisgarh,2001,C.H. Not Amounting To Murder,3,0,3,31,2,33,45,2,47,4,3,7,83,7,90
Chhattisgarh,2001,Rape,7,0,7,156,1,157,148,2,150,33,0,33,344,3,347
Chhattisgarh,2001,Kidnapping And Abduction,0,0,0,21,0,21,4,0,4,0,0,0,25,0,25
Chhattisgarh,2001,Dacoity,0,0,0,34,0,34,36,0,36,4,0,4,74,0,74
Chhattisgarh,2001,Prep. And Assembly For Dacoity,0,0,0,0,0,0,0,0,0,0,0,0,0,0,0
Chhattisgarh,2001,Robbery,0,0,0,13,0,13,7,0,7,0,0,0,20,0,20
Chhattisgarh,2001,Burglary,0,0,0,17,0,17,23,1,24,0,0,0,40,1,41
Chhattisgarh,2001,Thefts,5,0,5,113,1,114,95,1,96,0,0,0,213,2,215
Chhattisgarh,2001,Extortion,0,0,0,0,0,0,0,0,0,0,0,0,0,0,0
Chhattisgarh,2001,Riots,0,0,0,0,0,0,0,0,0,0,0,0,0,0,0
Chhattisgarh,2001,Arson,0,0,0,8,0,8,2,0,2,0,0,0,10,0,10
Chhattisgarh,2001,Criminal Breach Of Trust,0,0,0,1,0,1,3,0,3,0,0,0,4,0,4
Chhattisgarh,2001,Cheating,0,0,0,1,0,1,3,0,3,0,0,0,4,0,4
Chhattisgarh,2001,Counter Feiting,0,0,0,0,0,0,0,0,0,0,0,0,0,0,0
Chhattisgarh,2001,Dowry Deaths,0,0,0,14,1,15,11,1,12,4,2,6,29,4,33
Chhattisgarh,2001,Molestation,0,0,0,6,0,6,1,0,1,0,0,0,7,0,7
Chhattisgarh,2001,Eve-Teasing,0,0,0,0,0,0,0,0,0,0,0,0,0,0,0
Chhattisgarh,2001,Cruelty By Husband Or Relative Of Husband,0,0,0,4,0,4,5,1,6,3,1,4,12,2,14
Chhattisgarh,2001,Other Ipc Crimes,2,0,2,62,2,64,53,4,57,0,0,0,117,6,123
Chhattisgarh,2002,Murder,11,0,11,1437,20,1457,1622,120,1742,234,14,248,3304,154,3458
Chhattisgarh,2002,Attempt To Commit Murder,9,0,9,81,1,82,39,1,40,11,0,11,140,2,142
Chhattisgarh,2002,C.H. Not Amounting To Murder,0,0,0,47,2,49,69,3,72,9,6,15,125,11,136
Chhattisgarh,2002,Rape,28,0,28,137,0,137,159,1,160,15,0,15,339,1,340
Chhattisgarh,2002,Kidnapping And Abduction,0,0,0,25,0,25,14,0,14,7,0,7,46,0,46
Chhattisgarh,2002,Dacoity,2,0,2,42,0,42,27,0,27,3,0,3,74,0,74
Chhattisgarh,2002,Prep. And Assembly For Dacoity,0,0,0,0,0,0,0,0,0,0,0,0,0,0,0
Chhattisgarh,2002,Robbery,0,0,0,23,0,23,19,0,19,6,0,6,48,0,48
Chhattisgarh,2002,Burglary,5,0,5,14,0,14,9,0,9,1,0,1,29,0,29
Chhattisgarh,2002,Thefts,17,1,18,103,2,105,77,0,77,15,1,16,212,4,216
Chhattisgarh,2002,Extortion,0,0,0,2,0,2,0,0,0,1,0,1,3,0,3
Chhattisgarh,2002,Riots,0,0,0,4,0,4,1,0,1,2,0,2,7,0,7
Chhattisgarh,2002,Arson,0,0,0,5,0,5,4,0,4,1,0,1,10,0,10
Chhattisgarh,2002,Criminal Breach Of Trust,0,0,0,10,0,10,3,0,3,2,0,2,15,0,15
Chhattisgarh,2002,Cheating,0,0,0,5,0,5,5,0,5,2,0,2,12,0,12
Chhattisgarh,2002,Counter Feiting,0,0,0,1,0,1,1,0,1,0,0,0,2,0,2
Chhattisgarh,2002,Dowry Deaths,0,0,0,15,1,16,12,4,16,7,0,7,34,5,39
Chhattisgarh,2002,Molestation,0,0,0,3,0,3,2,0,2,0,0,0,5,0,5
Chhattisgarh,2002,Eve-Teasing,0,0,0,1,0,1,1,0,1,0,0,0,2,0,2
Chhattisgarh,2002,Cruelty By Husband Or Relative Of Husband,0,0,0,5,0,5,15,0,15,8,0,8,28,0,28
Chhattisgarh,2002,Other Ipc Crimes,4,0,4,45,0,45,44,2,46,17,0,17,110,2,112
Chhattisgarh,2003,Murder,7,0,7,1010,56,1066,1691,84,1775,250,22,272,2958,162,3120
Chhattisgarh,2003,Attempt To Commit Murder,1,0,1,77,2,79,46,0,46,6,0,6,130,2,132
Chhattisgarh,2003,C.H. Not Amounting To Murder,1,0,1,24,0,24,54,2,56,7,1,8,86,3,89
Chhattisgarh,2003,Rape,3,0,3,185,1,186,211,0,211,28,0,28,427,1,428
Chhattisgarh,2003,Kidnapping And Abduction,0,0,0,2,0,2,0,0,0,0,0,0,2,0,2
Chhattisgarh,2003,Dacoity,1,0,1,41,1,42,44,0,44,10,0,10,96,1,97
Chhattisgarh,2003,Prep. And Assembly For Dacoity,0,0,0,17,0,17,15,0,15,0,0,0,32,0,32
Chhattisgarh,2003,Robbery,0,0,0,14,1,15,41,0,41,5,0,5,60,1,61
Chhattisgarh,2003,Burglary,0,0,0,19,0,19,20,0,20,6,0,6,45,0,45
Chhattisgarh,2003,Thefts,8,0,8,78,0,78,79,0,79,18,0,18,183,0,183
Chhattisgarh,2003,Extortion,0,0,0,0,0,0,0,0,0,0,0,0,0,0,0
Chhattisgarh,2003,Riots,0,0,0,0,0,0,0,0,0,0,0,0,0,0,0
Chhattisgarh,2003,Arson,0,0,0,3,0,3,8,0,8,0,0,0,11,0,11
Chhattisgarh,2003,Criminal Breach Of Trust,0,0,0,0,0,0,1,0,1,0,0,0,1,0,1
Chhattisgarh,2003,Cheating,0,0,0,2,0,2,6,0,6,0,0,0,8,0,8
Chhattisgarh,2003,Counter Feiting,0,0,0,0,0,0,0,0,0,2,0,2,2,0,2
Chhattisgarh,2003,Dowry Deaths,0,0,0,20,3,23,32,2,34,9,1,10,61,6,67
Chhattisgarh,2003,Molestation,0,0,0,6,0,6,2,0,2,0,0,0,8,0,8
Chhattisgarh,2003,Eve-Teasing,0,0,0,0,0,0,0,0,0,0,0,0,0,0,0
Chhattisgarh,2003,Cruelty By Husband Or Relative Of Husband,0,0,0,4,0,4,4,1,5,0,0,0,8,1,9
Chhattisgarh,2003,Other Ipc Crimes,0,0,0,51,1,52,56,2,58,11,1,12,118,4,122
Chhattisgarh,2004,Murder,0,0,0,917,34,951,1726,82,1808,359,27,386,3002,143,3145
Chhattisgarh,2004,Attempt To Commit Murder,0,0,0,44,3,47,71,2,73,19,0,19,134,5,139
Chhattisgarh,2004,C.H. Not Amounting To Murder,0,0,0,28,1,29,34,3,37,12,1,13,74,5,79
Chhattisgarh,2004,Rape,0,0,0,122,1,123,186,0,186,29,0,29,337,1,338
Chhattisgarh,2004,Kidnapping And Abduction,0,0,0,10,8,18,28,0,28,8,0,8,46,8,54
Chhattisgarh,2004,Dacoity,0,0,0,23,0,23,7,0,7,8,0,8,38,0,38
Chhattisgarh,2004,Prep. And Assembly For Dacoity,0,0,0,6,0,6,6,0,6,8,0,8,20,0,20
Chhattisgarh,2004,Robbery,0,0,0,12,0,12,10,0,10,7,0,7,29,0,29
Chhattisgarh,2004,Burglary,0,0,0,17,0,17,16,0,16,2,0,2,35,0,35
Chhattisgarh,2004,Thefts,0,0,0,39,0,39,29,0,29,2,0,2,70,0,70
Chhattisgarh,2004,Extortion,0,0,0,0,0,0,0,0,0,0,0,0,0,0,0
Chhattisgarh,2004,Riots,0,0,0,10,0,10,10,0,10,0,0,0,20,0,20
Chhattisgarh,2004,Arson,0,0,0,3,0,3,2,0,2,0,0,0,5,0,5
Chhattisgarh,2004,Criminal Breach Of Trust,0,0,0,0,0,0,16,0,16,1,0,1,17,0,17
Chhattisgarh,2004,Cheating,0,0,0,0,0,0,10,0,10,9,0,9,19,0,19
Chhattisgarh,2004,Counter Feiting,0,0,0,2,0,2,0,0,0,6,0,6,8,0,8
Chhattisgarh,2004,Dowry Deaths,0,0,0,0,0,0,18,3,21,1,0,1,19,3,22
Chhattisgarh,2004,Molestation,0,0,0,2,0,2,8,0,8,0,0,0,10,0,10
Chhattisgarh,2004,Eve-Teasing,0,0,0,0,0,0,0,0,0,0,0,0,0,0,0
Chhattisgarh,2004,Cruelty By Husband Or Relative Of Husband,0,0,0,2,6,8,12,2,14,0,1,1,14,9,23
Chhattisgarh,2004,Other Ipc Crimes,0,0,0,50,4,54,64,5,69,16,0,16,130,9,139
Chhattisgarh,2005,Murder,0,0,0,656,20,676,1651,69,1720,320,28,348,2627,117,2744
Chhattisgarh,2005,Attempt To Commit Murder,0,0,0,74,1,75,134,8,142,17,2,19,225,11,236
Chhattisgarh,2005,C.H. Not Amounting To Murder,0,0,0,34,2,36,69,6,75,15,0,15,118,8,126
Chhattisgarh,2005,Rape,0,0,0,118,0,118,159,0,159,13,0,13,290,0,290
Chhattisgarh,2005,Kidnapping And Abduction,0,0,0,31,0,31,23,0,23,0,0,0,54,0,54
Chhattisgarh,2005,Dacoity,0,0,0,38,1,39,22,0,22,0,0,0,60,1,61
Chhattisgarh,2005,Prep. And Assembly For Dacoity,0,0,0,11,0,11,3,0,3,5,0,5,19,0,19
Chhattisgarh,2005,Robbery,0,0,0,29,0,29,13,0,13,4,0,4,46,0,46
Chhattisgarh,2005,Burglary,0,0,0,18,0,18,18,0,18,0,0,0,36,0,36
Chhattisgarh,2005,Thefts,0,0,0,43,2,45,16,0,16,1,0,1,60,2,62
Chhattisgarh,2005,Extortion,0,0,0,3,0,3,11,0,11,0,0,0,14,0,14
Chhattisgarh,2005,Riots,0,0,0,7,0,7,3,3,6,7,0,7,17,3,20
Chhattisgarh,2005,Arson,0,0,0,2,0,2,0,0,0,1,0,1,3,0,3
Chhattisgarh,2005,Criminal Breach Of Trust,0,0,0,3,0,3,5,0,5,3,0,3,11,0,11
Chhattisgarh,2005,Cheating,0,0,0,10,0,10,7,0,7,0,0,0,17,0,17
Chhattisgarh,2005,Counter Feiting,0,0,0,4,0,4,0,0,0,0,0,0,4,0,4
Chhattisgarh,2005,Dowry Deaths,0,0,0,16,1,17,23,9,32,2,0,2,41,10,51
Chhattisgarh,2005,Molestation,0,0,0,6,0,6,7,0,7,2,0,2,15,0,15
Chhattisgarh,2005,Eve-Teasing,0,0,0,0,0,0,0,0,0,0,0,0,0,0,0
Chhattisgarh,2005,Cruelty By Husband Or Relative Of Husband,0,0,0,13,6,19,13,1,14,2,2,4,28,9,37
Chhattisgarh,2005,Other Ipc Crimes,0,0,0,58,1,59,38,1,39,5,1,6,101,3,104
Chhattisgarh,2006,Murder,0,0,0,817,33,850,1837,81,1918,202,27,229,2856,141,2997
Chhattisgarh,2006,Attempt To Commit Murder,0,0,0,58,3,61,102,3,105,33,1,34,193,7,200
Chhattisgarh,2006,C.H. Not Amounting To Murder,0,0,0,33,3,36,79,5,84,24,2,26,136,10,146
Chhattisgarh,2006,Rape,0,0,0,164,1,165,100,2,102,43,0,43,307,3,310
Chhattisgarh,2006,Kidnapping And Abduction,0,0,0,11,0,11,20,0,20,11,0,11,42,0,42
Chhattisgarh,2006,Dacoity,0,0,0,23,0,23,32,0,32,5,0,5,60,0,60
Chhattisgarh,2006,Prep. And Assembly For Dacoity,0,0,0,2,0,2,0,0,0,0,0,0,2,0,2
Chhattisgarh,2006,Robbery,0,0,0,12,1,13,8,1,9,8,0,8,28,2,30
Chhattisgarh,2006,Burglary,0,0,0,17,0,17,14,0,14,2,0,2,33,0,33
Chhattisgarh,2006,Thefts,0,0,0,42,0,42,38,1,39,7,0,7,87,1,88
Chhattisgarh,2006,Extortion,0,0,0,1,0,1,0,0,0,0,0,0,1,0,1
Chhattisgarh,2006,Riots,0,0,0,3,0,3,1,0,1,2,0,2,6,0,6
Chhattisgarh,2006,Arson,0,0,0,0,0,0,1,0,1,0,0,0,1,0,1
Chhattisgarh,2006,Criminal Breach Of Trust,0,0,0,1,0,1,0,0,0,0,0,0,1,0,1
Chhattisgarh,2006,Cheating,0,0,0,7,0,7,2,0,2,2,0,2,11,0,11
Chhattisgarh,2006,Counter Feiting,0,0,0,0,0,0,1,0,1,0,0,0,1,0,1
Chhattisgarh,2006,Dowry Deaths,0,0,0,22,0,22,32,5,37,4,1,5,58,6,64
Chhattisgarh,2006,Molestation,0,0,0,6,0,6,9,0,9,1,0,1,16,0,16
Chhattisgarh,2006,Eve-Teasing,0,0,0,0,0,0,0,0,0,0,0,0,0,0,0
Chhattisgarh,2006,Cruelty By Husband Or Relative Of Husband,0,0,0,1,0,1,3,0,3,0,0,0,4,0,4
Chhattisgarh,2006,Other Ipc Crimes,0,0,0,19,2,21,36,1,37,12,0,12,67,3,70
Chhattisgarh,2007,Murder,0,0,0,949,41,990,1744,77,1821,206,17,223,2899,135,3034
Chhattisgarh,2007,Attempt To Commit Murder,0,0,0,85,4,89,98,5,103,8,2,10,191,11,202
Chhattisgarh,2007,C.H. Not Amounting To Murder,0,0,0,49,3,52,94,5,99,11,1,12,154,9,163
Chhattisgarh,2007,Rape,0,0,0,155,1,156,113,0,113,8,0,8,276,1,277
Chhattisgarh,2007,Kidnapping And Abduction,0,0,0,19,0,19,41,0,41,1,0,1,61,0,61
Chhattisgarh,2007,Dacoity,0,0,0,26,0,26,44,0,44,0,0,0,70,0,70
Chhattisgarh,2007,Prep. And Assembly For Dacoity,0,0,0,0,0,0,0,0,0,0,0,0,0,0,0
Chhattisgarh,2007,Robbery,0,0,0,23,1,24,18,0,18,3,0,3,44,1,45
Chhattisgarh,2007,Burglary,0,0,0,9,0,9,9,0,9,0,0,0,18,0,18
Chhattisgarh,2007,Thefts,0,0,0,52,0,52,81,1,82,30,0,30,163,1,164
Chhattisgarh,2007,Extortion,0,0,0,0,0,0,0,0,0,0,0,0,0,0,0
Chhattisgarh,2007,Riots,0,0,0,8,0,8,4,0,4,0,0,0,12,0,12
Chhattisgarh,2007,Arson,0,0,0,2,0,2,2,0,2,0,0,0,4,0,4
Chhattisgarh,2007,Criminal Breach Of Trust,0,0,0,0,0,0,1,0,1,0,0,0,1,0,1
Chhattisgarh,2007,Cheating,0,0,0,4,0,4,4,0,4,5,0,5,13,0,13
Chhattisgarh,2007,Counter Feiting,0,0,0,11,0,11,0,0,0,0,0,0,11,0,11
Chhattisgarh,2007,Dowry Deaths,0,0,0,27,5,32,24,0,24,20,9,29,71,14,85
Chhattisgarh,2007,Molestation,0,0,0,5,0,5,1,2,3,6,0,6,12,2,14
Chhattisgarh,2007,Eve-Teasing,0,0,0,0,0,0,0,0,0,0,0,0,0,0,0
Chhattisgarh,2007,Cruelty By Husband Or Relative Of Husband,0,0,0,13,1,14,6,3,9,2,4,6,21,8,29
Chhattisgarh,2007,Other Ipc Crimes,0,0,0,14,1,15,55,1,56,7,0,7,76,2,78
Chhattisgarh,2008,Murder,0,0,0,1018,36,1054,1528,75,1603,345,29,374,2891,140,3031
Chhattisgarh,2008,Attempt To Commit Murder,0,0,0,90,1,91,107,0,107,15,1,16,212,2,214
Chhattisgarh,2008,C.H. Not Amounting To Murder,0,0,0,59,2,61,75,5,80,19,3,22,153,10,163
Chhattisgarh,2008,Rape,0,0,0,214,0,214,131,0,131,12,0,12,357,0,357
Chhattisgarh,2008,Kidnapping And Abduction,0,0,0,17,1,18,13,1,14,0,0,0,30,2,32
Chhattisgarh,2008,Dacoity,0,0,0,37,0,37,42,0,42,1,0,1,80,0,80
Chhattisgarh,2008,Prep. And Assembly For Dacoity,0,0,0,2,0,2,2,0,2,0,0,0,4,0,4
Chhattisgarh,2008,Robbery,0,0,0,40,1,41,29,0,29,3,0,3,72,1,73
Chhattisgarh,2008,Burglary,0,0,0,13,1,14,9,0,9,1,0,1,23,1,24
Chhattisgarh,2008,Thefts,0,0,0,74,1,75,33,0,33,0,0,0,107,1,108
Chhattisgarh,2008,Extortion,0,0,0,12,0,12,15,0,15,2,0,2,29,0,29
Chhattisgarh,2008,Riots,0,0,0,0,0,0,2,0,2,0,0,0,2,0,2
Chhattisgarh,2008,Arson,0,0,0,9,0,9,5,0,5,1,0,1,15,0,15
Chhattisgarh,2008,Criminal Breach Of Trust,0,0,0,0,0,0,3,0,3,1,0,1,4,0,4
Chhattisgarh,2008,Cheating,0,0,0,6,0,6,3,0,3,5,0,5,14,0,14
Chhattisgarh,2008,Counter Feiting,0,0,0,24,0,24,27,0,27,0,0,0,51,0,51
Chhattisgarh,2008,Dowry Deaths,0,0,0,34,4,38,43,7,50,8,3,11,85,14,99
Chhattisgarh,2008,Molestation,0,0,0,4,0,4,5,0,5,0,0,0,9,0,9
Chhattisgarh,2008,Eve-Teasing,0,0,0,11,0,11,12,0,12,0,0,0,23,0,23
Chhattisgarh,2008,Cruelty By Husband Or Relative Of Husband,0,0,0,21,0,21,23,1,24,4,1,5,48,2,50
Chhattisgarh,2008,Other Ipc Crimes,0,0,0,37,0,37,20,0,20,3,0,3,60,0,60
Chhattisgarh,2009,Murder,0,0,0,983,37,1020,1699,81,1780,456,29,485,3138,147,3285
Chhattisgarh,2009,Attempt To Commit Murder,0,0,0,106,1,107,98,4,102,22,2,24,226,7,233
Chhattisgarh,2009,C.H. Not Amounting To Murder,0,0,0,67,4,71,57,7,64,13,2,15,137,13,150
Chhattisgarh,2009,Rape,0,0,0,148,1,149,147,0,147,29,0,29,324,1,325
Chhattisgarh,2009,Kidnapping And Abduction,0,0,0,13,2,15,9,0,9,1,0,1,23,2,25
Chhattisgarh,2009,Dacoity,0,0,0,35,0,35,41,0,41,4,0,4,80,0,80
Chhattisgarh,2009,Prep. And Assembly For Dacoity,0,0,0,7,0,7,2,0,2,0,0,0,9,0,9
Chhattisgarh,2009,Robbery,0,0,0,13,0,13,17,0,17,0,0,0,30,0,30
Chhattisgarh,2009,Burglary,0,0,0,22,0,22,11,0,11,0,0,0,33,0,33
Chhattisgarh,2009,Thefts,0,0,0,56,1,57,32,0,32,6,0,6,94,1,95
Chhattisgarh,2009,Extortion,0,0,0,2,0,2,2,0,2,0,0,0,4,0,4
Chhattisgarh,2009,Riots,0,0,0,0,0,0,0,0,0,0,0,0,0,0,0
Chhattisgarh,2009,Arson,0,0,0,1,0,1,3,0,3,0,0,0,4,0,4
Chhattisgarh,2009,Criminal Breach Of Trust,0,0,0,0,0,0,0,0,0,0,0,0,0,0,0
Chhattisgarh,2009,Cheating,0,0,0,1,0,1,3,1,4,0,0,0,4,1,5
Chhattisgarh,2009,Counter Feiting,0,0,0,4,0,4,2,0,2,0,0,0,6,0,6
Chhattisgarh,2009,Dowry Deaths,0,0,0,36,8,44,49,8,57,6,2,8,91,18,109
Chhattisgarh,2009,Molestation,0,0,0,9,0,9,26,0,26,0,0,0,35,0,35
Chhattisgarh,2009,Eve-Teasing,0,0,0,0,0,0,2,0,2,0,0,0,2,0,2
Chhattisgarh,2009,Cruelty By Husband Or Relative Of Husband,0,0,0,22,1,23,17,4,21,0,3,3,39,8,47
Chhattisgarh,2009,Other Ipc Crimes,0,0,0,13,0,13,43,0,43,6,1,7,62,1,63
Chhattisgarh,2010,Murder,0,0,0,1086,52,1138,1548,68,1616,541,24,565,3175,144,3319
Chhattisgarh,2010,Attempt To Commit Murder,0,0,0,85,3,88,96,1,97,55,1,56,236,5,241
Chhattisgarh,2010,C.H. Not Amounting To Murder,0,0,0,54,4,58,34,0,34,25,1,26,113,5,118
Chhattisgarh,2010,Rape,0,0,0,230,1,231,193,0,193,51,0,51,474,1,475
Chhattisgarh,2010,Kidnapping And Abduction,0,0,0,19,0,19,19,0,19,6,0,6,44,0,44
Chhattisgarh,2010,Dacoity,0,0,0,55,0,55,72,0,72,4,0,4,131,0,131
Chhattisgarh,2010,Prep. And Assembly For Dacoity,0,0,0,7,0,7,7,0,7,0,0,0,14,0,14
Chhattisgarh,2010,Robbery,0,0,0,20,0,20,22,0,22,1,0,1,43,0,43
Chhattisgarh,2010,Burglary,0,0,0,20,0,20,16,0,16,12,0,12,48,0,48
Chhattisgarh,2010,Thefts,0,0,0,62,0,62,29,0,29,0,0,0,91,0,91
Chhattisgarh,2010,Extortion,0,0,0,0,0,0,0,0,0,0,0,0,0,0,0
Chhattisgarh,2010,Riots,0,0,0,0,0,0,0,0,0,0,0,0,0,0,0
Chhattisgarh,2010,Arson,0,0,0,2,0,2,6,0,6,3,0,3,11,0,11
Chhattisgarh,2010,Criminal Breach Of Trust,0,0,0,4,0,4,0,0,0,0,0,0,4,0,4
Chhattisgarh,2010,Cheating,0,0,0,5,0,5,14,0,14,2,0,2,21,0,21
Chhattisgarh,2010,Counter Feiting,0,0,0,3,0,3,10,0,10,1,0,1,14,0,14
Chhattisgarh,2010,Dowry Deaths,0,0,0,65,15,80,70,7,77,11,7,18,146,29,175
Chhattisgarh,2010,Molestation,0,0,0,5,0,5,7,0,7,0,0,0,12,0,12
Chhattisgarh,2010,Eve-Teasing,0,0,0,0,0,0,0,0,0,0,0,0,0,0,0
Chhattisgarh,2010,Cruelty By Husband Or Relative Of Husband,0,0,0,4,1,5,14,0,14,6,0,6,24,1,25
Chhattisgarh,2010,Other Ipc Crimes,0,0,0,52,3,55,49,1,50,15,0,15,116,4,120
Chhattisgarh,2011,Murder,0,0,0,1215,64,1279,1890,95,1985,659,20,679,3764,179,3943
Chhattisgarh,2011,Attempt To Commit Murder,0,0,0,77,0,77,74,0,74,38,2,40,189,2,191
Chhattisgarh,2011,C.H. Not Amounting To Murder,0,0,0,65,4,69,54,3,57,31,1,32,150,8,158
Chhattisgarh,2011,Rape,0,0,0,231,0,231,158,0,158,44,0,44,433,0,433
Chhattisgarh,2011,Kidnapping And Abduction,0,0,0,14,0,14,15,1,16,5,0,5,34,1,35
Chhattisgarh,2011,Dacoity,0,0,0,37,0,37,22,0,22,2,0,2,61,0,61
Chhattisgarh,2011,Prep. And Assembly For Dacoity,0,0,0,1,0,1,4,0,4,2,0,2,7,0,7
Chhattisgarh,2011,Robbery,0,0,0,21,0,21,24,0,24,2,0,2,47,0,47
Chhattisgarh,2011,Burglary,0,0,0,12,0,12,11,0,11,10,0,10,33,0,33
Chhattisgarh,2011,Thefts,0,0,0,58,0,58,41,1,42,15,0,15,114,1,115
Chhattisgarh,2011,Extortion,0,0,0,1,0,1,0,0,0,0,0,0,1,0,1
Chhattisgarh,2011,Riots,0,0,0,0,0,0,0,0,0,0,0,0,0,0,0
Chhattisgarh,2011,Arson,0,0,0,9,0,9,5,0,5,2,0,2,16,0,16
Chhattisgarh,2011,Criminal Breach Of Trust,0,0,0,1,0,1,1,0,1,0,0,0,2,0,2
Chhattisgarh,2011,Cheating,0,0,0,0,0,0,4,0,4,1,0,1,5,0,5
Chhattisgarh,2011,Counter Feiting,0,0,0,6,0,6,13,0,13,5,0,5,24,0,24
Chhattisgarh,2011,Dowry Deaths,0,0,0,39,5,44,42,10,52,18,5,23,99,20,119
Chhattisgarh,2011,Molestation,0,0,0,9,0,9,8,0,8,4,0,4,21,0,21
Chhattisgarh,2011,Eve-Teasing,0,0,0,0,0,0,0,0,0,0,0,0,0,0,0
Chhattisgarh,2011,Cruelty By Husband Or Relative Of Husband,0,0,0,3,1,4,6,1,7,7,0,7,16,2,18
Chhattisgarh,2011,Other Ipc Crimes,0,0,0,42,1,43,51,3,54,13,0,13,106,4,110
Goa,2001,Murder,0,0,0,17,0,17,23,2,25,1,0,1,41,2,43
Goa,2001,Attempt To Commit Murder,0,0,0,0,0,0,0,0,0,0,0,0,0,0,0
Goa,2001,C.H. Not Amounting To Murder,0,0,0,16,0,16,3,1,4,0,0,0,19,1,20
Goa,2001,Rape,0,0,0,12,0,12,2,0,2,0,0,0,14,0,14
Goa,2001,Kidnapping And Abduction,0,0,0,1,0,1,0,0,0,0,0,0,1,0,1
Goa,2001,Dacoity,0,0,0,2,0,2,1,0,1,0,0,0,3,0,3
Goa,2001,Prep. And Assembly For Dacoity,0,0,0,0,0,0,0,0,0,0,0,0,0,0,0
Goa,2001,Robbery,0,0,0,0,0,0,0,0,0,0,0,0,0,0,0
Goa,2001,Burglary,0,0,0,0,0,0,0,0,0,0,0,0,0,0,0
Goa,2001,Thefts,0,0,0,0,0,0,4,0,4,0,0,0,4,0,4
Goa,2001,Extortion,0,0,0,0,0,0,3,1,4,0,0,0,3,1,4
Goa,2001,Riots,0,0,0,0,0,0,0,0,0,0,0,0,0,0,0
Goa,2001,Arson,0,0,0,0,0,0,0,0,0,0,0,0,0,0,0
Goa,2001,Criminal Breach Of Trust,0,0,0,0,0,0,0,0,0,0,0,0,0,0,0
Goa,2001,Cheating,0,0,0,0,0,0,2,0,2,1,0,1,3,0,3
Goa,2001,Counter Feiting,0,0,0,3,0,3,0,0,0,0,0,0,3,0,3
Goa,2001,Dowry Deaths,0,0,0,0,0,0,0,0,0,0,0,0,0,0,0
Goa,2001,Molestation,0,0,0,0,0,0,2,0,2,0,0,0,2,0,2
Goa,2001,Eve-Teasing,0,0,0,0,0,0,1,0,1,4,0,4,5,0,5
Goa,2001,Cruelty By Husband Or Relative Of Husband,0,0,0,0,0,0,0,0,0,3,0,3,3,0,3
Goa,2001,Other Ipc Crimes,0,0,0,0,0,0,3,0,3,0,0,0,3,0,3
Goa,2002,Murder,0,0,0,26,0,26,17,4,21,10,0,10,53,4,57
Goa,2002,Attempt To Commit Murder,0,0,0,0,0,0,2,0,2,0,0,0,2,0,2
Goa,2002,C.H. Not Amounting To Murder,0,0,0,4,0,4,20,0,20,0,0,0,24,0,24
Goa,2002,Rape,0,0,0,0,0,0,11,0,11,0,0,0,11,0,11
Goa,2002,Kidnapping And Abduction,0,0,0,0,0,0,0,0,0,1,0,1,1,0,1
Goa,2002,Dacoity,0,0,0,0,0,0,9,0,9,0,0,0,9,0,9
Goa,2002,Prep. And Assembly For Dacoity,0,0,0,0,0,0,0,0,0,0,0,0,0,0,0
Goa,2002,Robbery,0,0,0,0,0,0,0,0,0,0,0,0,0,0,0
Goa,2002,Burglary,0,0,0,0,0,0,0,0,0,0,0,0,0,0,0
Goa,2002,Thefts,0,0,0,2,0,2,1,0,1,0,0,0,3,0,3
Goa,2002,Extortion,0,0,0,0,0,0,0,0,0,0,0,0,0,0,0
Goa,2002,Riots,0,0,0,0,0,0,0,0,0,0,0,0,0,0,0
Goa,2002,Arson,0,0,0,0,0,0,0,0,0,0,0,0,0,0,0
Goa,2002,Criminal Breach Of Trust,0,0,0,0,0,0,1,0,1,0,0,0,1,0,1
Goa,2002,Cheating,0,0,0,1,0,1,1,0,1,0,0,0,2,0,2
Goa,2002,Counter Feiting,0,0,0,0,0,0,0,0,0,0,0,0,0,0,0
Goa,2002,Dowry Deaths,0,0,0,0,0,0,0,0,0,0,0,0,0,0,0
Goa,2002,Molestation,0,0,0,0,0,0,0,0,0,0,0,0,0,0,0
Goa,2002,Eve-Teasing,0,0,0,0,0,0,0,0,0,0,0,0,0,0,0
Goa,2002,Cruelty By Husband Or Relative Of Husband,0,0,0,0,0,0,0,0,0,0,0,0,0,0,0
Goa,2002,Other Ipc Crimes,0,0,0,0,0,0,0,0,0,0,0,0,0,0,0
Goa,2003,Murder,0,0,0,21,0,21,16,2,18,14,0,14,51,2,53
Goa,2003,Attempt To Commit Murder,0,0,0,0,0,0,1,0,1,0,0,0,1,0,1
Goa,2003,C.H. Not Amounting To Murder,0,0,0,1,0,1,0,0,0,0,0,0,1,0,1
Goa,2003,Rape,0,0,0,6,0,6,4,0,4,1,0,1,11,0,11
Goa,2003,Kidnapping And Abduction,0,0,0,5,0,5,11,0,11,0,0,0,16,0,16
Goa,2003,Dacoity,0,0,0,5,0,5,7,0,7,0,0,0,12,0,12
Goa,2003,Prep. And Assembly For Dacoity,0,0,0,0,0,0,0,0,0,0,0,0,0,0,0
Goa,2003,Robbery,0,0,0,0,0,0,1,0,1,0,0,0,1,0,1
Goa,2003,Burglary,0,0,0,0,0,0,0,0,0,0,0,0,0,0,0
Goa,2003,Thefts,0,0,0,0,0,0,4,0,4,0,0,0,4,0,4
Goa,2003,Extortion,0,0,0,0,0,0,0,0,0,0,0,0,0,0,0
Goa,2003,Riots,0,0,0,0,0,0,0,0,0,0,0,0,0,0,0
Goa,2003,Arson,0,0,0,0,0,0,1,0,1,0,0,0,1,0,1
Goa,2003,Criminal Breach Of Trust,0,0,0,0,0,0,1,0,1,0,0,0,1,0,1
Goa,2003,Cheating,0,0,0,0,0,0,0,0,0,0,0,0,0,0,0
Goa,2003,Counter Feiting,0,0,0,0,0,0,0,0,0,0,0,0,0,0,0
Goa,2003,Dowry Deaths,0,0,0,0,0,0,0,0,0,0,0,0,0,0,0
Goa,2003,Molestation,0,0,0,0,0,0,0,0,0,0,0,0,0,0,0
Goa,2003,Eve-Teasing,0,0,0,0,0,0,0,0,0,0,0,0,0,0,0
Goa,2003,Cruelty By Husband Or Relative Of Husband,0,0,0,0,0,0,0,0,0,0,0,0,0,0,0
Goa,2003,Other Ipc Crimes,0,0,0,4,1,5,5,0,5,0,0,0,9,1,10
Goa,2004,Murder,0,0,0,16,0,16,7,2,9,6,0,6,29,2,31
Goa,2004,Attempt To Commit Murder,0,0,0,4,0,4,1,0,1,1,0,1,6,0,6
Goa,2004,C.H. Not Amounting To Murder,0,0,0,17,0,17,0,0,0,0,0,0,17,0,17
Goa,2004,Rape,0,0,0,8,0,8,8,0,8,0,0,0,16,0,16
Goa,2004,Kidnapping And Abduction,0,0,0,0,0,0,0,0,0,0,0,0,0,0,0
Goa,2004,Dacoity,0,0,0,7,0,7,5,0,5,0,0,0,12,0,12
Goa,2004,Prep. And Assembly For Dacoity,0,0,0,0,0,0,0,0,0,0,0,0,0,0,0
Goa,2004,Robbery,0,0,0,0,0,0,1,0,1,0,0,0,1,0,1
Goa,2004,Burglary,0,0,0,0,0,0,4,0,4,1,0,1,5,0,5
Goa,2004,Thefts,0,0,0,0,0,0,1,0,1,0,0,0,1,0,1
Goa,2004,Extortion,0,0,0,0,0,0,0,0,0,0,0,0,0,0,0
Goa,2004,Riots,0,0,0,0,0,0,0,0,0,0,0,0,0,0,0
Goa,2004,Arson,0,0,0,0,0,0,0,0,0,0,0,0,0,0,0
Goa,2004,Criminal Breach Of Trust,0,0,0,0,0,0,0,0,0,0,0,0,0,0,0
Goa,2004,Cheating,0,0,0,0,0,0,0,0,0,0,0,0,0,0,0
Goa,2004,Counter Feiting,0,0,0,0,0,0,0,0,0,0,0,0,0,0,0
Goa,2004,Dowry Deaths,0,0,0,0,0,0,0,0,0,0,0,0,0,0,0
Goa,2004,Molestation,0,0,0,0,0,0,0,0,0,0,0,0,0,0,0
Goa,2004,Eve-Teasing,0,0,0,0,0,0,0,0,0,0,0,0,0,0,0
Goa,2004,Cruelty By Husband Or Relative Of Husband,0,0,0,0,0,0,0,0,0,0,0,0,0,0,0
Goa,2004,Other Ipc Crimes,0,0,0,15,0,15,9,0,9,0,0,0,24,0,24
Goa,2005,Murder,0,0,0,4,0,4,38,2,40,7,0,7,49,2,51
Goa,2005,Attempt To Commit Murder,0,0,0,2,0,2,1,0,1,0,0,0,3,0,3
Goa,2005,C.H. Not Amounting To Murder,0,0,0,3,0,3,8,0,8,0,0,0,11,0,11
Goa,2005,Rape,0,0,0,4,0,4,14,0,14,0,0,0,18,0,18
Goa,2005,Kidnapping And Abduction,0,0,0,0,0,0,0,1,1,0,0,0,0,1,1
Goa,2005,Dacoity,0,0,0,0,0,0,5,0,5,0,0,0,5,0,5
Goa,2005,Prep. And Assembly For Dacoity,0,0,0,0,0,0,0,0,0,0,0,0,0,0,0
Goa,2005,Robbery,0,0,0,0,0,0,1,0,1,0,0,0,1,0,1
Goa,2005,Burglary,0,0,0,0,0,0,0,0,0,0,0,0,0,0,0
Goa,2005,Thefts,0,0,0,0,0,0,3,0,3,0,0,0,3,0,3
Goa,2005,Extortion,0,0,0,0,0,0,0,0,0,0,0,0,0,0,0
Goa,2005,Riots,0,0,0,0,0,0,0,0,0,0,0,0,0,0,0
Goa,2005,Arson,0,0,0,0,0,0,0,0,0,0,0,0,0,0,0
Goa,2005,Criminal Breach Of Trust,0,0,0,0,0,0,0,0,0,0,0,0,0,0,0
Goa,2005,Cheating,0,0,0,0,0,0,0,0,0,0,0,0,0,0,0
Goa,2005,Counter Feiting,0,0,0,0,0,0,1,0,1,0,0,0,1,0,1
Goa,2005,Dowry Deaths,0,0,0,0,0,0,0,0,0,0,0,0,0,0,0
Goa,2005,Molestation,0,0,0,0,0,0,0,0,0,0,0,0,0,0,0
Goa,2005,Eve-Teasing,0,0,0,0,0,0,0,0,0,0,0,0,0,0,0
Goa,2005,Cruelty By Husband Or Relative Of Husband,0,0,0,0,0,0,0,0,0,0,0,0,0,0,0
Goa,2005,Other Ipc Crimes,0,0,0,0,0,0,2,0,2,2,0,2,4,0,4
Goa,2006,Murder,0,0,0,20,0,20,28,1,29,7,1,8,55,2,57
Goa,2006,Attempt To Commit Murder,0,0,0,0,0,0,7,0,7,0,0,0,7,0,7
Goa,2006,C.H. Not Amounting To Murder,0,0,0,2,0,2,4,0,4,0,0,0,6,0,6
Goa,2006,Rape,0,0,0,12,0,12,4,0,4,0,0,0,16,0,16
Goa,2006,Kidnapping And Abduction,0,0,0,0,0,0,0,0,0,0,0,0,0,0,0
Goa,2006,Dacoity,0,0,0,2,0,2,2,0,2,0,0,0,4,0,4
Goa,2006,Prep. And Assembly For Dacoity,0,0,0,0,0,0,0,0,0,0,0,0,0,0,0
Goa,2006,Robbery,0,0,0,0,0,0,0,0,0,0,0,0,0,0,0
Goa,2006,Burglary,0,0,0,2,0,2,1,0,1,0,0,0,3,0,3
Goa,2006,Thefts,0,0,0,0,0,0,1,0,1,0,0,0,1,0,1
Goa,2006,Extortion,0,0,0,0,0,0,0,0,0,0,0,0,0,0,0
Goa,2006,Riots,0,0,0,0,0,0,0,0,0,0,0,0,0,0,0
Goa,2006,Arson,0,0,0,1,0,1,2,0,2,0,0,0,3,0,3
Goa,2006,Criminal Breach Of Trust,0,0,0,0,0,0,0,0,0,0,0,0,0,0,0
Goa,2006,Cheating,0,0,0,0,0,0,0,0,0,0,0,0,0,0,0
Goa,2006,Counter Feiting,0,0,0,0,0,0,0,0,0,0,0,0,0,0,0
Goa,2006,Dowry Deaths,0,0,0,0,0,0,0,0,0,0,0,0,0,0,0
Goa,2006,Molestation,0,0,0,0,0,0,0,0,0,0,0,0,0,0,0
Goa,2006,Eve-Teasing,0,0,0,0,0,0,0,0,0,0,0,0,0,0,0
Goa,2006,Cruelty By Husband Or Relative Of Husband,0,0,0,0,0,0,0,0,0,0,0,0,0,0,0
Goa,2006,Other Ipc Crimes,0,0,0,9,0,9,7,0,7,0,0,0,16,0,16
Goa,2007,Murder,0,0,0,18,0,18,22,1,23,6,0,6,46,1,47
Goa,2007,Attempt To Commit Murder,0,0,0,2,0,2,9,0,9,9,0,9,20,0,20
Goa,2007,C.H. Not Amounting To Murder,0,0,0,3,1,4,8,0,8,5,0,5,16,1,17
Goa,2007,Rape,0,0,0,1,0,1,6,0,6,4,0,4,11,0,11
Goa,2007,Kidnapping And Abduction,0,0,0,1,0,1,0,0,0,0,0,0,1,0,1
Goa,2007,Dacoity,0,0,0,3,0,3,4,0,4,0,0,0,7,0,7
Goa,2007,Prep. And Assembly For Dacoity,0,0,0,1,0,1,1,0,1,0,0,0,2,0,2
Goa,2007,Robbery,0,0,0,0,0,0,0,0,0,0,0,0,0,0,0
Goa,2007,Burglary,0,0,0,0,0,0,2,0,2,0,0,0,2,0,2
Goa,2007,Thefts,0,0,0,1,0,1,0,0,0,0,0,0,1,0,1
Goa,2007,Extortion,0,0,0,0,0,0,0,0,0,0,0,0,0,0,0
Goa,2007,Riots,0,0,0,0,0,0,0,0,0,0,0,0,0,0,0
Goa,2007,Arson,0,0,0,0,0,0,0,0,0,0,0,0,0,0,0
Goa,2007,Criminal Breach Of Trust,0,0,0,0,0,0,0,0,0,0,0,0,0,0,0
Goa,2007,Cheating,0,0,0,5,0,5,3,0,3,0,0,0,8,0,8
Goa,2007,Counter Feiting,0,0,0,0,0,0,0,0,0,0,0,0,0,0,0
Goa,2007,Dowry Deaths,0,0,0,0,0,0,0,0,0,0,0,0,0,0,0
Goa,2007,Molestation,0,0,0,0,0,0,0,0,0,0,0,0,0,0,0
Goa,2007,Eve-Teasing,0,0,0,0,0,0,0,0,0,0,0,0,0,0,0
Goa,2007,Cruelty By Husband Or Relative Of Husband,0,0,0,0,0,0,0,0,0,0,0,0,0,0,0
Goa,2007,Other Ipc Crimes,0,0,0,1,0,1,1,0,1,3,0,3,5,0,5
Goa,2008,Murder,0,0,0,31,1,32,27,1,28,6,1,7,64,3,67
Goa,2008,Attempt To Commit Murder,0,0,0,1,0,1,0,0,0,1,0,1,2,0,2
Goa,2008,C.H. Not Amounting To Murder,0,0,0,1,0,1,4,3,7,1,0,1,6,3,9
Goa,2008,Rape,0,0,0,7,0,7,3,0,3,1,0,1,11,0,11
Goa,2008,Kidnapping And Abduction,0,0,0,4,0,4,0,0,0,0,0,0,4,0,4
Goa,2008,Dacoity,0,0,0,3,0,3,3,0,3,0,0,0,6,0,6
Goa,2008,Prep. And Assembly For Dacoity,0,0,0,2,0,2,1,0,1,0,0,0,3,0,3
Goa,2008,Robbery,0,0,0,2,0,2,0,0,0,0,0,0,2,0,2
Goa,2008,Burglary,0,0,0,2,0,2,0,0,0,0,0,0,2,0,2
Goa,2008,Thefts,0,0,0,1,0,1,1,2,3,0,0,0,2,2,4
Goa,2008,Extortion,0,0,0,0,0,0,0,0,0,0,0,0,0,0,0
Goa,2008,Riots,0,0,0,0,0,0,0,0,0,0,0,0,0,0,0
Goa,2008,Arson,0,0,0,0,0,0,0,0,0,0,0,0,0,0,0
Goa,2008,Criminal Breach Of Trust,0,0,0,0,0,0,0,0,0,0,0,0,0,0,0
Goa,2008,Cheating,0,0,0,6,0,6,2,0,2,0,0,0,8,0,8
Goa,2008,Counter Feiting,0,0,0,0,0,0,0,0,0,0,0,0,0,0,0
Goa,2008,Dowry Deaths,0,0,0,0,0,0,0,0,0,0,0,0,0,0,0
Goa,2008,Molestation,0,0,0,0,0,0,0,0,0,0,0,0,0,0,0
Goa,2008,Eve-Teasing,0,0,0,0,0,0,0,0,0,0,0,0,0,0,0
Goa,2008,Cruelty By Husband Or Relative Of Husband,0,0,0,0,0,0,0,0,0,0,0,0,0,0,0
Goa,2008,Other Ipc Crimes,0,0,0,0,0,0,0,1,1,0,0,0,0,1,1
Goa,2009,Murder,0,0,0,31,0,31,27,1,28,6,0,6,64,1,65
Goa,2009,Attempt To Commit Murder,0,0,0,1,0,1,0,0,0,1,0,1,2,0,2
Goa,2009,C.H. Not Amounting To Murder,0,0,0,3,0,3,6,3,9,1,0,1,10,3,13
Goa,2009,Rape,0,0,0,10,0,10,4,0,4,0,0,0,14,0,14
Goa,2009,Kidnapping And Abduction,0,0,0,3,0,3,1,0,1,0,0,0,4,0,4
Goa,2009,Dacoity,0,0,0,0,0,0,2,0,2,0,0,0,2,0,2
Goa,2009,Prep. And Assembly For Dacoity,0,0,0,0,0,0,0,0,0,0,0,0,0,0,0
Goa,2009,Robbery,0,0,0,1,0,1,0,0,0,0,0,0,1,0,1
Goa,2009,Burglary,0,0,0,7,0,7,0,0,0,0,0,0,7,0,7
Goa,2009,Thefts,0,0,0,3,0,3,0,2,2,0,0,0,3,2,5
Goa,2009,Extortion,0,0,0,0,0,0,0,0,0,0,0,0,0,0,0
Goa,2009,Riots,0,0,0,0,0,0,0,0,0,0,0,0,0,0,0
Goa,2009,Arson,0,0,0,0,0,0,0,0,0,0,0,0,0,0,0
Goa,2009,Criminal Breach Of Trust,0,0,0,0,0,0,0,0,0,0,0,0,0,0,0
Goa,2009,Cheating,0,0,0,2,0,2,2,0,2,1,0,1,5,0,5
Goa,2009,Counter Feiting,0,0,0,1,0,1,0,0,0,0,0,0,1,0,1
Goa,2009,Dowry Deaths,0,0,0,0,0,0,0,0,0,0,0,0,0,0,0
Goa,2009,Molestation,0,0,0,0,0,0,0,0,0,0,0,0,0,0,0
Goa,2009,Eve-Teasing,0,0,0,0,0,0,0,0,0,0,0,0,0,0,0
Goa,2009,Cruelty By Husband Or Relative Of Husband,0,0,0,0,0,0,0,0,0,0,0,0,0,0,0
Goa,2009,Other Ipc Crimes,0,0,0,3,0,3,5,1,6,0,0,0,8,1,9
Goa,2010,Murder,0,0,0,30,0,30,28,2,30,6,0,6,64,2,66
Goa,2010,Attempt To Commit Murder,0,0,0,1,0,1,0,1,1,1,0,1,2,1,3
Goa,2010,C.H. Not Amounting To Murder,0,0,0,2,0,2,6,2,8,0,0,0,8,2,10
Goa,2010,Rape,0,0,0,12,0,12,6,0,6,0,0,0,18,0,18
Goa,2010,Kidnapping And Abduction,0,0,0,2,0,2,2,0,2,0,0,0,4,0,4
Goa,2010,Dacoity,0,0,0,0,0,0,4,0,4,0,0,0,4,0,4
Goa,2010,Prep. And Assembly For Dacoity,0,0,0,0,0,0,0,0,0,0,0,0,0,0,0
Goa,2010,Robbery,0,0,0,1,0,1,2,0,2,0,0,0,3,0,3
Goa,2010,Burglary,0,0,0,5,0,5,2,0,2,0,0,0,7,0,7
Goa,2010,Thefts,0,0,0,10,0,10,4,3,7,0,0,0,14,3,17
Goa,2010,Extortion,0,0,0,0,0,0,0,0,0,0,0,0,0,0,0
Goa,2010,Riots,0,0,0,0,0,0,0,0,0,0,0,0,0,0,0
Goa,2010,Arson,0,0,0,0,0,0,0,0,0,0,0,0,0,0,0
Goa,2010,Criminal Breach Of Trust,0,0,0,0,0,0,0,0,0,0,0,0,0,0,0
Goa,2010,Cheating,0,0,0,1,0,1,0,0,0,0,0,0,1,0,1
Goa,2010,Counter Feiting,0,0,0,0,0,0,0,0,0,0,0,0,0,0,0
Goa,2010,Dowry Deaths,0,0,0,0,0,0,0,0,0,0,0,0,0,0,0
Goa,2010,Molestation,0,0,0,0,0,0,1,0,1,0,0,0,1,0,1
Goa,2010,Eve-Teasing,0,0,0,0,0,0,0,0,0,0,0,0,0,0,0
Goa,2010,Cruelty By Husband Or Relative Of Husband,0,0,0,0,0,0,0,0,0,0,0,0,0,0,0
Goa,2010,Other Ipc Crimes,0,0,0,0,0,0,0,0,0,0,0,0,0,0,0
Goa,2011,Murder,0,0,0,27,0,27,35,2,37,9,0,9,71,2,73
Goa,2011,Attempt To Commit Murder,0,0,0,2,0,2,1,0,1,0,0,0,3,0,3
Goa,2011,C.H. Not Amounting To Murder,0,0,0,3,0,3,4,2,6,0,0,0,7,2,9
Goa,2011,Rape,0,0,0,10,0,10,7,0,7,1,0,1,18,0,18
Goa,2011,Kidnapping And Abduction,0,0,0,0,0,0,0,0,0,0,0,0,0,0,0
Goa,2011,Dacoity,0,0,0,0,0,0,0,0,0,0,0,0,0,0,0
Goa,2011,Prep. And Assembly For Dacoity,0,0,0,0,0,0,0,0,0,0,0,0,0,0,0
Goa,2011,Robbery,0,0,0,4,0,4,2,0,2,0,0,0,6,0,6
Goa,2011,Burglary,0,0,0,0,0,0,2,0,2,0,0,0,2,0,2
Goa,2011,Thefts,0,0,0,5,0,5,2,0,2,0,0,0,7,0,7
Goa,2011,Extortion,0,0,0,0,0,0,0,0,0,0,0,0,0,0,0
Goa,2011,Riots,0,0,0,0,0,0,0,0,0,0,0,0,0,0,0
Goa,2011,Arson,0,0,0,0,0,0,0,0,0,0,0,0,0,0,0
Goa,2011,Criminal Breach Of Trust,0,0,0,0,0,0,0,0,0,0,0,0,0,0,0
Goa,2011,Cheating,0,0,0,3,0,3,0,2,2,0,0,0,3,2,5
Goa,2011,Counter Feiting,0,0,0,0,0,0,0,0,0,0,0,0,0,0,0
Goa,2011,Dowry Deaths,0,0,0,0,0,0,0,0,0,0,0,0,0,0,0
Goa,2011,Molestation,0,0,0,0,0,0,0,0,0,0,0,0,0,0,0
Goa,2011,Eve-Teasing,0,0,0,0,0,0,0,0,0,0,0,0,0,0,0
Goa,2011,Cruelty By Husband Or Relative Of Husband,0,0,0,0,0,0,0,0,0,0,0,0,0,0,0
Goa,2011,Other Ipc Crimes,0,0,0,0,0,0,0,0,0,0,0,0,0,0,0
Goa,2012,Murder,0,0,0,23,0,23,34,1,35,8,0,8,65,1,66
Goa,2012,Attempt To Commit Murder,0,0,0,1,0,1,1,0,1,0,0,0,2,0,2
Goa,2012,C.H. Not Amounting To Murder,0,0,0,4,0,4,3,1,4,1,0,1,8,1,9
Goa,2012,Rape,0,0,0,10,0,10,9,0,9,0,0,0,19,0,19
Goa,2012,Kidnapping And Abduction,0,0,0,0,0,0,0,0,0,0,0,0,0,0,0
Goa,2012,Dacoity,0,0,0,0,0,0,0,0,0,0,0,0,0,0,0
Goa,2012,Prep. And Assembly For Dacoity,0,0,0,0,0,0,0,0,0,0,0,0,0,0,0
Goa,2012,Robbery,0,0,0,5,0,5,3,0,3,0,0,0,8,0,8
Goa,2012,Burglary,0,0,0,0,0,0,1,0,1,0,0,0,1,0,1
Goa,2012,Thefts,0,0,0,4,0,4,1,0,1,0,0,0,5,0,5
Goa,2012,Extortion,0,0,0,0,0,0,0,0,0,0,0,0,0,0,0
Goa,2012,Riots,0,0,0,0,0,0,0,0,0,0,0,0,0,0,0
Goa,2012,Arson,0,0,0,0,0,0,0,0,0,0,0,0,0,0,0
Goa,2012,Criminal Breach Of Trust,0,0,0,0,0,0,0,0,0,0,0,0,0,0,0
Goa,2012,Cheating,0,0,0,2,0,2,2,1,3,0,0,0,4,1,5
Goa,2012,Counter Feiting,0,0,0,1,0,1,0,0,0,0,0,0,1,0,1
Goa,2012,Dowry Deaths,0,0,0,0,0,0,0,0,0,0,0,0,0,0,0
Goa,2012,Molestation,0,0,0,0,0,0,0,0,0,0,0,0,0,0,0
Goa,2012,Eve-Teasing,0,0,0,0,0,0,0,0,0,0,0,0,0,0,0
Goa,2012,Cruelty By Husband Or Relative Of Husband,0,0,0,0,0,0,0,0,0,0,0,0,0,0,0
Goa,2012,Other Ipc Crimes,0,0,0,0,0,0,0,1,1,0,0,0,0,1,1
Gujarat,2001,Murder,0,0,0,632,24,656,1078,15,1093,78,7,85,1788,46,1834
Gujarat,2001,Attempt To Commit Murder,0,0,0,13,0,13,23,0,23,3,0,3,39,0,39
Gujarat,2001,C.H. Not Amounting To Murder,0,0,0,22,0,22,17,0,17,3,0,3,42,0,42
Gujarat,2001,Rape,0,0,0,43,0,43,46,0,46,0,0,0,89,0,89
Gujarat,2001,Kidnapping And Abduction,0,0,0,27,0,27,38,0,38,0,0,0,65,0,65
Gujarat,2001,Dacoity,0,0,0,14,0,14,9,1,10,0,0,0,23,1,24
Gujarat,2001,Prep. And Assembly For Dacoity,0,0,0,13,0,13,0,0,0,0,0,0,13,0,13
Gujarat,2001,Robbery,0,0,0,42,0,42,26,0,26,0,0,0,68,0,68
Gujarat,2001,Burglary,0,0,0,23,0,23,13,0,13,0,0,0,36,0,36
Gujarat,2001,Thefts,0,0,0,9,0,9,15,0,15,1,0,1,25,0,25
Gujarat,2001,Extortion,0,0,0,5,0,5,3,0,3,0,0,0,8,0,8
Gujarat,2001,Riots,0,0,0,0,0,0,0,0,0,0,0,0,0,0,0
Gujarat,2001,Arson,0,0,0,0,0,0,0,0,0,0,0,0,0,0,0
Gujarat,2001,Criminal Breach Of Trust,0,0,0,0,0,0,0,0,0,0,0,0,0,0,0
Gujarat,2001,Cheating,0,0,0,2,0,2,1,0,1,1,0,1,4,0,4
Gujarat,2001,Counter Feiting,0,0,0,0,0,0,0,0,0,0,0,0,0,0,0
Gujarat,2001,Dowry Deaths,0,0,0,0,0,0,0,0,0,0,0,0,0,0,0
Gujarat,2001,Molestation,0,0,0,0,0,0,0,0,0,0,0,0,0,0,0
Gujarat,2001,Eve-Teasing,0,0,0,0,0,0,0,0,0,0,0,0,0,0,0
Gujarat,2001,Cruelty By Husband Or Relative Of Husband,0,0,0,18,5,23,32,5,37,6,0,6,56,10,66
Gujarat,2001,Other Ipc Crimes,0,0,0,54,0,54,36,0,36,0,0,0,90,0,90
Gujarat,2002,Murder,0,0,0,672,31,703,1108,19,1127,108,11,119,1888,61,1949
Gujarat,2002,Attempt To Commit Murder,0,0,0,20,0,20,29,2,31,10,0,10,59,2,61
Gujarat,2002,C.H. Not Amounting To Murder,0,0,0,32,1,33,27,2,29,13,1,14,72,4,76
Gujarat,2002,Rape,0,0,0,53,0,53,55,0,55,6,0,6,114,0,114
Gujarat,2002,Kidnapping And Abduction,0,0,0,30,0,30,45,2,47,3,0,3,78,2,80
Gujarat,2002,Dacoity,0,0,0,21,0,21,11,3,14,1,0,1,33,3,36
Gujarat,2002,Prep. And Assembly For Dacoity,0,0,0,10,0,10,3,0,3,0,0,0,13,0,13
Gujarat,2002,Robbery,0,0,0,52,0,52,31,0,31,3,0,3,86,0,86
Gujarat,2002,Burglary,0,0,0,27,0,27,18,1,19,2,0,2,47,1,48
Gujarat,2002,Thefts,0,0,0,15,2,17,18,0,18,3,0,3,36,2,38
Gujarat,2002,Extortion,0,0,0,3,0,3,5,0,5,2,0,2,10,0,10
Gujarat,2002,Riots,0,0,0,10,0,10,14,0,14,6,0,6,30,0,30
Gujarat,2002,Arson,0,0,0,0,0,0,0,0,0,0,0,0,0,0,0
Gujarat,2002,Criminal Breach Of Trust,0,0,0,0,0,0,0,0,0,0,0,0,0,0,0
Gujarat,2002,Cheating,0,0,0,8,0,8,3,0,3,3,0,3,14,0,14
Gujarat,2002,Counter Feiting,0,0,0,0,0,0,0,0,0,0,0,0,0,0,0
Gujarat,2002,Dowry Deaths,0,0,0,0,0,0,0,0,0,0,0,0,0,0,0
Gujarat,2002,Molestation,0,0,0,0,0,0,0,0,0,0,0,0,0,0,0
Gujarat,2002,Eve-Teasing,0,0,0,0,0,0,0,0,0,0,0,0,0,0,0
Gujarat,2002,Cruelty By Husband Or Relative Of Husband,0,0,0,28,7,35,36,5,41,10,1,11,74,13,87
Gujarat,2002,Other Ipc Crimes,0,0,0,60,2,62,40,2,42,0,0,0,100,4,104
Gujarat,2003,Murder,8,0,8,613,14,627,964,35,999,272,0,272,1857,49,1906
Gujarat,2003,Attempt To Commit Murder,0,0,0,73,2,75,47,4,51,8,2,10,128,8,136
Gujarat,2003,C.H. Not Amounting To Murder,0,0,0,49,0,49,37,1,38,10,4,14,96,5,101
Gujarat,2003,Rape,1,0,1,116,2,118,35,0,35,3,0,3,155,2,157
Gujarat,2003,Kidnapping And Abduction,0,0,0,63,0,63,41,2,43,2,0,2,106,2,108
Gujarat,2003,Dacoity,0,0,0,32,0,32,29,3,32,2,0,2,63,3,66
Gujarat,2003,Prep. And Assembly For Dacoity,0,0,0,20,0,20,0,0,0,0,0,0,20,0,20
Gujarat,2003,Robbery,0,0,0,59,0,59,11,0,11,0,0,0,70,0,70
Gujarat,2003,Burglary,0,0,0,30,0,30,21,0,21,8,0,8,59,0,59
Gujarat,2003,Thefts,0,0,0,8,0,8,18,0,18,0,3,3,26,3,29
Gujarat,2003,Extortion,0,0,0,14,0,14,2,0,2,0,0,0,16,0,16
Gujarat,2003,Riots,0,0,0,0,0,0,3,0,3,0,0,0,3,0,3
Gujarat,2003,Arson,0,0,0,6,0,6,8,0,8,0,0,0,14,0,14
Gujarat,2003,Criminal Breach Of Trust,0,0,0,3,0,3,2,0,2,0,0,0,5,0,5
Gujarat,2003,Cheating,0,0,0,4,0,4,4,0,4,2,0,2,10,0,10
Gujarat,2003,Counter Feiting,0,0,0,5,0,5,4,0,4,0,0,0,9,0,9
Gujarat,2003,Dowry Deaths,0,0,0,5,3,8,2,3,5,0,0,0,7,6,13
Gujarat,2003,Molestation,0,0,0,3,0,3,0,0,0,0,0,0,3,0,3
Gujarat,2003,Eve-Teasing,0,0,0,0,0,0,0,0,0,0,0,0,0,0,0
Gujarat,2003,Cruelty By Husband Or Relative Of Husband,0,0,0,6,4,10,12,6,18,0,3,3,18,13,31
Gujarat,2003,Other Ipc Crimes,0,0,0,10,2,12,31,4,35,15,2,17,56,8,64
Gujarat,2004,Murder,3,0,3,465,10,475,747,51,798,231,29,260,1446,90,1536
Gujarat,2004,Attempt To Commit Murder,0,0,0,161,5,166,72,8,80,50,2,52,283,15,298
Gujarat,2004,C.H. Not Amounting To Murder,0,0,0,45,0,45,75,0,75,22,0,22,142,0,142
Gujarat,2004,Rape,0,0,0,102,1,103,57,0,57,3,0,3,162,1,163
Gujarat,2004,Kidnapping And Abduction,0,0,0,150,2,152,87,2,89,8,0,8,245,4,249
Gujarat,2004,Dacoity,0,0,0,10,0,10,167,0,167,9,0,9,186,0,186
Gujarat,2004,Prep. And Assembly For Dacoity,0,0,0,0,0,0,0,0,0,0,0,0,0,0,0
Gujarat,2004,Robbery,0,0,0,22,0,22,62,0,62,13,0,13,97,0,97
Gujarat,2004,Burglary,0,0,0,5,0,5,10,0,10,0,0,0,15,0,15
Gujarat,2004,Thefts,0,0,0,16,1,17,24,0,24,0,0,0,40,1,41
Gujarat,2004,Extortion,0,0,0,0,0,0,0,0,0,0,0,0,0,0,0
Gujarat,2004,Riots,0,0,0,8,0,8,31,0,31,0,0,0,39,0,39
Gujarat,2004,Arson,0,0,0,5,0,5,0,0,0,0,0,0,5,0,5
Gujarat,2004,Criminal Breach Of Trust,0,0,0,0,0,0,0,0,0,0,0,0,0,0,0
Gujarat,2004,Cheating,0,0,0,12,0,12,48,3,51,4,0,4,64,3,67
Gujarat,2004,Counter Feiting,0,0,0,0,0,0,0,0,0,0,0,0,0,0,0
Gujarat,2004,Dowry Deaths,0,0,0,22,2,24,50,1,51,20,0,20,92,3,95
Gujarat,2004,Molestation,0,0,0,0,0,0,0,0,0,0,0,0,0,0,0
Gujarat,2004,Eve-Teasing,0,0,0,0,0,0,0,0,0,0,0,0,0,0,0
Gujarat,2004,Cruelty By Husband Or Relative Of Husband,0,0,0,31,1,32,144,6,150,63,4,67,238,11,249
Gujarat,2004,Other Ipc Crimes,0,0,0,38,2,40,55,1,56,42,2,44,135,5,140
Gujarat,2005,Murder,0,0,0,810,15,825,1518,52,1570,198,29,227,2526,96,2622
Gujarat,2005,Attempt To Commit Murder,0,0,0,80,3,83,133,2,135,9,1,10,222,6,228
Gujarat,2005,C.H. Not Amounting To Murder,0,0,0,22,0,22,77,1,78,6,0,6,105,1,106
Gujarat,2005,Rape,0,0,0,114,1,115,58,0,58,6,0,6,178,1,179
Gujarat,2005,Kidnapping And Abduction,0,0,0,128,4,132,40,1,41,8,1,9,176,6,182
Gujarat,2005,Dacoity,0,0,0,13,0,13,12,0,12,1,0,1,26,0,26
Gujarat,2005,Prep. And Assembly For Dacoity,0,0,0,2,0,2,11,0,11,0,0,0,13,0,13
Gujarat,2005,Robbery,0,0,0,16,0,16,10,0,10,1,0,1,27,0,27
Gujarat,2005,Burglary,0,0,0,8,0,8,4,0,4,0,0,0,12,0,12
Gujarat,2005,Thefts,0,0,0,45,2,47,40,1,41,15,0,15,100,3,103
Gujarat,2005,Extortion,0,0,0,0,0,0,0,0,0,0,0,0,0,0,0
Gujarat,2005,Riots,0,0,0,0,0,0,0,0,0,0,0,0,0,0,0
Gujarat,2005,Arson,0,0,0,0,0,0,0,0,0,0,0,0,0,0,0
Gujarat,2005,Criminal Breach Of Trust,0,0,0,0,0,0,1,0,1,0,0,0,1,0,1
Gujarat,2005,Cheating,0,0,0,1,0,1,10,0,10,0,0,0,11,0,11
Gujarat,2005,Counter Feiting,0,0,0,6,0,6,6,0,6,1,0,1,13,0,13
Gujarat,2005,Dowry Deaths,0,0,0,33,1,34,14,0,14,0,2,2,47,3,50
Gujarat,2005,Molestation,0,0,0,0,0,0,0,0,0,0,0,0,0,0,0
Gujarat,2005,Eve-Teasing,0,0,0,0,0,0,0,0,0,0,0,0,0,0,0
Gujarat,2005,Cruelty By Husband Or Relative Of Husband,0,0,0,26,0,26,2,0,2,0,0,0,28,0,28
Gujarat,2005,Other Ipc Crimes,0,0,0,220,0,220,88,1,89,42,0,42,350,1,351
Gujarat,2006,Murder,0,0,0,864,13,877,1441,64,1505,182,15,197,2487,92,2579
Gujarat,2006,Attempt To Commit Murder,0,0,0,96,0,96,116,2,118,38,1,39,250,3,253
Gujarat,2006,C.H. Not Amounting To Murder,0,0,0,42,0,42,106,0,106,16,0,16,164,0,164
Gujarat,2006,Rape,0,0,0,123,1,124,102,1,103,5,0,5,230,2,232
Gujarat,2006,Kidnapping And Abduction,0,0,0,37,2,39,24,0,24,4,0,4,65,2,67
Gujarat,2006,Dacoity,0,0,0,15,0,15,25,2,27,6,0,6,46,2,48
Gujarat,2006,Prep. And Assembly For Dacoity,0,0,0,5,0,5,10,0,10,1,0,1,16,0,16
Gujarat,2006,Robbery,0,0,0,35,0,35,19,1,20,11,0,11,65,1,66
Gujarat,2006,Burglary,0,0,0,4,0,4,0,0,0,0,0,0,4,0,4
Gujarat,2006,Thefts,0,0,0,65,0,65,61,4,65,7,0,7,133,4,137
Gujarat,2006,Extortion,0,0,0,0,0,0,0,0,0,0,0,0,0,0,0
Gujarat,2006,Riots,0,0,0,0,0,0,0,0,0,0,0,0,0,0,0
Gujarat,2006,Arson,0,0,0,0,0,0,0,0,0,0,0,0,0,0,0
Gujarat,2006,Criminal Breach Of Trust,0,0,0,0,0,0,1,0,1,0,0,0,1,0,1
Gujarat,2006,Cheating,0,0,0,7,0,7,13,0,13,0,0,0,20,0,20
Gujarat,2006,Counter Feiting,0,0,0,10,0,10,9,0,9,2,2,4,21,2,23
Gujarat,2006,Dowry Deaths,0,0,0,42,2,44,26,1,27,3,0,3,71,3,74
Gujarat,2006,Molestation,0,0,0,0,0,0,0,0,0,0,0,0,0,0,0
Gujarat,2006,Eve-Teasing,0,0,0,0,0,0,0,0,0,0,0,0,0,0,0
Gujarat,2006,Cruelty By Husband Or Relative Of Husband,0,0,0,34,0,34,7,12,19,11,7,18,52,19,71
Gujarat,2006,Other Ipc Crimes,0,0,0,251,3,254,64,1,65,34,0,34,349,4,353
Gujarat,2007,Murder,0,0,0,924,17,941,959,63,1022,313,23,336,2196,103,2299
Gujarat,2007,Attempt To Commit Murder,0,0,0,106,2,108,120,0,120,47,0,47,273,2,275
Gujarat,2007,C.H. Not Amounting To Murder,0,0,0,125,0,125,111,2,113,58,2,60,294,4,298
Gujarat,2007,Rape,0,0,0,215,1,216,178,1,179,22,0,22,415,2,417
Gujarat,2007,Kidnapping And Abduction,0,0,0,32,2,34,33,1,34,8,0,8,73,3,76
Gujarat,2007,Dacoity,0,0,0,44,0,44,56,2,58,6,0,6,106,2,108
Gujarat,2007,Prep. And Assembly For Dacoity,0,0,0,0,0,0,6,0,6,0,0,0,6,0,6
Gujarat,2007,Robbery,0,0,0,94,0,94,16,1,17,13,0,13,123,1,124
Gujarat,2007,Burglary,0,0,0,11,0,11,0,0,0,0,0,0,11,0,11
Gujarat,2007,Thefts,0,0,0,99,0,99,52,0,52,7,0,7,158,0,158
Gujarat,2007,Extortion,0,0,0,10,0,10,6,0,6,5,0,5,21,0,21
Gujarat,2007,Riots,0,0,0,0,0,0,0,0,0,0,0,0,0,0,0
Gujarat,2007,Arson,0,0,0,5,0,5,10,0,10,8,0,8,23,0,23
Gujarat,2007,Criminal Breach Of Trust,0,0,0,2,0,2,0,0,0,1,0,1,3,0,3
Gujarat,2007,Cheating,0,0,0,8,0,8,11,0,11,1,0,1,20,0,20
Gujarat,2007,Counter Feiting,0,0,0,5,0,5,0,0,0,0,0,0,5,0,5
Gujarat,2007,Dowry Deaths,0,0,0,52,2,54,29,1,30,3,1,4,84,4,88
Gujarat,2007,Molestation,0,0,0,0,0,0,0,0,0,0,0,0,0,0,0
Gujarat,2007,Eve-Teasing,0,0,0,0,0,0,0,0,0,0,0,0,0,0,0
Gujarat,2007,Cruelty By Husband Or Relative Of Husband,0,0,0,101,10,111,28,19,47,16,7,23,145,36,181
Gujarat,2007,Other Ipc Crimes,0,0,0,43,4,47,37,2,39,11,0,11,91,6,97
Gujarat,2008,Murder,0,0,0,767,33,800,905,91,996,342,33,375,2014,157,2171
Gujarat,2008,Attempt To Commit Murder,0,0,0,139,0,139,187,0,187,41,0,41,367,0,367
Gujarat,2008,C.H. Not Amounting To Murder,0,0,0,154,0,154,37,1,38,38,0,38,229,1,230
Gujarat,2008,Rape,0,0,0,291,0,291,210,0,210,24,2,26,525,2,527
Gujarat,2008,Kidnapping And Abduction,0,0,0,46,0,46,88,2,90,8,2,10,142,4,146
Gujarat,2008,Dacoity,0,0,0,33,0,33,34,0,34,8,0,8,75,0,75
Gujarat,2008,Prep. And Assembly For Dacoity,0,0,0,5,0,5,38,0,38,0,0,0,43,0,43
Gujarat,2008,Robbery,0,0,0,55,0,55,108,0,108,15,0,15,178,0,178
Gujarat,2008,Burglary,0,0,0,42,0,42,0,0,0,0,0,0,42,0,42
Gujarat,2008,Thefts,0,0,0,22,0,22,49,0,49,8,0,8,79,0,79
Gujarat,2008,Extortion,0,0,0,0,0,0,0,0,0,0,0,0,0,0,0
Gujarat,2008,Riots,0,0,0,5,0,5,35,0,35,18,0,18,58,0,58
Gujarat,2008,Arson,0,0,0,2,0,2,0,0,0,0,0,0,2,0,2
Gujarat,2008,Criminal Breach Of Trust,0,0,0,15,0,15,32,0,32,8,0,8,55,0,55
Gujarat,2008,Cheating,0,0,0,1,0,1,1,0,1,1,0,1,3,0,3
Gujarat,2008,Counter Feiting,0,0,0,30,1,31,33,0,33,5,0,5,68,1,69
Gujarat,2008,Dowry Deaths,0,0,0,34,0,34,26,0,26,3,0,3,63,0,63
Gujarat,2008,Molestation,0,0,0,0,0,0,0,0,0,0,0,0,0,0,0
Gujarat,2008,Eve-Teasing,0,0,0,0,0,0,0,0,0,0,0,0,0,0,0
Gujarat,2008,Cruelty By Husband Or Relative Of Husband,0,0,0,30,9,39,72,10,82,27,6,33,129,25,154
Gujarat,2008,Other Ipc Crimes,0,0,0,21,0,21,46,1,47,7,0,7,74,1,75
Gujarat,2009,Murder,0,0,0,794,62,856,797,25,822,114,20,134,1705,107,1812
Gujarat,2009,Attempt To Commit Murder,0,0,0,82,0,82,68,0,68,24,0,24,174,0,174
Gujarat,2009,C.H. Not Amounting To Murder,0,0,0,144,1,145,55,3,58,29,2,31,228,6,234
Gujarat,2009,Rape,0,0,0,345,1,346,131,1,132,8,0,8,484,2,486
Gujarat,2009,Kidnapping And Abduction,0,0,0,46,0,46,28,0,28,11,0,11,85,0,85
Gujarat,2009,Dacoity,0,0,0,70,1,71,26,0,26,1,0,1,97,1,98
Gujarat,2009,Prep. And Assembly For Dacoity,0,0,0,14,1,15,24,0,24,1,0,1,39,1,40
Gujarat,2009,Robbery,0,0,0,22,0,22,73,0,73,0,0,0,95,0,95
Gujarat,2009,Burglary,0,0,0,0,0,0,26,0,26,0,0,0,26,0,26
Gujarat,2009,Thefts,0,0,0,7,0,7,44,0,44,2,0,2,53,0,53
Gujarat,2009,Extortion,0,0,0,0,0,0,0,0,0,0,0,0,0,0,0
Gujarat,2009,Riots,0,0,0,1,0,1,21,0,21,11,0,11,33,0,33
Gujarat,2009,Arson,0,0,0,3,0,3,2,0,2,0,0,0,5,0,5
Gujarat,2009,Criminal Breach Of Trust,0,0,0,11,0,11,28,0,28,7,0,7,46,0,46
Gujarat,2009,Cheating,0,0,0,3,0,3,2,0,2,4,0,4,9,0,9
Gujarat,2009,Counter Feiting,0,0,0,41,0,41,36,0,36,8,0,8,85,0,85
Gujarat,2009,Dowry Deaths,0,0,0,29,1,30,30,2,32,0,0,0,59,3,62
Gujarat,2009,Molestation,0,0,0,0,0,0,0,0,0,0,0,0,0,0,0
Gujarat,2009,Eve-Teasing,0,0,0,0,0,0,0,0,0,0,0,0,0,0,0
Gujarat,2009,Cruelty By Husband Or Relative Of Husband,0,0,0,13,0,13,52,0,52,18,0,18,83,0,83
Gujarat,2009,Other Ipc Crimes,0,0,0,20,9,29,40,9,49,7,0,7,67,18,85
Gujarat,2010,Murder,0,0,0,714,29,743,951,56,1007,116,25,141,1781,110,1891
Gujarat,2010,Attempt To Commit Murder,0,0,0,67,0,67,47,0,47,23,0,23,137,0,137
Gujarat,2010,C.H. Not Amounting To Murder,0,0,0,143,4,147,84,8,92,37,3,40,264,15,279
Gujarat,2010,Rape,0,0,0,392,1,393,129,3,132,8,1,9,529,5,534
Gujarat,2010,Kidnapping And Abduction,0,0,0,35,0,35,24,2,26,4,0,4,63,2,65
Gujarat,2010,Dacoity,0,0,0,82,0,82,43,0,43,0,0,0,125,0,125
Gujarat,2010,Prep. And Assembly For Dacoity,0,0,0,10,0,10,7,0,7,1,0,1,18,0,18
Gujarat,2010,Robbery,0,0,0,29,0,29,16,0,16,3,0,3,48,0,48
Gujarat,2010,Burglary,0,0,0,1,0,1,5,0,5,11,0,11,17,0,17
Gujarat,2010,Thefts,0,0,0,48,0,48,20,1,21,5,0,5,73,1,74
Gujarat,2010,Extortion,0,0,0,4,0,4,0,0,0,0,0,0,4,0,4
Gujarat,2010,Riots,0,0,0,0,0,0,0,0,0,0,0,0,0,0,0
Gujarat,2010,Arson,0,0,0,0,0,0,0,0,0,0,0,0,0,0,0
Gujarat,2010,Criminal Breach Of Trust,0,0,0,2,1,3,7,1,8,4,0,4,13,2,15
Gujarat,2010,Cheating,0,0,0,3,0,3,1,0,1,4,0,4,8,0,8
Gujarat,2010,Counter Feiting,0,0,0,38,0,38,21,0,21,15,0,15,74,0,74
Gujarat,2010,Dowry Deaths,0,0,0,6,0,6,14,2,16,0,0,0,20,2,22
Gujarat,2010,Molestation,0,0,0,1,0,1,1,0,1,0,0,0,2,0,2
Gujarat,2010,Eve-Teasing,0,0,0,0,0,0,0,0,0,0,0,0,0,0,0
Gujarat,2010,Cruelty By Husband Or Relative Of Husband,0,0,0,44,0,44,34,0,34,11,3,14,89,3,92
Gujarat,2010,Other Ipc Crimes,0,0,0,34,2,36,57,5,62,31,1,32,122,8,130
Gujarat,2011,Murder,0,0,0,636,36,672,929,52,981,122,27,149,1687,115,1802
Gujarat,2011,Attempt To Commit Murder,0,0,0,61,0,61,78,0,78,14,1,15,153,1,154
Gujarat,2011,C.H. Not Amounting To Murder,0,0,0,145,4,149,99,9,108,40,5,45,284,18,302
Gujarat,2011,Rape,0,0,0,346,0,346,138,1,139,6,0,6,490,1,491
Gujarat,2011,Kidnapping And Abduction,0,0,0,63,1,64,40,3,43,0,1,1,103,5,108
Gujarat,2011,Dacoity,0,0,0,67,0,67,56,0,56,3,0,3,126,0,126
Gujarat,2011,Prep. And Assembly For Dacoity,0,0,0,21,0,21,14,0,14,4,0,4,39,0,39
Gujarat,2011,Robbery,0,0,0,60,0,60,71,0,71,6,0,6,137,0,137
Gujarat,2011,Burglary,0,0,0,1,0,1,23,0,23,13,0,13,37,0,37
Gujarat,2011,Thefts,0,0,0,47,1,48,32,0,32,12,0,12,91,1,92
Gujarat,2011,Extortion,0,0,0,0,0,0,0,0,0,0,0,0,0,0,0
Gujarat,2011,Riots,0,0,0,0,0,0,0,0,0,0,0,0,0,0,0
Gujarat,2011,Arson,0,0,0,9,0,9,1,0,1,0,0,0,10,0,10
Gujarat,2011,Criminal Breach Of Trust,0,0,0,17,0,17,13,1,14,8,0,8,38,1,39
Gujarat,2011,Cheating,0,0,0,3,0,3,1,0,1,0,0,0,4,0,4
Gujarat,2011,Counter Feiting,0,0,0,34,0,34,27,0,27,11,0,11,72,0,72
Gujarat,2011,Dowry Deaths,0,0,0,11,0,11,29,0,29,5,0,5,45,0,45
Gujarat,2011,Molestation,0,0,0,0,0,0,1,0,1,0,0,0,1,0,1
Gujarat,2011,Eve-Teasing,0,0,0,2,0,2,0,0,0,0,0,0,2,0,2
Gujarat,2011,Cruelty By Husband Or Relative Of Husband,0,0,0,41,2,43,40,3,43,13,7,20,94,12,106
Gujarat,2011,Other Ipc Crimes,0,0,0,83,1,84,77,2,79,15,0,15,175,3,178
Gujarat,2012,Murder,0,0,0,352,18,370,1001,71,1072,270,26,296,1623,115,1738
Gujarat,2012,Attempt To Commit Murder,0,0,0,72,0,72,127,0,127,55,2,57,254,2,256
Gujarat,2012,C.H. Not Amounting To Murder,0,0,0,140,1,141,124,7,131,50,4,54,314,12,326
Gujarat,2012,Rape,0,0,0,179,0,179,192,4,196,36,0,36,407,4,411
Gujarat,2012,Kidnapping And Abduction,0,0,0,41,0,41,37,0,37,6,2,8,84,2,86
Gujarat,2012,Dacoity,0,0,0,40,0,40,63,0,63,2,0,2,105,0,105
Gujarat,2012,Prep. And Assembly For Dacoity,0,0,0,28,0,28,24,0,24,1,0,1,53,0,53
Gujarat,2012,Robbery,0,0,0,65,0,65,86,0,86,7,0,7,158,0,158
Gujarat,2012,Burglary,0,0,0,16,0,16,19,1,20,13,0,13,48,1,49
Gujarat,2012,Thefts,0,0,0,32,0,32,18,0,18,7,0,7,57,0,57
Gujarat,2012,Extortion,0,0,0,0,0,0,0,0,0,0,0,0,0,0,0
Gujarat,2012,Riots,0,0,0,0,0,0,0,0,0,0,0,0,0,0,0
Gujarat,2012,Arson,0,0,0,6,0,6,1,0,1,3,1,4,10,1,11
Gujarat,2012,Criminal Breach Of Trust,0,0,0,14,0,14,12,0,12,7,0,7,33,0,33
Gujarat,2012,Cheating,0,0,0,12,0,12,1,0,1,0,0,0,13,0,13
Gujarat,2012,Counter Feiting,0,0,0,15,0,15,37,0,37,18,0,18,70,0,70
Gujarat,2012,Dowry Deaths,0,0,0,3,1,4,55,4,59,10,3,13,68,8,76
Gujarat,2012,Molestation,0,0,0,0,0,0,1,0,1,0,0,0,1,0,1
Gujarat,2012,Eve-Teasing,0,0,0,1,0,1,0,0,0,0,0,0,1,0,1
Gujarat,2012,Cruelty By Husband Or Relative Of Husband,0,0,0,34,3,37,46,12,58,14,9,23,94,24,118
Gujarat,2012,Other Ipc Crimes,0,0,0,38,0,38,114,1,115,14,0,14,166,1,167
Haryana,2001,Murder,0,0,0,399,13,412,589,28,617,215,15,230,1203,56,1259
Haryana,2001,Attempt To Commit Murder,0,0,0,71,0,71,79,2,81,29,2,31,179,4,183
Haryana,2001,C.H. Not Amounting To Murder,0,0,0,21,0,21,30,0,30,10,0,10,61,0,61
Haryana,2001,Rape,0,0,0,128,0,128,69,0,69,10,0,10,207,0,207
Haryana,2001,Kidnapping And Abduction,0,0,0,26,0,26,50,0,50,11,0,11,87,0,87
Haryana,2001,Dacoity,0,0,0,61,0,61,55,0,55,12,0,12,128,0,128
Haryana,2001,Prep. And Assembly For Dacoity,0,0,0,41,0,41,51,0,51,17,0,17,109,0,109
Haryana,2001,Robbery,0,0,0,27,0,27,23,0,23,9,0,9,59,0,59
Haryana,2001,Burglary,0,0,0,36,0,36,43,0,43,21,0,21,100,0,100
Haryana,2001,Thefts,0,0,0,27,2,29,21,0,21,7,0,7,55,2,57
Haryana,2001,Extortion,0,0,0,0,0,0,0,0,0,0,0,0,0,0,0
Haryana,2001,Riots,0,0,0,0,0,0,0,0,0,1,0,1,1,0,1
Haryana,2001,Arson,0,0,0,0,0,0,0,0,0,1,0,1,1,0,1
Haryana,2001,Criminal Breach Of Trust,0,0,0,0,0,0,0,0,0,0,0,0,0,0,0
Haryana,2001,Cheating,0,0,0,17,0,17,18,0,18,4,0,4,39,0,39
Haryana,2001,Counter Feiting,0,0,0,0,0,0,0,0,0,0,0,0,0,0,0
Haryana,2001,Dowry Deaths,0,0,0,66,4,70,70,19,89,27,12,39,163,35,198
Haryana,2001,Molestation,0,0,0,4,0,4,2,0,2,0,0,0,6,0,6
Haryana,2001,Eve-Teasing,0,0,0,1,0,1,0,0,0,0,0,0,1,0,1
Haryana,2001,Cruelty By Husband Or Relative Of Husband,0,0,0,10,0,10,21,0,21,9,0,9,40,0,40
Haryana,2001,Other Ipc Crimes,0,0,0,19,0,19,8,0,8,7,0,7,34,0,34
Haryana,2002,Murder,3,0,3,647,9,656,769,39,808,216,19,235,1635,67,1702
Haryana,2002,Attempt To Commit Murder,0,0,0,94,1,95,58,2,60,33,0,33,185,3,188
Haryana,2002,C.H. Not Amounting To Murder,0,0,0,52,3,55,41,8,49,25,2,27,118,13,131
Haryana,2002,Rape,0,0,0,118,0,118,72,0,72,7,0,7,197,0,197
Haryana,2002,Kidnapping And Abduction,0,0,0,25,3,28,25,2,27,26,0,26,76,5,81
Haryana,2002,Dacoity,0,0,0,54,0,54,39,0,39,8,1,9,101,1,102
Haryana,2002,Prep. And Assembly For Dacoity,0,0,0,13,0,13,4,0,4,0,0,0,17,0,17
Haryana,2002,Robbery,0,0,0,59,0,59,33,0,33,11,0,11,103,0,103
Haryana,2002,Burglary,0,0,0,39,0,39,44,0,44,4,0,4,87,0,87
Haryana,2002,Thefts,0,0,0,35,0,35,13,0,13,4,0,4,52,0,52
Haryana,2002,Extortion,0,0,0,2,0,2,0,0,0,0,0,0,2,0,2
Haryana,2002,Riots,0,0,0,7,0,7,0,0,0,0,0,0,7,0,7
Haryana,2002,Arson,0,0,0,2,0,2,8,0,8,0,0,0,10,0,10
Haryana,2002,Criminal Breach Of Trust,0,0,0,1,0,1,9,0,9,0,0,0,10,0,10
Haryana,2002,Cheating,0,0,0,6,0,6,4,1,5,2,0,2,12,1,13
Haryana,2002,Counter Feiting,0,0,0,1,0,1,0,0,0,0,0,0,1,0,1
Haryana,2002,Dowry Deaths,0,0,0,67,3,70,27,18,45,13,12,25,107,33,140
Haryana,2002,Molestation,0,0,0,8,0,8,4,0,4,0,0,0,12,0,12
Haryana,2002,Eve-Teasing,0,0,0,0,0,0,0,0,0,0,0,0,0,0,0
Haryana,2002,Cruelty By Husband Or Relative Of Husband,2,0,2,10,0,10,15,0,15,0,0,0,27,0,27
Haryana,2002,Other Ipc Crimes,0,0,0,7,0,7,7,0,7,14,0,14,28,0,28
Haryana,2003,Murder,0,0,0,600,30,630,826,40,866,330,27,357,1756,97,1853
Haryana,2003,Attempt To Commit Murder,0,0,0,100,2,102,121,0,121,71,0,71,292,2,294
Haryana,2003,C.H. Not Amounting To Murder,0,0,0,0,0,0,0,0,0,0,0,0,0,0,0
Haryana,2003,Rape,0,0,0,151,5,156,143,3,146,53,1,54,347,9,356
Haryana,2003,Kidnapping And Abduction,0,0,0,47,0,47,44,0,44,5,0,5,96,0,96
Haryana,2003,Dacoity,0,0,0,77,0,77,50,0,50,7,0,7,134,0,134
Haryana,2003,Prep. And Assembly For Dacoity,0,0,0,43,0,43,39,0,39,8,0,8,90,0,90
Haryana,2003,Robbery,0,0,0,44,0,44,61,0,61,37,0,37,142,0,142
Haryana,2003,Burglary,0,0,0,30,0,30,59,0,59,26,0,26,115,0,115
Haryana,2003,Thefts,0,0,0,40,0,40,19,0,19,6,0,6,65,0,65
Haryana,2003,Extortion,0,0,0,0,0,0,0,0,0,0,0,0,0,0,0
Haryana,2003,Riots,0,0,0,0,0,0,1,0,1,0,0,0,1,0,1
Haryana,2003,Arson,0,0,0,0,0,0,2,0,2,0,0,0,2,0,2
Haryana,2003,Criminal Breach Of Trust,0,0,0,0,0,0,5,0,5,2,0,2,7,0,7
Haryana,2003,Cheating,0,0,0,0,0,0,8,2,10,0,0,0,8,2,10
Haryana,2003,Counter Feiting,0,0,0,0,0,0,0,0,0,0,0,0,0,0,0
Haryana,2003,Dowry Deaths,0,0,0,108,20,128,98,9,107,73,9,82,279,38,317
Haryana,2003,Molestation,0,0,0,4,0,4,2,0,2,0,0,0,6,0,6
Haryana,2003,Eve-Teasing,0,0,0,0,0,0,0,0,0,0,0,0,0,0,0
Haryana,2003,Cruelty By Husband Or Relative Of Husband,0,0,0,18,0,18,22,2,24,13,0,13,53,2,55
Haryana,2003,Other Ipc Crimes,0,0,0,15,0,15,13,0,13,3,0,3,31,0,31
Haryana,2004,Murder,0,0,0,733,29,762,751,44,795,282,25,307,1766,98,1864
Haryana,2004,Attempt To Commit Murder,0,0,0,108,2,110,130,0,130,58,1,59,296,3,299
Haryana,2004,C.H. Not Amounting To Murder,0,0,0,54,2,56,58,0,58,14,0,14,126,2,128
Haryana,2004,Rape,0,0,0,221,2,223,151,0,151,28,0,28,400,2,402
Haryana,2004,Kidnapping And Abduction,0,0,0,38,1,39,26,0,26,5,0,5,69,1,70
Haryana,2004,Dacoity,0,0,0,95,0,95,110,0,110,17,0,17,222,0,222
Haryana,2004,Prep. And Assembly For Dacoity,0,0,0,26,0,26,51,0,51,6,0,6,83,0,83
Haryana,2004,Robbery,0,0,0,59,0,59,60,0,60,15,0,15,134,0,134
Haryana,2004,Burglary,0,0,0,37,0,37,44,0,44,22,0,22,103,0,103
Haryana,2004,Thefts,0,0,0,31,0,31,28,0,28,4,0,4,63,0,63
Haryana,2004,Extortion,0,0,0,1,0,1,0,0,0,0,0,0,1,0,1
Haryana,2004,Riots,0,0,0,0,0,0,0,0,0,0,0,0,0,0,0
Haryana,2004,Arson,0,0,0,0,0,0,0,0,0,0,0,0,0,0,0
Haryana,2004,Criminal Breach Of Trust,0,0,0,0,0,0,0,0,0,0,0,0,0,0,0
Haryana,2004,Cheating,0,0,0,2,0,2,5,0,5,0,0,0,7,0,7
Haryana,2004,Counter Feiting,0,0,0,4,0,4,11,0,11,0,0,0,15,0,15
Haryana,2004,Dowry Deaths,0,0,0,107,13,120,142,23,165,103,19,122,352,55,407
Haryana,2004,Molestation,0,0,0,5,0,5,3,0,3,0,0,0,8,0,8
Haryana,2004,Eve-Teasing,0,0,0,0,0,0,0,0,0,0,0,0,0,0,0
Haryana,2004,Cruelty By Husband Or Relative Of Husband,0,0,0,25,0,25,14,0,14,0,0,0,39,0,39
Haryana,2004,Other Ipc Crimes,0,0,0,18,4,22,22,4,26,14,0,14,54,8,62
Haryana,2005,Murder,0,0,0,659,28,687,1004,26,1030,246,10,256,1909,64,1973
Haryana,2005,Attempt To Commit Murder,0,0,0,216,2,218,182,4,186,46,0,46,444,6,450
Haryana,2005,C.H. Not Amounting To Murder,0,0,0,42,3,45,56,1,57,7,0,7,105,4,109
Haryana,2005,Rape,0,0,0,298,1,299,79,3,82,17,0,17,394,4,398
Haryana,2005,Kidnapping And Abduction,0,0,0,97,0,97,36,0,36,9,0,9,142,0,142
Haryana,2005,Dacoity,0,0,0,99,0,99,47,0,47,12,0,12,158,0,158
Haryana,2005,Prep. And Assembly For Dacoity,0,0,0,36,0,36,38,0,38,9,0,9,83,0,83
Haryana,2005,Robbery,4,0,4,71,0,71,44,0,44,4,0,4,123,0,123
Haryana,2005,Burglary,0,0,0,19,0,19,16,0,16,8,0,8,43,0,43
Haryana,2005,Thefts,4,0,4,23,0,23,10,0,10,0,0,0,37,0,37
Haryana,2005,Extortion,0,0,0,6,0,6,2,0,2,0,0,0,8,0,8
Haryana,2005,Riots,0,0,0,3,0,3,3,0,3,1,0,1,7,0,7
Haryana,2005,Arson,0,0,0,1,0,1,3,0,3,1,0,1,5,0,5
Haryana,2005,Criminal Breach Of Trust,0,0,0,3,0,3,1,0,1,1,0,1,5,0,5
Haryana,2005,Cheating,0,0,0,2,0,2,1,0,1,2,0,2,5,0,5
Haryana,2005,Counter Feiting,0,0,0,7,0,7,3,0,3,0,0,0,10,0,10
Haryana,2005,Dowry Deaths,0,0,0,102,22,124,89,22,111,33,27,60,224,71,295
Haryana,2005,Molestation,0,0,0,1,0,1,2,0,2,1,0,1,4,0,4
Haryana,2005,Eve-Teasing,0,0,0,0,0,0,0,0,0,0,0,0,0,0,0
Haryana,2005,Cruelty By Husband Or Relative Of Husband,0,0,0,20,2,22,12,2,14,6,0,6,38,4,42
Haryana,2005,Other Ipc Crimes,0,0,0,49,1,50,46,0,46,31,0,31,126,1,127
Haryana,2006,Murder,0,0,0,672,28,700,1047,52,1099,414,26,440,2133,106,2239
Haryana,2006,Attempt To Commit Murder,0,0,0,107,2,109,189,4,193,142,2,144,438,8,446
Haryana,2006,C.H. Not Amounting To Murder,0,0,0,38,0,38,48,2,50,14,2,16,100,4,104
Haryana,2006,Rape,0,0,0,164,0,164,188,5,193,60,1,61,412,6,418
Haryana,2006,Kidnapping And Abduction,0,0,0,47,1,48,52,4,56,22,0,22,121,5,126
Haryana,2006,Dacoity,0,0,0,78,1,79,72,0,72,42,0,42,192,1,193
Haryana,2006,Prep. And Assembly For Dacoity,0,0,0,89,0,89,11,0,11,0,0,0,100,0,100
Haryana,2006,Robbery,0,0,0,39,0,39,42,0,42,1,0,1,82,0,82
Haryana,2006,Burglary,0,0,0,14,0,14,9,0,9,0,0,0,23,0,23
Haryana,2006,Thefts,0,0,0,29,0,29,19,3,22,1,0,1,49,3,52
Haryana,2006,Extortion,0,0,0,4,0,4,5,0,5,0,0,0,9,0,9
Haryana,2006,Riots,0,0,0,2,0,2,1,0,1,0,0,0,3,0,3
Haryana,2006,Arson,0,0,0,3,0,3,1,0,1,2,0,2,6,0,6
Haryana,2006,Criminal Breach Of Trust,0,0,0,4,0,4,2,0,2,0,0,0,6,0,6
Haryana,2006,Cheating,0,0,0,13,0,13,29,0,29,3,0,3,45,0,45
Haryana,2006,Counter Feiting,0,0,0,5,0,5,5,0,5,0,0,0,10,0,10
Haryana,2006,Dowry Deaths,0,0,0,109,10,119,111,22,133,51,10,61,271,42,313
Haryana,2006,Molestation,0,0,0,0,0,0,2,0,2,0,0,0,2,0,2
Haryana,2006,Eve-Teasing,0,0,0,0,0,0,0,0,0,0,0,0,0,0,0
Haryana,2006,Cruelty By Husband Or Relative Of Husband,0,0,0,26,0,26,20,2,22,2,1,3,48,3,51
Haryana,2006,Other Ipc Crimes,0,0,0,14,0,14,71,0,71,6,0,6,91,0,91
Haryana,2007,Murder,0,0,0,672,28,700,1047,52,1099,414,26,440,2133,106,2239
Haryana,2007,Attempt To Commit Murder,0,0,0,107,2,109,189,4,193,142,2,144,438,8,446
Haryana,2007,C.H. Not Amounting To Murder,0,0,0,38,0,38,48,2,50,14,2,16,100,4,104
Haryana,2007,Rape,0,0,0,164,0,164,188,5,193,60,1,61,412,6,418
Haryana,2007,Kidnapping And Abduction,0,0,0,47,1,48,52,4,56,22,0,22,121,5,126
Haryana,2007,Dacoity,0,0,0,78,1,79,72,0,72,42,0,42,192,1,193
Haryana,2007,Prep. And Assembly For Dacoity,0,0,0,89,0,89,11,0,11,0,0,0,100,0,100
Haryana,2007,Robbery,0,0,0,39,0,39,42,0,42,1,0,1,82,0,82
Haryana,2007,Burglary,0,0,0,14,0,14,9,0,9,0,0,0,23,0,23
Haryana,2007,Thefts,0,0,0,29,0,29,19,3,22,1,0,1,49,3,52
Haryana,2007,Extortion,0,0,0,4,0,4,5,0,5,0,0,0,9,0,9
Haryana,2007,Riots,0,0,0,2,0,2,1,0,1,0,0,0,3,0,3
Haryana,2007,Arson,0,0,0,3,0,3,1,0,1,2,0,2,6,0,6
Haryana,2007,Criminal Breach Of Trust,0,0,0,4,0,4,2,0,2,0,0,0,6,0,6
Haryana,2007,Cheating,0,0,0,13,0,13,29,0,29,3,0,3,45,0,45
Haryana,2007,Counter Feiting,0,0,0,5,0,5,5,0,5,0,0,0,10,0,10
Haryana,2007,Dowry Deaths,0,0,0,109,10,119,111,22,133,51,10,61,271,42,313
Haryana,2007,Molestation,0,0,0,0,0,0,2,0,2,0,0,0,2,0,2
Haryana,2007,Eve-Teasing,0,0,0,0,0,0,0,0,0,0,0,0,0,0,0
Haryana,2007,Cruelty By Husband Or Relative Of Husband,0,0,0,26,0,26,20,2,22,2,1,3,48,3,51
Haryana,2007,Other Ipc Crimes,0,0,0,14,0,14,71,0,71,6,0,6,91,0,91
Haryana,2008,Murder,0,0,0,746,33,779,1243,77,1320,429,23,452,2418,133,2551
Haryana,2008,Attempt To Commit Murder,0,0,0,103,1,104,114,3,117,43,0,43,260,4,264
Haryana,2008,C.H. Not Amounting To Murder,0,0,0,37,1,38,52,1,53,17,1,18,106,3,109
Haryana,2008,Rape,0,0,0,194,4,198,194,8,202,50,0,50,438,12,450
Haryana,2008,Kidnapping And Abduction,0,0,0,48,1,49,62,2,64,5,0,5,115,3,118
Haryana,2008,Dacoity,0,0,0,84,0,84,98,0,98,7,0,7,189,0,189
Haryana,2008,Prep. And Assembly For Dacoity,0,0,0,45,0,45,44,0,44,1,0,1,90,0,90
Haryana,2008,Robbery,0,0,0,69,0,69,58,0,58,4,0,4,131,0,131
Haryana,2008,Burglary,0,0,0,29,0,29,26,0,26,3,0,3,58,0,58
Haryana,2008,Thefts,0,0,0,33,0,33,47,1,48,3,0,3,83,1,84
Haryana,2008,Extortion,0,0,0,8,0,8,2,0,2,0,0,0,10,0,10
Haryana,2008,Riots,0,0,0,12,0,12,7,0,7,5,0,5,24,0,24
Haryana,2008,Arson,0,0,0,5,0,5,2,0,2,1,0,1,8,0,8
Haryana,2008,Criminal Breach Of Trust,0,0,0,3,0,3,5,0,5,0,0,0,8,0,8
Haryana,2008,Cheating,0,0,0,2,0,2,16,0,16,5,0,5,23,0,23
Haryana,2008,Counter Feiting,0,0,0,10,0,10,12,0,12,3,0,3,25,0,25
Haryana,2008,Dowry Deaths,0,0,0,94,9,103,93,17,110,61,34,95,248,60,308
Haryana,2008,Molestation,0,0,0,0,1,1,8,0,8,1,0,1,9,1,10
Haryana,2008,Eve-Teasing,0,0,0,0,0,0,0,0,0,0,0,0,0,0,0
Haryana,2008,Cruelty By Husband Or Relative Of Husband,0,0,0,13,0,13,20,0,20,1,2,3,34,2,36
Haryana,2008,Other Ipc Crimes,0,0,0,33,3,36,35,1,36,18,3,21,86,7,93
Haryana,2009,Murder,0,0,0,883,28,911,1301,45,1346,481,54,535,2665,127,2792
Haryana,2009,Attempt To Commit Murder,0,0,0,157,1,158,131,2,133,44,2,46,332,5,337
Haryana,2009,C.H. Not Amounting To Murder,0,0,0,64,0,64,62,0,62,25,0,25,151,0,151
Haryana,2009,Rape,0,0,0,236,3,239,161,1,162,41,0,41,438,4,442
Haryana,2009,Kidnapping And Abduction,0,0,0,71,13,84,45,4,49,22,5,27,138,22,160
Haryana,2009,Dacoity,0,0,0,146,0,146,86,0,86,12,0,12,244,0,244
Haryana,2009,Prep. And Assembly For Dacoity,0,0,0,38,0,38,42,0,42,1,0,1,81,0,81
Haryana,2009,Robbery,0,0,0,74,0,74,50,0,50,20,0,20,144,0,144
Haryana,2009,Burglary,0,0,0,30,0,30,28,0,28,0,0,0,58,0,58
Haryana,2009,Thefts,0,0,0,20,1,21,21,0,21,1,0,1,42,1,43
Haryana,2009,Extortion,0,0,0,4,0,4,2,0,2,0,0,0,6,0,6
Haryana,2009,Riots,0,0,0,3,0,3,3,0,3,1,0,1,7,0,7
Haryana,2009,Arson,0,0,0,5,0,5,2,0,2,1,0,1,8,0,8
Haryana,2009,Criminal Breach Of Trust,0,0,0,6,0,6,7,0,7,0,0,0,13,0,13
Haryana,2009,Cheating,0,0,0,0,0,0,5,0,5,1,0,1,6,0,6
Haryana,2009,Counter Feiting,0,0,0,11,0,11,13,1,14,1,0,1,25,1,26
Haryana,2009,Dowry Deaths,0,0,0,121,12,133,138,27,165,81,27,108,340,66,406
Haryana,2009,Molestation,0,0,0,1,0,1,1,0,1,1,0,1,3,0,3
Haryana,2009,Eve-Teasing,0,0,0,0,0,0,0,0,0,0,0,0,0,0,0
Haryana,2009,Cruelty By Husband Or Relative Of Husband,0,0,0,15,0,15,20,9,29,1,0,1,36,9,45
Haryana,2009,Other Ipc Crimes,0,0,0,17,0,17,16,0,16,5,0,5,38,0,38
Haryana,2010,Murder,0,0,0,1163,25,1188,1107,46,1153,370,38,408,2640,109,2749
Haryana,2010,Attempt To Commit Murder,0,0,0,169,0,169,176,5,181,63,0,63,408,5,413
Haryana,2010,C.H. Not Amounting To Murder,0,0,0,34,0,34,54,1,55,21,2,23,109,3,112
Haryana,2010,Rape,0,0,0,314,1,315,185,3,188,22,0,22,521,4,525
Haryana,2010,Kidnapping And Abduction,0,0,0,133,3,136,82,7,89,9,1,10,224,11,235
Haryana,2010,Dacoity,0,0,0,229,0,229,79,0,79,6,0,6,314,0,314
Haryana,2010,Prep. And Assembly For Dacoity,0,0,0,42,0,42,26,0,26,1,0,1,69,0,69
Haryana,2010,Robbery,0,0,0,100,0,100,61,0,61,0,0,0,161,0,161
Haryana,2010,Burglary,0,0,0,19,0,19,17,0,17,7,0,7,43,0,43
Haryana,2010,Thefts,0,0,0,20,0,20,19,0,19,3,0,3,42,0,42
Haryana,2010,Extortion,0,0,0,3,0,3,2,0,2,0,0,0,5,0,5
Haryana,2010,Riots,0,0,0,2,0,2,0,0,0,0,0,0,2,0,2
Haryana,2010,Arson,0,0,0,0,0,0,1,0,1,0,0,0,1,0,1
Haryana,2010,Criminal Breach Of Trust,0,0,0,0,0,0,6,1,7,3,0,3,9,1,10
Haryana,2010,Cheating,0,0,0,1,0,1,7,0,7,2,0,2,10,0,10
Haryana,2010,Counter Feiting,0,0,0,10,0,10,9,1,10,1,0,1,20,1,21
Haryana,2010,Dowry Deaths,0,0,0,175,2,177,154,30,184,100,43,143,429,75,504
Haryana,2010,Molestation,0,0,0,9,0,9,4,0,4,0,0,0,13,0,13
Haryana,2010,Eve-Teasing,0,0,0,0,0,0,0,0,0,0,0,0,0,0,0
Haryana,2010,Cruelty By Husband Or Relative Of Husband,0,0,0,14,0,14,10,3,13,6,9,15,30,12,42
Haryana,2010,Other Ipc Crimes,0,0,0,0,0,0,169,1,170,28,2,30,197,3,200
Haryana,2011,Murder,0,0,0,1188,31,1219,1286,59,1345,376,43,419,2850,133,2983
Haryana,2011,Attempt To Commit Murder,0,0,0,143,5,148,200,1,201,60,2,62,403,8,411
Haryana,2011,C.H. Not Amounting To Murder,0,0,0,74,2,76,106,4,110,59,4,63,239,10,249
Haryana,2011,Rape,0,0,0,292,0,292,195,1,196,34,0,34,521,1,522
Haryana,2011,Kidnapping And Abduction,0,0,0,141,5,146,98,6,104,27,1,28,266,12,278
Haryana,2011,Dacoity,0,0,0,173,0,173,83,2,85,16,0,16,272,2,274
Haryana,2011,Prep. And Assembly For Dacoity,0,0,0,76,0,76,43,0,43,0,0,0,119,0,119
Haryana,2011,Robbery,0,0,0,108,0,108,66,0,66,3,0,3,177,0,177
Haryana,2011,Burglary,0,0,0,21,0,21,18,0,18,4,0,4,43,0,43
Haryana,2011,Thefts,0,0,0,15,0,15,11,0,11,2,1,3,28,1,29
Haryana,2011,Extortion,0,0,0,4,0,4,1,0,1,0,0,0,5,0,5
Haryana,2011,Riots,0,0,0,6,0,6,2,0,2,0,0,0,8,0,8
Haryana,2011,Arson,0,0,0,1,0,1,1,0,1,0,0,0,2,0,2
Haryana,2011,Criminal Breach Of Trust,0,0,0,6,0,6,5,0,5,0,0,0,11,0,11
Haryana,2011,Cheating,0,0,0,6,0,6,7,0,7,1,1,2,14,1,15
Haryana,2011,Counter Feiting,0,0,0,5,0,5,8,1,9,1,1,2,14,2,16
Haryana,2011,Dowry Deaths,0,0,0,143,5,148,121,37,158,39,44,83,303,86,389
Haryana,2011,Molestation,0,0,0,9,0,9,5,0,5,3,0,3,17,0,17
Haryana,2011,Eve-Teasing,0,0,0,1,0,1,1,1,2,0,0,0,2,1,3
Haryana,2011,Cruelty By Husband Or Relative Of Husband,0,0,0,11,0,11,15,0,15,8,1,9,34,1,35
Haryana,2011,Other Ipc Crimes,0,0,0,55,0,55,112,2,114,46,1,47,213,3,216
Haryana,2012,Murder,0,0,0,1082,39,1121,1394,71,1465,358,39,397,2834,149,2983
Haryana,2012,Attempt To Commit Murder,0,0,0,144,0,144,210,0,210,65,0,65,419,0,419
Haryana,2012,C.H. Not Amounting To Murder,0,0,0,63,0,63,62,6,68,37,2,39,162,8,170
Haryana,2012,Rape,0,0,0,244,1,245,214,3,217,40,0,40,498,4,502
Haryana,2012,Kidnapping And Abduction,0,0,0,128,5,133,85,5,90,29,1,30,242,11,253
Haryana,2012,Dacoity,0,0,0,233,0,233,153,0,153,12,0,12,398,0,398
Haryana,2012,Prep. And Assembly For Dacoity,0,0,0,20,0,20,22,0,22,0,0,0,42,0,42
Haryana,2012,Robbery,0,0,0,110,0,110,49,0,49,2,0,2,161,0,161
Haryana,2012,Burglary,0,0,0,19,0,19,28,0,28,4,0,4,51,0,51
Haryana,2012,Thefts,0,0,0,30,0,30,22,1,23,0,1,1,52,2,54
Haryana,2012,Extortion,0,0,0,1,0,1,6,0,6,0,0,0,7,0,7
Haryana,2012,Riots,0,0,0,25,1,26,16,0,16,9,0,9,50,1,51
Haryana,2012,Arson,0,0,0,2,0,2,1,0,1,1,0,1,4,0,4
Haryana,2012,Criminal Breach Of Trust,0,0,0,0,0,0,7,0,7,3,0,3,10,0,10
Haryana,2012,Cheating,0,0,0,2,0,2,15,0,15,6,0,6,23,0,23
Haryana,2012,Counter Feiting,0,0,0,2,0,2,5,1,6,1,0,1,8,1,9
Haryana,2012,Dowry Deaths,0,0,0,143,3,146,149,33,182,63,42,105,355,78,433
Haryana,2012,Molestation,0,0,0,3,0,3,6,0,6,0,0,0,9,0,9
Haryana,2012,Eve-Teasing,0,0,0,0,0,0,0,0,0,0,0,0,0,0,0
Haryana,2012,Cruelty By Husband Or Relative Of Husband,0,0,0,11,1,12,24,1,25,2,3,5,37,5,42
Haryana,2012,Other Ipc Crimes,0,0,0,152,2,154,181,4,185,64,0,64,397,6,403
Himachal Pradesh,2001,Murder,0,0,0,34,1,35,29,2,31,26,0,26,89,3,92
Himachal Pradesh,2001,Attempt To Commit Murder,4,0,4,31,1,32,61,1,62,19,1,20,115,3,118
Himachal Pradesh,2001,C.H. Not Amounting To Murder,3,0,3,20,2,22,35,1,36,11,1,12,69,4,73
Himachal Pradesh,2001,Rape,0,0,0,21,0,21,11,0,11,4,0,4,36,0,36
Himachal Pradesh,2001,Kidnapping And Abduction,0,0,0,0,0,0,0,0,0,0,0,0,0,0,0
Himachal Pradesh,2001,Dacoity,0,0,0,9,0,9,6,0,6,3,0,3,18,0,18
Himachal Pradesh,2001,Prep. And Assembly For Dacoity,0,0,0,0,0,0,0,0,0,0,0,0,0,0,0
Himachal Pradesh,2001,Robbery,0,0,0,0,0,0,0,0,0,0,0,0,0,0,0
Himachal Pradesh,2001,Burglary,0,0,0,7,0,7,15,0,15,3,0,3,25,0,25
Himachal Pradesh,2001,Thefts,0,0,0,0,0,0,0,0,0,0,0,0,0,0,0
Himachal Pradesh,2001,Extortion,0,0,0,0,0,0,0,0,0,0,0,0,0,0,0
Himachal Pradesh,2001,Riots,0,0,0,0,0,0,0,0,0,0,0,0,0,0,0
Himachal Pradesh,2001,Arson,0,0,0,0,0,0,0,0,0,0,0,0,0,0,0
Himachal Pradesh,2001,Criminal Breach Of Trust,0,0,0,0,0,0,0,0,0,0,0,0,0,0,0
Himachal Pradesh,2001,Cheating,0,0,0,6,0,6,5,1,6,0,0,0,11,1,12
Himachal Pradesh,2001,Counter Feiting,0,0,0,0,0,0,0,0,0,0,0,0,0,0,0
Himachal Pradesh,2001,Dowry Deaths,0,0,0,0,0,0,0,0,0,0,0,0,0,0,0
Himachal Pradesh,2001,Molestation,0,0,0,0,0,0,0,0,0,0,0,0,0,0,0
Himachal Pradesh,2001,Eve-Teasing,0,0,0,0,0,0,0,0,0,0,0,0,0,0,0
Himachal Pradesh,2001,Cruelty By Husband Or Relative Of Husband,0,0,0,0,0,0,0,0,0,0,0,0,0,0,0
Himachal Pradesh,2001,Other Ipc Crimes,0,0,0,0,0,0,0,0,0,0,0,0,0,0,0
Himachal Pradesh,2002,Murder,0,0,0,61,2,63,106,3,109,14,0,14,181,5,186
Himachal Pradesh,2002,Attempt To Commit Murder,0,0,0,1,0,1,7,0,7,8,0,8,16,0,16
Himachal Pradesh,2002,C.H. Not Amounting To Murder,0,0,0,2,0,2,8,0,8,15,0,15,25,0,25
Himachal Pradesh,2002,Rape,0,0,0,41,0,41,24,0,24,0,0,0,65,0,65
Himachal Pradesh,2002,Kidnapping And Abduction,0,0,0,2,0,2,2,0,2,0,0,0,4,0,4
Himachal Pradesh,2002,Dacoity,0,0,0,0,0,0,0,0,0,0,0,0,0,0,0
Himachal Pradesh,2002,Prep. And Assembly For Dacoity,0,0,0,0,0,0,0,0,0,0,0,0,0,0,0
Himachal Pradesh,2002,Robbery,0,0,0,1,0,1,0,0,0,0,0,0,1,0,1
Himachal Pradesh,2002,Burglary,0,0,0,1,0,1,0,0,0,0,0,0,1,0,1
Himachal Pradesh,2002,Thefts,0,0,0,7,0,7,0,0,0,0,0,0,7,0,7
Himachal Pradesh,2002,Extortion,0,0,0,0,0,0,0,0,0,0,0,0,0,0,0
Himachal Pradesh,2002,Riots,0,0,0,0,0,0,0,0,0,0,0,0,0,0,0
Himachal Pradesh,2002,Arson,0,0,0,0,0,0,0,0,0,0,0,0,0,0,0
Himachal Pradesh,2002,Criminal Breach Of Trust,0,0,0,0,0,0,0,0,0,0,0,0,0,0,0
Himachal Pradesh,2002,Cheating,0,0,0,0,0,0,0,0,0,0,0,0,0,0,0
Himachal Pradesh,2002,Counter Feiting,0,0,0,0,0,0,0,0,0,0,0,0,0,0,0
Himachal Pradesh,2002,Dowry Deaths,0,0,0,1,0,1,5,0,5,0,0,0,6,0,6
Himachal Pradesh,2002,Molestation,0,0,0,0,0,0,0,0,0,1,0,1,1,0,1
Himachal Pradesh,2002,Eve-Teasing,0,0,0,0,0,0,0,0,0,0,0,0,0,0,0
Himachal Pradesh,2002,Cruelty By Husband Or Relative Of Husband,0,0,0,0,0,0,0,0,0,0,0,0,0,0,0
Himachal Pradesh,2002,Other Ipc Crimes,0,0,0,0,0,0,2,0,2,0,0,0,2,0,2
Himachal Pradesh,2003,Murder,0,0,0,47,0,47,113,4,117,30,2,32,190,6,196
Himachal Pradesh,2003,Attempt To Commit Murder,0,0,0,0,0,0,7,0,7,1,0,1,8,0,8
Himachal Pradesh,2003,C.H. Not Amounting To Murder,0,0,0,9,0,9,9,0,9,2,0,2,20,0,20
Himachal Pradesh,2003,Rape,0,0,0,53,0,53,43,0,43,0,0,0,96,0,96
Himachal Pradesh,2003,Kidnapping And Abduction,0,0,0,0,0,0,0,0,0,0,0,0,0,0,0
Himachal Pradesh,2003,Dacoity,0,0,0,0,0,0,0,0,0,0,0,0,0,0,0
Himachal Pradesh,2003,Prep. And Assembly For Dacoity,0,0,0,0,0,0,0,0,0,0,0,0,0,0,0
Himachal Pradesh,2003,Robbery,1,0,1,0,0,0,0,0,0,0,0,0,1,0,1
Himachal Pradesh,2003,Burglary,0,0,0,0,0,0,0,0,0,0,0,0,0,0,0
Himachal Pradesh,2003,Thefts,0,0,0,2,0,2,3,0,3,0,0,0,5,0,5
Himachal Pradesh,2003,Extortion,0,0,0,0,0,0,0,0,0,0,0,0,0,0,0
Himachal Pradesh,2003,Riots,0,0,0,0,0,0,0,0,0,0,0,0,0,0,0
Himachal Pradesh,2003,Arson,0,0,0,0,0,0,0,0,0,0,0,0,0,0,0
Himachal Pradesh,2003,Criminal Breach Of Trust,0,0,0,0,0,0,1,0,1,0,0,0,1,0,1
Himachal Pradesh,2003,Cheating,0,0,0,0,0,0,0,0,0,0,0,0,0,0,0
Himachal Pradesh,2003,Counter Feiting,0,0,0,0,0,0,0,0,0,0,0,0,0,0,0
Himachal Pradesh,2003,Dowry Deaths,1,0,1,0,0,0,0,0,0,0,0,0,1,0,1
Himachal Pradesh,2003,Molestation,0,0,0,0,0,0,0,0,0,0,0,0,0,0,0
Himachal Pradesh,2003,Eve-Teasing,0,0,0,0,0,0,0,0,0,0,0,0,0,0,0
Himachal Pradesh,2003,Cruelty By Husband Or Relative Of Husband,0,0,0,1,0,1,2,0,2,0,0,0,3,0,3
Himachal Pradesh,2003,Other Ipc Crimes,0,0,0,14,0,14,11,0,11,1,0,1,26,0,26
Himachal Pradesh,2004,Murder,0,0,0,60,1,61,118,6,124,36,3,39,214,10,224
Himachal Pradesh,2004,Attempt To Commit Murder,0,0,0,13,0,13,5,0,5,3,0,3,21,0,21
Himachal Pradesh,2004,C.H. Not Amounting To Murder,0,0,0,11,0,11,5,0,5,3,0,3,19,0,19
Himachal Pradesh,2004,Rape,0,0,0,39,0,39,47,0,47,4,0,4,90,0,90
Himachal Pradesh,2004,Kidnapping And Abduction,0,0,0,2,0,2,0,0,0,0,0,0,2,0,2
Himachal Pradesh,2004,Dacoity,0,0,0,1,0,1,0,0,0,0,0,0,1,0,1
Himachal Pradesh,2004,Prep. And Assembly For Dacoity,0,0,0,0,0,0,0,0,0,0,0,0,0,0,0
Himachal Pradesh,2004,Robbery,0,0,0,2,0,2,1,0,1,0,0,0,3,0,3
Himachal Pradesh,2004,Burglary,0,0,0,2,0,2,0,0,0,0,0,0,2,0,2
Himachal Pradesh,2004,Thefts,0,0,0,3,0,3,4,0,4,1,0,1,8,0,8
Himachal Pradesh,2004,Extortion,0,0,0,0,0,0,0,0,0,0,0,0,0,0,0
Himachal Pradesh,2004,Riots,0,0,0,0,0,0,0,0,0,0,0,0,0,0,0
Himachal Pradesh,2004,Arson,0,0,0,0,0,0,0,0,0,0,0,0,0,0,0
Himachal Pradesh,2004,Criminal Breach Of Trust,0,0,0,0,0,0,1,0,1,0,0,0,1,0,1
Himachal Pradesh,2004,Cheating,0,0,0,0,0,0,1,0,1,0,0,0,1,0,1
Himachal Pradesh,2004,Counter Feiting,0,0,0,0,0,0,0,0,0,0,0,0,0,0,0
Himachal Pradesh,2004,Dowry Deaths,0,0,0,3,0,3,0,0,0,0,0,0,3,0,3
Himachal Pradesh,2004,Molestation,0,0,0,0,0,0,0,0,0,0,0,0,0,0,0
Himachal Pradesh,2004,Eve-Teasing,0,0,0,0,0,0,0,0,0,0,0,0,0,0,0
Himachal Pradesh,2004,Cruelty By Husband Or Relative Of Husband,0,0,0,0,0,0,1,0,1,0,0,0,1,0,1
Himachal Pradesh,2004,Other Ipc Crimes,0,0,0,2,0,2,3,0,3,0,0,0,5,0,5
Himachal Pradesh,2005,Murder,0,0,0,61,0,61,132,2,134,52,3,55,245,5,250
Himachal Pradesh,2005,Attempt To Commit Murder,0,0,0,12,0,12,2,0,2,6,0,6,20,0,20
Himachal Pradesh,2005,C.H. Not Amounting To Murder,0,0,0,8,0,8,7,0,7,0,0,0,15,0,15
Himachal Pradesh,2005,Rape,0,0,0,49,0,49,35,1,36,8,0,8,92,1,93
Himachal Pradesh,2005,Kidnapping And Abduction,0,0,0,3,0,3,3,0,3,0,0,0,6,0,6
Himachal Pradesh,2005,Dacoity,0,0,0,0,0,0,0,0,0,0,0,0,0,0,0
Himachal Pradesh,2005,Prep. And Assembly For Dacoity,0,0,0,2,0,2,6,0,6,0,0,0,8,0,8
Himachal Pradesh,2005,Robbery,0,0,0,0,0,0,0,0,0,0,0,0,0,0,0
Himachal Pradesh,2005,Burglary,0,0,0,5,0,5,3,0,3,0,0,0,8,0,8
Himachal Pradesh,2005,Thefts,0,0,0,11,0,11,2,0,2,0,0,0,13,0,13
Himachal Pradesh,2005,Extortion,0,0,0,0,0,0,0,0,0,0,0,0,0,0,0
Himachal Pradesh,2005,Riots,0,0,0,0,0,0,0,0,0,0,0,0,0,0,0
Himachal Pradesh,2005,Arson,0,0,0,0,0,0,0,0,0,0,0,0,0,0,0
Himachal Pradesh,2005,Criminal Breach Of Trust,0,0,0,0,0,0,3,0,3,0,0,0,3,0,3
Himachal Pradesh,2005,Cheating,0,0,0,0,0,0,0,0,0,0,0,0,0,0,0
Himachal Pradesh,2005,Counter Feiting,0,0,0,0,0,0,0,0,0,0,0,0,0,0,0
Himachal Pradesh,2005,Dowry Deaths,0,0,0,1,0,1,2,0,2,0,0,0,3,0,3
Himachal Pradesh,2005,Molestation,0,0,0,0,0,0,0,0,0,0,0,0,0,0,0
Himachal Pradesh,2005,Eve-Teasing,0,0,0,0,0,0,0,0,0,0,0,0,0,0,0
Himachal Pradesh,2005,Cruelty By Husband Or Relative Of Husband,0,0,0,0,0,0,1,0,1,0,0,0,1,0,1
Himachal Pradesh,2005,Other Ipc Crimes,0,0,0,1,0,1,0,0,0,0,0,0,1,0,1
Himachal Pradesh,2006,Murder,0,0,0,95,0,95,146,9,155,41,3,44,282,12,294
Himachal Pradesh,2006,Attempt To Commit Murder,0,0,0,19,0,19,8,0,8,4,0,4,31,0,31
Himachal Pradesh,2006,C.H. Not Amounting To Murder,0,0,0,4,0,4,6,0,6,0,0,0,10,0,10
Himachal Pradesh,2006,Rape,0,0,0,75,0,75,40,1,41,7,0,7,122,1,123
Himachal Pradesh,2006,Kidnapping And Abduction,0,0,0,3,0,3,1,0,1,1,0,1,5,0,5
Himachal Pradesh,2006,Dacoity,0,0,0,10,0,10,3,0,3,0,0,0,13,0,13
Himachal Pradesh,2006,Prep. And Assembly For Dacoity,0,0,0,0,0,0,1,0,1,0,0,0,1,0,1
Himachal Pradesh,2006,Robbery,0,0,0,3,0,3,0,0,0,0,0,0,3,0,3
Himachal Pradesh,2006,Burglary,0,0,0,2,0,2,0,0,0,0,0,0,2,0,2
Himachal Pradesh,2006,Thefts,0,0,0,5,0,5,7,0,7,0,0,0,12,0,12
Himachal Pradesh,2006,Extortion,0,0,0,0,0,0,0,0,0,0,0,0,0,0,0
Himachal Pradesh,2006,Riots,0,0,0,0,0,0,0,0,0,0,0,0,0,0,0
Himachal Pradesh,2006,Arson,0,0,0,0,0,0,0,0,0,0,0,0,0,0,0
Himachal Pradesh,2006,Criminal Breach Of Trust,0,0,0,0,0,0,0,0,0,0,0,0,0,0,0
Himachal Pradesh,2006,Cheating,0,0,0,1,0,1,1,0,1,0,0,0,2,0,2
Himachal Pradesh,2006,Counter Feiting,0,0,0,0,0,0,0,0,0,0,0,0,0,0,0
Himachal Pradesh,2006,Dowry Deaths,0,0,0,2,0,2,3,0,3,2,1,3,7,1,8
Himachal Pradesh,2006,Molestation,0,0,0,0,0,0,0,0,0,0,0,0,0,0,0
Himachal Pradesh,2006,Eve-Teasing,0,0,0,0,0,0,0,0,0,0,0,0,0,0,0
Himachal Pradesh,2006,Cruelty By Husband Or Relative Of Husband,0,0,0,0,0,0,0,0,0,1,0,1,1,0,1
Himachal Pradesh,2006,Other Ipc Crimes,0,0,0,4,0,4,6,0,6,0,0,0,10,0,10
Himachal Pradesh,2007,Murder,0,0,0,98,5,103,176,10,186,34,2,36,308,17,325
Himachal Pradesh,2007,Attempt To Commit Murder,0,0,0,6,0,6,26,2,28,6,0,6,38,2,40
Himachal Pradesh,2007,C.H. Not Amounting To Murder,0,0,0,2,0,2,13,0,13,3,2,5,18,2,20
Himachal Pradesh,2007,Rape,0,0,0,105,0,105,68,1,69,14,0,14,187,1,188
Himachal Pradesh,2007,Kidnapping And Abduction,0,0,0,9,0,9,2,0,2,0,0,0,11,0,11
Himachal Pradesh,2007,Dacoity,0,0,0,8,0,8,9,0,9,0,0,0,17,0,17
Himachal Pradesh,2007,Prep. And Assembly For Dacoity,0,0,0,0,0,0,0,0,0,0,0,0,0,0,0
Himachal Pradesh,2007,Robbery,0,0,0,2,0,2,0,0,0,0,0,0,2,0,2
Himachal Pradesh,2007,Burglary,0,0,0,0,0,0,0,0,0,0,0,0,0,0,0
Himachal Pradesh,2007,Thefts,0,0,0,12,0,12,8,0,8,0,0,0,20,0,20
Himachal Pradesh,2007,Extortion,0,0,0,0,0,0,0,0,0,0,0,0,0,0,0
Himachal Pradesh,2007,Riots,0,0,0,0,0,0,0,0,0,0,0,0,0,0,0
Himachal Pradesh,2007,Arson,0,0,0,0,0,0,0,0,0,0,0,0,0,0,0
Himachal Pradesh,2007,Criminal Breach Of Trust,0,0,0,0,0,0,1,0,1,0,0,0,1,0,1
Himachal Pradesh,2007,Cheating,0,0,0,0,0,0,3,0,3,0,0,0,3,0,3
Himachal Pradesh,2007,Counter Feiting,0,0,0,0,0,0,0,0,0,0,0,0,0,0,0
Himachal Pradesh,2007,Dowry Deaths,0,0,0,0,0,0,1,0,1,0,0,0,1,0,1
Himachal Pradesh,2007,Molestation,0,0,0,0,0,0,0,0,0,0,0,0,0,0,0
Himachal Pradesh,2007,Eve-Teasing,0,0,0,0,0,0,0,0,0,0,0,0,0,0,0
Himachal Pradesh,2007,Cruelty By Husband Or Relative Of Husband,0,0,0,0,0,0,1,0,1,0,0,0,1,0,1
Himachal Pradesh,2007,Other Ipc Crimes,0,0,0,9,0,9,29,1,30,6,0,6,44,1,45
Himachal Pradesh,2008,Murder,0,0,0,109,8,117,165,9,174,56,5,61,330,22,352
Himachal Pradesh,2008,Attempt To Commit Murder,0,0,0,17,0,17,17,0,17,7,0,7,41,0,41
Himachal Pradesh,2008,C.H. Not Amounting To Murder,0,0,0,6,0,6,15,1,16,3,1,4,24,2,26
Himachal Pradesh,2008,Rape,0,0,0,62,0,62,70,0,70,15,0,15,147,0,147
Himachal Pradesh,2008,Kidnapping And Abduction,0,0,0,2,0,2,0,0,0,1,0,1,3,0,3
Himachal Pradesh,2008,Dacoity,0,0,0,4,0,4,11,0,11,0,0,0,15,0,15
Himachal Pradesh,2008,Prep. And Assembly For Dacoity,0,0,0,0,0,0,0,0,0,0,0,0,0,0,0
Himachal Pradesh,2008,Robbery,0,0,0,18,0,18,2,0,2,0,0,0,20,0,20
Himachal Pradesh,2008,Burglary,0,0,0,1,0,1,3,0,3,0,0,0,4,0,4
Himachal Pradesh,2008,Thefts,0,0,0,19,0,19,4,0,4,1,0,1,24,0,24
Himachal Pradesh,2008,Extortion,0,0,0,0,0,0,0,0,0,0,0,0,0,0,0
Himachal Pradesh,2008,Riots,0,0,0,0,0,0,0,0,0,0,0,0,0,0,0
Himachal Pradesh,2008,Arson,0,0,0,0,0,0,2,0,2,0,0,0,2,0,2
Himachal Pradesh,2008,Criminal Breach Of Trust,0,0,0,1,0,1,4,0,4,2,0,2,7,0,7
Himachal Pradesh,2008,Cheating,0,0,0,0,0,0,0,0,0,0,0,0,0,0,0
Himachal Pradesh,2008,Counter Feiting,0,0,0,0,0,0,0,0,0,0,0,0,0,0,0
Himachal Pradesh,2008,Dowry Deaths,0,0,0,0,0,0,3,0,3,1,1,2,4,1,5
Himachal Pradesh,2008,Molestation,0,0,0,0,0,0,0,0,0,0,0,0,0,0,0
Himachal Pradesh,2008,Eve-Teasing,0,0,0,0,0,0,0,0,0,0,0,0,0,0,0
Himachal Pradesh,2008,Cruelty By Husband Or Relative Of Husband,0,0,0,0,0,0,4,0,4,0,0,0,4,0,4
Himachal Pradesh,2008,Other Ipc Crimes,0,0,0,1,0,1,12,0,12,0,0,0,13,0,13
Himachal Pradesh,2009,Murder,0,0,0,72,5,77,188,9,197,51,4,55,311,18,329
Himachal Pradesh,2009,Attempt To Commit Murder,0,0,0,7,1,8,9,0,9,5,0,5,21,1,22
Himachal Pradesh,2009,C.H. Not Amounting To Murder,0,0,0,7,0,7,29,1,30,6,1,7,42,2,44
Himachal Pradesh,2009,Rape,0,0,0,64,0,64,80,0,80,12,0,12,156,0,156
Himachal Pradesh,2009,Kidnapping And Abduction,0,0,0,0,0,0,0,0,0,0,0,0,0,0,0
Himachal Pradesh,2009,Dacoity,0,0,0,7,0,7,4,0,4,0,0,0,11,0,11
Himachal Pradesh,2009,Prep. And Assembly For Dacoity,0,0,0,0,0,0,0,0,0,0,0,0,0,0,0
Himachal Pradesh,2009,Robbery,0,0,0,0,0,0,7,0,7,0,0,0,7,0,7
Himachal Pradesh,2009,Burglary,0,0,0,0,0,0,1,0,1,0,0,0,1,0,1
Himachal Pradesh,2009,Thefts,0,0,0,10,0,10,4,0,4,2,0,2,16,0,16
Himachal Pradesh,2009,Extortion,0,0,0,0,0,0,0,0,0,0,0,0,0,0,0
Himachal Pradesh,2009,Riots,0,0,0,0,0,0,0,0,0,0,0,0,0,0,0
Himachal Pradesh,2009,Arson,0,0,0,0,0,0,2,0,2,0,0,0,2,0,2
Himachal Pradesh,2009,Criminal Breach Of Trust,0,0,0,0,0,0,1,0,1,0,0,0,1,0,1
Himachal Pradesh,2009,Cheating,0,0,0,0,0,0,0,0,0,0,0,0,0,0,0
Himachal Pradesh,2009,Counter Feiting,0,0,0,3,0,3,0,0,0,0,0,0,3,0,3
Himachal Pradesh,2009,Dowry Deaths,0,0,0,0,0,0,2,0,2,0,1,1,2,1,3
Himachal Pradesh,2009,Molestation,0,0,0,1,0,1,0,0,0,0,0,0,1,0,1
Himachal Pradesh,2009,Eve-Teasing,0,0,0,0,0,0,0,0,0,0,0,0,0,0,0
Himachal Pradesh,2009,Cruelty By Husband Or Relative Of Husband,0,0,0,1,0,1,1,2,3,0,0,0,2,2,4
Himachal Pradesh,2009,Other Ipc Crimes,0,0,0,1,0,1,28,0,28,8,1,9,37,1,38
Himachal Pradesh,2010,Murder,0,0,0,78,3,81,181,13,194,76,4,80,335,20,355
Himachal Pradesh,2010,Attempt To Commit Murder,0,0,0,15,0,15,16,0,16,2,0,2,33,0,33
Himachal Pradesh,2010,C.H. Not Amounting To Murder,0,0,0,16,0,16,34,1,35,4,0,4,54,1,55
Himachal Pradesh,2010,Rape,0,0,0,76,0,76,56,0,56,10,0,10,142,0,142
Himachal Pradesh,2010,Kidnapping And Abduction,0,0,0,8,0,8,3,0,3,1,0,1,12,0,12
Himachal Pradesh,2010,Dacoity,0,0,0,28,0,28,10,0,10,0,0,0,38,0,38
Himachal Pradesh,2010,Prep. And Assembly For Dacoity,0,0,0,0,0,0,0,0,0,0,0,0,0,0,0
Himachal Pradesh,2010,Robbery,0,0,0,2,0,2,2,0,2,0,0,0,4,0,4
Himachal Pradesh,2010,Burglary,0,0,0,0,0,0,1,0,1,0,0,0,1,0,1
Himachal Pradesh,2010,Thefts,0,0,0,3,0,3,3,0,3,2,0,2,8,0,8
Himachal Pradesh,2010,Extortion,0,0,0,0,0,0,0,0,0,0,0,0,0,0,0
Himachal Pradesh,2010,Riots,0,0,0,0,0,0,0,0,0,0,0,0,0,0,0
Himachal Pradesh,2010,Arson,0,0,0,0,0,0,0,0,0,1,0,1,1,0,1
Himachal Pradesh,2010,Criminal Breach Of Trust,0,0,0,0,0,0,0,0,0,0,0,0,0,0,0
Himachal Pradesh,2010,Cheating,0,0,0,0,0,0,0,0,0,0,0,0,0,0,0
Himachal Pradesh,2010,Counter Feiting,0,0,0,1,0,1,0,0,0,0,0,0,1,0,1
Himachal Pradesh,2010,Dowry Deaths,0,0,0,0,0,0,1,0,1,0,0,0,1,0,1
Himachal Pradesh,2010,Molestation,0,0,0,1,0,1,0,0,0,0,0,0,1,0,1
Himachal Pradesh,2010,Eve-Teasing,0,0,0,0,0,0,0,0,0,0,0,0,0,0,0
Himachal Pradesh,2010,Cruelty By Husband Or Relative Of Husband,0,0,0,0,0,0,0,0,0,0,0,0,0,0,0
Himachal Pradesh,2010,Other Ipc Crimes,0,0,0,19,0,19,39,0,39,7,0,7,65,0,65
Himachal Pradesh,2011,Murder,0,0,0,70,3,73,204,11,215,62,6,68,336,20,356
Himachal Pradesh,2011,Attempt To Commit Murder,0,0,0,14,0,14,16,0,16,5,0,5,35,0,35
Himachal Pradesh,2011,C.H. Not Amounting To Murder,0,0,0,22,0,22,27,0,27,6,0,6,55,0,55
Himachal Pradesh,2011,Rape,0,0,0,64,0,64,59,0,59,11,0,11,134,0,134
Himachal Pradesh,2011,Kidnapping And Abduction,0,0,0,2,0,2,0,0,0,0,0,0,2,0,2
Himachal Pradesh,2011,Dacoity,0,0,0,17,0,17,6,0,6,0,0,0,23,0,23
Himachal Pradesh,2011,Prep. And Assembly For Dacoity,0,0,0,0,0,0,0,0,0,0,0,0,0,0,0
Himachal Pradesh,2011,Robbery,0,0,0,3,0,3,1,0,1,0,0,0,4,0,4
Himachal Pradesh,2011,Burglary,0,0,0,4,0,4,2,0,2,0,0,0,6,0,6
Himachal Pradesh,2011,Thefts,0,0,0,7,0,7,3,0,3,1,0,1,11,0,11
Himachal Pradesh,2011,Extortion,0,0,0,0,0,0,0,0,0,0,0,0,0,0,0
Himachal Pradesh,2011,Riots,0,0,0,0,0,0,0,0,0,0,0,0,0,0,0
Himachal Pradesh,2011,Arson,0,0,0,0,0,0,1,0,1,0,0,0,1,0,1
Himachal Pradesh,2011,Criminal Breach Of Trust,0,0,0,0,0,0,2,0,2,2,0,2,4,0,4
Himachal Pradesh,2011,Cheating,0,0,0,2,0,2,0,0,0,1,0,1,3,0,3
Himachal Pradesh,2011,Counter Feiting,0,0,0,0,0,0,2,0,2,0,0,0,2,0,2
Himachal Pradesh,2011,Dowry Deaths,0,0,0,0,0,0,0,0,0,0,0,0,0,0,0
Himachal Pradesh,2011,Molestation,0,0,0,0,0,0,0,0,0,0,0,0,0,0,0
Himachal Pradesh,2011,Eve-Teasing,0,0,0,0,0,0,0,0,0,0,0,0,0,0,0
Himachal Pradesh,2011,Cruelty By Husband Or Relative Of Husband,0,0,0,0,0,0,0,0,0,1,0,1,1,0,1
Himachal Pradesh,2011,Other Ipc Crimes,0,0,0,7,0,7,18,0,18,17,0,17,42,0,42
Himachal Pradesh,2012,Murder,0,0,0,77,2,79,213,14,227,46,8,54,336,24,360
Himachal Pradesh,2012,Attempt To Commit Murder,0,0,0,8,0,8,17,1,18,5,0,5,30,1,31
Himachal Pradesh,2012,C.H. Not Amounting To Murder,0,0,0,13,0,13,24,0,24,4,0,4,41,0,41
Himachal Pradesh,2012,Rape,0,0,0,55,0,55,53,0,53,9,0,9,117,0,117
Himachal Pradesh,2012,Kidnapping And Abduction,0,0,0,0,0,0,0,0,0,0,0,0,0,0,0
Himachal Pradesh,2012,Dacoity,0,0,0,15,0,15,5,0,5,0,0,0,20,0,20
Himachal Pradesh,2012,Prep. And Assembly For Dacoity,0,0,0,0,0,0,0,0,0,0,0,0,0,0,0
Himachal Pradesh,2012,Robbery,0,0,0,4,0,4,1,0,1,0,0,0,5,0,5
Himachal Pradesh,2012,Burglary,0,0,0,2,0,2,1,0,1,0,0,0,3,0,3
Himachal Pradesh,2012,Thefts,0,0,0,10,0,10,6,0,6,1,0,1,17,0,17
Himachal Pradesh,2012,Extortion,0,0,0,0,0,0,0,0,0,0,0,0,0,0,0
Himachal Pradesh,2012,Riots,0,0,0,0,0,0,0,0,0,0,0,0,0,0,0
Himachal Pradesh,2012,Arson,0,0,0,0,0,0,0,0,0,0,0,0,0,0,0
Himachal Pradesh,2012,Criminal Breach Of Trust,0,0,0,0,0,0,1,0,1,1,0,1,2,0,2
Himachal Pradesh,2012,Cheating,0,0,0,0,0,0,1,0,1,0,0,0,1,0,1
Himachal Pradesh,2012,Counter Feiting,0,0,0,2,0,2,0,0,0,0,0,0,2,0,2
Himachal Pradesh,2012,Dowry Deaths,0,0,0,0,0,0,0,0,0,0,0,0,0,0,0
Himachal Pradesh,2012,Molestation,0,0,0,1,0,1,1,0,1,0,0,0,2,0,2
Himachal Pradesh,2012,Eve-Teasing,0,0,0,0,0,0,0,0,0,0,0,0,0,0,0
Himachal Pradesh,2012,Cruelty By Husband Or Relative Of Husband,0,0,0,0,0,0,6,0,6,0,1,1,6,1,7
Himachal Pradesh,2012,Other Ipc Crimes,0,0,0,23,1,24,37,0,37,11,0,11,71,1,72
Jammu & Kashmir,2001,Murder,0,0,0,9,1,10,51,1,52,14,1,15,74,3,77
Jammu & Kashmir,2001,Attempt To Commit Murder,0,0,0,2,0,2,2,0,2,0,0,0,4,0,4
Jammu & Kashmir,2001,C.H. Not Amounting To Murder,0,0,0,3,0,3,3,0,3,0,1,1,6,1,7
Jammu & Kashmir,2001,Rape,0,0,0,4,0,4,6,0,6,1,0,1,11,0,11
Jammu & Kashmir,2001,Kidnapping And Abduction,0,0,0,0,0,0,0,0,0,0,0,0,0,0,0
Jammu & Kashmir,2001,Dacoity,0,0,0,0,0,0,0,0,0,0,0,0,0,0,0
Jammu & Kashmir,2001,Prep. And Assembly For Dacoity,0,0,0,0,0,0,0,0,0,0,0,0,0,0,0
Jammu & Kashmir,2001,Robbery,0,0,0,0,0,0,0,0,0,0,0,0,0,0,0
Jammu & Kashmir,2001,Burglary,0,0,0,5,0,5,1,0,1,0,0,0,6,0,6
Jammu & Kashmir,2001,Thefts,0,0,0,0,0,0,0,0,0,0,0,0,0,0,0
Jammu & Kashmir,2001,Extortion,0,0,0,0,0,0,0,0,0,0,0,0,0,0,0
Jammu & Kashmir,2001,Riots,0,0,0,0,0,0,0,0,0,0,0,0,0,0,0
Jammu & Kashmir,2001,Arson,0,0,0,0,0,0,0,0,0,0,0,0,0,0,0
Jammu & Kashmir,2001,Criminal Breach Of Trust,0,0,0,0,0,0,0,0,0,0,0,0,0,0,0
Jammu & Kashmir,2001,Cheating,0,0,0,0,0,0,0,0,0,0,0,0,0,0,0
Jammu & Kashmir,2001,Counter Feiting,0,0,0,0,0,0,0,0,0,0,0,0,0,0,0
Jammu & Kashmir,2001,Dowry Deaths,0,0,0,0,0,0,0,0,0,0,0,0,0,0,0
Jammu & Kashmir,2001,Molestation,0,0,0,0,0,0,0,0,0,0,0,0,0,0,0
Jammu & Kashmir,2001,Eve-Teasing,0,0,0,0,0,0,0,0,0,0,0,0,0,0,0
Jammu & Kashmir,2001,Cruelty By Husband Or Relative Of Husband,0,0,0,0,0,0,0,0,0,0,0,0,0,0,0
Jammu & Kashmir,2001,Other Ipc Crimes,0,0,0,3,0,3,1,0,1,0,1,1,4,1,5
Jammu & Kashmir,2002,Murder,0,0,0,21,0,21,42,1,43,7,2,9,70,3,73
Jammu & Kashmir,2002,Attempt To Commit Murder,0,0,0,3,0,3,4,0,4,1,0,1,8,0,8
Jammu & Kashmir,2002,C.H. Not Amounting To Murder,0,0,0,0,0,0,0,0,0,0,0,0,0,0,0
Jammu & Kashmir,2002,Rape,0,0,0,9,0,9,0,0,0,0,0,0,9,0,9
Jammu & Kashmir,2002,Kidnapping And Abduction,0,0,0,0,0,0,0,0,0,0,0,0,0,0,0
Jammu & Kashmir,2002,Dacoity,0,0,0,0,0,0,0,0,0,0,0,0,0,0,0
Jammu & Kashmir,2002,Prep. And Assembly For Dacoity,0,0,0,0,0,0,0,0,0,0,0,0,0,0,0
Jammu & Kashmir,2002,Robbery,0,0,0,0,0,0,0,0,0,0,0,0,0,0,0
Jammu & Kashmir,2002,Burglary,0,0,0,0,0,0,0,0,0,0,0,0,0,0,0
Jammu & Kashmir,2002,Thefts,0,0,0,7,0,7,8,0,8,3,0,3,18,0,18
Jammu & Kashmir,2002,Extortion,0,0,0,0,0,0,0,0,0,0,0,0,0,0,0
Jammu & Kashmir,2002,Riots,0,0,0,0,0,0,0,0,0,0,0,0,0,0,0
Jammu & Kashmir,2002,Arson,0,0,0,0,0,0,0,0,0,0,0,0,0,0,0
Jammu & Kashmir,2002,Criminal Breach Of Trust,0,0,0,0,0,0,0,0,0,0,0,0,0,0,0
Jammu & Kashmir,2002,Cheating,0,0,0,0,0,0,0,0,0,0,0,0,0,0,0
Jammu & Kashmir,2002,Counter Feiting,0,0,0,0,0,0,0,0,0,0,0,0,0,0,0
Jammu & Kashmir,2002,Dowry Deaths,0,0,0,6,0,6,9,0,9,1,0,1,16,0,16
Jammu & Kashmir,2002,Molestation,0,0,0,0,0,0,0,0,0,0,0,0,0,0,0
Jammu & Kashmir,2002,Eve-Teasing,0,0,0,0,0,0,0,0,0,0,0,0,0,0,0
Jammu & Kashmir,2002,Cruelty By Husband Or Relative Of Husband,0,0,0,2,0,2,3,0,3,0,0,0,5,0,5
Jammu & Kashmir,2002,Other Ipc Crimes,0,0,0,0,0,0,0,0,0,0,0,0,0,0,0
Jammu & Kashmir,2003,Murder,0,0,0,12,1,13,34,0,34,6,0,6,52,1,53
Jammu & Kashmir,2003,Attempt To Commit Murder,0,0,0,3,0,3,11,0,11,3,0,3,17,0,17
Jammu & Kashmir,2003,C.H. Not Amounting To Murder,0,0,0,6,0,6,0,0,0,1,0,1,7,0,7
Jammu & Kashmir,2003,Rape,0,0,0,5,0,5,10,0,10,0,0,0,15,0,15
Jammu & Kashmir,2003,Kidnapping And Abduction,0,0,0,0,0,0,0,0,0,0,0,0,0,0,0
Jammu & Kashmir,2003,Dacoity,0,0,0,0,0,0,0,0,0,0,0,0,0,0,0
Jammu & Kashmir,2003,Prep. And Assembly For Dacoity,0,0,0,0,0,0,0,0,0,0,0,0,0,0,0
Jammu & Kashmir,2003,Robbery,0,0,0,4,0,4,2,0,2,0,0,0,6,0,6
Jammu & Kashmir,2003,Burglary,0,0,0,2,0,2,0,0,0,0,0,0,2,0,2
Jammu & Kashmir,2003,Thefts,0,0,0,3,0,3,3,0,3,2,0,2,8,0,8
Jammu & Kashmir,2003,Extortion,0,0,0,0,0,0,0,0,0,0,0,0,0,0,0
Jammu & Kashmir,2003,Riots,0,0,0,0,0,0,0,0,0,0,0,0,0,0,0
Jammu & Kashmir,2003,Arson,0,0,0,0,0,0,0,0,0,0,0,0,0,0,0
Jammu & Kashmir,2003,Criminal Breach Of Trust,0,0,0,1,0,1,0,0,0,1,0,1,2,0,2
Jammu & Kashmir,2003,Cheating,0,0,0,0,0,0,0,0,0,1,0,1,1,0,1
Jammu & Kashmir,2003,Counter Feiting,0,0,0,0,0,0,0,0,0,0,0,0,0,0,0
Jammu & Kashmir,2003,Dowry Deaths,0,0,0,0,0,0,0,0,0,0,0,0,0,0,0
Jammu & Kashmir,2003,Molestation,0,0,0,0,0,0,0,0,0,0,0,0,0,0,0
Jammu & Kashmir,2003,Eve-Teasing,0,0,0,0,0,0,0,0,0,0,0,0,0,0,0
Jammu & Kashmir,2003,Cruelty By Husband Or Relative Of Husband,0,0,0,1,0,1,0,0,0,0,0,0,1,0,1
Jammu & Kashmir,2003,Other Ipc Crimes,0,0,0,0,0,0,4,0,4,0,0,0,4,0,4
Jammu & Kashmir,2004,Murder,0,0,0,17,0,17,60,0,60,6,1,7,83,1,84
Jammu & Kashmir,2004,Attempt To Commit Murder,0,0,0,2,0,2,4,0,4,0,0,0,6,0,6
Jammu & Kashmir,2004,C.H. Not Amounting To Murder,0,0,0,5,0,5,5,0,5,4,0,4,14,0,14
Jammu & Kashmir,2004,Rape,0,0,0,5,0,5,9,0,9,0,0,0,14,0,14
Jammu & Kashmir,2004,Kidnapping And Abduction,0,0,0,0,0,0,0,0,0,0,0,0,0,0,0
Jammu & Kashmir,2004,Dacoity,0,0,0,0,0,0,0,0,0,0,0,0,0,0,0
Jammu & Kashmir,2004,Prep. And Assembly For Dacoity,0,0,0,0,0,0,0,0,0,0,0,0,0,0,0
Jammu & Kashmir,2004,Robbery,0,0,0,0,0,0,2,0,2,0,0,0,2,0,2
Jammu & Kashmir,2004,Burglary,0,0,0,3,0,3,1,0,1,0,0,0,4,0,4
Jammu & Kashmir,2004,Thefts,0,0,0,5,0,5,0,0,0,0,0,0,5,0,5
Jammu & Kashmir,2004,Extortion,0,0,0,6,0,6,0,0,0,0,0,0,6,0,6
Jammu & Kashmir,2004,Riots,0,0,0,0,0,0,0,2,2,2,1,3,2,3,5
Jammu & Kashmir,2004,Arson,0,0,0,0,0,0,0,0,0,0,0,0,0,0,0
Jammu & Kashmir,2004,Criminal Breach Of Trust,0,0,0,0,0,0,0,0,0,0,0,0,0,0,0
Jammu & Kashmir,2004,Cheating,0,0,0,0,0,0,0,0,0,0,0,0,0,0,0
Jammu & Kashmir,2004,Counter Feiting,0,0,0,0,0,0,0,0,0,0,0,0,0,0,0
Jammu & Kashmir,2004,Dowry Deaths,0,0,0,0,0,0,1,0,1,0,0,0,1,0,1
Jammu & Kashmir,2004,Molestation,0,0,0,0,0,0,0,0,0,0,0,0,0,0,0
Jammu & Kashmir,2004,Eve-Teasing,0,0,0,0,0,0,0,0,0,0,0,0,0,0,0
Jammu & Kashmir,2004,Cruelty By Husband Or Relative Of Husband,0,0,0,0,0,0,0,0,0,0,0,0,0,0,0
Jammu & Kashmir,2004,Other Ipc Crimes,0,0,0,4,0,4,2,0,2,2,0,2,8,0,8
Jammu & Kashmir,2005,Murder,0,0,0,30,1,31,64,1,65,13,5,18,107,7,114
Jammu & Kashmir,2005,Attempt To Commit Murder,0,0,0,1,0,1,1,0,1,0,0,0,2,0,2
Jammu & Kashmir,2005,C.H. Not Amounting To Murder,0,0,0,2,0,2,2,0,2,3,0,3,7,0,7
Jammu & Kashmir,2005,Rape,0,0,0,4,0,4,10,0,10,2,0,2,16,0,16
Jammu & Kashmir,2005,Kidnapping And Abduction,0,0,0,0,0,0,0,0,0,0,0,0,0,0,0
Jammu & Kashmir,2005,Dacoity,0,0,0,0,0,0,1,0,1,0,0,0,1,0,1
Jammu & Kashmir,2005,Prep. And Assembly For Dacoity,0,0,0,0,0,0,0,0,0,0,0,0,0,0,0
Jammu & Kashmir,2005,Robbery,0,0,0,0,0,0,2,0,2,0,0,0,2,0,2
Jammu & Kashmir,2005,Burglary,0,0,0,3,0,3,1,0,1,0,0,0,4,0,4
Jammu & Kashmir,2005,Thefts,0,0,0,6,0,6,1,0,1,0,0,0,7,0,7
Jammu & Kashmir,2005,Extortion,0,0,0,0,0,0,0,0,0,0,0,0,0,0,0
Jammu & Kashmir,2005,Riots,0,0,0,0,0,0,0,0,0,0,0,0,0,0,0
Jammu & Kashmir,2005,Arson,0,0,0,0,0,0,0,0,0,0,0,0,0,0,0
Jammu & Kashmir,2005,Criminal Breach Of Trust,0,0,0,0,0,0,0,0,0,0,0,0,0,0,0
Jammu & Kashmir,2005,Cheating,0,0,0,0,0,0,0,0,0,0,0,0,0,0,0
Jammu & Kashmir,2005,Counter Feiting,0,0,0,0,0,0,0,0,0,0,0,0,0,0,0
Jammu & Kashmir,2005,Dowry Deaths,0,0,0,0,0,0,0,0,0,0,0,0,0,0,0
Jammu & Kashmir,2005,Molestation,0,0,0,2,0,2,0,0,0,0,0,0,2,0,2
Jammu & Kashmir,2005,Eve-Teasing,0,0,0,0,0,0,0,0,0,0,0,0,0,0,0
Jammu & Kashmir,2005,Cruelty By Husband Or Relative Of Husband,0,0,0,0,0,0,0,0,0,0,0,0,0,0,0
Jammu & Kashmir,2005,Other Ipc Crimes,0,0,0,6,0,6,11,0,11,2,0,2,19,0,19
Jammu & Kashmir,2006,Murder,0,0,0,34,0,34,57,3,60,20,4,24,111,7,118
Jammu & Kashmir,2006,Attempt To Commit Murder,0,0,0,0,0,0,0,1,1,0,0,0,0,1,1
Jammu & Kashmir,2006,C.H. Not Amounting To Murder,0,0,0,0,0,0,6,0,6,4,0,4,10,0,10
Jammu & Kashmir,2006,Rape,0,0,0,10,0,10,15,0,15,2,0,2,27,0,27
Jammu & Kashmir,2006,Kidnapping And Abduction,0,0,0,0,0,0,0,0,0,0,0,0,0,0,0
Jammu & Kashmir,2006,Dacoity,0,0,0,0,0,0,0,0,0,0,0,0,0,0,0
Jammu & Kashmir,2006,Prep. And Assembly For Dacoity,0,0,0,0,0,0,0,0,0,0,0,0,0,0,0
Jammu & Kashmir,2006,Robbery,0,0,0,0,0,0,0,0,0,0,0,0,0,0,0
Jammu & Kashmir,2006,Burglary,0,0,0,3,0,3,2,0,2,0,0,0,5,0,5
Jammu & Kashmir,2006,Thefts,0,0,0,5,0,5,3,0,3,0,0,0,8,0,8
Jammu & Kashmir,2006,Extortion,0,0,0,0,0,0,0,0,0,0,0,0,0,0,0
Jammu & Kashmir,2006,Riots,0,0,0,0,0,0,5,0,5,0,0,0,5,0,5
Jammu & Kashmir,2006,Arson,0,0,0,0,0,0,0,0,0,0,0,0,0,0,0
Jammu & Kashmir,2006,Criminal Breach Of Trust,0,0,0,0,0,0,0,0,0,0,0,0,0,0,0
Jammu & Kashmir,2006,Cheating,0,0,0,0,0,0,0,0,0,1,0,1,1,0,1
Jammu & Kashmir,2006,Counter Feiting,0,0,0,0,0,0,0,0,0,0,0,0,0,0,0
Jammu & Kashmir,2006,Dowry Deaths,0,0,0,0,0,0,0,0,0,0,0,0,0,0,0
Jammu & Kashmir,2006,Molestation,0,0,0,0,0,0,0,0,0,0,0,0,0,0,0
Jammu & Kashmir,2006,Eve-Teasing,0,0,0,0,0,0,0,0,0,0,0,0,0,0,0
Jammu & Kashmir,2006,Cruelty By Husband Or Relative Of Husband,0,0,0,0,0,0,0,0,0,0,0,0,0,0,0
Jammu & Kashmir,2006,Other Ipc Crimes,0,0,0,3,0,3,6,0,6,3,0,3,12,0,12
Jammu & Kashmir,2007,Murder,0,0,0,26,1,27,55,0,55,17,5,22,98,6,104
Jammu & Kashmir,2007,Attempt To Commit Murder,0,0,0,0,0,0,4,0,4,0,0,0,4,0,4
Jammu & Kashmir,2007,C.H. Not Amounting To Murder,0,0,0,5,0,5,10,0,10,1,0,1,16,0,16
Jammu & Kashmir,2007,Rape,0,0,0,7,0,7,6,0,6,5,0,5,18,0,18
Jammu & Kashmir,2007,Kidnapping And Abduction,0,0,0,2,0,2,4,0,4,0,0,0,6,0,6
Jammu & Kashmir,2007,Dacoity,0,0,0,0,0,0,0,0,0,0,0,0,0,0,0
Jammu & Kashmir,2007,Prep. And Assembly For Dacoity,0,0,0,0,0,0,0,0,0,0,0,0,0,0,0
Jammu & Kashmir,2007,Robbery,0,0,0,0,0,0,0,0,0,0,0,0,0,0,0
Jammu & Kashmir,2007,Burglary,0,0,0,2,0,2,0,0,0,0,0,0,2,0,2
Jammu & Kashmir,2007,Thefts,2,0,2,7,0,7,5,0,5,0,0,0,14,0,14
Jammu & Kashmir,2007,Extortion,0,0,0,0,0,0,0,0,0,0,0,0,0,0,0
Jammu & Kashmir,2007,Riots,0,0,0,0,0,0,4,0,4,0,0,0,4,0,4
Jammu & Kashmir,2007,Arson,0,0,0,0,0,0,0,0,0,0,0,0,0,0,0
Jammu & Kashmir,2007,Criminal Breach Of Trust,0,0,0,0,0,0,0,0,0,0,0,0,0,0,0
Jammu & Kashmir,2007,Cheating,0,0,0,0,0,0,0,0,0,1,0,1,1,0,1
Jammu & Kashmir,2007,Counter Feiting,0,0,0,0,0,0,0,0,0,0,0,0,0,0,0
Jammu & Kashmir,2007,Dowry Deaths,0,0,0,1,0,1,0,0,0,0,0,0,1,0,1
Jammu & Kashmir,2007,Molestation,0,0,0,0,0,0,0,0,0,0,0,0,0,0,0
Jammu & Kashmir,2007,Eve-Teasing,0,0,0,0,0,0,0,0,0,0,0,0,0,0,0
Jammu & Kashmir,2007,Cruelty By Husband Or Relative Of Husband,0,0,0,0,0,0,1,0,1,0,0,0,1,0,1
Jammu & Kashmir,2007,Other Ipc Crimes,0,0,0,3,0,3,0,0,0,0,0,0,3,0,3
Jammu & Kashmir,2008,Murder,0,0,0,48,1,49,57,2,59,26,5,31,131,8,139
Jammu & Kashmir,2008,Attempt To Commit Murder,0,0,0,0,0,0,0,0,0,0,0,0,0,0,0
Jammu & Kashmir,2008,C.H. Not Amounting To Murder,0,0,0,1,0,1,3,0,3,2,0,2,6,0,6
Jammu & Kashmir,2008,Rape,0,0,0,21,0,21,30,0,30,2,0,2,53,0,53
Jammu & Kashmir,2008,Kidnapping And Abduction,0,0,0,0,0,0,2,0,2,0,0,0,2,0,2
Jammu & Kashmir,2008,Dacoity,0,0,0,1,0,1,0,0,0,0,0,0,1,0,1
Jammu & Kashmir,2008,Prep. And Assembly For Dacoity,0,0,0,0,0,0,0,0,0,0,0,0,0,0,0
Jammu & Kashmir,2008,Robbery,0,0,0,0,0,0,0,0,0,0,0,0,0,0,0
Jammu & Kashmir,2008,Burglary,0,0,0,0,0,0,0,0,0,0,0,0,0,0,0
Jammu & Kashmir,2008,Thefts,0,0,0,13,0,13,4,0,4,0,0,0,17,0,17
Jammu & Kashmir,2008,Extortion,0,0,0,0,0,0,0,0,0,0,0,0,0,0,0
Jammu & Kashmir,2008,Riots,0,0,0,0,0,0,1,0,1,0,0,0,1,0,1
Jammu & Kashmir,2008,Arson,0,0,0,0,0,0,0,0,0,0,0,0,0,0,0
Jammu & Kashmir,2008,Criminal Breach Of Trust,0,0,0,0,0,0,0,0,0,0,0,0,0,0,0
Jammu & Kashmir,2008,Cheating,0,0,0,0,0,0,0,0,0,0,0,0,0,0,0
Jammu & Kashmir,2008,Counter Feiting,0,0,0,0,0,0,0,0,0,0,0,0,0,0,0
Jammu & Kashmir,2008,Dowry Deaths,0,0,0,0,0,0,0,0,0,0,0,0,0,0,0
Jammu & Kashmir,2008,Molestation,0,0,0,0,0,0,0,0,0,0,0,0,0,0,0
Jammu & Kashmir,2008,Eve-Teasing,0,0,0,0,0,0,0,0,0,0,0,0,0,0,0
Jammu & Kashmir,2008,Cruelty By Husband Or Relative Of Husband,0,0,0,1,0,1,0,0,0,0,0,0,1,0,1
Jammu & Kashmir,2008,Other Ipc Crimes,0,0,0,0,0,0,0,0,0,0,0,0,0,0,0
Jammu & Kashmir,2009,Murder,0,0,0,37,0,37,80,2,82,17,5,22,134,7,141
Jammu & Kashmir,2009,Attempt To Commit Murder,0,0,0,1,0,1,4,0,4,0,0,0,5,0,5
Jammu & Kashmir,2009,C.H. Not Amounting To Murder,0,0,0,3,0,3,5,0,5,0,0,0,8,0,8
Jammu & Kashmir,2009,Rape,0,0,0,4,0,4,17,0,17,0,0,0,21,0,21
Jammu & Kashmir,2009,Kidnapping And Abduction,0,0,0,7,0,7,10,0,10,0,0,0,17,0,17
Jammu & Kashmir,2009,Dacoity,0,0,0,0,0,0,0,0,0,0,0,0,0,0,0
Jammu & Kashmir,2009,Prep. And Assembly For Dacoity,0,0,0,0,0,0,0,0,0,0,0,0,0,0,0
Jammu & Kashmir,2009,Robbery,0,0,0,0,0,0,0,0,0,0,0,0,0,0,0
Jammu & Kashmir,2009,Burglary,0,0,0,0,0,0,3,0,3,0,0,0,3,0,3
Jammu & Kashmir,2009,Thefts,0,0,0,3,0,3,3,0,3,0,0,0,6,0,6
Jammu & Kashmir,2009,Extortion,0,0,0,0,0,0,0,0,0,0,0,0,0,0,0
Jammu & Kashmir,2009,Riots,0,0,0,0,0,0,0,0,0,0,0,0,0,0,0
Jammu & Kashmir,2009,Arson,0,0,0,0,0,0,0,0,0,0,0,0,0,0,0
Jammu & Kashmir,2009,Criminal Breach Of Trust,0,0,0,0,1,1,0,0,0,0,0,0,0,1,1
Jammu & Kashmir,2009,Cheating,0,0,0,0,0,0,0,0,0,2,0,2,2,0,2
Jammu & Kashmir,2009,Counter Feiting,0,0,0,0,0,0,0,0,0,0,0,0,0,0,0
Jammu & Kashmir,2009,Dowry Deaths,0,0,0,0,0,0,0,0,0,0,0,0,0,0,0
Jammu & Kashmir,2009,Molestation,0,0,0,0,0,0,1,0,1,0,0,0,1,0,1
Jammu & Kashmir,2009,Eve-Teasing,0,0,0,0,0,0,1,0,1,0,0,0,1,0,1
Jammu & Kashmir,2009,Cruelty By Husband Or Relative Of Husband,0,0,0,2,0,2,10,0,10,0,0,0,12,0,12
Jammu & Kashmir,2009,Other Ipc Crimes,0,0,0,13,0,13,0,0,0,0,1,1,13,1,14
Jammu & Kashmir,2010,Murder,0,0,0,59,2,61,131,3,134,11,2,13,201,7,208
Jammu & Kashmir,2010,Attempt To Commit Murder,0,0,0,3,0,3,4,0,4,2,0,2,9,0,9
Jammu & Kashmir,2010,C.H. Not Amounting To Murder,0,0,0,0,0,0,0,0,0,0,0,0,0,0,0
Jammu & Kashmir,2010,Rape,0,0,0,18,0,18,0,0,0,0,0,0,18,0,18
Jammu & Kashmir,2010,Kidnapping And Abduction,0,0,0,0,0,0,0,0,0,0,0,0,0,0,0
Jammu & Kashmir,2010,Dacoity,0,0,0,0,0,0,0,0,0,0,0,0,0,0,0
Jammu & Kashmir,2010,Prep. And Assembly For Dacoity,0,0,0,0,0,0,0,0,0,0,0,0,0,0,0
Jammu & Kashmir,2010,Robbery,0,0,0,0,0,0,0,0,0,0,0,0,0,0,0
Jammu & Kashmir,2010,Burglary,0,0,0,0,0,0,0,0,0,0,0,0,0,0,0
Jammu & Kashmir,2010,Thefts,0,0,0,0,0,0,3,0,3,0,0,0,3,0,3
Jammu & Kashmir,2010,Extortion,0,0,0,0,0,0,0,0,0,0,0,0,0,0,0
Jammu & Kashmir,2010,Riots,0,0,0,0,0,0,0,0,0,0,0,0,0,0,0
Jammu & Kashmir,2010,Arson,0,0,0,0,0,0,0,0,0,0,0,0,0,0,0
Jammu & Kashmir,2010,Criminal Breach Of Trust,0,0,0,0,0,0,0,0,0,0,0,0,0,0,0
Jammu & Kashmir,2010,Cheating,0,0,0,0,0,0,0,0,0,0,0,0,0,0,0
Jammu & Kashmir,2010,Counter Feiting,0,0,0,0,0,0,0,0,0,0,0,0,0,0,0
Jammu & Kashmir,2010,Dowry Deaths,0,0,0,0,0,0,0,0,0,0,0,0,0,0,0
Jammu & Kashmir,2010,Molestation,0,0,0,0,0,0,0,0,0,0,0,0,0,0,0
Jammu & Kashmir,2010,Eve-Teasing,0,0,0,0,0,0,0,0,0,0,0,0,0,0,0
Jammu & Kashmir,2010,Cruelty By Husband Or Relative Of Husband,0,0,0,0,0,0,0,0,0,0,0,0,0,0,0
Jammu & Kashmir,2010,Other Ipc Crimes,0,0,0,0,0,0,0,0,0,0,0,0,0,0,0
Jammu & Kashmir,2011,Murder,0,0,0,41,1,42,66,3,69,54,6,60,161,10,171
Jammu & Kashmir,2011,Attempt To Commit Murder,0,0,0,0,0,0,0,0,0,0,0,0,0,0,0
Jammu & Kashmir,2011,C.H. Not Amounting To Murder,0,0,0,9,0,9,6,0,6,3,0,3,18,0,18
Jammu & Kashmir,2011,Rape,0,0,0,0,0,0,23,0,23,5,0,5,28,0,28
Jammu & Kashmir,2011,Kidnapping And Abduction,0,0,0,0,0,0,0,0,0,0,0,0,0,0,0
Jammu & Kashmir,2011,Dacoity,0,0,0,0,0,0,0,0,0,0,0,0,0,0,0
Jammu & Kashmir,2011,Prep. And Assembly For Dacoity,0,0,0,0,0,0,0,0,0,0,0,0,0,0,0
Jammu & Kashmir,2011,Robbery,0,0,0,0,0,0,0,0,0,0,0,0,0,0,0
Jammu & Kashmir,2011,Burglary,0,0,0,0,0,0,4,0,4,0,0,0,4,0,4
Jammu & Kashmir,2011,Thefts,0,0,0,4,0,4,0,0,0,0,0,0,4,0,4
Jammu & Kashmir,2011,Extortion,0,0,0,0,0,0,0,0,0,0,0,0,0,0,0
Jammu & Kashmir,2011,Riots,0,0,0,0,0,0,0,0,0,0,0,0,0,0,0
Jammu & Kashmir,2011,Arson,0,0,0,0,0,0,0,0,0,0,0,0,0,0,0
Jammu & Kashmir,2011,Criminal Breach Of Trust,0,0,0,0,0,0,0,0,0,0,0,0,0,0,0
Jammu & Kashmir,2011,Cheating,0,0,0,8,0,8,2,0,2,0,0,0,10,0,10
Jammu & Kashmir,2011,Counter Feiting,0,0,0,0,0,0,0,0,0,0,0,0,0,0,0
Jammu & Kashmir,2011,Dowry Deaths,0,0,0,0,0,0,0,0,0,0,0,0,0,0,0
Jammu & Kashmir,2011,Molestation,0,0,0,0,0,0,0,0,0,0,0,0,0,0,0
Jammu & Kashmir,2011,Eve-Teasing,0,0,0,0,0,0,0,0,0,0,0,0,0,0,0
Jammu & Kashmir,2011,Cruelty By Husband Or Relative Of Husband,0,0,0,0,0,0,0,0,0,0,0,0,0,0,0
Jammu & Kashmir,2011,Other Ipc Crimes,0,0,0,0,0,0,0,0,0,0,0,0,0,0,0
Jammu & Kashmir,2012,Murder,0,0,0,47,1,48,107,7,114,34,5,39,188,13,201
Jammu & Kashmir,2012,Attempt To Commit Murder,0,0,0,2,0,2,2,0,2,1,0,1,5,0,5
Jammu & Kashmir,2012,C.H. Not Amounting To Murder,0,0,0,5,0,5,11,0,11,4,0,4,20,0,20
Jammu & Kashmir,2012,Rape,0,0,0,17,0,17,23,0,23,3,0,3,43,0,43
Jammu & Kashmir,2012,Kidnapping And Abduction,0,0,0,0,0,0,0,0,0,0,0,0,0,0,0
Jammu & Kashmir,2012,Dacoity,0,0,0,0,0,0,0,0,0,0,0,0,0,0,0
Jammu & Kashmir,2012,Prep. And Assembly For Dacoity,0,0,0,3,0,3,1,0,1,0,0,0,4,0,4
Jammu & Kashmir,2012,Robbery,0,0,0,0,0,0,0,0,0,0,0,0,0,0,0
Jammu & Kashmir,2012,Burglary,0,0,0,2,0,2,2,0,2,1,0,1,5,0,5
Jammu & Kashmir,2012,Thefts,0,0,0,3,0,3,1,0,1,0,0,0,4,0,4
Jammu & Kashmir,2012,Extortion,0,0,0,0,0,0,0,0,0,0,0,0,0,0,0
Jammu & Kashmir,2012,Riots,0,0,0,5,0,5,0,0,0,0,0,0,5,0,5
Jammu & Kashmir,2012,Arson,0,0,0,0,0,0,0,0,0,0,0,0,0,0,0
Jammu & Kashmir,2012,Criminal Breach Of Trust,0,0,0,0,0,0,0,0,0,0,0,0,0,0,0
Jammu & Kashmir,2012,Cheating,0,0,0,0,0,0,1,0,1,0,0,0,1,0,1
Jammu & Kashmir,2012,Counter Feiting,0,0,0,0,0,0,0,0,0,0,0,0,0,0,0
Jammu & Kashmir,2012,Dowry Deaths,0,0,0,0,0,0,0,0,0,0,0,0,0,0,0
Jammu & Kashmir,2012,Molestation,0,0,0,0,0,0,0,0,0,0,0,0,0,0,0
Jammu & Kashmir,2012,Eve-Teasing,0,0,0,0,0,0,0,0,0,0,0,0,0,0,0
Jammu & Kashmir,2012,Cruelty By Husband Or Relative Of Husband,0,0,0,0,0,0,0,0,0,0,0,0,0,0,0
Jammu & Kashmir,2012,Other Ipc Crimes,0,0,0,2,0,2,4,0,4,0,0,0,6,0,6
Jharkhand,2001,Murder,11,0,11,500,9,509,700,10,710,126,2,128,1337,21,1358
Jharkhand,2001,Attempt To Commit Murder,1,0,1,20,0,20,43,0,43,9,0,9,73,0,73
Jharkhand,2001,C.H. Not Amounting To Murder,0,0,0,14,0,14,19,6,25,40,2,42,73,8,81
Jharkhand,2001,Rape,2,0,2,84,0,84,139,0,139,16,0,16,241,0,241
Jharkhand,2001,Kidnapping And Abduction,1,0,1,4,0,4,23,1,24,6,0,6,34,1,35
Jharkhand,2001,Dacoity,0,0,0,9,1,10,44,0,44,19,0,19,72,1,73
Jharkhand,2001,Prep. And Assembly For Dacoity,0,0,0,7,0,7,16,0,16,0,0,0,23,0,23
Jharkhand,2001,Robbery,1,0,1,2,0,2,27,0,27,3,0,3,33,0,33
Jharkhand,2001,Burglary,0,0,0,2,0,2,6,0,6,0,0,0,8,0,8
Jharkhand,2001,Thefts,0,0,0,8,0,8,6,2,8,5,0,5,19,2,21
Jharkhand,2001,Extortion,0,0,0,0,0,0,2,0,2,0,0,0,2,0,2
Jharkhand,2001,Riots,0,0,0,0,0,0,0,0,0,0,0,0,0,0,0
Jharkhand,2001,Arson,0,0,0,0,0,0,7,0,7,8,0,8,15,0,15
Jharkhand,2001,Criminal Breach Of Trust,0,0,0,0,0,0,0,0,0,0,0,0,0,0,0
Jharkhand,2001,Cheating,0,0,0,0,0,0,0,0,0,2,0,2,2,0,2
Jharkhand,2001,Counter Feiting,0,0,0,0,0,0,0,0,0,0,0,0,0,0,0
Jharkhand,2001,Dowry Deaths,0,0,0,18,3,21,194,8,202,105,3,108,317,14,331
Jharkhand,2001,Molestation,0,0,0,0,0,0,0,0,0,1,0,1,1,0,1
Jharkhand,2001,Eve-Teasing,0,0,0,0,0,0,8,0,8,0,0,0,8,0,8
Jharkhand,2001,Cruelty By Husband Or Relative Of Husband,0,0,0,0,0,0,1,0,1,0,0,0,1,0,1
Jharkhand,2001,Other Ipc Crimes,0,0,0,21,0,21,2,0,2,0,0,0,23,0,23
Jharkhand,2002,Murder,7,0,7,549,11,560,1027,16,1043,242,2,244,1825,29,1854
Jharkhand,2002,Attempt To Commit Murder,7,0,7,49,2,51,50,1,51,85,1,86,191,4,195
Jharkhand,2002,C.H. Not Amounting To Murder,0,0,0,24,2,26,26,1,27,32,0,32,82,3,85
Jharkhand,2002,Rape,0,0,0,75,0,75,65,0,65,6,0,6,146,0,146
Jharkhand,2002,Kidnapping And Abduction,0,0,0,22,0,22,24,4,28,1,0,1,47,4,51
Jharkhand,2002,Dacoity,0,0,0,39,0,39,34,0,34,1,0,1,74,0,74
Jharkhand,2002,Prep. And Assembly For Dacoity,0,0,0,7,0,7,8,0,8,0,0,0,15,0,15
Jharkhand,2002,Robbery,0,0,0,19,0,19,12,0,12,0,0,0,31,0,31
Jharkhand,2002,Burglary,0,0,0,3,0,3,0,0,0,0,0,0,3,0,3
Jharkhand,2002,Thefts,2,0,2,38,0,38,25,1,26,0,0,0,65,1,66
Jharkhand,2002,Extortion,0,0,0,0,0,0,0,0,0,0,0,0,0,0,0
Jharkhand,2002,Riots,0,0,0,0,0,0,0,0,0,0,0,0,0,0,0
Jharkhand,2002,Arson,0,0,0,0,0,0,0,0,0,0,0,0,0,0,0
Jharkhand,2002,Criminal Breach Of Trust,0,0,0,0,0,0,1,0,1,2,0,2,3,0,3
Jharkhand,2002,Cheating,0,0,0,20,1,21,12,0,12,20,0,20,52,1,53
Jharkhand,2002,Counter Feiting,0,0,0,0,0,0,0,0,0,0,0,0,0,0,0
Jharkhand,2002,Dowry Deaths,0,0,0,67,8,75,98,16,114,12,4,16,177,28,205
Jharkhand,2002,Molestation,0,0,0,0,0,0,0,0,0,0,0,0,0,0,0
Jharkhand,2002,Eve-Teasing,0,0,0,0,0,0,0,0,0,0,0,0,0,0,0
Jharkhand,2002,Cruelty By Husband Or Relative Of Husband,0,0,0,10,0,10,12,0,12,0,0,0,22,0,22
Jharkhand,2002,Other Ipc Crimes,0,0,0,2,0,2,0,0,0,0,0,0,2,0,2
Jharkhand,2003,Murder,0,0,0,550,8,558,1229,27,1256,433,4,437,2212,39,2251
Jharkhand,2003,Attempt To Commit Murder,0,0,0,91,5,96,87,5,92,22,0,22,200,10,210
Jharkhand,2003,C.H. Not Amounting To Murder,0,0,0,75,1,76,49,5,54,14,0,14,138,6,144
Jharkhand,2003,Rape,2,0,2,208,0,208,164,1,165,29,0,29,403,1,404
Jharkhand,2003,Kidnapping And Abduction,0,0,0,38,1,39,50,2,52,6,0,6,94,3,97
Jharkhand,2003,Dacoity,7,0,7,106,0,106,144,0,144,5,0,5,262,0,262
Jharkhand,2003,Prep. And Assembly For Dacoity,0,0,0,37,0,37,1,0,1,0,0,0,38,0,38
Jharkhand,2003,Robbery,5,0,5,64,0,64,15,2,17,2,0,2,86,2,88
Jharkhand,2003,Burglary,0,0,0,6,0,6,2,0,2,0,0,0,8,0,8
Jharkhand,2003,Thefts,8,0,8,56,0,56,32,2,34,5,0,5,101,2,103
Jharkhand,2003,Extortion,0,0,0,2,0,2,3,0,3,1,0,1,6,0,6
Jharkhand,2003,Riots,0,0,0,0,0,0,1,0,1,0,0,0,1,0,1
Jharkhand,2003,Arson,0,0,0,0,0,0,3,0,3,3,0,3,6,0,6
Jharkhand,2003,Criminal Breach Of Trust,0,0,0,0,0,0,0,0,0,0,0,0,0,0,0
Jharkhand,2003,Cheating,0,0,0,0,0,0,0,0,0,0,0,0,0,0,0
Jharkhand,2003,Counter Feiting,0,0,0,0,0,0,3,0,3,1,0,1,4,0,4
Jharkhand,2003,Dowry Deaths,0,0,0,212,19,231,98,29,127,80,15,95,390,63,453
Jharkhand,2003,Molestation,0,0,0,1,0,1,0,0,0,0,0,0,1,0,1
Jharkhand,2003,Eve-Teasing,0,0,0,0,0,0,0,0,0,0,0,0,0,0,0
Jharkhand,2003,Cruelty By Husband Or Relative Of Husband,0,0,0,2,0,2,9,0,9,4,0,4,15,0,15
Jharkhand,2003,Other Ipc Crimes,0,0,0,6,0,6,12,0,12,1,0,1,19,0,19
Jharkhand,2004,Murder,0,0,0,850,30,880,1869,43,1912,686,10,696,3405,83,3488
Jharkhand,2004,Attempt To Commit Murder,0,0,0,81,3,84,106,2,108,24,1,25,211,6,217
Jharkhand,2004,C.H. Not Amounting To Murder,0,0,0,41,1,42,43,0,43,4,0,4,88,1,89
Jharkhand,2004,Rape,0,0,0,166,0,166,211,1,212,58,0,58,435,1,436
Jharkhand,2004,Kidnapping And Abduction,0,0,0,37,1,38,34,3,37,5,1,6,76,5,81
Jharkhand,2004,Dacoity,0,0,0,64,0,64,45,0,45,12,0,12,121,0,121
Jharkhand,2004,Prep. And Assembly For Dacoity,0,0,0,12,0,12,9,0,9,0,0,0,21,0,21
Jharkhand,2004,Robbery,0,0,0,27,0,27,18,0,18,4,0,4,49,0,49
Jharkhand,2004,Burglary,0,0,0,8,0,8,5,0,5,2,0,2,15,0,15
Jharkhand,2004,Thefts,0,0,0,32,1,33,28,0,28,9,0,9,69,1,70
Jharkhand,2004,Extortion,0,0,0,0,0,0,17,0,17,0,0,0,17,0,17
Jharkhand,2004,Riots,0,0,0,0,0,0,0,0,0,0,0,0,0,0,0
Jharkhand,2004,Arson,0,0,0,0,0,0,1,0,1,0,0,0,1,0,1
Jharkhand,2004,Criminal Breach Of Trust,0,0,0,0,0,0,4,0,4,0,0,0,4,0,4
Jharkhand,2004,Cheating,0,0,0,0,0,0,5,0,5,4,0,4,9,0,9
Jharkhand,2004,Counter Feiting,0,0,0,0,0,0,0,0,0,0,0,0,0,0,0
Jharkhand,2004,Dowry Deaths,0,0,0,45,7,52,84,20,104,55,7,62,184,34,218
Jharkhand,2004,Molestation,0,0,0,0,0,0,0,0,0,0,0,0,0,0,0
Jharkhand,2004,Eve-Teasing,0,0,0,0,0,0,0,0,0,0,0,0,0,0,0
Jharkhand,2004,Cruelty By Husband Or Relative Of Husband,0,0,0,2,0,2,6,0,6,2,0,2,10,0,10
Jharkhand,2004,Other Ipc Crimes,0,0,0,0,0,0,1,0,1,0,0,0,1,0,1
Jharkhand,2005,Murder,0,0,0,982,17,999,1555,41,1596,796,9,805,3333,67,3400
Jharkhand,2005,Attempt To Commit Murder,0,0,0,94,2,96,79,5,84,18,0,18,191,7,198
Jharkhand,2005,C.H. Not Amounting To Murder,0,0,0,26,5,31,53,2,55,14,1,15,93,8,101
Jharkhand,2005,Rape,0,0,0,195,1,196,149,0,149,48,0,48,392,1,393
Jharkhand,2005,Kidnapping And Abduction,0,0,0,29,3,32,53,2,55,7,1,8,89,6,95
Jharkhand,2005,Dacoity,0,0,0,90,0,90,96,1,97,25,0,25,211,1,212
Jharkhand,2005,Prep. And Assembly For Dacoity,0,0,0,10,0,10,11,0,11,0,0,0,21,0,21
Jharkhand,2005,Robbery,0,0,0,22,0,22,17,0,17,4,0,4,43,0,43
Jharkhand,2005,Burglary,0,0,0,7,0,7,11,0,11,0,0,0,18,0,18
Jharkhand,2005,Thefts,0,0,0,96,0,96,79,0,79,16,0,16,191,0,191
Jharkhand,2005,Extortion,0,0,0,10,0,10,13,0,13,2,0,2,25,0,25
Jharkhand,2005,Riots,0,0,0,0,0,0,0,0,0,0,0,0,0,0,0
Jharkhand,2005,Arson,0,0,0,0,0,0,0,0,0,0,0,0,0,0,0
Jharkhand,2005,Criminal Breach Of Trust,0,0,0,0,0,0,5,0,5,1,0,1,6,0,6
Jharkhand,2005,Cheating,0,0,0,3,0,3,1,0,1,1,0,1,5,0,5
Jharkhand,2005,Counter Feiting,0,0,0,0,0,0,0,0,0,0,0,0,0,0,0
Jharkhand,2005,Dowry Deaths,0,0,0,88,17,105,103,21,124,48,10,58,239,48,287
Jharkhand,2005,Molestation,0,0,0,0,0,0,0,0,0,0,0,0,0,0,0
Jharkhand,2005,Eve-Teasing,0,0,0,0,0,0,5,0,5,0,0,0,5,0,5
Jharkhand,2005,Cruelty By Husband Or Relative Of Husband,0,0,0,25,0,25,9,11,20,4,1,5,38,12,50
Jharkhand,2005,Other Ipc Crimes,0,0,0,0,0,0,1,0,1,0,0,0,1,0,1
Jharkhand,2006,Murder,0,0,0,1312,29,1341,2738,57,2795,716,11,727,4766,97,4863
Jharkhand,2006,Attempt To Commit Murder,0,0,0,135,6,141,138,7,145,18,3,21,291,16,307
Jharkhand,2006,C.H. Not Amounting To Murder,0,0,0,37,8,45,72,7,79,8,0,8,117,15,132
Jharkhand,2006,Rape,0,0,0,284,0,284,241,0,241,46,0,46,571,0,571
Jharkhand,2006,Kidnapping And Abduction,0,0,0,42,1,43,84,3,87,14,0,14,140,4,144
Jharkhand,2006,Dacoity,0,0,0,134,0,134,103,0,103,15,0,15,252,0,252
Jharkhand,2006,Prep. And Assembly For Dacoity,0,0,0,10,0,10,9,0,9,1,0,1,20,0,20
Jharkhand,2006,Robbery,0,0,0,33,1,34,22,0,22,0,0,0,55,1,56
Jharkhand,2006,Burglary,0,0,0,3,0,3,2,0,2,0,0,0,5,0,5
Jharkhand,2006,Thefts,0,0,0,125,0,125,124,0,124,13,0,13,262,0,262
Jharkhand,2006,Extortion,0,0,0,7,0,7,5,0,5,0,0,0,12,0,12
Jharkhand,2006,Riots,0,0,0,0,0,0,0,0,0,0,0,0,0,0,0
Jharkhand,2006,Arson,0,0,0,0,0,0,1,0,1,0,0,0,1,0,1
Jharkhand,2006,Criminal Breach Of Trust,0,0,0,4,0,4,5,0,5,0,0,0,9,0,9
Jharkhand,2006,Cheating,0,0,0,3,0,3,2,0,2,1,0,1,6,0,6
Jharkhand,2006,Counter Feiting,0,0,0,0,0,0,3,0,3,0,0,0,3,0,3
Jharkhand,2006,Dowry Deaths,0,0,0,93,30,123,186,56,242,47,20,67,326,106,432
Jharkhand,2006,Molestation,0,0,0,0,0,0,0,0,0,0,0,0,0,0,0
Jharkhand,2006,Eve-Teasing,0,0,0,0,0,0,0,0,0,0,0,0,0,0,0
Jharkhand,2006,Cruelty By Husband Or Relative Of Husband,0,0,0,51,0,51,29,0,29,8,1,9,88,1,89
Jharkhand,2006,Other Ipc Crimes,0,0,0,4,0,4,7,0,7,0,0,0,11,0,11
Jharkhand,2007,Murder,0,0,0,1064,27,1091,1992,35,2027,543,24,567,3599,86,3685
Jharkhand,2007,Attempt To Commit Murder,0,0,0,100,4,104,138,4,142,50,3,53,288,11,299
Jharkhand,2007,C.H. Not Amounting To Murder,0,0,0,20,0,20,29,0,29,23,0,23,72,0,72
Jharkhand,2007,Rape,0,0,0,131,0,131,148,0,148,31,0,31,310,0,310
Jharkhand,2007,Kidnapping And Abduction,0,0,0,68,5,73,80,3,83,13,1,14,161,9,170
Jharkhand,2007,Dacoity,0,0,0,115,1,116,120,0,120,15,0,15,250,1,251
Jharkhand,2007,Prep. And Assembly For Dacoity,0,0,0,6,2,8,2,0,2,1,0,1,9,2,11
Jharkhand,2007,Robbery,0,0,0,32,0,32,57,0,57,10,0,10,99,0,99
Jharkhand,2007,Burglary,0,0,0,2,0,2,0,0,0,0,0,0,2,0,2
Jharkhand,2007,Thefts,0,0,0,64,3,67,71,3,74,8,0,8,143,6,149
Jharkhand,2007,Extortion,0,0,0,22,0,22,5,0,5,1,0,1,28,0,28
Jharkhand,2007,Riots,0,0,0,0,0,0,0,0,0,0,0,0,0,0,0
Jharkhand,2007,Arson,0,0,0,36,0,36,4,1,5,0,0,0,40,1,41
Jharkhand,2007,Criminal Breach Of Trust,0,0,0,0,0,0,0,0,0,1,0,1,1,0,1
Jharkhand,2007,Cheating,0,0,0,35,0,35,0,0,0,0,0,0,35,0,35
Jharkhand,2007,Counter Feiting,0,0,0,1,0,1,0,0,0,0,0,0,1,0,1
Jharkhand,2007,Dowry Deaths,0,0,0,133,10,143,125,41,166,94,6,100,352,57,409
Jharkhand,2007,Molestation,0,0,0,8,0,8,0,0,0,0,0,0,8,0,8
Jharkhand,2007,Eve-Teasing,0,0,0,0,0,0,0,0,0,0,0,0,0,0,0
Jharkhand,2007,Cruelty By Husband Or Relative Of Husband,0,0,0,12,0,12,8,2,10,3,0,3,23,2,25
Jharkhand,2007,Other Ipc Crimes,0,0,0,0,1,1,11,2,13,2,1,3,13,4,17
Jharkhand,2008,Murder,0,0,0,1162,14,1176,1922,38,1960,718,13,731,3802,65,3867
Jharkhand,2008,Attempt To Commit Murder,0,0,0,85,9,94,181,7,188,32,2,34,298,18,316
Jharkhand,2008,C.H. Not Amounting To Murder,0,0,0,15,1,16,25,0,25,14,0,14,54,1,55
Jharkhand,2008,Rape,0,0,0,162,0,162,184,0,184,46,0,46,392,0,392
Jharkhand,2008,Kidnapping And Abduction,0,0,0,78,3,81,68,1,69,7,3,10,153,7,160
Jharkhand,2008,Dacoity,0,0,0,78,3,81,96,1,97,16,3,19,190,7,197
Jharkhand,2008,Prep. And Assembly For Dacoity,0,0,0,2,0,2,3,0,3,0,0,0,5,0,5
Jharkhand,2008,Robbery,0,0,0,20,1,21,39,0,39,4,2,6,63,3,66
Jharkhand,2008,Burglary,0,0,0,5,0,5,4,0,4,0,0,0,9,0,9
Jharkhand,2008,Thefts,0,0,0,38,4,42,31,0,31,8,2,10,77,6,83
Jharkhand,2008,Extortion,0,0,0,0,0,0,0,0,0,0,2,2,0,2,2
Jharkhand,2008,Riots,0,0,0,0,0,0,0,0,0,0,0,0,0,0,0
Jharkhand,2008,Arson,0,0,0,0,0,0,6,0,6,0,0,0,6,0,6
Jharkhand,2008,Criminal Breach Of Trust,0,0,0,0,0,0,8,0,8,0,0,0,8,0,8
Jharkhand,2008,Cheating,0,0,0,1,0,1,4,0,4,0,0,0,5,0,5
Jharkhand,2008,Counter Feiting,0,0,0,0,0,0,4,0,4,0,0,0,4,0,4
Jharkhand,2008,Dowry Deaths,0,0,0,72,19,91,77,22,99,50,8,58,199,49,248
Jharkhand,2008,Molestation,0,0,0,0,0,0,0,0,0,0,0,0,0,0,0
Jharkhand,2008,Eve-Teasing,0,0,0,0,0,0,0,0,0,0,0,0,0,0,0
Jharkhand,2008,Cruelty By Husband Or Relative Of Husband,0,0,0,10,3,13,9,2,11,8,0,8,27,5,32
Jharkhand,2008,Other Ipc Crimes,0,0,0,8,0,8,16,0,16,1,0,1,25,0,25
Jharkhand,2009,Murder,0,0,0,1129,28,1157,2007,72,2079,762,17,779,3898,117,4015
Jharkhand,2009,Attempt To Commit Murder,0,0,0,86,0,86,60,0,60,32,0,32,178,0,178
Jharkhand,2009,C.H. Not Amounting To Murder,0,0,0,2,0,2,14,0,14,9,0,9,25,0,25
Jharkhand,2009,Rape,0,0,0,178,0,178,111,0,111,27,0,27,316,0,316
Jharkhand,2009,Kidnapping And Abduction,0,0,0,98,0,98,58,1,59,10,0,10,166,1,167
Jharkhand,2009,Dacoity,0,0,0,88,0,88,44,0,44,9,0,9,141,0,141
Jharkhand,2009,Prep. And Assembly For Dacoity,0,0,0,4,0,4,2,0,2,0,0,0,6,0,6
Jharkhand,2009,Robbery,0,0,0,47,0,47,20,0,20,1,0,1,68,0,68
Jharkhand,2009,Burglary,0,0,0,0,0,0,0,0,0,0,0,0,0,0,0
Jharkhand,2009,Thefts,0,0,0,55,0,55,29,0,29,11,0,11,95,0,95
Jharkhand,2009,Extortion,0,0,0,8,0,8,1,0,1,1,0,1,10,0,10
Jharkhand,2009,Riots,0,0,0,0,0,0,0,0,0,0,0,0,0,0,0
Jharkhand,2009,Arson,0,0,0,0,0,0,2,0,2,0,0,0,2,0,2
Jharkhand,2009,Criminal Breach Of Trust,0,0,0,1,0,1,1,0,1,2,0,2,4,0,4
Jharkhand,2009,Cheating,0,0,0,0,0,0,3,0,3,2,0,2,5,0,5
Jharkhand,2009,Counter Feiting,0,0,0,0,0,0,0,0,0,0,0,0,0,0,0
Jharkhand,2009,Dowry Deaths,0,0,0,76,11,87,79,18,97,41,18,59,196,47,243
Jharkhand,2009,Molestation,0,0,0,0,0,0,0,0,0,0,0,0,0,0,0
Jharkhand,2009,Eve-Teasing,0,0,0,0,0,0,0,0,0,0,0,0,0,0,0
Jharkhand,2009,Cruelty By Husband Or Relative Of Husband,0,0,0,16,0,16,20,1,21,3,0,3,39,1,40
Jharkhand,2009,Other Ipc Crimes,0,0,0,5,0,5,19,0,19,0,0,0,24,0,24
Jharkhand,2010,Murder,0,0,0,1164,20,1184,1852,52,1904,658,14,672,3674,86,3760
Jharkhand,2010,Attempt To Commit Murder,0,0,0,61,2,63,64,3,67,50,4,54,175,9,184
Jharkhand,2010,C.H. Not Amounting To Murder,0,0,0,34,0,34,17,0,17,13,0,13,64,0,64
Jharkhand,2010,Rape,0,0,0,118,0,118,110,0,110,31,0,31,259,0,259
Jharkhand,2010,Kidnapping And Abduction,0,0,0,81,1,82,46,3,49,11,0,11,138,4,142
Jharkhand,2010,Dacoity,0,0,0,36,0,36,33,0,33,5,0,5,74,0,74
Jharkhand,2010,Prep. And Assembly For Dacoity,0,0,0,38,0,38,5,0,5,0,0,0,43,0,43
Jharkhand,2010,Robbery,0,0,0,20,0,20,26,0,26,2,0,2,48,0,48
Jharkhand,2010,Burglary,0,0,0,21,0,21,3,0,3,0,0,0,24,0,24
Jharkhand,2010,Thefts,0,0,0,25,0,25,25,0,25,5,0,5,55,0,55
Jharkhand,2010,Extortion,0,0,0,3,0,3,2,0,2,0,0,0,5,0,5
Jharkhand,2010,Riots,0,0,0,0,0,0,0,0,0,0,0,0,0,0,0
Jharkhand,2010,Arson,0,0,0,0,0,0,4,1,5,0,0,0,4,1,5
Jharkhand,2010,Criminal Breach Of Trust,0,0,0,0,1,1,1,0,1,1,0,1,2,1,3
Jharkhand,2010,Cheating,0,0,0,0,0,0,3,0,3,0,0,0,3,0,3
Jharkhand,2010,Counter Feiting,0,0,0,0,0,0,0,0,0,0,0,0,0,0,0
Jharkhand,2010,Dowry Deaths,0,0,0,65,10,75,72,37,109,47,10,57,184,57,241
Jharkhand,2010,Molestation,0,0,0,0,0,0,0,0,0,0,0,0,0,0,0
Jharkhand,2010,Eve-Teasing,0,0,0,0,0,0,0,0,0,0,0,0,0,0,0
Jharkhand,2010,Cruelty By Husband Or Relative Of Husband,0,0,0,15,0,15,16,0,16,4,0,4,35,0,35
Jharkhand,2010,Other Ipc Crimes,0,0,0,1,0,1,19,0,19,0,0,0,20,0,20
Jharkhand,2011,Murder,0,0,0,793,18,811,1639,40,1679,460,21,481,2892,79,2971
Jharkhand,2011,Attempt To Commit Murder,0,0,0,45,1,46,83,2,85,32,3,35,160,6,166
Jharkhand,2011,C.H. Not Amounting To Murder,0,0,0,22,0,22,4,0,4,3,0,3,29,0,29
Jharkhand,2011,Rape,0,0,0,102,0,102,94,0,94,12,0,12,208,0,208
Jharkhand,2011,Kidnapping And Abduction,0,0,0,59,2,61,62,2,64,14,1,15,135,5,140
Jharkhand,2011,Dacoity,0,0,0,46,0,46,60,0,60,10,0,10,116,0,116
Jharkhand,2011,Prep. And Assembly For Dacoity,0,0,0,22,0,22,8,0,8,2,0,2,32,0,32
Jharkhand,2011,Robbery,0,0,0,18,0,18,10,0,10,2,0,2,30,0,30
Jharkhand,2011,Burglary,0,0,0,17,0,17,8,0,8,4,0,4,29,0,29
Jharkhand,2011,Thefts,0,0,0,44,1,45,47,2,49,3,1,4,94,4,98
Jharkhand,2011,Extortion,0,0,0,1,0,1,4,0,4,0,0,0,5,0,5
Jharkhand,2011,Riots,0,0,0,0,0,0,0,0,0,0,0,0,0,0,0
Jharkhand,2011,Arson,0,0,0,0,0,0,6,0,6,0,0,0,6,0,6
Jharkhand,2011,Criminal Breach Of Trust,0,0,0,0,0,0,1,0,1,0,0,0,1,0,1
Jharkhand,2011,Cheating,0,0,0,2,0,2,5,1,6,0,0,0,7,1,8
Jharkhand,2011,Counter Feiting,0,0,0,1,0,1,5,0,5,2,0,2,8,0,8
Jharkhand,2011,Dowry Deaths,0,0,0,61,6,67,77,19,96,35,12,47,173,37,210
Jharkhand,2011,Molestation,0,0,0,0,0,0,0,0,0,0,0,0,0,0,0
Jharkhand,2011,Eve-Teasing,0,0,0,0,0,0,0,0,0,0,0,0,0,0,0
Jharkhand,2011,Cruelty By Husband Or Relative Of Husband,0,0,0,8,0,8,30,0,30,0,0,0,38,0,38
Jharkhand,2011,Other Ipc Crimes,0,0,0,0,1,1,7,0,7,0,0,0,7,1,8
Jharkhand,2012,Murder,0,0,0,773,13,786,1492,51,1543,469,14,483,2734,78,2812
Jharkhand,2012,Attempt To Commit Murder,0,0,0,45,2,47,101,3,104,52,2,54,198,7,205
Jharkhand,2012,C.H. Not Amounting To Murder,0,0,0,2,0,2,12,1,13,4,0,4,18,1,19
Jharkhand,2012,Rape,0,0,0,76,0,76,102,0,102,21,0,21,199,0,199
Jharkhand,2012,Kidnapping And Abduction,0,0,0,34,1,35,58,0,58,19,0,19,111,1,112
Jharkhand,2012,Dacoity,0,0,0,46,0,46,72,0,72,11,0,11,129,0,129
Jharkhand,2012,Prep. And Assembly For Dacoity,0,0,0,5,0,5,7,0,7,0,0,0,12,0,12
Jharkhand,2012,Robbery,0,0,0,12,0,12,18,0,18,10,0,10,40,0,40
Jharkhand,2012,Burglary,0,0,0,3,0,3,1,0,1,0,0,0,4,0,4
Jharkhand,2012,Thefts,0,0,0,43,0,43,48,1,49,8,0,8,99,1,100
Jharkhand,2012,Extortion,0,0,0,6,0,6,17,0,17,0,0,0,23,0,23
Jharkhand,2012,Riots,0,0,0,0,0,0,0,0,0,0,0,0,0,0,0
Jharkhand,2012,Arson,0,0,0,0,0,0,1,0,1,0,0,0,1,0,1
Jharkhand,2012,Criminal Breach Of Trust,0,0,0,2,0,2,7,0,7,0,0,0,9,0,9
Jharkhand,2012,Cheating,0,0,0,6,0,6,18,0,18,0,0,0,24,0,24
Jharkhand,2012,Counter Feiting,0,0,0,0,0,0,0,0,0,0,0,0,0,0,0
Jharkhand,2012,Dowry Deaths,0,0,0,50,11,61,86,24,110,56,19,75,192,54,246
Jharkhand,2012,Molestation,0,0,0,0,0,0,1,0,1,0,0,0,1,0,1
Jharkhand,2012,Eve-Teasing,0,0,0,1,0,1,0,0,0,0,0,0,1,0,1
Jharkhand,2012,Cruelty By Husband Or Relative Of Husband,0,0,0,8,0,8,29,1,30,1,0,1,38,1,39
Jharkhand,2012,Other Ipc Crimes,0,0,0,3,0,3,7,0,7,0,0,0,10,0,10
Karnataka,2001,Murder,0,0,0,663,9,672,481,26,507,42,0,42,1186,35,1221
Karnataka,2001,Attempt To Commit Murder,0,0,0,17,0,17,12,0,12,2,0,2,31,0,31
Karnataka,2001,C.H. Not Amounting To Murder,0,0,0,0,0,0,6,0,6,2,0,2,8,0,8
Karnataka,2001,Rape,3,0,3,18,0,18,24,0,24,0,0,0,45,0,45
Karnataka,2001,Kidnapping And Abduction,0,0,0,7,0,7,3,0,3,0,0,0,10,0,10
Karnataka,2001,Dacoity,0,0,0,13,0,13,15,0,15,1,0,1,29,0,29
Karnataka,2001,Prep. And Assembly For Dacoity,0,0,0,0,0,0,5,0,5,0,0,0,5,0,5
Karnataka,2001,Robbery,3,0,3,5,0,5,3,0,3,2,0,2,13,0,13
Karnataka,2001,Burglary,7,0,7,21,2,23,11,0,11,12,0,12,51,2,53
Karnataka,2001,Thefts,7,0,7,10,0,10,10,0,10,1,0,1,28,0,28
Karnataka,2001,Extortion,3,0,3,11,0,11,9,0,9,0,0,0,23,0,23
Karnataka,2001,Riots,0,0,0,0,0,0,0,0,0,3,0,3,3,0,3
Karnataka,2001,Arson,1,0,1,7,0,7,3,0,3,1,0,1,12,0,12
Karnataka,2001,Criminal Breach Of Trust,0,0,0,0,0,0,0,0,0,2,0,2,2,0,2
Karnataka,2001,Cheating,0,0,0,11,0,11,3,1,4,4,0,4,18,1,19
Karnataka,2001,Counter Feiting,0,0,0,0,0,0,0,0,0,0,0,0,0,0,0
Karnataka,2001,Dowry Deaths,0,0,0,8,0,8,12,0,12,2,1,3,22,1,23
Karnataka,2001,Molestation,0,0,0,2,0,2,1,0,1,0,0,0,3,0,3
Karnataka,2001,Eve-Teasing,0,0,0,6,0,6,3,0,3,0,0,0,9,0,9
Karnataka,2001,Cruelty By Husband Or Relative Of Husband,0,0,0,4,0,4,9,0,9,0,0,0,13,0,13
Karnataka,2001,Other Ipc Crimes,2,0,2,9,0,9,8,0,8,15,0,15,34,0,34
Karnataka,2002,Murder,0,0,0,878,18,896,405,23,428,68,1,69,1351,42,1393
Karnataka,2002,Attempt To Commit Murder,0,0,0,11,0,11,34,0,34,6,0,6,51,0,51
Karnataka,2002,C.H. Not Amounting To Murder,0,0,0,0,0,0,0,0,0,4,0,4,4,0,4
Karnataka,2002,Rape,3,0,3,17,0,17,9,0,9,0,0,0,29,0,29
Karnataka,2002,Kidnapping And Abduction,0,0,0,15,0,15,17,0,17,0,0,0,32,0,32
Karnataka,2002,Dacoity,0,0,0,38,0,38,9,0,9,0,0,0,47,0,47
Karnataka,2002,Prep. And Assembly For Dacoity,0,0,0,0,0,0,6,0,6,0,0,0,6,0,6
Karnataka,2002,Robbery,0,0,0,33,0,33,7,0,7,2,0,2,42,0,42
Karnataka,2002,Burglary,0,0,0,7,0,7,11,0,11,2,0,2,20,0,20
Karnataka,2002,Thefts,7,0,7,52,8,60,41,0,41,9,0,9,109,8,117
Karnataka,2002,Extortion,0,0,0,0,0,0,0,0,0,0,0,0,0,0,0
Karnataka,2002,Riots,0,0,0,0,0,0,6,0,6,0,0,0,6,0,6
Karnataka,2002,Arson,0,0,0,0,0,0,0,0,0,0,0,0,0,0,0
Karnataka,2002,Criminal Breach Of Trust,0,0,0,0,0,0,8,0,8,0,0,0,8,0,8
Karnataka,2002,Cheating,0,0,0,39,3,42,34,6,40,3,0,3,76,9,85
Karnataka,2002,Counter Feiting,0,0,0,0,0,0,2,0,2,0,0,0,2,0,2
Karnataka,2002,Dowry Deaths,0,0,0,6,0,6,12,4,16,8,0,8,26,4,30
Karnataka,2002,Molestation,0,0,0,0,0,0,0,0,0,0,0,0,0,0,0
Karnataka,2002,Eve-Teasing,0,0,0,0,0,0,0,0,0,0,0,0,0,0,0
Karnataka,2002,Cruelty By Husband Or Relative Of Husband,0,0,0,6,0,6,8,0,8,2,0,2,16,0,16
Karnataka,2002,Other Ipc Crimes,7,0,7,32,3,35,52,1,53,28,0,28,119,4,123
Karnataka,2003,Murder,1,0,1,1212,29,1241,506,22,528,91,2,93,1810,53,1863
Karnataka,2003,Attempt To Commit Murder,2,0,2,12,0,12,31,0,31,8,0,8,53,0,53
Karnataka,2003,C.H. Not Amounting To Murder,0,0,0,2,0,2,1,0,1,0,0,0,3,0,3
Karnataka,2003,Rape,2,0,2,19,0,19,11,0,11,0,0,0,32,0,32
Karnataka,2003,Kidnapping And Abduction,0,0,0,19,0,19,0,0,0,0,0,0,19,0,19
Karnataka,2003,Dacoity,1,0,1,0,0,0,0,0,0,0,0,0,1,0,1
Karnataka,2003,Prep. And Assembly For Dacoity,0,0,0,2,0,2,7,0,7,0,0,0,9,0,9
Karnataka,2003,Robbery,1,0,1,37,0,37,9,0,9,1,0,1,48,0,48
Karnataka,2003,Burglary,0,0,0,6,0,6,13,0,13,0,0,0,19,0,19
Karnataka,2003,Thefts,3,0,3,57,6,63,43,0,43,6,0,6,109,6,115
Karnataka,2003,Extortion,0,0,0,0,0,0,0,0,0,0,0,0,0,0,0
Karnataka,2003,Riots,0,0,0,0,0,0,8,0,8,0,0,0,8,0,8
Karnataka,2003,Arson,0,0,0,0,0,0,0,0,0,0,0,0,0,0,0
Karnataka,2003,Criminal Breach Of Trust,0,0,0,0,0,0,7,0,7,0,0,0,7,0,7
Karnataka,2003,Cheating,0,0,0,36,3,39,31,1,32,3,0,3,70,4,74
Karnataka,2003,Counter Feiting,0,0,0,0,0,0,2,0,2,0,0,0,2,0,2
Karnataka,2003,Dowry Deaths,0,0,0,0,0,0,0,0,0,0,0,0,0,0,0
Karnataka,2003,Molestation,0,0,0,0,0,0,0,0,0,0,0,0,0,0,0
Karnataka,2003,Eve-Teasing,0,0,0,0,0,0,0,0,0,0,0,0,0,0,0
Karnataka,2003,Cruelty By Husband Or Relative Of Husband,0,0,0,0,0,0,0,0,0,0,0,0,0,0,0
Karnataka,2003,Other Ipc Crimes,3,0,3,43,1,44,84,1,85,43,0,43,173,2,175
Karnataka,2004,Murder,1,0,1,1597,29,1626,627,27,654,93,2,95,2318,58,2376
Karnataka,2004,Attempt To Commit Murder,2,0,2,13,0,13,37,0,37,7,0,7,59,0,59
Karnataka,2004,C.H. Not Amounting To Murder,0,0,0,2,0,2,1,0,1,0,0,0,3,0,3
Karnataka,2004,Rape,2,0,2,31,0,31,13,0,13,0,0,0,46,0,46
Karnataka,2004,Kidnapping And Abduction,3,0,3,27,0,27,3,0,3,0,0,0,33,0,33
Karnataka,2004,Dacoity,1,0,1,3,0,3,2,0,2,0,0,0,6,0,6
Karnataka,2004,Prep. And Assembly For Dacoity,0,0,0,3,0,3,8,0,8,0,0,0,11,0,11
Karnataka,2004,Robbery,1,0,1,51,0,51,11,0,11,1,0,1,64,0,64
Karnataka,2004,Burglary,3,0,3,13,0,13,19,0,19,0,0,0,35,0,35
Karnataka,2004,Thefts,3,0,3,61,8,69,47,0,47,4,0,4,115,8,123
Karnataka,2004,Extortion,0,0,0,0,0,0,0,0,0,0,0,0,0,0,0
Karnataka,2004,Riots,0,0,0,2,0,2,1,0,1,0,0,0,3,0,3
Karnataka,2004,Arson,0,0,0,0,0,0,0,0,0,0,0,0,0,0,0
Karnataka,2004,Criminal Breach Of Trust,0,0,0,0,0,0,3,0,3,0,0,0,3,0,3
Karnataka,2004,Cheating,0,0,0,39,2,41,37,3,40,2,0,2,78,5,83
Karnataka,2004,Counter Feiting,0,0,0,0,0,0,1,0,1,0,0,0,1,0,1
Karnataka,2004,Dowry Deaths,0,0,0,0,0,0,0,0,0,0,0,0,0,0,0
Karnataka,2004,Molestation,0,0,0,0,0,0,0,0,0,0,0,0,0,0,0
Karnataka,2004,Eve-Teasing,0,0,0,0,0,0,0,0,0,0,0,0,0,0,0
Karnataka,2004,Cruelty By Husband Or Relative Of Husband,0,0,0,0,0,0,0,0,0,0,0,0,0,0,0
Karnataka,2004,Other Ipc Crimes,1,0,1,37,2,39,63,1,64,37,0,37,138,3,141
Karnataka,2005,Murder,0,0,0,1656,51,1707,876,27,903,155,1,156,2687,79,2766
Karnataka,2005,Attempt To Commit Murder,0,0,0,22,0,22,62,0,62,6,0,6,90,0,90
Karnataka,2005,C.H. Not Amounting To Murder,0,0,0,3,0,3,1,0,1,0,0,0,4,0,4
Karnataka,2005,Rape,0,0,0,53,0,53,21,0,21,0,0,0,74,0,74
Karnataka,2005,Kidnapping And Abduction,0,0,0,37,0,37,2,0,2,0,0,0,39,0,39
Karnataka,2005,Dacoity,0,0,0,4,0,4,2,0,2,0,0,0,6,0,6
Karnataka,2005,Prep. And Assembly For Dacoity,0,0,0,3,0,3,10,0,10,0,0,0,13,0,13
Karnataka,2005,Robbery,0,0,0,74,0,74,11,0,11,0,0,0,85,0,85
Karnataka,2005,Burglary,0,0,0,14,0,14,16,0,16,0,0,0,30,0,30
Karnataka,2005,Thefts,0,0,0,81,1,82,71,8,79,3,0,3,155,9,164
Karnataka,2005,Extortion,0,0,0,0,0,0,0,0,0,0,0,0,0,0,0
Karnataka,2005,Riots,0,0,0,3,0,3,2,0,2,0,0,0,5,0,5
Karnataka,2005,Arson,0,0,0,0,0,0,0,0,0,0,0,0,0,0,0
Karnataka,2005,Criminal Breach Of Trust,0,0,0,0,0,0,2,0,2,0,0,0,2,0,2
Karnataka,2005,Cheating,0,0,0,49,1,50,44,2,46,2,0,2,95,3,98
Karnataka,2005,Counter Feiting,0,0,0,0,0,0,1,0,1,0,0,0,1,0,1
Karnataka,2005,Dowry Deaths,0,0,0,37,1,38,65,2,67,8,2,10,110,5,115
Karnataka,2005,Molestation,0,0,0,0,0,0,0,0,0,0,0,0,0,0,0
Karnataka,2005,Eve-Teasing,0,0,0,0,0,0,0,0,0,0,0,0,0,0,0
Karnataka,2005,Cruelty By Husband Or Relative Of Husband,0,0,0,0,0,0,0,0,0,0,0,0,0,0,0
Karnataka,2005,Other Ipc Crimes,0,0,0,37,0,37,65,2,67,8,2,10,110,4,114
Karnataka,2006,Murder,0,0,0,1632,82,1714,941,46,987,159,5,164,2732,133,2865
Karnataka,2006,Attempt To Commit Murder,0,0,0,19,0,19,67,0,67,5,0,5,91,0,91
Karnataka,2006,C.H. Not Amounting To Murder,0,0,0,3,0,3,1,0,1,0,0,0,4,0,4
Karnataka,2006,Rape,0,0,0,39,0,39,27,0,27,0,0,0,66,0,66
Karnataka,2006,Kidnapping And Abduction,0,0,0,33,0,33,2,0,2,0,0,0,35,0,35
Karnataka,2006,Dacoity,0,0,0,3,0,3,2,0,2,0,0,0,5,0,5
Karnataka,2006,Prep. And Assembly For Dacoity,0,0,0,2,0,2,12,0,12,0,0,0,14,0,14
Karnataka,2006,Robbery,0,0,0,53,0,53,11,0,11,0,0,0,64,0,64
Karnataka,2006,Burglary,0,0,0,16,0,16,17,0,17,0,0,0,33,0,33
Karnataka,2006,Thefts,0,0,0,56,1,57,69,8,77,3,0,3,128,9,137
Karnataka,2006,Extortion,0,0,0,3,0,3,2,0,2,0,0,0,5,0,5
Karnataka,2006,Riots,0,0,0,0,0,0,0,0,0,0,0,0,0,0,0
Karnataka,2006,Arson,0,0,0,0,0,0,0,0,0,0,0,0,0,0,0
Karnataka,2006,Criminal Breach Of Trust,0,0,0,0,0,0,1,0,1,0,0,0,1,0,1
Karnataka,2006,Cheating,0,0,0,38,1,39,43,2,45,2,0,2,83,3,86
Karnataka,2006,Counter Feiting,0,0,0,0,0,0,0,0,0,0,0,0,0,0,0
Karnataka,2006,Dowry Deaths,0,0,0,33,1,34,63,2,65,6,2,8,102,5,107
Karnataka,2006,Molestation,0,0,0,0,0,0,0,0,0,0,0,0,0,0,0
Karnataka,2006,Eve-Teasing,0,0,0,0,0,0,0,0,0,0,0,0,0,0,0
Karnataka,2006,Cruelty By Husband Or Relative Of Husband,0,0,0,0,0,0,0,0,0,0,0,0,0,0,0
Karnataka,2006,Other Ipc Crimes,0,0,0,16,0,16,8,0,8,3,0,3,27,0,27
Karnataka,2007,Murder,0,0,0,1666,79,1745,924,41,965,131,2,133,2721,122,2843
Karnataka,2007,Attempt To Commit Murder,0,0,0,23,0,23,63,0,63,2,0,2,88,0,88
Karnataka,2007,C.H. Not Amounting To Murder,0,0,0,1,0,1,1,0,1,0,0,0,2,0,2
Karnataka,2007,Rape,0,0,0,37,0,37,24,0,24,0,0,0,61,0,61
Karnataka,2007,Kidnapping And Abduction,0,0,0,34,0,34,2,0,2,0,0,0,36,0,36
Karnataka,2007,Dacoity,0,0,0,2,0,2,2,0,2,0,0,0,4,0,4
Karnataka,2007,Prep. And Assembly For Dacoity,0,0,0,2,0,2,11,0,11,0,0,0,13,0,13
Karnataka,2007,Robbery,0,0,0,57,0,57,13,0,13,0,0,0,70,0,70
Karnataka,2007,Burglary,0,0,0,17,0,17,16,0,16,0,0,0,33,0,33
Karnataka,2007,Thefts,0,0,0,56,1,57,61,6,67,1,0,1,118,7,125
Karnataka,2007,Extortion,0,0,0,3,0,3,2,0,2,0,0,0,5,0,5
Karnataka,2007,Riots,0,0,0,0,0,0,2,0,2,0,0,0,2,0,2
Karnataka,2007,Arson,0,0,0,0,0,0,0,0,0,0,0,0,0,0,0
Karnataka,2007,Criminal Breach Of Trust,0,0,0,0,0,0,1,0,1,0,0,0,1,0,1
Karnataka,2007,Cheating,0,0,0,39,1,40,41,1,42,2,0,2,82,2,84
Karnataka,2007,Counter Feiting,0,0,0,0,0,0,0,0,0,0,0,0,0,0,0
Karnataka,2007,Dowry Deaths,0,0,0,31,1,32,63,1,64,4,2,6,98,4,102
Karnataka,2007,Molestation,0,0,0,0,0,0,0,0,0,0,0,0,0,0,0
Karnataka,2007,Eve-Teasing,0,0,0,0,0,0,0,0,0,0,0,0,0,0,0
Karnataka,2007,Cruelty By Husband Or Relative Of Husband,0,0,0,0,0,0,0,0,0,0,0,0,0,0,0
Karnataka,2007,Other Ipc Crimes,0,0,0,21,0,21,6,0,6,3,0,3,30,0,30
Karnataka,2008,Murder,0,0,0,1741,78,1819,931,47,978,133,3,136,2805,128,2933
Karnataka,2008,Attempt To Commit Murder,0,0,0,29,0,29,68,0,68,2,0,2,99,0,99
Karnataka,2008,C.H. Not Amounting To Murder,0,0,0,3,0,3,2,0,2,1,0,1,6,0,6
Karnataka,2008,Rape,0,0,0,42,0,42,25,0,25,0,0,0,67,0,67
Karnataka,2008,Kidnapping And Abduction,0,0,0,37,0,37,2,0,2,0,0,0,39,0,39
Karnataka,2008,Dacoity,0,0,0,2,0,2,2,0,2,0,0,0,4,0,4
Karnataka,2008,Prep. And Assembly For Dacoity,0,0,0,1,0,1,11,0,11,0,0,0,12,0,12
Karnataka,2008,Robbery,0,0,0,56,0,56,12,0,12,0,0,0,68,0,68
Karnataka,2008,Burglary,0,0,0,17,0,17,16,0,16,0,0,0,33,0,33
Karnataka,2008,Thefts,0,0,0,56,1,57,62,6,68,1,0,1,119,7,126
Karnataka,2008,Extortion,0,0,0,4,0,4,2,0,2,0,0,0,6,0,6
Karnataka,2008,Riots,0,0,0,0,0,0,2,0,2,0,0,0,2,0,2
Karnataka,2008,Arson,0,0,0,0,0,0,0,0,0,0,0,0,0,0,0
Karnataka,2008,Criminal Breach Of Trust,0,0,0,0,0,0,1,0,1,0,0,0,1,0,1
Karnataka,2008,Cheating,0,0,0,41,1,42,41,1,42,2,0,2,84,2,86
Karnataka,2008,Counter Feiting,0,0,0,0,0,0,0,0,0,0,0,0,0,0,0
Karnataka,2008,Dowry Deaths,0,0,0,32,1,33,63,2,65,4,2,6,99,5,104
Karnataka,2008,Molestation,0,0,0,0,0,0,0,0,0,0,0,0,0,0,0
Karnataka,2008,Eve-Teasing,0,0,0,0,0,0,0,0,0,0,0,0,0,0,0
Karnataka,2008,Cruelty By Husband Or Relative Of Husband,0,0,0,0,0,0,0,0,0,0,0,0,0,0,0
Karnataka,2008,Other Ipc Crimes,0,0,0,25,0,25,8,0,8,4,0,4,37,0,37
Karnataka,2009,Murder,0,0,0,1591,66,1657,904,35,939,129,2,131,2624,103,2727
Karnataka,2009,Attempt To Commit Murder,0,0,0,31,0,31,67,0,67,2,0,2,100,0,100
Karnataka,2009,C.H. Not Amounting To Murder,0,0,0,3,0,3,2,0,2,1,0,1,6,0,6
Karnataka,2009,Rape,0,0,0,44,0,44,23,0,23,0,0,0,67,0,67
Karnataka,2009,Kidnapping And Abduction,0,0,0,35,0,35,2,0,2,0,0,0,37,0,37
Karnataka,2009,Dacoity,0,0,0,2,0,2,11,0,11,0,0,0,13,0,13
Karnataka,2009,Prep. And Assembly For Dacoity,0,0,0,2,0,2,2,0,2,0,0,0,4,0,4
Karnataka,2009,Robbery,0,0,0,51,0,51,12,0,12,0,0,0,63,0,63
Karnataka,2009,Burglary,0,0,0,21,0,21,16,0,16,0,0,0,37,0,37
Karnataka,2009,Thefts,0,0,0,61,1,62,61,7,68,1,0,1,123,8,131
Karnataka,2009,Extortion,0,0,0,4,0,4,2,0,2,0,0,0,6,0,6
Karnataka,2009,Riots,0,0,0,0,0,0,2,0,2,0,0,0,2,0,2
Karnataka,2009,Arson,0,0,0,0,0,0,0,0,0,0,0,0,0,0,0
Karnataka,2009,Criminal Breach Of Trust,0,0,0,0,0,0,1,0,1,0,0,0,1,0,1
Karnataka,2009,Cheating,0,0,0,38,1,39,40,1,41,2,0,2,80,2,82
Karnataka,2009,Counter Feiting,0,0,0,0,0,0,0,0,0,0,0,0,0,0,0
Karnataka,2009,Dowry Deaths,0,0,0,29,1,30,71,2,73,4,2,6,104,5,109
Karnataka,2009,Molestation,0,0,0,0,0,0,0,0,0,0,0,0,0,0,0
Karnataka,2009,Eve-Teasing,0,0,0,0,0,0,0,0,0,0,0,0,0,0,0
Karnataka,2009,Cruelty By Husband Or Relative Of Husband,0,0,0,0,0,0,0,0,0,0,0,0,0,0,0
Karnataka,2009,Other Ipc Crimes,0,0,0,11,0,11,8,1,9,4,0,4,23,1,24
Karnataka,2010,Murder,0,0,0,1517,77,1594,907,35,942,131,3,134,2555,115,2670
Karnataka,2010,Attempt To Commit Murder,0,0,0,91,0,91,81,0,81,4,0,4,176,0,176
Karnataka,2010,C.H. Not Amounting To Murder,0,0,0,5,0,5,3,0,3,1,0,1,9,0,9
Karnataka,2010,Rape,0,0,0,63,0,63,27,0,27,0,0,0,90,0,90
Karnataka,2010,Kidnapping And Abduction,0,0,0,41,0,41,8,0,8,0,0,0,49,0,49
Karnataka,2010,Dacoity,0,0,0,8,0,8,11,0,11,0,0,0,19,0,19
Karnataka,2010,Prep. And Assembly For Dacoity,0,0,0,7,0,7,9,0,9,0,0,0,16,0,16
Karnataka,2010,Robbery,0,0,0,71,0,71,13,0,13,0,0,0,84,0,84
Karnataka,2010,Burglary,0,0,0,31,0,31,17,0,17,0,0,0,48,0,48
Karnataka,2010,Thefts,0,0,0,93,1,94,77,9,86,2,0,2,172,10,182
Karnataka,2010,Extortion,0,0,0,3,0,3,2,0,2,0,0,0,5,0,5
Karnataka,2010,Riots,0,0,0,4,0,4,2,0,2,0,0,0,6,0,6
Karnataka,2010,Arson,0,0,0,0,0,0,0,0,0,0,0,0,0,0,0
Karnataka,2010,Criminal Breach Of Trust,0,0,0,1,0,1,2,0,2,0,0,0,3,0,3
Karnataka,2010,Cheating,0,0,0,47,1,48,41,1,42,2,0,2,90,2,92
Karnataka,2010,Counter Feiting,0,0,0,0,0,0,0,0,0,0,0,0,0,0,0
Karnataka,2010,Dowry Deaths,0,0,0,31,1,32,71,3,74,4,2,6,106,6,112
Karnataka,2010,Molestation,0,0,0,0,0,0,0,0,0,0,0,0,0,0,0
Karnataka,2010,Eve-Teasing,0,0,0,0,0,0,0,0,0,0,0,0,0,0,0
Karnataka,2010,Cruelty By Husband Or Relative Of Husband,0,0,0,6,0,6,0,0,0,0,0,0,6,0,6
Karnataka,2010,Other Ipc Crimes,0,0,0,14,0,14,11,2,13,4,0,4,29,2,31
Karnataka,2011,Murder,0,0,0,1637,84,1721,958,47,1005,131,3,134,2726,134,2860
Karnataka,2011,Attempt To Commit Murder,0,0,0,103,0,103,97,0,97,4,0,4,204,0,204
Karnataka,2011,C.H. Not Amounting To Murder,0,0,0,6,0,6,4,0,4,1,0,1,11,0,11
Karnataka,2011,Rape,0,0,0,67,0,67,31,0,31,0,0,0,98,0,98
Karnataka,2011,Kidnapping And Abduction,0,0,0,44,0,44,4,0,4,0,0,0,48,0,48
Karnataka,2011,Dacoity,0,0,0,11,0,11,14,0,14,0,0,0,25,0,25
Karnataka,2011,Prep. And Assembly For Dacoity,0,0,0,9,0,9,12,0,12,0,0,0,21,0,21
Karnataka,2011,Robbery,0,0,0,77,0,77,17,0,17,0,0,0,94,0,94
Karnataka,2011,Burglary,0,0,0,37,0,37,21,0,21,0,0,0,58,0,58
Karnataka,2011,Thefts,0,0,0,101,1,102,21,11,32,2,0,2,124,12,136
Karnataka,2011,Extortion,0,0,0,4,0,4,2,0,2,0,0,0,6,0,6
Karnataka,2011,Riots,0,0,0,7,0,7,2,0,2,0,0,0,9,0,9
Karnataka,2011,Arson,0,0,0,0,0,0,0,0,0,0,0,0,0,0,0
Karnataka,2011,Criminal Breach Of Trust,0,0,0,3,0,3,2,0,2,0,0,0,5,0,5
Karnataka,2011,Cheating,0,0,0,49,1,50,44,3,47,2,0,2,95,4,99
Karnataka,2011,Counter Feiting,0,0,0,0,0,0,0,0,0,0,0,0,0,0,0
Karnataka,2011,Dowry Deaths,0,0,0,37,1,38,76,3,79,4,2,6,117,6,123
Karnataka,2011,Molestation,0,0,0,0,0,0,0,0,0,0,0,0,0,0,0
Karnataka,2011,Eve-Teasing,0,0,0,0,0,0,0,0,0,0,0,0,0,0,0
Karnataka,2011,Cruelty By Husband Or Relative Of Husband,0,0,0,9,0,9,0,0,0,0,0,0,9,0,9
Karnataka,2011,Other Ipc Crimes,0,0,0,17,0,17,17,5,22,4,0,4,38,5,43
Karnataka,2012,Murder,0,0,0,1363,79,1442,1143,59,1202,116,4,120,2622,142,2764
Karnataka,2012,Attempt To Commit Murder,0,0,0,109,1,110,93,0,93,5,0,5,207,1,208
Karnataka,2012,C.H. Not Amounting To Murder,0,0,0,13,0,13,32,0,32,2,0,2,47,0,47
Karnataka,2012,Rape,0,0,0,73,0,73,44,0,44,0,0,0,117,0,117
Karnataka,2012,Kidnapping And Abduction,0,0,0,47,0,47,19,0,19,0,0,0,66,0,66
Karnataka,2012,Dacoity,0,0,0,33,0,33,61,0,61,0,0,0,94,0,94
Karnataka,2012,Prep. And Assembly For Dacoity,0,0,0,7,0,7,9,0,9,0,0,0,16,0,16
Karnataka,2012,Robbery,0,0,0,71,0,71,26,0,26,1,0,1,98,0,98
Karnataka,2012,Burglary,0,0,0,33,0,33,38,0,38,1,0,1,72,0,72
Karnataka,2012,Thefts,0,0,0,114,3,117,33,13,46,4,0,4,151,16,167
Karnataka,2012,Extortion,0,0,0,3,0,3,5,0,5,0,0,0,8,0,8
Karnataka,2012,Riots,0,0,0,11,0,11,7,0,7,1,0,1,19,0,19
Karnataka,2012,Arson,0,0,0,2,0,2,2,0,2,0,0,0,4,0,4
Karnataka,2012,Criminal Breach Of Trust,0,0,0,3,0,3,3,0,3,0,0,0,6,0,6
Karnataka,2012,Cheating,0,0,0,32,1,33,47,3,50,3,0,3,82,4,86
Karnataka,2012,Counter Feiting,0,0,0,0,0,0,0,0,0,0,0,0,0,0,0
Karnataka,2012,Dowry Deaths,0,0,0,33,1,34,71,3,74,6,2,8,110,6,116
Karnataka,2012,Molestation,0,0,0,1,0,1,7,0,7,1,0,1,9,0,9
Karnataka,2012,Eve-Teasing,0,0,0,3,0,3,2,0,2,0,0,0,5,0,5
Karnataka,2012,Cruelty By Husband Or Relative Of Husband,0,0,0,7,0,7,13,2,15,1,1,2,21,3,24
Karnataka,2012,Other Ipc Crimes,0,0,0,13,6,19,11,3,14,1,0,1,25,9,34
Kerala,2001,Murder,0,0,0,146,3,149,204,7,211,22,1,23,372,11,383
Kerala,2001,Attempt To Commit Murder,0,0,0,105,0,105,176,21,197,14,0,14,295,21,316
Kerala,2001,C.H. Not Amounting To Murder,0,0,0,16,0,16,12,0,12,0,0,0,28,0,28
Kerala,2001,Rape,0,0,0,20,0,20,8,0,8,0,0,0,28,0,28
Kerala,2001,Kidnapping And Abduction,0,0,0,42,0,42,5,0,5,8,1,9,55,1,56
Kerala,2001,Dacoity,0,0,0,6,0,6,3,0,3,22,0,22,31,0,31
Kerala,2001,Prep. And Assembly For Dacoity,0,0,0,0,0,0,0,0,0,0,0,0,0,0,0
Kerala,2001,Robbery,0,0,0,51,2,53,48,0,48,0,0,0,99,2,101
Kerala,2001,Burglary,0,0,0,31,0,31,63,0,63,0,0,0,94,0,94
Kerala,2001,Thefts,0,0,0,96,4,100,38,2,40,48,1,49,182,7,189
Kerala,2001,Extortion,0,0,0,0,0,0,0,0,0,0,0,0,0,0,0
Kerala,2001,Riots,0,0,0,9,0,9,2,0,2,0,0,0,11,0,11
Kerala,2001,Arson,0,0,0,39,0,39,7,0,7,0,0,0,46,0,46
Kerala,2001,Criminal Breach Of Trust,0,0,0,0,0,0,0,0,0,0,0,0,0,0,0
Kerala,2001,Cheating,0,0,0,83,0,83,11,0,11,0,0,0,94,0,94
Kerala,2001,Counter Feiting,0,0,0,2,0,2,1,0,1,0,0,0,3,0,3
Kerala,2001,Dowry Deaths,0,0,0,0,0,0,0,0,0,0,0,0,0,0,0
Kerala,2001,Molestation,0,0,0,0,0,0,0,0,0,0,0,0,0,0,0
Kerala,2001,Eve-Teasing,0,0,0,0,0,0,0,0,0,0,0,0,0,0,0
Kerala,2001,Cruelty By Husband Or Relative Of Husband,0,0,0,0,0,0,0,0,0,0,0,0,0,0,0
Kerala,2001,Other Ipc Crimes,0,0,0,7,0,7,3,0,3,31,0,31,41,0,41
Kerala,2002,Murder,0,0,0,206,1,207,156,2,158,21,1,22,383,4,387
Kerala,2002,Attempt To Commit Murder,0,0,0,74,0,74,120,0,120,15,0,15,209,0,209
Kerala,2002,C.H. Not Amounting To Murder,0,0,0,12,0,12,13,0,13,2,0,2,27,0,27
Kerala,2002,Rape,0,0,0,4,0,4,4,0,4,7,0,7,15,0,15
Kerala,2002,Kidnapping And Abduction,0,0,0,8,0,8,3,0,3,5,0,5,16,0,16
Kerala,2002,Dacoity,0,0,0,47,0,47,35,0,35,12,0,12,94,0,94
Kerala,2002,Prep. And Assembly For Dacoity,0,0,0,10,0,10,5,0,5,1,0,1,16,0,16
Kerala,2002,Robbery,0,0,0,30,3,33,46,4,50,7,0,7,83,7,90
Kerala,2002,Burglary,0,0,0,13,0,13,57,0,57,3,0,3,73,0,73
Kerala,2002,Thefts,0,0,0,66,6,72,54,0,54,43,2,45,163,8,171
Kerala,2002,Extortion,0,0,0,0,0,0,0,0,0,0,0,0,0,0,0
Kerala,2002,Riots,0,0,0,3,0,3,2,0,2,0,0,0,5,0,5
Kerala,2002,Arson,0,0,0,0,0,0,0,0,0,0,0,0,0,0,0
Kerala,2002,Criminal Breach Of Trust,0,0,0,5,0,5,4,0,4,0,0,0,9,0,9
Kerala,2002,Cheating,0,0,0,76,0,76,10,3,13,1,0,1,87,3,90
Kerala,2002,Counter Feiting,0,0,0,2,0,2,2,1,3,0,0,0,4,1,5
Kerala,2002,Dowry Deaths,0,0,0,0,0,0,0,0,0,0,0,0,0,0,0
Kerala,2002,Molestation,0,0,0,0,0,0,0,0,0,0,0,0,0,0,0
Kerala,2002,Eve-Teasing,0,0,0,0,0,0,0,0,0,0,0,0,0,0,0
Kerala,2002,Cruelty By Husband Or Relative Of Husband,0,0,0,0,0,0,4,0,4,0,0,0,4,0,4
Kerala,2002,Other Ipc Crimes,0,0,0,19,2,21,25,0,25,8,2,10,52,4,56
Kerala,2003,Murder,0,0,0,226,1,227,185,5,190,59,3,62,470,9,479
Kerala,2003,Attempt To Commit Murder,0,0,0,79,0,79,123,0,123,17,0,17,219,0,219
Kerala,2003,C.H. Not Amounting To Murder,0,0,0,13,0,13,15,0,15,2,0,2,30,0,30
Kerala,2003,Rape,0,0,0,12,0,12,20,0,20,8,0,8,40,0,40
Kerala,2003,Kidnapping And Abduction,0,0,0,13,0,13,15,0,15,6,0,6,34,0,34
Kerala,2003,Dacoity,0,0,0,62,0,62,47,0,47,16,0,16,125,0,125
Kerala,2003,Prep. And Assembly For Dacoity,0,0,0,11,0,11,4,0,4,0,0,0,15,0,15
Kerala,2003,Robbery,0,0,0,47,4,51,68,6,74,12,0,12,127,10,137
Kerala,2003,Burglary,0,0,0,28,0,28,73,0,73,5,0,5,106,0,106
Kerala,2003,Thefts,0,0,0,116,9,125,88,0,88,37,0,37,241,9,250
Kerala,2003,Extortion,0,0,0,0,0,0,0,0,0,0,0,0,0,0,0
Kerala,2003,Riots,0,0,0,5,0,5,3,0,3,0,0,0,8,0,8
Kerala,2003,Arson,0,0,0,0,0,0,0,0,0,0,0,0,0,0,0
Kerala,2003,Criminal Breach Of Trust,0,0,0,7,0,7,6,0,6,0,0,0,13,0,13
Kerala,2003,Cheating,0,0,0,97,0,97,51,4,55,13,0,13,161,4,165
Kerala,2003,Counter Feiting,0,0,0,3,0,3,2,1,3,0,0,0,5,1,6
Kerala,2003,Dowry Deaths,0,0,0,2,0,2,5,0,5,2,0,2,9,0,9
Kerala,2003,Molestation,0,0,0,0,0,0,0,0,0,0,0,0,0,0,0
Kerala,2003,Eve-Teasing,0,0,0,0,0,0,0,0,0,0,0,0,0,0,0
Kerala,2003,Cruelty By Husband Or Relative Of Husband,0,0,0,0,0,0,5,0,5,0,0,0,5,0,5
Kerala,2003,Other Ipc Crimes,0,0,0,21,3,24,27,0,27,11,2,13,59,5,64
Kerala,2004,Murder,0,0,0,473,1,474,468,9,477,89,8,97,1030,18,1048
Kerala,2004,Attempt To Commit Murder,0,0,0,86,0,86,53,0,53,47,0,47,186,0,186
Kerala,2004,C.H. Not Amounting To Murder,0,0,0,6,0,6,7,0,7,2,0,2,15,0,15
Kerala,2004,Rape,0,0,0,0,0,0,0,0,0,0,0,0,0,0,0
Kerala,2004,Kidnapping And Abduction,0,0,0,0,0,0,0,0,0,0,0,0,0,0,0
Kerala,2004,Dacoity,0,0,0,0,0,0,0,0,0,0,0,0,0,0,0
Kerala,2004,Prep. And Assembly For Dacoity,0,0,0,0,0,0,0,0,0,0,0,0,0,0,0
Kerala,2004,Robbery,0,0,0,0,0,0,0,0,0,0,0,0,0,0,0
Kerala,2004,Burglary,0,0,0,0,0,0,0,0,0,0,0,0,0,0,0
Kerala,2004,Thefts,0,0,0,88,0,88,39,0,39,9,0,9,136,0,136
Kerala,2004,Extortion,0,0,0,0,0,0,0,0,0,0,0,0,0,0,0
Kerala,2004,Riots,0,0,0,0,0,0,0,0,0,0,0,0,0,0,0
Kerala,2004,Arson,0,0,0,0,0,0,0,0,0,0,0,0,0,0,0
Kerala,2004,Criminal Breach Of Trust,0,0,0,0,0,0,0,0,0,0,0,0,0,0,0
Kerala,2004,Cheating,0,0,0,26,1,27,28,1,29,4,1,5,58,3,61
Kerala,2004,Counter Feiting,0,0,0,0,0,0,0,0,0,0,0,0,0,0,0
Kerala,2004,Dowry Deaths,0,0,0,0,0,0,0,1,1,0,1,1,0,2,2
Kerala,2004,Molestation,0,0,0,0,0,0,0,0,0,0,0,0,0,0,0
Kerala,2004,Eve-Teasing,0,0,0,0,0,0,0,0,0,0,0,0,0,0,0
Kerala,2004,Cruelty By Husband Or Relative Of Husband,0,0,0,25,0,25,18,0,18,2,0,2,45,0,45
Kerala,2004,Other Ipc Crimes,0,0,0,94,6,100,103,9,112,26,3,29,223,18,241
Kerala,2005,Murder,0,0,0,175,1,176,490,9,499,96,3,99,761,13,774
Kerala,2005,Attempt To Commit Murder,0,0,0,88,0,88,156,0,156,89,0,89,333,0,333
Kerala,2005,C.H. Not Amounting To Murder,0,0,0,0,0,0,0,0,0,0,0,0,0,0,0
Kerala,2005,Rape,0,0,0,0,0,0,0,0,0,0,0,0,0,0,0
Kerala,2005,Kidnapping And Abduction,0,0,0,0,0,0,0,0,0,0,0,0,0,0,0
Kerala,2005,Dacoity,0,0,0,0,0,0,0,0,0,0,0,0,0,0,0
Kerala,2005,Prep. And Assembly For Dacoity,0,0,0,0,0,0,0,0,0,0,0,0,0,0,0
Kerala,2005,Robbery,0,0,0,0,0,0,0,0,0,0,0,0,0,0,0
Kerala,2005,Burglary,0,0,0,0,0,0,0,0,0,0,0,0,0,0,0
Kerala,2005,Thefts,0,0,0,68,8,76,241,12,253,39,0,39,348,20,368
Kerala,2005,Extortion,0,0,0,0,0,0,0,0,0,0,0,0,0,0,0
Kerala,2005,Riots,0,0,0,0,0,0,0,0,0,0,0,0,0,0,0
Kerala,2005,Arson,0,0,0,0,0,0,0,0,0,0,0,0,0,0,0
Kerala,2005,Criminal Breach Of Trust,0,0,0,0,0,0,0,0,0,0,0,0,0,0,0
Kerala,2005,Cheating,0,0,0,6,1,7,29,1,30,6,0,6,41,2,43
Kerala,2005,Counter Feiting,0,0,0,0,0,0,0,0,0,0,0,0,0,0,0
Kerala,2005,Dowry Deaths,0,0,0,0,0,0,0,0,0,0,0,0,0,0,0
Kerala,2005,Molestation,0,0,0,0,0,0,0,0,0,0,0,0,0,0,0
Kerala,2005,Eve-Teasing,0,0,0,0,0,0,0,0,0,0,0,0,0,0,0
Kerala,2005,Cruelty By Husband Or Relative Of Husband,0,0,0,9,0,9,16,0,16,2,0,2,27,0,27
Kerala,2005,Other Ipc Crimes,0,0,0,98,8,106,198,0,198,94,0,94,390,8,398
Kerala,2006,Murder,0,0,0,353,10,363,651,12,663,300,0,300,1304,22,1326
Kerala,2006,Attempt To Commit Murder,0,0,0,26,0,26,47,0,47,10,0,10,83,0,83
Kerala,2006,C.H. Not Amounting To Murder,0,0,0,24,0,24,24,0,24,8,0,8,56,0,56
Kerala,2006,Rape,0,0,0,19,0,19,18,0,18,12,0,12,49,0,49
Kerala,2006,Kidnapping And Abduction,0,0,0,17,1,18,13,0,13,1,0,1,31,1,32
Kerala,2006,Dacoity,0,0,0,23,0,23,14,0,14,8,0,8,45,0,45
Kerala,2006,Prep. And Assembly For Dacoity,0,0,0,18,0,18,9,0,9,1,0,1,28,0,28
Kerala,2006,Robbery,0,0,0,26,0,26,41,0,41,21,0,21,88,0,88
Kerala,2006,Burglary,0,0,0,24,0,24,17,0,17,1,0,1,42,0,42
Kerala,2006,Thefts,0,0,0,130,4,134,137,1,138,29,0,29,296,5,301
Kerala,2006,Extortion,0,0,0,0,0,0,2,0,2,0,0,0,2,0,2
Kerala,2006,Riots,0,0,0,12,0,12,7,0,7,2,0,2,21,0,21
Kerala,2006,Arson,0,0,0,7,0,7,9,0,9,3,0,3,19,0,19
Kerala,2006,Criminal Breach Of Trust,0,0,0,3,0,3,6,0,6,2,0,2,11,0,11
Kerala,2006,Cheating,0,0,0,10,0,10,39,0,39,10,0,10,59,0,59
Kerala,2006,Counter Feiting,0,0,0,3,0,3,9,0,9,3,0,3,15,0,15
Kerala,2006,Dowry Deaths,0,0,0,0,0,0,8,0,8,2,4,6,10,4,14
Kerala,2006,Molestation,0,0,0,2,0,2,8,0,8,4,0,4,14,0,14
Kerala,2006,Eve-Teasing,0,0,0,0,0,0,0,0,0,0,0,0,0,0,0
Kerala,2006,Cruelty By Husband Or Relative Of Husband,0,0,0,5,0,5,11,0,11,16,0,16,32,0,32
Kerala,2006,Other Ipc Crimes,0,0,0,19,1,20,19,2,21,22,0,22,60,3,63
Kerala,2007,Murder,0,0,0,397,6,403,654,12,666,300,0,300,1351,18,1369
Kerala,2007,Attempt To Commit Murder,0,0,0,26,0,26,47,0,47,10,0,10,83,0,83
Kerala,2007,C.H. Not Amounting To Murder,0,0,0,24,0,24,24,0,24,8,0,8,56,0,56
Kerala,2007,Rape,0,0,0,19,0,19,18,0,18,7,0,7,44,0,44
Kerala,2007,Kidnapping And Abduction,0,0,0,17,0,17,13,0,13,1,0,1,31,0,31
Kerala,2007,Dacoity,0,0,0,23,0,23,14,0,14,8,0,8,45,0,45
Kerala,2007,Prep. And Assembly For Dacoity,0,0,0,18,0,18,9,0,9,1,0,1,28,0,28
Kerala,2007,Robbery,0,0,0,26,0,26,41,0,41,11,0,11,78,0,78
Kerala,2007,Burglary,0,0,0,34,0,34,27,0,27,8,0,8,69,0,69
Kerala,2007,Thefts,0,0,0,90,2,92,137,1,138,29,0,29,256,3,259
Kerala,2007,Extortion,0,0,0,0,0,0,0,0,0,0,0,0,0,0,0
Kerala,2007,Riots,0,0,0,12,0,12,7,0,7,2,0,2,21,0,21
Kerala,2007,Arson,0,0,0,7,0,7,9,0,9,3,0,3,19,0,19
Kerala,2007,Criminal Breach Of Trust,0,0,0,3,0,3,6,0,6,2,0,2,11,0,11
Kerala,2007,Cheating,0,0,0,10,0,10,39,0,39,10,0,10,59,0,59
Kerala,2007,Counter Feiting,0,0,0,3,0,3,9,0,9,3,0,3,15,0,15
Kerala,2007,Dowry Deaths,0,0,0,0,0,0,8,0,8,2,4,6,10,4,14
Kerala,2007,Molestation,0,0,0,2,0,2,8,0,8,4,0,4,14,0,14
Kerala,2007,Eve-Teasing,0,0,0,0,0,0,0,0,0,0,0,0,0,0,0
Kerala,2007,Cruelty By Husband Or Relative Of Husband,0,0,0,5,0,5,11,0,11,16,0,16,32,0,32
Kerala,2007,Other Ipc Crimes,0,0,0,19,1,20,19,5,24,12,0,12,50,6,56
Kerala,2008,Murder,0,0,0,328,2,330,641,17,658,257,6,263,1226,25,1251
Kerala,2008,Attempt To Commit Murder,0,0,0,29,1,30,88,2,90,35,0,35,152,3,155
Kerala,2008,C.H. Not Amounting To Murder,0,0,0,9,0,9,9,0,9,0,0,0,18,0,18
Kerala,2008,Rape,0,0,0,33,0,33,38,0,38,10,0,10,81,0,81
Kerala,2008,Kidnapping And Abduction,0,0,0,11,0,11,13,0,13,1,0,1,25,0,25
Kerala,2008,Dacoity,0,0,0,21,0,21,21,0,21,3,0,3,45,0,45
Kerala,2008,Prep. And Assembly For Dacoity,0,0,0,17,0,17,21,0,21,2,0,2,40,0,40
Kerala,2008,Robbery,0,0,0,65,0,65,71,0,71,19,0,19,155,0,155
Kerala,2008,Burglary,0,0,0,20,0,20,20,1,21,3,0,3,43,1,44
Kerala,2008,Thefts,0,0,0,98,3,101,102,5,107,66,2,68,266,10,276
Kerala,2008,Extortion,0,0,0,20,0,20,32,1,33,7,0,7,59,1,60
Kerala,2008,Riots,0,0,0,6,0,6,6,0,6,1,0,1,13,0,13
Kerala,2008,Arson,0,0,0,7,0,7,4,0,4,0,0,0,11,0,11
Kerala,2008,Criminal Breach Of Trust,0,0,0,2,0,2,5,0,5,0,0,0,7,0,7
Kerala,2008,Cheating,0,0,0,12,0,12,25,1,26,15,0,15,52,1,53
Kerala,2008,Counter Feiting,0,0,0,3,0,3,0,0,0,2,0,2,5,0,5
Kerala,2008,Dowry Deaths,0,0,0,3,0,3,8,0,8,2,1,3,13,1,14
Kerala,2008,Molestation,0,0,0,0,0,0,0,0,0,0,0,0,0,0,0
Kerala,2008,Eve-Teasing,0,0,0,0,0,0,0,0,0,0,0,0,0,0,0
Kerala,2008,Cruelty By Husband Or Relative Of Husband,0,0,0,9,0,9,18,0,18,4,0,4,31,0,31
Kerala,2008,Other Ipc Crimes,0,0,0,10,0,10,12,0,12,4,0,4,26,0,26
Kerala,2009,Murder,0,0,0,431,3,434,711,19,730,199,2,201,1341,24,1365
Kerala,2009,Attempt To Commit Murder,0,0,0,33,0,33,61,0,61,28,0,28,122,0,122
Kerala,2009,C.H. Not Amounting To Murder,0,0,0,9,0,9,18,0,18,10,0,10,37,0,37
Kerala,2009,Rape,0,0,0,17,0,17,31,1,32,0,0,0,48,1,49
Kerala,2009,Kidnapping And Abduction,0,0,0,2,0,2,0,0,0,0,0,0,2,0,2
Kerala,2009,Dacoity,0,0,0,9,0,9,16,0,16,15,0,15,40,0,40
Kerala,2009,Prep. And Assembly For Dacoity,0,0,0,6,0,6,13,0,13,0,0,0,19,0,19
Kerala,2009,Robbery,0,0,0,64,0,64,29,0,29,53,0,53,146,0,146
Kerala,2009,Burglary,0,0,0,52,0,52,35,0,35,39,0,39,126,0,126
Kerala,2009,Thefts,0,0,0,111,4,115,116,1,117,29,0,29,256,5,261
Kerala,2009,Extortion,0,0,0,0,1,1,0,1,1,0,0,0,0,2,2
Kerala,2009,Riots,0,0,0,41,0,41,22,0,22,11,0,11,74,0,74
Kerala,2009,Arson,0,0,0,1,0,1,1,0,1,0,0,0,2,0,2
Kerala,2009,Criminal Breach Of Trust,0,0,0,8,0,8,2,0,2,4,0,4,14,0,14
Kerala,2009,Cheating,0,0,0,7,0,7,29,1,30,2,0,2,38,1,39
Kerala,2009,Counter Feiting,0,0,0,3,0,3,2,0,2,4,0,4,9,0,9
Kerala,2009,Dowry Deaths,0,0,0,3,0,3,6,0,6,6,0,6,15,0,15
Kerala,2009,Molestation,0,0,0,0,0,0,10,0,10,6,0,6,16,0,16
Kerala,2009,Eve-Teasing,0,0,0,0,0,0,0,0,0,0,0,0,0,0,0
Kerala,2009,Cruelty By Husband Or Relative Of Husband,0,0,0,11,0,11,10,0,10,6,0,6,27,0,27
Kerala,2009,Other Ipc Crimes,0,0,0,25,0,25,43,2,45,11,4,15,79,6,85
Kerala,2010,Murder,0,0,0,569,7,576,783,19,802,231,3,234,1583,29,1612
Kerala,2010,Attempt To Commit Murder,0,0,0,33,0,33,45,1,46,48,0,48,126,1,127
Kerala,2010,C.H. Not Amounting To Murder,0,0,0,4,0,4,11,0,11,23,0,23,38,0,38
Kerala,2010,Rape,0,0,0,8,0,8,15,0,15,0,0,0,23,0,23
Kerala,2010,Kidnapping And Abduction,0,0,0,0,0,0,0,0,0,0,0,0,0,0,0
Kerala,2010,Dacoity,0,0,0,9,0,9,4,0,4,15,0,15,28,0,28
Kerala,2010,Prep. And Assembly For Dacoity,0,0,0,6,0,6,9,0,9,0,0,0,15,0,15
Kerala,2010,Robbery,0,0,0,21,0,21,18,0,18,53,0,53,92,0,92
Kerala,2010,Burglary,0,0,0,31,0,31,22,0,22,41,0,41,94,0,94
Kerala,2010,Thefts,0,0,0,52,2,54,72,1,73,36,0,36,160,3,163
Kerala,2010,Extortion,0,0,0,0,0,0,0,0,0,0,0,0,0,0,0
Kerala,2010,Riots,0,0,0,20,0,20,12,0,12,11,0,11,43,0,43
Kerala,2010,Arson,0,0,0,1,0,1,1,0,1,0,0,0,2,0,2
Kerala,2010,Criminal Breach Of Trust,0,0,0,8,0,8,2,0,2,4,0,4,14,0,14
Kerala,2010,Cheating,0,0,0,7,0,7,13,0,13,2,0,2,22,0,22
Kerala,2010,Counter Feiting,0,0,0,1,0,1,2,0,2,4,0,4,7,0,7
Kerala,2010,Dowry Deaths,0,0,0,3,0,3,6,0,6,6,0,6,15,0,15
Kerala,2010,Molestation,0,0,0,0,0,0,6,0,6,6,0,6,12,0,12
Kerala,2010,Eve-Teasing,0,0,0,0,0,0,0,0,0,0,0,0,0,0,0
Kerala,2010,Cruelty By Husband Or Relative Of Husband,0,0,0,5,0,5,4,0,4,6,0,6,15,0,15
Kerala,2010,Other Ipc Crimes,0,0,0,10,0,10,35,0,35,11,4,15,56,4,60
Kerala,2011,Murder,0,0,0,449,1,450,616,19,635,167,4,171,1232,24,1256
Kerala,2011,Attempt To Commit Murder,0,0,0,36,0,36,55,1,56,35,0,35,126,1,127
Kerala,2011,C.H. Not Amounting To Murder,0,0,0,6,0,6,11,0,11,20,0,20,37,0,37
Kerala,2011,Rape,0,0,0,8,0,8,35,0,35,0,0,0,43,0,43
Kerala,2011,Kidnapping And Abduction,0,0,0,0,0,0,0,0,0,0,0,0,0,0,0
Kerala,2011,Dacoity,0,0,0,9,0,9,4,0,4,15,0,15,28,0,28
Kerala,2011,Prep. And Assembly For Dacoity,0,0,0,8,0,8,9,0,9,0,0,0,17,0,17
Kerala,2011,Robbery,0,0,0,24,0,24,18,0,18,43,0,43,85,0,85
Kerala,2011,Burglary,0,0,0,32,0,32,22,0,22,41,0,41,95,0,95
Kerala,2011,Thefts,0,0,0,40,5,45,77,7,84,28,0,28,145,12,157
Kerala,2011,Extortion,0,0,0,0,0,0,0,0,0,0,0,0,0,0,0
Kerala,2011,Riots,0,0,0,21,0,21,12,0,12,11,0,11,44,0,44
Kerala,2011,Arson,0,0,0,1,0,1,1,0,1,0,0,0,2,0,2
Kerala,2011,Criminal Breach Of Trust,0,0,0,5,0,5,3,0,3,4,0,4,12,0,12
Kerala,2011,Cheating,0,0,0,8,0,8,11,0,11,2,0,2,21,0,21
Kerala,2011,Counter Feiting,0,0,0,3,0,3,3,0,3,4,0,4,10,0,10
Kerala,2011,Dowry Deaths,0,0,0,2,0,2,4,0,4,5,0,5,11,0,11
Kerala,2011,Molestation,0,0,0,2,0,2,8,0,8,7,0,7,17,0,17
Kerala,2011,Eve-Teasing,0,0,0,0,0,0,1,0,1,0,0,0,1,0,1
Kerala,2011,Cruelty By Husband Or Relative Of Husband,0,0,0,4,0,4,3,0,3,6,0,6,13,0,13
Kerala,2011,Other Ipc Crimes,0,0,0,10,0,10,40,0,40,11,4,15,61,4,65
Kerala,2012,Murder,0,0,0,451,4,455,758,20,778,230,5,235,1439,29,1468
Kerala,2012,Attempt To Commit Murder,0,0,0,37,0,37,58,2,60,38,0,38,133,2,135
Kerala,2012,C.H. Not Amounting To Murder,0,0,0,7,0,7,15,0,15,21,0,21,43,0,43
Kerala,2012,Rape,0,0,0,0,0,0,0,0,0,0,0,0,0,0,0
Kerala,2012,Kidnapping And Abduction,0,0,0,0,0,0,0,0,0,0,0,0,0,0,0
Kerala,2012,Dacoity,0,0,0,11,0,11,6,0,6,18,0,18,35,0,35
Kerala,2012,Prep. And Assembly For Dacoity,0,0,0,11,0,11,15,0,15,0,0,0,26,0,26
Kerala,2012,Robbery,0,0,0,27,0,27,21,0,21,53,0,53,101,0,101
Kerala,2012,Burglary,0,0,0,35,0,35,26,0,26,52,0,52,113,0,113
Kerala,2012,Thefts,0,0,0,44,7,51,81,4,85,39,0,39,164,11,175
Kerala,2012,Extortion,0,0,0,0,0,0,0,0,0,0,0,0,0,0,0
Kerala,2012,Riots,0,0,0,23,0,23,15,0,15,12,0,12,50,0,50
Kerala,2012,Arson,0,0,0,9,0,9,4,0,4,6,0,6,19,0,19
Kerala,2012,Criminal Breach Of Trust,0,0,0,9,0,9,15,0,15,3,0,3,27,0,27
Kerala,2012,Cheating,0,0,0,1,0,1,3,0,3,5,0,5,9,0,9
Kerala,2012,Counter Feiting,0,0,0,4,0,4,7,0,7,7,0,7,18,0,18
Kerala,2012,Dowry Deaths,0,0,0,0,0,0,7,0,7,7,0,7,14,0,14
Kerala,2012,Molestation,0,0,0,0,0,0,0,0,0,0,0,0,0,0,0
Kerala,2012,Eve-Teasing,0,0,0,0,0,0,0,0,0,0,0,0,0,0,0
Kerala,2012,Cruelty By Husband Or Relative Of Husband,0,0,0,6,0,6,5,0,5,7,0,7,18,0,18
Kerala,2012,Other Ipc Crimes,0,0,0,11,0,11,40,0,40,12,0,12,63,0,63
Madhya Pradesh,2001,Murder,13,0,13,3403,62,3465,3224,103,3327,975,22,997,7615,187,7802
Madhya Pradesh,2001,Attempt To Commit Murder,5,0,5,340,0,340,170,0,170,39,0,39,554,0,554
Madhya Pradesh,2001,C.H. Not Amounting To Murder,7,0,7,285,4,289,138,8,146,42,3,45,472,15,487
Madhya Pradesh,2001,Rape,0,0,0,533,1,534,299,3,302,38,0,38,870,4,874
Madhya Pradesh,2001,Kidnapping And Abduction,0,0,0,80,3,83,53,2,55,3,2,5,136,7,143
Madhya Pradesh,2001,Dacoity,2,0,2,107,0,107,82,0,82,16,0,16,207,0,207
Madhya Pradesh,2001,Prep. And Assembly For Dacoity,0,0,0,23,0,23,15,0,15,3,0,3,41,0,41
Madhya Pradesh,2001,Robbery,0,0,0,69,0,69,39,0,39,8,0,8,116,0,116
Madhya Pradesh,2001,Burglary,0,0,0,50,0,50,19,0,19,6,0,6,75,0,75
Madhya Pradesh,2001,Thefts,2,0,2,104,0,104,61,1,62,12,1,13,179,2,181
Madhya Pradesh,2001,Extortion,0,0,0,3,0,3,1,0,1,0,0,0,4,0,4
Madhya Pradesh,2001,Riots,0,0,0,0,0,0,0,0,0,0,0,0,0,0,0
Madhya Pradesh,2001,Arson,0,0,0,7,0,7,4,0,4,1,0,1,12,0,12
Madhya Pradesh,2001,Criminal Breach Of Trust,0,0,0,8,0,8,6,0,6,2,0,2,16,0,16
Madhya Pradesh,2001,Cheating,0,0,0,7,0,7,10,0,10,2,0,2,19,0,19
Madhya Pradesh,2001,Counter Feiting,0,0,0,4,0,4,1,0,1,1,0,1,6,0,6
Madhya Pradesh,2001,Dowry Deaths,0,0,0,54,0,54,37,4,41,14,3,17,105,7,112
Madhya Pradesh,2001,Molestation,0,0,0,2,0,2,4,0,4,0,0,0,6,0,6
Madhya Pradesh,2001,Eve-Teasing,0,0,0,1,0,1,0,0,0,1,0,1,2,0,2
Madhya Pradesh,2001,Cruelty By Husband Or Relative Of Husband,0,0,0,18,0,18,8,2,10,6,1,7,32,3,35
Madhya Pradesh,2001,Other Ipc Crimes,6,0,6,190,3,193,162,2,164,25,2,27,383,7,390
Madhya Pradesh,2002,Murder,15,0,15,2000,43,2043,3449,73,3522,602,24,626,6066,140,6206
Madhya Pradesh,2002,Attempt To Commit Murder,3,0,3,297,0,297,198,6,204,62,0,62,560,6,566
Madhya Pradesh,2002,C.H. Not Amounting To Murder,0,0,0,222,3,225,167,2,169,67,4,71,456,9,465
Madhya Pradesh,2002,Rape,3,0,3,443,2,445,220,2,222,31,3,34,697,7,704
Madhya Pradesh,2002,Kidnapping And Abduction,4,0,4,206,2,208,71,1,72,12,1,13,293,4,297
Madhya Pradesh,2002,Dacoity,0,0,0,143,0,143,82,0,82,17,0,17,242,0,242
Madhya Pradesh,2002,Prep. And Assembly For Dacoity,0,0,0,49,0,49,60,0,60,5,0,5,114,0,114
Madhya Pradesh,2002,Robbery,3,0,3,135,0,135,79,0,79,11,0,11,228,0,228
Madhya Pradesh,2002,Burglary,3,0,3,109,0,109,111,3,114,12,0,12,235,3,238
Madhya Pradesh,2002,Thefts,0,0,0,205,2,207,163,3,166,30,0,30,398,5,403
Madhya Pradesh,2002,Extortion,0,0,0,5,0,5,2,0,2,0,0,0,7,0,7
Madhya Pradesh,2002,Riots,0,0,0,20,0,20,12,0,12,3,0,3,35,0,35
Madhya Pradesh,2002,Arson,0,0,0,9,0,9,6,0,6,2,0,2,17,0,17
Madhya Pradesh,2002,Criminal Breach Of Trust,0,0,0,6,0,6,4,0,4,4,0,4,14,0,14
Madhya Pradesh,2002,Cheating,0,0,0,10,0,10,13,0,13,0,0,0,23,0,23
Madhya Pradesh,2002,Counter Feiting,0,0,0,12,0,12,17,2,19,5,0,5,34,2,36
Madhya Pradesh,2002,Dowry Deaths,0,0,0,61,3,64,39,5,44,18,8,26,118,16,134
Madhya Pradesh,2002,Molestation,0,0,0,21,0,21,16,0,16,1,0,1,38,0,38
Madhya Pradesh,2002,Eve-Teasing,0,0,0,1,0,1,1,0,1,0,0,0,2,0,2
Madhya Pradesh,2002,Cruelty By Husband Or Relative Of Husband,0,0,0,37,2,39,19,3,22,8,0,8,64,5,69
Madhya Pradesh,2002,Other Ipc Crimes,4,0,4,303,3,306,287,5,292,65,2,67,659,10,669
Madhya Pradesh,2003,Murder,2,0,2,2801,71,2872,3261,124,3385,619,31,650,6683,226,6909
Madhya Pradesh,2003,Attempt To Commit Murder,0,0,0,327,3,330,410,6,416,94,11,105,831,20,851
Madhya Pradesh,2003,C.H. Not Amounting To Murder,0,0,0,190,12,202,171,6,177,46,1,47,407,19,426
Madhya Pradesh,2003,Rape,0,0,0,388,2,390,308,14,322,60,0,60,756,16,772
Madhya Pradesh,2003,Kidnapping And Abduction,2,0,2,132,5,137,125,1,126,52,0,52,311,6,317
Madhya Pradesh,2003,Dacoity,0,0,0,54,0,54,83,0,83,29,0,29,166,0,166
Madhya Pradesh,2003,Prep. And Assembly For Dacoity,0,0,0,32,0,32,38,0,38,4,0,4,74,0,74
Madhya Pradesh,2003,Robbery,0,0,0,104,0,104,124,0,124,34,0,34,262,0,262
Madhya Pradesh,2003,Burglary,0,0,0,48,0,48,60,0,60,27,0,27,135,0,135
Madhya Pradesh,2003,Thefts,0,0,0,125,6,131,143,1,144,16,0,16,284,7,291
Madhya Pradesh,2003,Extortion,0,0,0,3,0,3,33,0,33,0,0,0,36,0,36
Madhya Pradesh,2003,Riots,0,0,0,4,0,4,5,0,5,4,0,4,13,0,13
Madhya Pradesh,2003,Arson,0,0,0,9,0,9,10,0,10,10,0,10,29,0,29
Madhya Pradesh,2003,Criminal Breach Of Trust,0,0,0,5,0,5,16,0,16,2,0,2,23,0,23
Madhya Pradesh,2003,Cheating,0,0,0,29,8,37,19,0,19,0,0,0,48,8,56
Madhya Pradesh,2003,Counter Feiting,0,0,0,15,0,15,1,0,1,0,0,0,16,0,16
Madhya Pradesh,2003,Dowry Deaths,0,0,0,86,7,93,79,17,96,33,13,46,198,37,235
Madhya Pradesh,2003,Molestation,0,0,0,14,0,14,24,0,24,0,0,0,38,0,38
Madhya Pradesh,2003,Eve-Teasing,0,0,0,0,0,0,0,0,0,0,0,0,0,0,0
Madhya Pradesh,2003,Cruelty By Husband Or Relative Of Husband,0,0,0,22,0,22,32,1,33,12,1,13,66,2,68
Madhya Pradesh,2003,Other Ipc Crimes,0,0,0,153,4,157,212,3,215,50,0,50,415,7,422
Madhya Pradesh,2004,Murder,0,0,0,2405,56,2461,4297,84,4381,1026,16,1042,7728,156,7884
Madhya Pradesh,2004,Attempt To Commit Murder,0,0,0,270,9,279,380,5,385,70,2,72,720,16,736
Madhya Pradesh,2004,C.H. Not Amounting To Murder,0,0,0,138,3,141,182,13,195,40,2,42,360,18,378
Madhya Pradesh,2004,Rape,0,0,0,436,1,437,318,1,319,43,0,43,797,2,799
Madhya Pradesh,2004,Kidnapping And Abduction,0,0,0,87,4,91,113,3,116,29,2,31,229,9,238
Madhya Pradesh,2004,Dacoity,0,0,0,63,0,63,101,0,101,26,0,26,190,0,190
Madhya Pradesh,2004,Prep. And Assembly For Dacoity,0,0,0,17,0,17,26,0,26,8,0,8,51,0,51
Madhya Pradesh,2004,Robbery,0,0,0,87,0,87,146,0,146,31,0,31,264,0,264
Madhya Pradesh,2004,Burglary,0,0,0,36,0,36,44,0,44,10,0,10,90,0,90
Madhya Pradesh,2004,Thefts,0,0,0,89,1,90,53,0,53,19,0,19,161,1,162
Madhya Pradesh,2004,Extortion,0,0,0,2,0,2,6,0,6,2,0,2,10,0,10
Madhya Pradesh,2004,Riots,0,0,0,8,0,8,9,0,9,0,0,0,17,0,17
Madhya Pradesh,2004,Arson,0,0,0,6,0,6,8,0,8,0,0,0,14,0,14
Madhya Pradesh,2004,Criminal Breach Of Trust,0,0,0,9,0,9,16,0,16,7,0,7,32,0,32
Madhya Pradesh,2004,Cheating,0,0,0,9,0,9,14,0,14,7,0,7,30,0,30
Madhya Pradesh,2004,Counter Feiting,0,0,0,2,0,2,9,0,9,1,0,1,12,0,12
Madhya Pradesh,2004,Dowry Deaths,0,0,0,86,1,87,109,9,118,29,6,35,224,16,240
Madhya Pradesh,2004,Molestation,0,0,0,9,0,9,17,0,17,2,0,2,28,0,28
Madhya Pradesh,2004,Eve-Teasing,0,0,0,1,0,1,1,0,1,0,0,0,2,0,2
Madhya Pradesh,2004,Cruelty By Husband Or Relative Of Husband,0,0,0,31,0,31,76,3,79,8,7,15,115,10,125
Madhya Pradesh,2004,Other Ipc Crimes,0,0,0,106,0,106,165,1,166,11,0,11,282,1,283
Madhya Pradesh,2005,Murder,0,0,0,3196,57,3253,3851,81,3932,1077,21,1098,8124,159,8283
Madhya Pradesh,2005,Attempt To Commit Murder,0,0,0,447,8,455,279,4,283,105,3,108,831,15,846
Madhya Pradesh,2005,C.H. Not Amounting To Murder,0,0,0,159,4,163,146,3,149,48,3,51,353,10,363
Madhya Pradesh,2005,Rape,0,0,0,412,0,412,296,0,296,39,0,39,747,0,747
Madhya Pradesh,2005,Kidnapping And Abduction,0,0,0,126,5,131,113,2,115,38,1,39,277,8,285
Madhya Pradesh,2005,Dacoity,0,0,0,142,0,142,108,0,108,23,0,23,273,0,273
Madhya Pradesh,2005,Prep. And Assembly For Dacoity,0,0,0,38,0,38,33,0,33,11,0,11,82,0,82
Madhya Pradesh,2005,Robbery,0,0,0,92,0,92,71,0,71,22,0,22,185,0,185
Madhya Pradesh,2005,Burglary,0,0,0,43,0,43,38,0,38,10,0,10,91,0,91
Madhya Pradesh,2005,Thefts,0,0,0,156,1,157,60,0,60,23,0,23,239,1,240
Madhya Pradesh,2005,Extortion,0,0,0,4,0,4,3,0,3,0,0,0,7,0,7
Madhya Pradesh,2005,Riots,0,0,0,17,0,17,20,0,20,6,0,6,43,0,43
Madhya Pradesh,2005,Arson,0,0,0,6,0,6,10,0,10,1,0,1,17,0,17
Madhya Pradesh,2005,Criminal Breach Of Trust,0,0,0,11,0,11,14,0,14,5,0,5,30,0,30
Madhya Pradesh,2005,Cheating,0,0,0,20,0,20,26,1,27,9,1,10,55,2,57
Madhya Pradesh,2005,Counter Feiting,0,0,0,22,0,22,6,0,6,0,0,0,28,0,28
Madhya Pradesh,2005,Dowry Deaths,0,0,0,74,6,80,104,15,119,29,5,34,207,26,233
Madhya Pradesh,2005,Molestation,0,0,0,48,0,48,9,0,9,2,0,2,59,0,59
Madhya Pradesh,2005,Eve-Teasing,0,0,0,5,0,5,0,0,0,0,0,0,5,0,5
Madhya Pradesh,2005,Cruelty By Husband Or Relative Of Husband,0,0,0,30,1,31,35,9,44,9,3,12,74,13,87
Madhya Pradesh,2005,Other Ipc Crimes,0,0,0,223,7,230,250,7,257,90,0,90,563,14,577
Madhya Pradesh,2006,Murder,0,0,0,3465,65,3530,4265,102,4367,1208,19,1227,8938,186,9124
Madhya Pradesh,2006,Attempt To Commit Murder,0,0,0,359,5,364,278,14,292,104,2,106,741,21,762
Madhya Pradesh,2006,C.H. Not Amounting To Murder,0,0,0,163,6,169,180,13,193,64,1,65,407,20,427
Madhya Pradesh,2006,Rape,0,0,0,481,0,481,354,0,354,44,0,44,879,0,879
Madhya Pradesh,2006,Kidnapping And Abduction,0,0,0,132,5,137,107,2,109,34,0,34,273,7,280
Madhya Pradesh,2006,Dacoity,0,0,0,102,0,102,76,0,76,24,0,24,202,0,202
Madhya Pradesh,2006,Prep. And Assembly For Dacoity,0,0,0,35,0,35,25,0,25,8,0,8,68,0,68
Madhya Pradesh,2006,Robbery,0,0,0,138,2,140,69,2,71,25,0,25,232,4,236
Madhya Pradesh,2006,Burglary,0,0,0,31,0,31,30,0,30,5,0,5,66,0,66
Madhya Pradesh,2006,Thefts,0,0,0,149,2,151,79,0,79,20,0,20,248,2,250
Madhya Pradesh,2006,Extortion,0,0,0,6,0,6,9,0,9,0,0,0,15,0,15
Madhya Pradesh,2006,Riots,0,0,0,9,0,9,10,0,10,2,0,2,21,0,21
Madhya Pradesh,2006,Arson,0,0,0,7,0,7,9,0,9,2,0,2,18,0,18
Madhya Pradesh,2006,Criminal Breach Of Trust,0,0,0,5,0,5,9,0,9,4,0,4,18,0,18
Madhya Pradesh,2006,Cheating,0,0,0,23,1,24,28,1,29,8,0,8,59,2,61
Madhya Pradesh,2006,Counter Feiting,0,0,0,18,0,18,8,0,8,3,0,3,29,0,29
Madhya Pradesh,2006,Dowry Deaths,0,0,0,112,8,120,86,18,104,32,10,42,230,36,266
Madhya Pradesh,2006,Molestation,0,0,0,17,0,17,6,0,6,1,0,1,24,0,24
Madhya Pradesh,2006,Eve-Teasing,0,0,0,1,0,1,0,0,0,0,0,0,1,0,1
Madhya Pradesh,2006,Cruelty By Husband Or Relative Of Husband,0,0,0,32,1,33,18,0,18,8,1,9,58,2,60
Madhya Pradesh,2006,Other Ipc Crimes,0,0,0,231,3,234,235,5,240,82,0,82,548,8,556
Madhya Pradesh,2007,Murder,0,0,0,3403,28,3431,4871,123,4994,1278,21,1299,9552,172,9724
Madhya Pradesh,2007,Attempt To Commit Murder,0,0,0,264,11,275,365,18,383,105,0,105,734,29,763
Madhya Pradesh,2007,C.H. Not Amounting To Murder,0,0,0,147,7,154,178,4,182,81,6,87,406,17,423
Madhya Pradesh,2007,Rape,0,0,0,421,3,424,319,2,321,40,0,40,780,5,785
Madhya Pradesh,2007,Kidnapping And Abduction,0,0,0,81,4,85,120,2,122,24,0,24,225,6,231
Madhya Pradesh,2007,Dacoity,0,0,0,104,2,106,109,3,112,29,0,29,242,5,247
Madhya Pradesh,2007,Prep. And Assembly For Dacoity,0,0,0,32,0,32,31,0,31,9,0,9,72,0,72
Madhya Pradesh,2007,Robbery,0,0,0,97,3,100,70,1,71,21,0,21,188,4,192
Madhya Pradesh,2007,Burglary,0,0,0,30,0,30,35,0,35,6,0,6,71,0,71
Madhya Pradesh,2007,Thefts,0,0,0,140,3,143,127,3,130,29,1,30,296,7,303
Madhya Pradesh,2007,Extortion,0,0,0,17,0,17,8,0,8,0,0,0,25,0,25
Madhya Pradesh,2007,Riots,0,0,0,8,0,8,5,0,5,1,0,1,14,0,14
Madhya Pradesh,2007,Arson,0,0,0,5,0,5,8,0,8,1,0,1,14,0,14
Madhya Pradesh,2007,Criminal Breach Of Trust,0,0,0,4,0,4,11,0,11,1,0,1,16,0,16
Madhya Pradesh,2007,Cheating,0,0,0,10,2,12,25,0,25,7,0,7,42,2,44
Madhya Pradesh,2007,Counter Feiting,0,0,0,13,0,13,13,0,13,1,0,1,27,0,27
Madhya Pradesh,2007,Dowry Deaths,0,0,0,100,6,106,125,19,144,44,10,54,269,35,304
Madhya Pradesh,2007,Molestation,0,0,0,17,0,17,10,0,10,3,0,3,30,0,30
Madhya Pradesh,2007,Eve-Teasing,0,0,0,0,0,0,1,0,1,0,0,0,1,0,1
Madhya Pradesh,2007,Cruelty By Husband Or Relative Of Husband,0,0,0,29,7,36,45,5,50,15,0,15,89,12,101
Madhya Pradesh,2007,Other Ipc Crimes,0,0,0,488,8,496,293,7,300,78,2,80,859,17,876
Madhya Pradesh,2008,Murder,0,0,0,3275,53,3328,5268,109,5377,853,24,877,9396,186,9582
Madhya Pradesh,2008,Attempt To Commit Murder,0,0,0,275,9,284,324,13,337,57,1,58,656,23,679
Madhya Pradesh,2008,C.H. Not Amounting To Murder,0,0,0,141,7,148,218,5,223,44,6,50,403,18,421
Madhya Pradesh,2008,Rape,0,0,0,397,2,399,365,1,366,35,0,35,797,3,800
Madhya Pradesh,2008,Kidnapping And Abduction,0,0,0,95,1,96,121,4,125,24,2,26,240,7,247
Madhya Pradesh,2008,Dacoity,0,0,0,111,2,113,116,0,116,26,0,26,253,2,255
Madhya Pradesh,2008,Prep. And Assembly For Dacoity,0,0,0,34,0,34,59,0,59,11,0,11,104,0,104
Madhya Pradesh,2008,Robbery,0,0,0,114,3,117,93,1,94,17,0,17,224,4,228
Madhya Pradesh,2008,Burglary,0,0,0,41,0,41,30,0,30,4,0,4,75,0,75
Madhya Pradesh,2008,Thefts,0,0,0,146,6,152,129,5,134,24,5,29,299,16,315
Madhya Pradesh,2008,Extortion,0,0,0,2,0,2,2,0,2,0,0,0,4,0,4
Madhya Pradesh,2008,Riots,0,0,0,6,0,6,7,0,7,0,0,0,13,0,13
Madhya Pradesh,2008,Arson,0,0,0,7,0,7,17,0,17,1,0,1,25,0,25
Madhya Pradesh,2008,Criminal Breach Of Trust,0,0,0,3,0,3,8,0,8,0,0,0,11,0,11
Madhya Pradesh,2008,Cheating,0,0,0,14,2,16,19,1,20,6,0,6,39,3,42
Madhya Pradesh,2008,Counter Feiting,0,0,0,5,0,5,10,0,10,1,0,1,16,0,16
Madhya Pradesh,2008,Dowry Deaths,0,0,0,96,4,100,114,30,144,33,12,45,243,46,289
Madhya Pradesh,2008,Molestation,0,0,0,19,0,19,21,0,21,2,0,2,42,0,42
Madhya Pradesh,2008,Eve-Teasing,0,0,0,0,0,0,1,0,1,0,0,0,1,0,1
Madhya Pradesh,2008,Cruelty By Husband Or Relative Of Husband,0,0,0,24,6,30,29,9,38,6,0,6,59,15,74
Madhya Pradesh,2008,Other Ipc Crimes,0,0,0,459,7,466,213,5,218,73,3,76,745,15,760
Madhya Pradesh,2009,Murder,0,0,0,3085,50,3135,4741,108,4849,1019,29,1048,8845,187,9032
Madhya Pradesh,2009,Attempt To Commit Murder,0,0,0,239,3,242,364,16,380,55,0,55,658,19,677
Madhya Pradesh,2009,C.H. Not Amounting To Murder,0,0,0,144,3,147,197,19,216,63,3,66,404,25,429
Madhya Pradesh,2009,Rape,0,0,0,393,0,393,279,1,280,39,0,39,711,1,712
Madhya Pradesh,2009,Kidnapping And Abduction,0,0,0,87,7,94,114,4,118,30,0,30,231,11,242
Madhya Pradesh,2009,Dacoity,0,0,0,101,1,102,105,1,106,35,0,35,241,2,243
Madhya Pradesh,2009,Prep. And Assembly For Dacoity,0,0,0,25,0,25,33,0,33,8,0,8,66,0,66
Madhya Pradesh,2009,Robbery,0,0,0,111,0,111,92,1,93,13,0,13,216,1,217
Madhya Pradesh,2009,Burglary,0,0,0,30,0,30,28,0,28,7,0,7,65,0,65
Madhya Pradesh,2009,Thefts,0,0,0,143,3,146,143,4,147,18,0,18,304,7,311
Madhya Pradesh,2009,Extortion,0,0,0,4,0,4,2,0,2,0,0,0,6,0,6
Madhya Pradesh,2009,Riots,0,0,0,6,0,6,11,0,11,0,0,0,17,0,17
Madhya Pradesh,2009,Arson,0,0,0,10,0,10,7,0,7,0,0,0,17,0,17
Madhya Pradesh,2009,Criminal Breach Of Trust,0,0,0,5,0,5,8,0,8,0,0,0,13,0,13
Madhya Pradesh,2009,Cheating,0,0,0,18,1,19,21,2,23,7,0,7,46,3,49
Madhya Pradesh,2009,Counter Feiting,0,0,0,14,0,14,11,0,11,0,0,0,25,0,25
Madhya Pradesh,2009,Dowry Deaths,0,0,0,94,11,105,169,28,197,56,10,66,319,49,368
Madhya Pradesh,2009,Molestation,0,0,0,7,0,7,12,0,12,1,0,1,20,0,20
Madhya Pradesh,2009,Eve-Teasing,0,0,0,3,0,3,6,0,6,0,0,0,9,0,9
Madhya Pradesh,2009,Cruelty By Husband Or Relative Of Husband,0,0,0,27,4,31,31,5,36,9,1,10,67,10,77
Madhya Pradesh,2009,Other Ipc Crimes,0,0,0,453,6,459,252,6,258,79,4,83,784,16,800
Madhya Pradesh,2010,Murder,0,0,0,3962,77,4039,4357,121,4478,1052,35,1087,9371,233,9604
Madhya Pradesh,2010,Attempt To Commit Murder,0,0,0,207,3,210,185,6,191,69,2,71,461,11,472
Madhya Pradesh,2010,C.H. Not Amounting To Murder,0,0,0,116,2,118,105,5,110,34,0,34,255,7,262
Madhya Pradesh,2010,Rape,0,0,0,237,0,237,191,1,192,26,0,26,454,1,455
Madhya Pradesh,2010,Kidnapping And Abduction,0,0,0,107,5,112,106,2,108,43,1,44,256,8,264
Madhya Pradesh,2010,Dacoity,0,0,0,88,0,88,59,0,59,13,0,13,160,0,160
Madhya Pradesh,2010,Prep. And Assembly For Dacoity,0,0,0,38,0,38,24,0,24,2,0,2,64,0,64
Madhya Pradesh,2010,Robbery,0,0,0,73,0,73,65,0,65,9,0,9,147,0,147
Madhya Pradesh,2010,Burglary,0,0,0,31,0,31,24,0,24,0,0,0,55,0,55
Madhya Pradesh,2010,Thefts,0,0,0,107,2,109,136,4,140,17,1,18,260,7,267
Madhya Pradesh,2010,Extortion,0,0,0,9,0,9,2,0,2,0,0,0,11,0,11
Madhya Pradesh,2010,Riots,0,0,0,5,0,5,5,0,5,0,0,0,10,0,10
Madhya Pradesh,2010,Arson,0,0,0,3,0,3,3,0,3,3,0,3,9,0,9
Madhya Pradesh,2010,Criminal Breach Of Trust,0,0,0,4,0,4,3,0,3,3,0,3,10,0,10
Madhya Pradesh,2010,Cheating,0,0,0,12,2,14,26,3,29,11,0,11,49,5,54
Madhya Pradesh,2010,Counter Feiting,0,0,0,20,0,20,13,0,13,8,0,8,41,0,41
Madhya Pradesh,2010,Dowry Deaths,0,0,0,86,11,97,98,23,121,72,11,83,256,45,301
Madhya Pradesh,2010,Molestation,0,0,0,13,0,13,9,0,9,2,0,2,24,0,24
Madhya Pradesh,2010,Eve-Teasing,0,0,0,2,0,2,1,0,1,0,0,0,3,0,3
Madhya Pradesh,2010,Cruelty By Husband Or Relative Of Husband,0,0,0,32,1,33,38,2,40,13,1,14,83,4,87
Madhya Pradesh,2010,Other Ipc Crimes,0,0,0,328,5,333,225,11,236,82,2,84,635,18,653
Madhya Pradesh,2011,Murder,0,0,0,3899,90,3989,5231,149,5380,1032,38,1070,10162,277,10439
Madhya Pradesh,2011,Attempt To Commit Murder,0,0,0,425,5,430,371,5,376,44,0,44,840,10,850
Madhya Pradesh,2011,C.H. Not Amounting To Murder,0,0,0,198,1,199,129,9,138,33,2,35,360,12,372
Madhya Pradesh,2011,Rape,0,0,0,332,2,334,214,1,215,31,0,31,577,3,580
Madhya Pradesh,2011,Kidnapping And Abduction,0,0,0,111,3,114,77,5,82,25,0,25,213,8,221
Madhya Pradesh,2011,Dacoity,0,0,0,138,0,138,61,0,61,6,0,6,205,0,205
Madhya Pradesh,2011,Prep. And Assembly For Dacoity,0,0,0,21,0,21,24,0,24,8,0,8,53,0,53
Madhya Pradesh,2011,Robbery,0,0,0,160,0,160,67,0,67,3,0,3,230,0,230
Madhya Pradesh,2011,Burglary,0,0,0,49,3,52,26,1,27,5,0,5,80,4,84
Madhya Pradesh,2011,Thefts,0,0,0,146,0,146,102,0,102,9,0,9,257,0,257
Madhya Pradesh,2011,Extortion,0,0,0,2,1,3,6,0,6,0,0,0,8,1,9
Madhya Pradesh,2011,Riots,0,0,0,10,0,10,13,0,13,3,0,3,26,0,26
Madhya Pradesh,2011,Arson,0,0,0,9,0,9,10,1,11,3,0,3,22,1,23
Madhya Pradesh,2011,Criminal Breach Of Trust,0,0,0,4,0,4,19,6,25,3,1,4,26,7,33
Madhya Pradesh,2011,Cheating,0,0,0,4,0,4,26,2,28,8,0,8,38,2,40
Madhya Pradesh,2011,Counter Feiting,0,0,0,11,0,11,7,0,7,0,0,0,18,0,18
Madhya Pradesh,2011,Dowry Deaths,0,0,0,97,8,105,87,14,101,49,10,59,233,32,265
Madhya Pradesh,2011,Molestation,0,0,0,14,0,14,11,0,11,1,0,1,26,0,26
Madhya Pradesh,2011,Eve-Teasing,0,0,0,8,0,8,3,1,4,0,0,0,11,1,12
Madhya Pradesh,2011,Cruelty By Husband Or Relative Of Husband,0,0,0,24,3,27,15,2,17,7,0,7,46,5,51
Madhya Pradesh,2011,Other Ipc Crimes,0,0,0,347,10,357,187,12,199,80,4,84,614,26,640
Madhya Pradesh,2012,Murder,0,0,0,3608,76,3684,5144,177,5321,1351,58,1409,10103,311,10414
Madhya Pradesh,2012,Attempt To Commit Murder,0,0,0,304,3,307,256,5,261,54,3,57,614,11,625
Madhya Pradesh,2012,C.H. Not Amounting To Murder,0,0,0,142,2,144,178,8,186,74,3,77,394,13,407
Madhya Pradesh,2012,Rape,0,0,0,479,5,484,302,3,305,51,0,51,832,8,840
Madhya Pradesh,2012,Kidnapping And Abduction,0,0,0,111,3,114,121,5,126,26,0,26,258,8,266
Madhya Pradesh,2012,Dacoity,0,0,0,103,0,103,72,0,72,15,0,15,190,0,190
Madhya Pradesh,2012,Prep. And Assembly For Dacoity,0,0,0,40,0,40,25,0,25,4,0,4,69,0,69
Madhya Pradesh,2012,Robbery,0,0,0,193,0,193,97,0,97,15,0,15,305,0,305
Madhya Pradesh,2012,Burglary,0,0,0,29,3,32,34,2,36,2,0,2,65,5,70
Madhya Pradesh,2012,Thefts,0,0,0,130,1,131,119,0,119,10,0,10,259,1,260
Madhya Pradesh,2012,Extortion,0,0,0,1,0,1,12,0,12,0,0,0,13,0,13
Madhya Pradesh,2012,Riots,0,0,0,0,0,0,0,0,0,0,0,0,0,0,0
Madhya Pradesh,2012,Arson,0,0,0,9,0,9,8,0,8,0,0,0,17,0,17
Madhya Pradesh,2012,Criminal Breach Of Trust,0,0,0,4,0,4,15,0,15,3,1,4,22,1,23
Madhya Pradesh,2012,Cheating,0,0,0,9,1,10,31,2,33,7,0,7,47,3,50
Madhya Pradesh,2012,Counter Feiting,0,0,0,12,0,12,15,0,15,1,0,1,28,0,28
Madhya Pradesh,2012,Dowry Deaths,0,0,0,129,18,147,127,28,155,42,13,55,298,59,357
Madhya Pradesh,2012,Molestation,0,0,0,14,0,14,25,0,25,1,0,1,40,0,40
Madhya Pradesh,2012,Eve-Teasing,0,0,0,0,0,0,2,1,3,0,0,0,2,1,3
Madhya Pradesh,2012,Cruelty By Husband Or Relative Of Husband,0,0,0,17,1,18,17,1,18,4,0,4,38,2,40
Madhya Pradesh,2012,Other Ipc Crimes,0,0,0,341,9,350,211,13,224,65,5,70,617,27,644
Maharashtra,2001,Murder,0,0,0,1337,40,1377,1637,96,1733,474,29,503,3448,165,3613
Maharashtra,2001,Attempt To Commit Murder,0,0,0,56,4,60,60,3,63,15,0,15,131,7,138
Maharashtra,2001,C.H. Not Amounting To Murder,0,0,0,70,0,70,58,0,58,10,0,10,138,0,138
Maharashtra,2001,Rape,0,0,0,114,0,114,87,0,87,13,0,13,214,0,214
Maharashtra,2001,Kidnapping And Abduction,0,0,0,24,2,26,7,0,7,0,0,0,31,2,33
Maharashtra,2001,Dacoity,0,0,0,66,2,68,38,1,39,7,0,7,111,3,114
Maharashtra,2001,Prep. And Assembly For Dacoity,0,0,0,18,1,19,8,1,9,2,0,2,28,2,30
Maharashtra,2001,Robbery,0,0,0,41,0,41,24,0,24,6,0,6,71,0,71
Maharashtra,2001,Burglary,0,0,0,55,0,55,26,0,26,5,0,5,86,0,86
Maharashtra,2001,Thefts,0,0,0,100,1,101,71,0,71,11,0,11,182,1,183
Maharashtra,2001,Extortion,0,0,0,0,0,0,0,0,0,0,0,0,0,0,0
Maharashtra,2001,Riots,0,0,0,18,0,18,15,0,15,0,0,0,33,0,33
Maharashtra,2001,Arson,0,0,0,0,0,0,0,0,0,0,0,0,0,0,0
Maharashtra,2001,Criminal Breach Of Trust,0,0,0,1,0,1,3,0,3,1,0,1,5,0,5
Maharashtra,2001,Cheating,0,0,0,14,1,15,26,1,27,6,0,6,46,2,48
Maharashtra,2001,Counter Feiting,0,0,0,0,0,0,0,0,0,0,0,0,0,0,0
Maharashtra,2001,Dowry Deaths,0,0,0,0,0,0,0,0,0,0,0,0,0,0,0
Maharashtra,2001,Molestation,0,0,0,0,0,0,0,0,0,0,0,0,0,0,0
Maharashtra,2001,Eve-Teasing,0,0,0,0,0,0,0,0,0,0,0,0,0,0,0
Maharashtra,2001,Cruelty By Husband Or Relative Of Husband,0,0,0,0,0,0,0,0,0,0,0,0,0,0,0
Maharashtra,2001,Other Ipc Crimes,0,0,0,292,2,294,225,24,249,12,4,16,529,30,559
Maharashtra,2002,Murder,0,0,0,1222,45,1267,2061,79,2140,438,37,475,3721,161,3882
Maharashtra,2002,Attempt To Commit Murder,0,0,0,93,2,95,104,3,107,26,0,26,223,5,228
Maharashtra,2002,C.H. Not Amounting To Murder,0,0,0,66,0,66,79,3,82,26,0,26,171,3,174
Maharashtra,2002,Rape,0,0,0,97,0,97,75,0,75,12,0,12,184,0,184
Maharashtra,2002,Kidnapping And Abduction,0,0,0,11,0,11,12,1,13,4,0,4,27,1,28
Maharashtra,2002,Dacoity,0,0,0,58,0,58,48,0,48,5,0,5,111,0,111
Maharashtra,2002,Prep. And Assembly For Dacoity,0,0,0,24,0,24,13,0,13,1,0,1,38,0,38
Maharashtra,2002,Robbery,0,0,0,47,0,47,43,0,43,5,0,5,95,0,95
Maharashtra,2002,Burglary,0,0,0,57,0,57,42,0,42,15,0,15,114,0,114
Maharashtra,2002,Thefts,3,0,3,130,2,132,84,0,84,14,0,14,231,2,233
Maharashtra,2002,Extortion,0,0,0,7,0,7,5,0,5,2,0,2,14,0,14
Maharashtra,2002,Riots,0,0,0,19,0,19,10,0,10,5,0,5,34,0,34
Maharashtra,2002,Arson,0,0,0,6,0,6,1,0,1,0,0,0,7,0,7
Maharashtra,2002,Criminal Breach Of Trust,0,0,0,4,6,10,6,2,8,1,0,1,11,8,19
Maharashtra,2002,Cheating,0,0,0,5,2,7,8,1,9,0,0,0,13,3,16
Maharashtra,2002,Counter Feiting,0,0,0,4,0,4,6,1,7,0,0,0,10,1,11
Maharashtra,2002,Dowry Deaths,0,0,0,6,0,6,20,0,20,6,0,6,32,0,32
Maharashtra,2002,Molestation,0,0,0,4,0,4,2,0,2,0,0,0,6,0,6
Maharashtra,2002,Eve-Teasing,0,0,0,0,0,0,1,0,1,0,0,0,1,0,1
Maharashtra,2002,Cruelty By Husband Or Relative Of Husband,0,0,0,14,0,14,37,4,41,10,1,11,61,5,66
Maharashtra,2002,Other Ipc Crimes,0,0,0,198,23,221,123,8,131,33,2,35,354,33,387
Maharashtra,2003,Murder,0,0,0,1289,65,1354,2011,72,2083,777,14,791,4077,151,4228
Maharashtra,2003,Attempt To Commit Murder,0,0,0,82,4,86,109,3,112,57,1,58,248,8,256
Maharashtra,2003,C.H. Not Amounting To Murder,0,0,0,43,1,44,62,3,65,35,3,38,140,7,147
Maharashtra,2003,Rape,0,0,0,173,0,173,125,2,127,46,0,46,344,2,346
Maharashtra,2003,Kidnapping And Abduction,0,0,0,23,2,25,19,1,20,5,0,5,47,3,50
Maharashtra,2003,Dacoity,0,0,0,82,0,82,73,0,73,23,0,23,178,0,178
Maharashtra,2003,Prep. And Assembly For Dacoity,0,0,0,40,0,40,37,0,37,6,0,6,83,0,83
Maharashtra,2003,Robbery,0,0,0,63,0,63,71,0,71,34,0,34,168,0,168
Maharashtra,2003,Burglary,0,0,0,87,1,88,76,0,76,17,0,17,180,1,181
Maharashtra,2003,Thefts,0,0,0,206,12,218,155,6,161,33,1,34,394,19,413
Maharashtra,2003,Extortion,0,0,0,0,0,0,2,0,2,0,0,0,2,0,2
Maharashtra,2003,Riots,0,0,0,1,0,1,3,0,3,0,0,0,4,0,4
Maharashtra,2003,Arson,0,0,0,8,0,8,10,0,10,0,0,0,18,0,18
Maharashtra,2003,Criminal Breach Of Trust,0,0,0,1,0,1,3,0,3,4,0,4,8,0,8
Maharashtra,2003,Cheating,0,0,0,22,4,26,18,3,21,2,1,3,42,8,50
Maharashtra,2003,Counter Feiting,0,0,0,0,0,0,0,0,0,0,0,0,0,0,0
Maharashtra,2003,Dowry Deaths,0,0,0,12,5,17,10,3,13,1,0,1,23,8,31
Maharashtra,2003,Molestation,0,0,0,6,0,6,4,0,4,1,0,1,11,0,11
Maharashtra,2003,Eve-Teasing,0,0,0,4,0,4,4,0,4,0,0,0,8,0,8
Maharashtra,2003,Cruelty By Husband Or Relative Of Husband,0,0,0,36,3,39,48,1,49,5,0,5,89,4,93
Maharashtra,2003,Other Ipc Crimes,0,0,0,109,12,121,114,10,124,45,2,47,268,24,292
Maharashtra,2004,Murder,0,0,0,1143,28,1171,2395,42,2437,719,28,747,4257,98,4355
Maharashtra,2004,Attempt To Commit Murder,0,0,0,77,8,85,113,27,140,53,5,58,243,40,283
Maharashtra,2004,C.H. Not Amounting To Murder,0,0,0,51,1,52,89,13,102,49,1,50,189,15,204
Maharashtra,2004,Rape,0,0,0,101,0,101,80,2,82,26,0,26,207,2,209
Maharashtra,2004,Kidnapping And Abduction,0,0,0,18,0,18,19,2,21,0,0,0,37,2,39
Maharashtra,2004,Dacoity,0,0,0,60,1,61,79,0,79,15,0,15,154,1,155
Maharashtra,2004,Prep. And Assembly For Dacoity,0,0,0,17,0,17,28,0,28,2,0,2,47,0,47
Maharashtra,2004,Robbery,0,0,0,61,0,61,61,0,61,6,0,6,128,0,128
Maharashtra,2004,Burglary,0,0,0,69,1,70,61,0,61,21,0,21,151,1,152
Maharashtra,2004,Thefts,0,0,0,200,14,214,150,10,160,54,1,55,404,25,429
Maharashtra,2004,Extortion,0,0,0,7,0,7,8,0,8,0,0,0,15,0,15
Maharashtra,2004,Riots,0,0,0,4,0,4,7,0,7,0,0,0,11,0,11
Maharashtra,2004,Arson,0,0,0,5,0,5,8,0,8,2,0,2,15,0,15
Maharashtra,2004,Criminal Breach Of Trust,0,0,0,3,0,3,12,0,12,6,0,6,21,0,21
Maharashtra,2004,Cheating,0,0,0,21,2,23,30,2,32,3,0,3,54,4,58
Maharashtra,2004,Counter Feiting,0,0,0,0,0,0,1,0,1,1,0,1,2,0,2
Maharashtra,2004,Dowry Deaths,0,0,0,13,0,13,12,5,17,3,3,6,28,8,36
Maharashtra,2004,Molestation,0,0,0,10,0,10,21,0,21,7,0,7,38,0,38
Maharashtra,2004,Eve-Teasing,0,0,0,10,0,10,2,0,2,0,0,0,12,0,12
Maharashtra,2004,Cruelty By Husband Or Relative Of Husband,0,0,0,41,0,41,31,7,38,32,0,32,104,7,111
Maharashtra,2004,Other Ipc Crimes,0,0,0,162,5,167,175,6,181,40,0,40,377,11,388
Maharashtra,2005,Murder,0,0,0,1333,36,1369,2488,122,2610,813,78,891,4634,236,4870
Maharashtra,2005,Attempt To Commit Murder,0,0,0,149,3,152,137,7,144,109,2,111,395,12,407
Maharashtra,2005,C.H. Not Amounting To Murder,0,0,0,74,1,75,100,6,106,40,0,40,214,7,221
Maharashtra,2005,Rape,0,0,0,122,0,122,89,0,89,13,0,13,224,0,224
Maharashtra,2005,Kidnapping And Abduction,0,0,0,29,1,30,43,3,46,7,1,8,79,5,84
Maharashtra,2005,Dacoity,0,0,0,59,1,60,98,1,99,19,0,19,176,2,178
Maharashtra,2005,Prep. And Assembly For Dacoity,0,0,0,47,0,47,56,0,56,6,0,6,109,0,109
Maharashtra,2005,Robbery,0,0,0,70,0,70,68,2,70,8,0,8,146,2,148
Maharashtra,2005,Burglary,0,0,0,74,1,75,77,1,78,22,0,22,173,2,175
Maharashtra,2005,Thefts,0,0,0,184,5,189,133,17,150,38,8,46,355,30,385
Maharashtra,2005,Extortion,0,0,0,0,0,0,4,0,4,0,0,0,4,0,4
Maharashtra,2005,Riots,0,0,0,4,0,4,15,0,15,0,0,0,19,0,19
Maharashtra,2005,Arson,0,0,0,10,0,10,3,0,3,0,0,0,13,0,13
Maharashtra,2005,Criminal Breach Of Trust,0,0,0,8,0,8,7,0,7,1,0,1,16,0,16
Maharashtra,2005,Cheating,0,0,0,48,2,50,40,5,45,10,2,12,98,9,107
Maharashtra,2005,Counter Feiting,0,0,0,4,0,4,1,0,1,0,0,0,5,0,5
Maharashtra,2005,Dowry Deaths,0,0,0,28,0,28,85,0,85,21,2,23,134,2,136
Maharashtra,2005,Molestation,0,0,0,17,0,17,17,0,17,2,0,2,36,0,36
Maharashtra,2005,Eve-Teasing,0,0,0,6,0,6,1,0,1,0,0,0,7,0,7
Maharashtra,2005,Cruelty By Husband Or Relative Of Husband,0,0,0,64,4,68,73,7,80,32,5,37,169,16,185
Maharashtra,2005,Other Ipc Crimes,0,0,0,161,6,167,141,2,143,39,1,40,341,9,350
Maharashtra,2006,Murder,0,0,0,1441,25,1466,2676,181,2857,718,72,790,4835,278,5113
Maharashtra,2006,Attempt To Commit Murder,0,0,0,135,12,147,205,7,212,58,4,62,398,23,421
Maharashtra,2006,C.H. Not Amounting To Murder,0,0,0,65,1,66,136,4,140,26,3,29,227,8,235
Maharashtra,2006,Rape,0,0,0,109,0,109,91,0,91,16,0,16,216,0,216
Maharashtra,2006,Kidnapping And Abduction,0,0,0,36,0,36,20,0,20,2,0,2,58,0,58
Maharashtra,2006,Dacoity,0,0,0,95,0,95,95,0,95,8,0,8,198,0,198
Maharashtra,2006,Prep. And Assembly For Dacoity,0,0,0,32,0,32,25,0,25,7,0,7,64,0,64
Maharashtra,2006,Robbery,0,0,0,79,3,82,65,6,71,12,4,16,156,13,169
Maharashtra,2006,Burglary,0,0,0,62,6,68,60,5,65,25,5,30,147,16,163
Maharashtra,2006,Thefts,0,0,0,229,6,235,233,8,241,43,0,43,505,14,519
Maharashtra,2006,Extortion,0,0,0,22,0,22,14,0,14,10,0,10,46,0,46
Maharashtra,2006,Riots,0,0,0,21,0,21,20,0,20,1,0,1,42,0,42
Maharashtra,2006,Arson,0,0,0,15,0,15,11,0,11,4,0,4,30,0,30
Maharashtra,2006,Criminal Breach Of Trust,0,0,0,2,0,2,16,0,16,3,0,3,21,0,21
Maharashtra,2006,Cheating,0,0,0,29,1,30,29,4,33,4,1,5,62,6,68
Maharashtra,2006,Counter Feiting,0,0,0,9,0,9,13,1,14,0,0,0,22,1,23
Maharashtra,2006,Dowry Deaths,0,0,0,50,0,50,76,0,76,51,0,51,177,0,177
Maharashtra,2006,Molestation,0,0,0,11,0,11,7,0,7,0,0,0,18,0,18
Maharashtra,2006,Eve-Teasing,0,0,0,12,0,12,3,0,3,0,0,0,15,0,15
Maharashtra,2006,Cruelty By Husband Or Relative Of Husband,0,0,0,60,2,62,70,1,71,11,0,11,141,3,144
Maharashtra,2006,Other Ipc Crimes,0,0,0,171,6,177,181,2,183,20,0,20,372,8,380
Maharashtra,2007,Murder,0,0,0,1461,44,1505,2989,198,3187,739,39,778,5189,281,5470
Maharashtra,2007,Attempt To Commit Murder,0,0,0,172,6,178,143,3,146,61,1,62,376,10,386
Maharashtra,2007,C.H. Not Amounting To Murder,0,0,0,29,0,29,61,5,66,33,0,33,123,5,128
Maharashtra,2007,Rape,0,0,0,101,0,101,106,1,107,33,0,33,240,1,241
Maharashtra,2007,Kidnapping And Abduction,0,0,0,37,0,37,35,0,35,3,2,5,75,2,77
Maharashtra,2007,Dacoity,0,0,0,85,2,87,90,1,91,11,0,11,186,3,189
Maharashtra,2007,Prep. And Assembly For Dacoity,0,0,0,27,0,27,42,1,43,4,0,4,73,1,74
Maharashtra,2007,Robbery,0,0,0,99,7,106,92,4,96,24,2,26,215,13,228
Maharashtra,2007,Burglary,0,0,0,65,0,65,58,0,58,15,0,15,138,0,138
Maharashtra,2007,Thefts,0,0,0,140,12,152,113,10,123,35,2,37,288,24,312
Maharashtra,2007,Extortion,0,0,0,11,2,13,18,4,22,6,1,7,35,7,42
Maharashtra,2007,Riots,0,0,0,12,0,12,6,0,6,0,0,0,18,0,18
Maharashtra,2007,Arson,0,0,0,13,0,13,5,0,5,4,0,4,22,0,22
Maharashtra,2007,Criminal Breach Of Trust,0,0,0,2,0,2,3,0,3,1,0,1,6,0,6
Maharashtra,2007,Cheating,0,0,0,16,0,16,23,0,23,10,0,10,49,0,49
Maharashtra,2007,Counter Feiting,0,0,0,4,0,4,5,0,5,3,0,3,12,0,12
Maharashtra,2007,Dowry Deaths,0,0,0,32,0,32,51,1,52,30,2,32,113,3,116
Maharashtra,2007,Molestation,0,0,0,6,0,6,6,0,6,0,0,0,12,0,12
Maharashtra,2007,Eve-Teasing,0,0,0,7,0,7,6,0,6,0,0,0,13,0,13
Maharashtra,2007,Cruelty By Husband Or Relative Of Husband,0,0,0,47,3,50,35,3,38,13,1,14,95,7,102
Maharashtra,2007,Other Ipc Crimes,0,0,0,159,23,182,133,12,145,40,5,45,332,40,372
Maharashtra,2008,Murder,0,0,0,1316,51,1367,3014,198,3212,831,37,868,5161,286,5447
Maharashtra,2008,Attempt To Commit Murder,0,0,0,128,5,133,151,4,155,54,1,55,333,10,343
Maharashtra,2008,C.H. Not Amounting To Murder,0,0,0,27,3,30,57,6,63,20,3,23,104,12,116
Maharashtra,2008,Rape,0,0,0,123,1,124,109,1,110,17,0,17,249,2,251
Maharashtra,2008,Kidnapping And Abduction,0,0,0,32,0,32,31,1,32,8,1,9,71,2,73
Maharashtra,2008,Dacoity,0,0,0,70,2,72,82,5,87,29,2,31,181,9,190
Maharashtra,2008,Prep. And Assembly For Dacoity,0,0,0,20,0,20,31,0,31,7,0,7,58,0,58
Maharashtra,2008,Robbery,0,0,0,59,1,60,68,0,68,20,0,20,147,1,148
Maharashtra,2008,Burglary,0,0,0,83,3,86,129,3,132,23,5,28,235,11,246
Maharashtra,2008,Thefts,0,0,0,116,2,118,145,0,145,28,0,28,289,2,291
Maharashtra,2008,Extortion,0,0,0,7,0,7,3,0,3,1,0,1,11,0,11
Maharashtra,2008,Riots,0,0,0,8,0,8,7,0,7,10,0,10,25,0,25
Maharashtra,2008,Arson,0,0,0,11,0,11,20,0,20,6,0,6,37,0,37
Maharashtra,2008,Criminal Breach Of Trust,0,0,0,2,0,2,6,0,6,2,0,2,10,0,10
Maharashtra,2008,Cheating,0,0,0,9,0,9,21,1,22,7,1,8,37,2,39
Maharashtra,2008,Counter Feiting,0,0,0,13,0,13,7,0,7,5,0,5,25,0,25
Maharashtra,2008,Dowry Deaths,0,0,0,19,0,19,31,0,31,31,3,34,81,3,84
Maharashtra,2008,Molestation,0,0,0,8,0,8,10,0,10,0,0,0,18,0,18
Maharashtra,2008,Eve-Teasing,0,0,0,15,0,15,12,0,12,10,0,10,37,0,37
Maharashtra,2008,Cruelty By Husband Or Relative Of Husband,0,0,0,47,0,47,64,1,65,47,4,51,158,5,163
Maharashtra,2008,Other Ipc Crimes,0,0,0,96,14,110,173,8,181,76,1,77,345,23,368
Maharashtra,2009,Murder,0,0,0,1556,52,1608,2532,181,2713,771,38,809,4859,271,5130
Maharashtra,2009,Attempt To Commit Murder,0,0,0,104,2,106,203,8,211,65,1,66,372,11,383
Maharashtra,2009,C.H. Not Amounting To Murder,0,0,0,56,1,57,82,4,86,53,4,57,191,9,200
Maharashtra,2009,Rape,0,0,0,128,0,128,136,2,138,35,0,35,299,2,301
Maharashtra,2009,Kidnapping And Abduction,0,0,0,28,0,28,23,7,30,10,0,10,61,7,68
Maharashtra,2009,Dacoity,0,0,0,38,0,38,59,0,59,20,0,20,117,0,117
Maharashtra,2009,Prep. And Assembly For Dacoity,0,0,0,45,0,45,148,0,148,20,0,20,213,0,213
Maharashtra,2009,Robbery,0,0,0,53,0,53,109,2,111,13,0,13,175,2,177
Maharashtra,2009,Burglary,0,0,0,47,0,47,55,2,57,16,0,16,118,2,120
Maharashtra,2009,Thefts,0,0,0,128,1,129,135,8,143,42,0,42,305,9,314
Maharashtra,2009,Extortion,0,0,0,10,0,10,10,0,10,3,0,3,23,0,23
Maharashtra,2009,Riots,0,0,0,10,0,10,2,0,2,0,0,0,12,0,12
Maharashtra,2009,Arson,0,0,0,0,0,0,0,0,0,0,0,0,0,0,0
Maharashtra,2009,Criminal Breach Of Trust,0,0,0,0,0,0,2,0,2,0,0,0,2,0,2
Maharashtra,2009,Cheating,0,0,0,16,0,16,24,2,26,10,0,10,50,2,52
Maharashtra,2009,Counter Feiting,0,0,0,1,0,1,3,0,3,1,0,1,5,0,5
Maharashtra,2009,Dowry Deaths,0,0,0,8,2,10,29,1,30,15,0,15,52,3,55
Maharashtra,2009,Molestation,0,0,0,4,0,4,5,0,5,0,0,0,9,0,9
Maharashtra,2009,Eve-Teasing,0,0,0,1,0,1,1,0,1,0,0,0,2,0,2
Maharashtra,2009,Cruelty By Husband Or Relative Of Husband,0,0,0,50,0,50,57,5,62,27,1,28,134,6,140
Maharashtra,2009,Other Ipc Crimes,0,0,0,100,0,100,115,5,120,12,1,13,227,6,233
Maharashtra,2010,Murder,0,0,0,1602,59,1661,2945,189,3134,811,48,859,5358,296,5654
Maharashtra,2010,Attempt To Commit Murder,0,0,0,80,5,85,82,3,85,56,0,56,218,8,226
Maharashtra,2010,C.H. Not Amounting To Murder,0,0,0,69,2,71,82,5,87,26,0,26,177,7,184
Maharashtra,2010,Rape,0,0,0,58,2,60,71,2,73,14,1,15,143,5,148
Maharashtra,2010,Kidnapping And Abduction,0,0,0,36,1,37,20,3,23,5,0,5,61,4,65
Maharashtra,2010,Dacoity,0,0,0,32,0,32,56,0,56,12,0,12,100,0,100
Maharashtra,2010,Prep. And Assembly For Dacoity,0,0,0,58,0,58,70,0,70,21,0,21,149,0,149
Maharashtra,2010,Robbery,0,0,0,32,1,33,49,2,51,10,1,11,91,4,95
Maharashtra,2010,Burglary,0,0,0,53,0,53,43,0,43,14,0,14,110,0,110
Maharashtra,2010,Thefts,0,0,0,49,3,52,124,7,131,5,2,7,178,12,190
Maharashtra,2010,Extortion,0,0,0,13,0,13,4,0,4,0,0,0,17,0,17
Maharashtra,2010,Riots,0,0,0,4,0,4,7,0,7,1,0,1,12,0,12
Maharashtra,2010,Arson,0,0,0,3,0,3,6,0,6,0,0,0,9,0,9
Maharashtra,2010,Criminal Breach Of Trust,0,0,0,0,0,0,0,0,0,1,0,1,1,0,1
Maharashtra,2010,Cheating,0,0,0,3,0,3,33,2,35,3,0,3,39,2,41
Maharashtra,2010,Counter Feiting,0,0,0,2,6,8,2,7,9,0,16,16,4,29,33
Maharashtra,2010,Dowry Deaths,0,0,0,20,0,20,19,1,20,5,0,5,44,1,45
Maharashtra,2010,Molestation,0,0,0,1,0,1,6,0,6,1,0,1,8,0,8
Maharashtra,2010,Eve-Teasing,0,0,0,1,0,1,1,0,1,1,0,1,3,0,3
Maharashtra,2010,Cruelty By Husband Or Relative Of Husband,0,0,0,16,6,22,87,22,109,17,2,19,120,30,150
Maharashtra,2010,Other Ipc Crimes,0,0,0,105,5,110,119,5,124,31,4,35,255,14,269
Maharashtra,2011,Murder,0,0,0,1989,38,2027,2125,176,2301,724,56,780,4838,270,5108
Maharashtra,2011,Attempt To Commit Murder,0,0,0,228,20,248,128,5,133,47,0,47,403,25,428
Maharashtra,2011,C.H. Not Amounting To Murder,0,0,0,80,6,86,82,2,84,11,0,11,173,8,181
Maharashtra,2011,Rape,0,0,0,122,2,124,77,1,78,10,0,10,209,3,212
Maharashtra,2011,Kidnapping And Abduction,0,0,0,61,2,63,43,2,45,5,0,5,109,4,113
Maharashtra,2011,Dacoity,0,0,0,40,0,40,45,0,45,27,0,27,112,0,112
Maharashtra,2011,Prep. And Assembly For Dacoity,0,0,0,17,0,17,24,0,24,11,0,11,52,0,52
Maharashtra,2011,Robbery,0,0,0,53,1,54,61,3,64,2,0,2,116,4,120
Maharashtra,2011,Burglary,0,0,0,34,0,34,18,0,18,10,0,10,62,0,62
Maharashtra,2011,Thefts,0,0,0,75,4,79,71,5,76,28,0,28,174,9,183
Maharashtra,2011,Extortion,0,0,0,7,0,7,8,0,8,3,0,3,18,0,18
Maharashtra,2011,Riots,0,0,0,4,0,4,4,0,4,0,0,0,8,0,8
Maharashtra,2011,Arson,0,0,0,2,0,2,4,0,4,0,0,0,6,0,6
Maharashtra,2011,Criminal Breach Of Trust,0,0,0,1,0,1,1,0,1,0,0,0,2,0,2
Maharashtra,2011,Cheating,0,0,0,16,1,17,62,2,64,3,0,3,81,3,84
Maharashtra,2011,Counter Feiting,0,0,0,0,0,0,7,1,8,0,0,0,7,1,8
Maharashtra,2011,Dowry Deaths,0,0,0,12,4,16,20,6,26,2,0,2,34,10,44
Maharashtra,2011,Molestation,0,0,0,1,0,1,0,0,0,0,0,0,1,0,1
Maharashtra,2011,Eve-Teasing,0,0,0,1,0,1,3,0,3,0,0,0,4,0,4
Maharashtra,2011,Cruelty By Husband Or Relative Of Husband,0,0,0,12,3,15,38,3,41,9,2,11,59,8,67
Maharashtra,2011,Other Ipc Crimes,0,0,0,99,4,103,169,20,189,48,6,54,316,30,346
Maharashtra,2012,Murder,0,0,0,1822,66,1888,1932,111,2043,717,52,769,4471,229,4700
Maharashtra,2012,Attempt To Commit Murder,0,0,0,148,3,151,107,24,131,111,1,112,366,28,394
Maharashtra,2012,C.H. Not Amounting To Murder,0,0,0,74,1,75,110,7,117,12,0,12,196,8,204
Maharashtra,2012,Rape,0,0,0,86,4,90,76,3,79,25,0,25,187,7,194
Maharashtra,2012,Kidnapping And Abduction,0,0,0,47,3,50,56,4,60,2,0,2,105,7,112
Maharashtra,2012,Dacoity,0,0,0,69,3,72,36,4,40,12,0,12,117,7,124
Maharashtra,2012,Prep. And Assembly For Dacoity,0,0,0,52,0,52,43,1,44,17,0,17,112,1,113
Maharashtra,2012,Robbery,0,0,0,64,3,67,37,2,39,19,0,19,120,5,125
Maharashtra,2012,Burglary,0,0,0,49,0,49,52,0,52,11,0,11,112,0,112
Maharashtra,2012,Thefts,0,0,0,87,6,93,98,11,109,38,0,38,223,17,240
Maharashtra,2012,Extortion,0,0,0,9,0,9,10,1,11,4,0,4,23,1,24
Maharashtra,2012,Riots,0,0,0,1,0,1,0,0,0,0,0,0,1,0,1
Maharashtra,2012,Arson,0,0,0,8,0,8,13,0,13,4,0,4,25,0,25
Maharashtra,2012,Criminal Breach Of Trust,0,0,0,1,0,1,3,0,3,0,0,0,4,0,4
Maharashtra,2012,Cheating,0,0,0,19,2,21,32,3,35,6,0,6,57,5,62
Maharashtra,2012,Counter Feiting,0,0,0,0,0,0,11,5,16,2,0,2,13,5,18
Maharashtra,2012,Dowry Deaths,0,0,0,15,2,17,22,2,24,6,1,7,43,5,48
Maharashtra,2012,Molestation,0,0,0,7,0,7,12,19,31,1,3,4,20,22,42
Maharashtra,2012,Eve-Teasing,0,0,0,3,0,3,8,0,8,3,0,3,14,0,14
Maharashtra,2012,Cruelty By Husband Or Relative Of Husband,0,0,0,14,3,17,34,4,38,13,0,13,61,7,68
Maharashtra,2012,Other Ipc Crimes,0,0,0,163,12,175,212,21,233,75,3,78,450,36,486
Manipur,2001,Murder,0,0,0,2,0,2,9,0,9,6,0,6,17,0,17
Manipur,2001,Attempt To Commit Murder,0,0,0,0,0,0,0,0,0,0,0,0,0,0,0
Manipur,2001,C.H. Not Amounting To Murder,0,0,0,0,0,0,0,0,0,0,0,0,0,0,0
Manipur,2001,Rape,0,0,0,0,0,0,0,0,0,0,0,0,0,0,0
Manipur,2001,Kidnapping And Abduction,0,0,0,0,0,0,0,0,0,0,0,0,0,0,0
Manipur,2001,Dacoity,0,0,0,0,0,0,0,0,0,0,0,0,0,0,0
Manipur,2001,Prep. And Assembly For Dacoity,0,0,0,0,0,0,0,0,0,0,0,0,0,0,0
Manipur,2001,Robbery,0,0,0,0,0,0,0,0,0,0,0,0,0,0,0
Manipur,2001,Burglary,0,0,0,0,0,0,0,0,0,0,0,0,0,0,0
Manipur,2001,Thefts,0,0,0,0,0,0,0,0,0,0,0,0,0,0,0
Manipur,2001,Extortion,0,0,0,0,0,0,0,0,0,0,0,0,0,0,0
Manipur,2001,Riots,0,0,0,0,0,0,0,0,0,0,0,0,0,0,0
Manipur,2001,Arson,0,0,0,0,0,0,0,0,0,0,0,0,0,0,0
Manipur,2001,Criminal Breach Of Trust,0,0,0,0,0,0,0,0,0,0,0,0,0,0,0
Manipur,2001,Cheating,0,0,0,0,0,0,0,0,0,0,0,0,0,0,0
Manipur,2001,Counter Feiting,0,0,0,0,0,0,0,0,0,0,0,0,0,0,0
Manipur,2001,Dowry Deaths,0,0,0,0,0,0,0,0,0,0,0,0,0,0,0
Manipur,2001,Molestation,0,0,0,0,0,0,0,0,0,0,0,0,0,0,0
Manipur,2001,Eve-Teasing,0,0,0,0,0,0,0,0,0,0,0,0,0,0,0
Manipur,2001,Cruelty By Husband Or Relative Of Husband,0,0,0,0,0,0,0,0,0,0,0,0,0,0,0
Manipur,2001,Other Ipc Crimes,0,0,0,0,0,0,0,0,0,0,0,0,0,0,0
Manipur,2002,Murder,0,0,0,6,0,6,11,0,11,8,0,8,25,0,25
Manipur,2002,Attempt To Commit Murder,0,0,0,0,0,0,0,0,0,0,0,0,0,0,0
Manipur,2002,C.H. Not Amounting To Murder,0,0,0,0,0,0,1,0,1,0,0,0,1,0,1
Manipur,2002,Rape,0,0,0,0,0,0,2,0,2,0,0,0,2,0,2
Manipur,2002,Kidnapping And Abduction,0,0,0,0,0,0,0,0,0,0,0,0,0,0,0
Manipur,2002,Dacoity,0,0,0,0,0,0,0,0,0,0,0,0,0,0,0
Manipur,2002,Prep. And Assembly For Dacoity,0,0,0,0,0,0,0,0,0,0,0,0,0,0,0
Manipur,2002,Robbery,0,0,0,0,0,0,0,0,0,0,0,0,0,0,0
Manipur,2002,Burglary,0,0,0,0,0,0,0,0,0,0,0,0,0,0,0
Manipur,2002,Thefts,0,0,0,0,0,0,1,0,1,0,0,0,1,0,1
Manipur,2002,Extortion,0,0,0,0,0,0,0,0,0,0,0,0,0,0,0
Manipur,2002,Riots,0,0,0,0,0,0,0,0,0,0,0,0,0,0,0
Manipur,2002,Arson,0,0,0,0,0,0,0,0,0,0,0,0,0,0,0
Manipur,2002,Criminal Breach Of Trust,0,0,0,0,0,0,1,0,1,0,0,0,1,0,1
Manipur,2002,Cheating,0,0,0,0,0,0,0,0,0,0,0,0,0,0,0
Manipur,2002,Counter Feiting,0,0,0,0,0,0,0,0,0,0,0,0,0,0,0
Manipur,2002,Dowry Deaths,0,0,0,0,0,0,0,0,0,0,0,0,0,0,0
Manipur,2002,Molestation,0,0,0,0,0,0,0,0,0,0,0,0,0,0,0
Manipur,2002,Eve-Teasing,0,0,0,0,0,0,0,0,0,0,0,0,0,0,0
Manipur,2002,Cruelty By Husband Or Relative Of Husband,0,0,0,0,0,0,0,0,0,0,0,0,0,0,0
Manipur,2002,Other Ipc Crimes,0,0,0,0,0,0,0,0,0,0,0,0,0,0,0
Manipur,2003,Murder,0,0,0,4,0,4,13,0,13,10,0,10,27,0,27
Manipur,2003,Attempt To Commit Murder,0,0,0,0,0,0,0,0,0,0,0,0,0,0,0
Manipur,2003,C.H. Not Amounting To Murder,0,0,0,0,0,0,2,0,2,0,0,0,2,0,2
Manipur,2003,Rape,0,0,0,0,0,0,1,0,1,0,0,0,1,0,1
Manipur,2003,Kidnapping And Abduction,0,0,0,0,0,0,0,0,0,0,0,0,0,0,0
Manipur,2003,Dacoity,0,0,0,0,0,0,0,0,0,0,0,0,0,0,0
Manipur,2003,Prep. And Assembly For Dacoity,0,0,0,0,0,0,0,0,0,0,0,0,0,0,0
Manipur,2003,Robbery,0,0,0,0,0,0,0,0,0,0,0,0,0,0,0
Manipur,2003,Burglary,0,0,0,0,0,0,0,0,0,0,0,0,0,0,0
Manipur,2003,Thefts,0,0,0,0,0,0,1,0,1,0,0,0,1,0,1
Manipur,2003,Extortion,0,0,0,0,0,0,0,0,0,0,0,0,0,0,0
Manipur,2003,Riots,0,0,0,0,0,0,0,0,0,0,0,0,0,0,0
Manipur,2003,Arson,0,0,0,0,0,0,0,0,0,0,0,0,0,0,0
Manipur,2003,Criminal Breach Of Trust,0,0,0,0,0,0,0,0,0,0,0,0,0,0,0
Manipur,2003,Cheating,0,0,0,0,0,0,0,0,0,0,0,0,0,0,0
Manipur,2003,Counter Feiting,0,0,0,0,0,0,0,0,0,0,0,0,0,0,0
Manipur,2003,Dowry Deaths,0,0,0,0,0,0,0,0,0,0,0,0,0,0,0
Manipur,2003,Molestation,0,0,0,0,0,0,0,0,0,0,0,0,0,0,0
Manipur,2003,Eve-Teasing,0,0,0,0,0,0,0,0,0,0,0,0,0,0,0
Manipur,2003,Cruelty By Husband Or Relative Of Husband,0,0,0,0,0,0,0,0,0,0,0,0,0,0,0
Manipur,2003,Other Ipc Crimes,0,0,0,0,0,0,0,0,0,0,0,0,0,0,0
Manipur,2004,Murder,0,0,0,0,0,0,15,0,15,7,0,7,22,0,22
Manipur,2004,Attempt To Commit Murder,0,0,0,0,0,0,0,0,0,0,0,0,0,0,0
Manipur,2004,C.H. Not Amounting To Murder,0,0,0,0,0,0,4,0,4,2,0,2,6,0,6
Manipur,2004,Rape,0,0,0,0,0,0,1,0,1,0,0,0,1,0,1
Manipur,2004,Kidnapping And Abduction,0,0,0,0,0,0,2,0,2,0,0,0,2,0,2
Manipur,2004,Dacoity,0,0,0,0,0,0,0,0,0,0,0,0,0,0,0
Manipur,2004,Prep. And Assembly For Dacoity,0,0,0,0,0,0,0,0,0,0,0,0,0,0,0
Manipur,2004,Robbery,0,0,0,0,0,0,0,0,0,0,0,0,0,0,0
Manipur,2004,Burglary,0,0,0,0,0,0,0,0,0,0,0,0,0,0,0
Manipur,2004,Thefts,0,0,0,0,0,0,0,0,0,0,0,0,0,0,0
Manipur,2004,Extortion,0,0,0,0,0,0,0,0,0,0,0,0,0,0,0
Manipur,2004,Riots,0,0,0,0,0,0,0,0,0,0,0,0,0,0,0
Manipur,2004,Arson,0,0,0,0,0,0,0,0,0,0,0,0,0,0,0
Manipur,2004,Criminal Breach Of Trust,0,0,0,0,0,0,0,0,0,0,0,0,0,0,0
Manipur,2004,Cheating,0,0,0,0,0,0,0,0,0,0,0,0,0,0,0
Manipur,2004,Counter Feiting,0,0,0,0,0,0,0,0,0,0,0,0,0,0,0
Manipur,2004,Dowry Deaths,0,0,0,0,0,0,0,0,0,0,0,0,0,0,0
Manipur,2004,Molestation,0,0,0,0,0,0,0,0,0,0,0,0,0,0,0
Manipur,2004,Eve-Teasing,0,0,0,0,0,0,0,0,0,0,0,0,0,0,0
Manipur,2004,Cruelty By Husband Or Relative Of Husband,0,0,0,0,0,0,0,0,0,0,0,0,0,0,0
Manipur,2004,Other Ipc Crimes,0,0,0,0,0,0,0,0,0,0,0,0,0,0,0
Manipur,2005,Murder,0,0,0,0,0,0,10,0,10,11,0,11,21,0,21
Manipur,2005,Attempt To Commit Murder,0,0,0,0,0,0,0,0,0,0,0,0,0,0,0
Manipur,2005,C.H. Not Amounting To Murder,0,0,0,0,0,0,1,0,1,2,0,2,3,0,3
Manipur,2005,Rape,0,0,0,0,0,0,1,0,1,0,0,0,1,0,1
Manipur,2005,Kidnapping And Abduction,0,0,0,0,0,0,1,0,1,0,0,0,1,0,1
Manipur,2005,Dacoity,0,0,0,0,0,0,0,0,0,0,0,0,0,0,0
Manipur,2005,Prep. And Assembly For Dacoity,0,0,0,0,0,0,0,0,0,0,0,0,0,0,0
Manipur,2005,Robbery,0,0,0,0,0,0,0,0,0,0,0,0,0,0,0
Manipur,2005,Burglary,0,0,0,0,0,0,0,0,0,0,0,0,0,0,0
Manipur,2005,Thefts,0,0,0,0,0,0,0,0,0,0,0,0,0,0,0
Manipur,2005,Extortion,0,0,0,0,0,0,0,0,0,0,0,0,0,0,0
Manipur,2005,Riots,0,0,0,0,0,0,0,0,0,0,0,0,0,0,0
Manipur,2005,Arson,0,0,0,0,0,0,0,0,0,0,0,0,0,0,0
Manipur,2005,Criminal Breach Of Trust,0,0,0,0,0,0,0,0,0,0,0,0,0,0,0
Manipur,2005,Cheating,0,0,0,0,0,0,0,0,0,0,0,0,0,0,0
Manipur,2005,Counter Feiting,0,0,0,0,0,0,0,0,0,0,0,0,0,0,0
Manipur,2005,Dowry Deaths,0,0,0,0,0,0,0,0,0,0,0,0,0,0,0
Manipur,2005,Molestation,0,0,0,0,0,0,0,0,0,0,0,0,0,0,0
Manipur,2005,Eve-Teasing,0,0,0,0,0,0,0,0,0,0,0,0,0,0,0
Manipur,2005,Cruelty By Husband Or Relative Of Husband,0,0,0,0,0,0,0,0,0,0,0,0,0,0,0
Manipur,2005,Other Ipc Crimes,0,0,0,0,0,0,0,0,0,0,0,0,0,0,0
Manipur,2006,Murder,0,0,0,0,0,0,11,0,11,12,0,12,23,0,23
Manipur,2006,Attempt To Commit Murder,0,0,0,0,0,0,0,0,0,0,0,0,0,0,0
Manipur,2006,C.H. Not Amounting To Murder,0,0,0,0,0,0,3,0,3,2,0,2,5,0,5
Manipur,2006,Rape,0,0,0,0,0,0,1,0,1,0,0,0,1,0,1
Manipur,2006,Kidnapping And Abduction,0,0,0,0,0,0,0,0,0,0,0,0,0,0,0
Manipur,2006,Dacoity,0,0,0,0,0,0,0,0,0,0,0,0,0,0,0
Manipur,2006,Prep. And Assembly For Dacoity,0,0,0,0,0,0,0,0,0,0,0,0,0,0,0
Manipur,2006,Robbery,0,0,0,0,0,0,0,0,0,0,0,0,0,0,0
Manipur,2006,Burglary,0,0,0,0,0,0,0,0,0,0,0,0,0,0,0
Manipur,2006,Thefts,0,0,0,0,0,0,0,0,0,0,0,0,0,0,0
Manipur,2006,Extortion,0,0,0,0,0,0,0,0,0,0,0,0,0,0,0
Manipur,2006,Riots,0,0,0,0,0,0,0,0,0,0,0,0,0,0,0
Manipur,2006,Arson,0,0,0,0,0,0,0,0,0,0,0,0,0,0,0
Manipur,2006,Criminal Breach Of Trust,0,0,0,0,0,0,0,0,0,0,0,0,0,0,0
Manipur,2006,Cheating,0,0,0,0,0,0,0,0,0,0,0,0,0,0,0
Manipur,2006,Counter Feiting,0,0,0,0,0,0,0,0,0,0,0,0,0,0,0
Manipur,2006,Dowry Deaths,0,0,0,0,0,0,0,0,0,0,0,0,0,0,0
Manipur,2006,Molestation,0,0,0,0,0,0,0,0,0,0,0,0,0,0,0
Manipur,2006,Eve-Teasing,0,0,0,0,0,0,0,0,0,0,0,0,0,0,0
Manipur,2006,Cruelty By Husband Or Relative Of Husband,0,0,0,0,0,0,0,0,0,0,0,0,0,0,0
Manipur,2006,Other Ipc Crimes,0,0,0,0,0,0,0,0,0,0,0,0,0,0,0
Manipur,2007,Murder,0,0,0,0,0,0,10,0,10,13,0,13,23,0,23
Manipur,2007,Attempt To Commit Murder,0,0,0,0,0,0,0,0,0,0,0,0,0,0,0
Manipur,2007,C.H. Not Amounting To Murder,0,0,0,0,0,0,2,0,2,3,0,3,5,0,5
Manipur,2007,Rape,0,0,0,0,0,0,1,0,1,0,0,0,1,0,1
Manipur,2007,Kidnapping And Abduction,0,0,0,0,0,0,0,0,0,0,0,0,0,0,0
Manipur,2007,Dacoity,0,0,0,0,0,0,0,0,0,0,0,0,0,0,0
Manipur,2007,Prep. And Assembly For Dacoity,0,0,0,0,0,0,0,0,0,0,0,0,0,0,0
Manipur,2007,Robbery,0,0,0,0,0,0,0,0,0,0,0,0,0,0,0
Manipur,2007,Burglary,0,0,0,0,0,0,0,0,0,0,0,0,0,0,0
Manipur,2007,Thefts,0,0,0,0,0,0,0,0,0,0,0,0,0,0,0
Manipur,2007,Extortion,0,0,0,0,0,0,0,0,0,0,0,0,0,0,0
Manipur,2007,Riots,0,0,0,0,0,0,0,0,0,0,0,0,0,0,0
Manipur,2007,Arson,0,0,0,0,0,0,0,0,0,0,0,0,0,0,0
Manipur,2007,Criminal Breach Of Trust,0,0,0,0,0,0,0,0,0,0,0,0,0,0,0
Manipur,2007,Cheating,0,0,0,0,0,0,0,0,0,0,0,0,0,0,0
Manipur,2007,Counter Feiting,0,0,0,0,0,0,0,0,0,0,0,0,0,0,0
Manipur,2007,Dowry Deaths,0,0,0,0,0,0,0,0,0,0,0,0,0,0,0
Manipur,2007,Molestation,0,0,0,0,0,0,0,0,0,0,0,0,0,0,0
Manipur,2007,Eve-Teasing,0,0,0,0,0,0,0,0,0,0,0,0,0,0,0
Manipur,2007,Cruelty By Husband Or Relative Of Husband,0,0,0,1,0,1,0,0,0,0,0,0,1,0,1
Manipur,2007,Other Ipc Crimes,0,0,0,0,0,0,0,0,0,0,0,0,0,0,0
Manipur,2008,Murder,0,0,0,0,0,0,12,0,12,12,0,12,24,0,24
Manipur,2008,Attempt To Commit Murder,0,0,0,0,0,0,0,0,0,0,0,0,0,0,0
Manipur,2008,C.H. Not Amounting To Murder,0,0,0,0,0,0,1,0,1,2,0,2,3,0,3
Manipur,2008,Rape,0,0,0,0,0,0,2,0,2,0,0,0,2,0,2
Manipur,2008,Kidnapping And Abduction,0,0,0,0,0,0,1,0,1,0,0,0,1,0,1
Manipur,2008,Dacoity,0,0,0,0,0,0,0,0,0,0,0,0,0,0,0
Manipur,2008,Prep. And Assembly For Dacoity,0,0,0,0,0,0,0,0,0,0,0,0,0,0,0
Manipur,2008,Robbery,0,0,0,0,0,0,0,0,0,0,0,0,0,0,0
Manipur,2008,Burglary,0,0,0,0,0,0,0,0,0,0,0,0,0,0,0
Manipur,2008,Thefts,0,0,0,0,0,0,0,0,0,0,0,0,0,0,0
Manipur,2008,Extortion,0,0,0,0,0,0,0,0,0,0,0,0,0,0,0
Manipur,2008,Riots,0,0,0,0,0,0,0,0,0,0,0,0,0,0,0
Manipur,2008,Arson,0,0,0,0,0,0,0,0,0,0,0,0,0,0,0
Manipur,2008,Criminal Breach Of Trust,0,0,0,0,0,0,0,0,0,0,0,0,0,0,0
Manipur,2008,Cheating,0,0,0,0,0,0,0,0,0,0,0,0,0,0,0
Manipur,2008,Counter Feiting,0,0,0,0,0,0,0,0,0,0,0,0,0,0,0
Manipur,2008,Dowry Deaths,0,0,0,0,0,0,0,0,0,0,0,0,0,0,0
Manipur,2008,Molestation,0,0,0,0,0,0,0,0,0,0,0,0,0,0,0
Manipur,2008,Eve-Teasing,0,0,0,0,0,0,0,0,0,0,0,0,0,0,0
Manipur,2008,Cruelty By Husband Or Relative Of Husband,0,0,0,0,0,0,0,0,0,0,0,0,0,0,0
Manipur,2008,Other Ipc Crimes,0,0,0,0,0,0,1,0,1,0,0,0,1,0,1
Manipur,2009,Murder,0,0,0,0,0,0,12,0,12,11,0,11,23,0,23
Manipur,2009,Attempt To Commit Murder,0,0,0,0,0,0,0,0,0,0,0,0,0,0,0
Manipur,2009,C.H. Not Amounting To Murder,0,0,0,0,0,0,3,0,3,2,0,2,5,0,5
Manipur,2009,Rape,0,0,0,0,0,0,0,0,0,0,0,0,0,0,0
Manipur,2009,Kidnapping And Abduction,0,0,0,0,0,0,0,0,0,0,0,0,0,0,0
Manipur,2009,Dacoity,0,0,0,0,0,0,0,0,0,0,0,0,0,0,0
Manipur,2009,Prep. And Assembly For Dacoity,0,0,0,0,0,0,0,0,0,0,0,0,0,0,0
Manipur,2009,Robbery,0,0,0,0,0,0,0,0,0,0,0,0,0,0,0
Manipur,2009,Burglary,0,0,0,0,0,0,0,0,0,0,0,0,0,0,0
Manipur,2009,Thefts,0,0,0,0,0,0,0,0,0,0,0,0,0,0,0
Manipur,2009,Extortion,0,0,0,0,0,0,0,0,0,0,0,0,0,0,0
Manipur,2009,Riots,0,0,0,0,0,0,0,0,0,0,0,0,0,0,0
Manipur,2009,Arson,0,0,0,0,0,0,0,0,0,0,0,0,0,0,0
Manipur,2009,Criminal Breach Of Trust,0,0,0,0,0,0,0,0,0,0,0,0,0,0,0
Manipur,2009,Cheating,0,0,0,0,0,0,0,0,0,0,0,0,0,0,0
Manipur,2009,Counter Feiting,0,0,0,0,0,0,0,0,0,0,0,0,0,0,0
Manipur,2009,Dowry Deaths,0,0,0,0,0,0,0,0,0,0,0,0,0,0,0
Manipur,2009,Molestation,0,0,0,0,0,0,0,0,0,0,0,0,0,0,0
Manipur,2009,Eve-Teasing,0,0,0,0,0,0,0,0,0,0,0,0,0,0,0
Manipur,2009,Cruelty By Husband Or Relative Of Husband,0,0,0,0,0,0,0,0,0,0,0,0,0,0,0
Manipur,2009,Other Ipc Crimes,0,0,0,0,0,0,0,0,0,0,0,0,0,0,0
Manipur,2010,Murder,0,0,0,0,0,0,8,1,9,15,0,15,23,1,24
Manipur,2010,Attempt To Commit Murder,0,0,0,0,0,0,0,0,0,0,0,0,0,0,0
Manipur,2010,C.H. Not Amounting To Murder,0,0,0,0,0,0,2,0,2,2,0,2,4,0,4
Manipur,2010,Rape,0,0,0,0,0,0,0,0,0,0,0,0,0,0,0
Manipur,2010,Kidnapping And Abduction,0,0,0,0,0,0,0,0,0,0,0,0,0,0,0
Manipur,2010,Dacoity,0,0,0,0,0,0,0,0,0,0,0,0,0,0,0
Manipur,2010,Prep. And Assembly For Dacoity,0,0,0,0,0,0,0,0,0,0,0,0,0,0,0
Manipur,2010,Robbery,0,0,0,0,0,0,0,0,0,0,0,0,0,0,0
Manipur,2010,Burglary,0,0,0,0,0,0,0,0,0,0,0,0,0,0,0
Manipur,2010,Thefts,0,0,0,0,0,0,0,0,0,0,0,0,0,0,0
Manipur,2010,Extortion,0,0,0,0,0,0,0,0,0,0,0,0,0,0,0
Manipur,2010,Riots,0,0,0,0,0,0,0,0,0,0,0,0,0,0,0
Manipur,2010,Arson,0,0,0,0,0,0,0,0,0,0,0,0,0,0,0
Manipur,2010,Criminal Breach Of Trust,0,0,0,0,0,0,0,0,0,0,0,0,0,0,0
Manipur,2010,Cheating,0,0,0,0,0,0,0,0,0,0,0,0,0,0,0
Manipur,2010,Counter Feiting,0,0,0,0,0,0,0,0,0,0,0,0,0,0,0
Manipur,2010,Dowry Deaths,0,0,0,0,0,0,0,0,0,0,0,0,0,0,0
Manipur,2010,Molestation,0,0,0,0,0,0,0,0,0,0,0,0,0,0,0
Manipur,2010,Eve-Teasing,0,0,0,0,0,0,0,0,0,0,0,0,0,0,0
Manipur,2010,Cruelty By Husband Or Relative Of Husband,0,0,0,0,0,0,0,0,0,0,0,0,0,0,0
Manipur,2010,Other Ipc Crimes,0,0,0,0,0,0,1,0,1,0,0,0,1,0,1
Manipur,2011,Murder,0,0,0,0,0,0,7,1,8,12,0,12,19,1,20
Manipur,2011,Attempt To Commit Murder,0,0,0,0,0,0,0,0,0,0,0,0,0,0,0
Manipur,2011,C.H. Not Amounting To Murder,0,0,0,0,0,0,1,0,1,0,0,0,1,0,1
Manipur,2011,Rape,0,0,0,0,0,0,0,0,0,0,0,0,0,0,0
Manipur,2011,Kidnapping And Abduction,0,0,0,0,0,0,0,0,0,0,0,0,0,0,0
Manipur,2011,Dacoity,0,0,0,0,0,0,0,0,0,0,0,0,0,0,0
Manipur,2011,Prep. And Assembly For Dacoity,0,0,0,0,0,0,0,0,0,0,0,0,0,0,0
Manipur,2011,Robbery,0,0,0,0,0,0,0,0,0,0,0,0,0,0,0
Manipur,2011,Burglary,0,0,0,0,0,0,0,0,0,0,0,0,0,0,0
Manipur,2011,Thefts,0,0,0,0,0,0,1,0,1,0,0,0,1,0,1
Manipur,2011,Extortion,0,0,0,0,0,0,0,0,0,0,0,0,0,0,0
Manipur,2011,Riots,0,0,0,0,0,0,0,0,0,0,0,0,0,0,0
Manipur,2011,Arson,0,0,0,0,0,0,0,0,0,0,0,0,0,0,0
Manipur,2011,Criminal Breach Of Trust,0,0,0,0,0,0,0,0,0,0,0,0,0,0,0
Manipur,2011,Cheating,0,0,0,0,0,0,0,0,0,0,0,0,0,0,0
Manipur,2011,Counter Feiting,0,0,0,0,0,0,0,0,0,0,0,0,0,0,0
Manipur,2011,Dowry Deaths,0,0,0,0,0,0,0,0,0,0,0,0,0,0,0
Manipur,2011,Molestation,0,0,0,0,0,0,0,0,0,0,0,0,0,0,0
Manipur,2011,Eve-Teasing,0,0,0,0,0,0,0,0,0,0,0,0,0,0,0
Manipur,2011,Cruelty By Husband Or Relative Of Husband,0,0,0,0,0,0,0,0,0,0,0,0,0,0,0
Manipur,2011,Other Ipc Crimes,0,0,0,0,0,0,1,0,1,0,0,0,1,0,1
Manipur,2012,Murder,0,0,0,0,0,0,8,1,9,11,0,11,19,1,20
Manipur,2012,Attempt To Commit Murder,0,0,0,0,0,0,0,0,0,0,0,0,0,0,0
Manipur,2012,C.H. Not Amounting To Murder,0,0,0,0,0,0,1,0,1,0,0,0,1,0,1
Manipur,2012,Rape,0,0,0,0,0,0,0,0,0,0,0,0,0,0,0
Manipur,2012,Kidnapping And Abduction,0,0,0,0,0,0,0,0,0,0,0,0,0,0,0
Manipur,2012,Dacoity,0,0,0,0,0,0,0,0,0,0,0,0,0,0,0
Manipur,2012,Prep. And Assembly For Dacoity,0,0,0,0,0,0,0,0,0,0,0,0,0,0,0
Manipur,2012,Robbery,0,0,0,0,0,0,0,0,0,0,0,0,0,0,0
Manipur,2012,Burglary,0,0,0,0,0,0,0,0,0,0,0,0,0,0,0
Manipur,2012,Thefts,0,0,0,0,0,0,1,0,1,0,0,0,1,0,1
Manipur,2012,Extortion,0,0,0,0,0,0,0,0,0,0,0,0,0,0,0
Manipur,2012,Riots,0,0,0,0,0,0,0,0,0,0,0,0,0,0,0
Manipur,2012,Arson,0,0,0,0,0,0,0,0,0,0,0,0,0,0,0
Manipur,2012,Criminal Breach Of Trust,0,0,0,0,0,0,0,0,0,0,0,0,0,0,0
Manipur,2012,Cheating,0,0,0,0,0,0,0,0,0,0,0,0,0,0,0
Manipur,2012,Counter Feiting,0,0,0,0,0,0,0,0,0,0,0,0,0,0,0
Manipur,2012,Dowry Deaths,0,0,0,0,0,0,0,0,0,0,0,0,0,0,0
Manipur,2012,Molestation,0,0,0,0,0,0,0,0,0,0,0,0,0,0,0
Manipur,2012,Eve-Teasing,0,0,0,0,0,0,0,0,0,0,0,0,0,0,0
Manipur,2012,Cruelty By Husband Or Relative Of Husband,0,0,0,0,0,0,0,0,0,0,0,0,0,0,0
Manipur,2012,Other Ipc Crimes,0,0,0,0,0,0,1,0,1,0,0,0,1,0,1
Meghalaya,2001,Murder,0,0,0,0,0,0,6,0,6,1,0,1,7,0,7
Meghalaya,2001,Attempt To Commit Murder,0,0,0,0,0,0,0,0,0,0,0,0,0,0,0
Meghalaya,2001,C.H. Not Amounting To Murder,0,0,0,0,0,0,0,0,0,0,0,0,0,0,0
Meghalaya,2001,Rape,0,0,0,0,0,0,1,0,1,0,0,0,1,0,1
Meghalaya,2001,Kidnapping And Abduction,0,0,0,0,0,0,0,0,0,0,0,0,0,0,0
Meghalaya,2001,Dacoity,0,0,0,1,0,1,0,0,0,0,0,0,1,0,1
Meghalaya,2001,Prep. And Assembly For Dacoity,0,0,0,0,0,0,0,0,0,0,0,0,0,0,0
Meghalaya,2001,Robbery,0,0,0,2,0,2,0,0,0,0,0,0,2,0,2
Meghalaya,2001,Burglary,0,0,0,0,0,0,1,0,1,0,0,0,1,0,1
Meghalaya,2001,Thefts,0,0,0,0,0,0,0,0,0,0,0,0,0,0,0
Meghalaya,2001,Extortion,0,0,0,0,0,0,0,0,0,0,0,0,0,0,0
Meghalaya,2001,Riots,0,0,0,0,0,0,0,0,0,0,0,0,0,0,0
Meghalaya,2001,Arson,0,0,0,0,0,0,0,0,0,0,0,0,0,0,0
Meghalaya,2001,Criminal Breach Of Trust,0,0,0,0,0,0,0,0,0,0,0,0,0,0,0
Meghalaya,2001,Cheating,0,0,0,0,0,0,0,0,0,0,0,0,0,0,0
Meghalaya,2001,Counter Feiting,0,0,0,0,0,0,0,0,0,0,0,0,0,0,0
Meghalaya,2001,Dowry Deaths,0,0,0,0,0,0,0,0,0,0,0,0,0,0,0
Meghalaya,2001,Molestation,0,0,0,0,0,0,1,0,1,0,0,0,1,0,1
Meghalaya,2001,Eve-Teasing,0,0,0,0,0,0,0,0,0,0,0,0,0,0,0
Meghalaya,2001,Cruelty By Husband Or Relative Of Husband,0,0,0,0,0,0,0,0,0,0,0,0,0,0,0
Meghalaya,2001,Other Ipc Crimes,0,0,0,0,0,0,0,0,0,0,0,0,0,0,0
Meghalaya,2002,Murder,0,0,0,5,0,5,6,0,6,0,0,0,11,0,11
Meghalaya,2002,Attempt To Commit Murder,0,0,0,0,0,0,0,0,0,0,0,0,0,0,0
Meghalaya,2002,C.H. Not Amounting To Murder,0,0,0,0,0,0,0,0,0,0,0,0,0,0,0
Meghalaya,2002,Rape,0,0,0,1,0,1,1,0,1,0,0,0,2,0,2
Meghalaya,2002,Kidnapping And Abduction,0,0,0,0,0,0,0,0,0,0,0,0,0,0,0
Meghalaya,2002,Dacoity,0,0,0,0,0,0,0,0,0,0,0,0,0,0,0
Meghalaya,2002,Prep. And Assembly For Dacoity,0,0,0,0,0,0,0,0,0,0,0,0,0,0,0
Meghalaya,2002,Robbery,0,0,0,0,0,0,0,0,0,0,0,0,0,0,0
Meghalaya,2002,Burglary,0,0,0,0,0,0,0,0,0,0,0,0,0,0,0
Meghalaya,2002,Thefts,0,0,0,0,0,0,2,0,2,0,0,0,2,0,2
Meghalaya,2002,Extortion,0,0,0,0,0,0,0,0,0,0,0,0,0,0,0
Meghalaya,2002,Riots,0,0,0,0,0,0,0,0,0,0,0,0,0,0,0
Meghalaya,2002,Arson,0,0,0,0,0,0,0,0,0,0,0,0,0,0,0
Meghalaya,2002,Criminal Breach Of Trust,0,0,0,0,0,0,0,0,0,0,0,0,0,0,0
Meghalaya,2002,Cheating,0,0,0,1,0,1,0,0,0,0,0,0,1,0,1
Meghalaya,2002,Counter Feiting,0,0,0,0,0,0,0,0,0,0,0,0,0,0,0
Meghalaya,2002,Dowry Deaths,0,0,0,0,0,0,0,0,0,0,0,0,0,0,0
Meghalaya,2002,Molestation,0,0,0,0,0,0,0,0,0,0,0,0,0,0,0
Meghalaya,2002,Eve-Teasing,0,0,0,0,0,0,0,0,0,0,0,0,0,0,0
Meghalaya,2002,Cruelty By Husband Or Relative Of Husband,0,0,0,0,0,0,0,0,0,0,0,0,0,0,0
Meghalaya,2002,Other Ipc Crimes,0,0,0,0,0,0,0,0,0,0,0,0,0,0,0
Meghalaya,2003,Murder,0,0,0,8,0,8,6,0,6,0,0,0,14,0,14
Meghalaya,2003,Attempt To Commit Murder,0,0,0,0,0,0,0,0,0,0,0,0,0,0,0
Meghalaya,2003,C.H. Not Amounting To Murder,0,0,0,0,0,0,0,0,0,0,0,0,0,0,0
Meghalaya,2003,Rape,0,0,0,0,0,0,1,0,1,0,0,0,1,0,1
Meghalaya,2003,Kidnapping And Abduction,0,0,0,0,0,0,0,0,0,0,0,0,0,0,0
Meghalaya,2003,Dacoity,0,0,0,1,0,1,3,0,3,0,0,0,4,0,4
Meghalaya,2003,Prep. And Assembly For Dacoity,0,0,0,0,0,0,0,0,0,0,0,0,0,0,0
Meghalaya,2003,Robbery,0,0,0,0,0,0,0,0,0,0,0,0,0,0,0
Meghalaya,2003,Burglary,0,0,0,0,0,0,0,0,0,0,0,0,0,0,0
Meghalaya,2003,Thefts,0,0,0,4,0,4,2,0,2,0,0,0,6,0,6
Meghalaya,2003,Extortion,0,0,0,0,0,0,1,0,1,0,0,0,1,0,1
Meghalaya,2003,Riots,0,0,0,0,0,0,0,0,0,0,0,0,0,0,0
Meghalaya,2003,Arson,0,0,0,0,0,0,0,0,0,0,0,0,0,0,0
Meghalaya,2003,Criminal Breach Of Trust,0,0,0,0,0,0,0,0,0,0,0,0,0,0,0
Meghalaya,2003,Cheating,0,0,0,0,0,0,0,0,0,0,0,0,0,0,0
Meghalaya,2003,Counter Feiting,0,0,0,0,0,0,0,0,0,0,0,0,0,0,0
Meghalaya,2003,Dowry Deaths,0,0,0,0,0,0,0,0,0,0,0,0,0,0,0
Meghalaya,2003,Molestation,0,0,0,0,0,0,0,0,0,0,0,0,0,0,0
Meghalaya,2003,Eve-Teasing,0,0,0,0,0,0,0,0,0,0,0,0,0,0,0
Meghalaya,2003,Cruelty By Husband Or Relative Of Husband,0,0,0,0,0,0,0,0,0,0,0,0,0,0,0
Meghalaya,2003,Other Ipc Crimes,0,0,0,0,0,0,1,0,1,0,0,0,1,0,1
Meghalaya,2004,Murder,0,0,0,0,0,0,13,0,13,0,0,0,13,0,13
Meghalaya,2004,Attempt To Commit Murder,0,0,0,0,0,0,0,0,0,0,0,0,0,0,0
Meghalaya,2004,C.H. Not Amounting To Murder,0,0,0,0,0,0,0,0,0,0,0,0,0,0,0
Meghalaya,2004,Rape,0,0,0,0,0,0,5,0,5,0,0,0,5,0,5
Meghalaya,2004,Kidnapping And Abduction,0,0,0,0,0,0,0,0,0,0,0,0,0,0,0
Meghalaya,2004,Dacoity,0,0,0,0,0,0,0,0,0,0,0,0,0,0,0
Meghalaya,2004,Prep. And Assembly For Dacoity,0,0,0,0,0,0,0,0,0,0,0,0,0,0,0
Meghalaya,2004,Robbery,0,0,0,2,0,2,0,0,0,0,0,0,2,0,2
Meghalaya,2004,Burglary,0,0,0,0,0,0,0,0,0,0,0,0,0,0,0
Meghalaya,2004,Thefts,0,0,0,4,0,4,0,0,0,0,0,0,4,0,4
Meghalaya,2004,Extortion,0,0,0,0,0,0,0,0,0,0,0,0,0,0,0
Meghalaya,2004,Riots,0,0,0,0,0,0,0,0,0,0,0,0,0,0,0
Meghalaya,2004,Arson,0,0,0,0,0,0,0,0,0,0,0,0,0,0,0
Meghalaya,2004,Criminal Breach Of Trust,0,0,0,0,0,0,0,0,0,0,0,0,0,0,0
Meghalaya,2004,Cheating,0,0,0,0,0,0,0,0,0,0,0,0,0,0,0
Meghalaya,2004,Counter Feiting,0,0,0,0,0,0,0,0,0,0,0,0,0,0,0
Meghalaya,2004,Dowry Deaths,0,0,0,0,0,0,0,0,0,0,0,0,0,0,0
Meghalaya,2004,Molestation,0,0,0,0,0,0,0,0,0,0,0,0,0,0,0
Meghalaya,2004,Eve-Teasing,0,0,0,0,0,0,0,0,0,0,0,0,0,0,0
Meghalaya,2004,Cruelty By Husband Or Relative Of Husband,0,0,0,0,0,0,0,0,0,0,0,0,0,0,0
Meghalaya,2004,Other Ipc Crimes,0,0,0,7,0,7,0,0,0,0,0,0,7,0,7
Meghalaya,2005,Murder,0,0,0,3,0,3,7,0,7,0,0,0,10,0,10
Meghalaya,2005,Attempt To Commit Murder,0,0,0,0,0,0,0,0,0,0,0,0,0,0,0
Meghalaya,2005,C.H. Not Amounting To Murder,0,0,0,0,0,0,0,0,0,0,0,0,0,0,0
Meghalaya,2005,Rape,0,0,0,1,0,1,4,0,4,0,0,0,5,0,5
Meghalaya,2005,Kidnapping And Abduction,0,0,0,0,0,0,0,0,0,0,0,0,0,0,0
Meghalaya,2005,Dacoity,0,0,0,0,0,0,0,0,0,0,0,0,0,0,0
Meghalaya,2005,Prep. And Assembly For Dacoity,0,0,0,0,0,0,0,0,0,0,0,0,0,0,0
Meghalaya,2005,Robbery,0,0,0,0,0,0,1,0,1,0,0,0,1,0,1
Meghalaya,2005,Burglary,0,0,0,2,0,2,1,0,1,0,0,0,3,0,3
Meghalaya,2005,Thefts,0,0,0,0,0,0,2,0,2,0,0,0,2,0,2
Meghalaya,2005,Extortion,0,0,0,0,0,0,0,0,0,0,0,0,0,0,0
Meghalaya,2005,Riots,0,0,0,0,0,0,0,0,0,0,0,0,0,0,0
Meghalaya,2005,Arson,0,0,0,0,0,0,0,0,0,0,0,0,0,0,0
Meghalaya,2005,Criminal Breach Of Trust,0,0,0,0,0,0,0,0,0,0,0,0,0,0,0
Meghalaya,2005,Cheating,0,0,0,0,0,0,0,0,0,0,0,0,0,0,0
Meghalaya,2005,Counter Feiting,0,0,0,0,0,0,0,0,0,0,0,0,0,0,0
Meghalaya,2005,Dowry Deaths,0,0,0,0,0,0,0,0,0,0,0,0,0,0,0
Meghalaya,2005,Molestation,0,0,0,0,0,0,0,0,0,0,0,0,0,0,0
Meghalaya,2005,Eve-Teasing,0,0,0,0,0,0,0,0,0,0,0,0,0,0,0
Meghalaya,2005,Cruelty By Husband Or Relative Of Husband,0,0,0,0,0,0,0,0,0,0,0,0,0,0,0
Meghalaya,2005,Other Ipc Crimes,0,0,0,0,0,0,1,0,1,0,0,0,1,0,1
Meghalaya,2006,Murder,0,0,0,5,0,5,6,1,7,4,0,4,15,1,16
Meghalaya,2006,Attempt To Commit Murder,0,0,0,0,0,0,3,0,3,0,0,0,3,0,3
Meghalaya,2006,C.H. Not Amounting To Murder,0,0,0,0,0,0,2,0,2,0,0,0,2,0,2
Meghalaya,2006,Rape,0,0,0,6,0,6,7,0,7,2,0,2,15,0,15
Meghalaya,2006,Kidnapping And Abduction,0,0,0,0,0,0,0,0,0,0,0,0,0,0,0
Meghalaya,2006,Dacoity,0,0,0,0,0,0,0,0,0,0,0,0,0,0,0
Meghalaya,2006,Prep. And Assembly For Dacoity,0,0,0,0,0,0,0,0,0,0,0,0,0,0,0
Meghalaya,2006,Robbery,0,0,0,2,0,2,6,0,6,0,0,0,8,0,8
Meghalaya,2006,Burglary,0,0,0,0,0,0,0,0,0,0,0,0,0,0,0
Meghalaya,2006,Thefts,0,0,0,0,0,0,0,0,0,0,0,0,0,0,0
Meghalaya,2006,Extortion,0,0,0,0,0,0,0,0,0,0,0,0,0,0,0
Meghalaya,2006,Riots,0,0,0,0,0,0,0,0,0,0,0,0,0,0,0
Meghalaya,2006,Arson,0,0,0,0,0,0,0,0,0,0,0,0,0,0,0
Meghalaya,2006,Criminal Breach Of Trust,0,0,0,0,0,0,0,0,0,0,0,0,0,0,0
Meghalaya,2006,Cheating,0,0,0,0,0,0,0,0,0,0,0,0,0,0,0
Meghalaya,2006,Counter Feiting,0,0,0,0,0,0,0,0,0,0,0,0,0,0,0
Meghalaya,2006,Dowry Deaths,0,0,0,0,0,0,0,0,0,0,0,0,0,0,0
Meghalaya,2006,Molestation,0,0,0,0,0,0,0,0,0,0,0,0,0,0,0
Meghalaya,2006,Eve-Teasing,0,0,0,0,0,0,0,0,0,0,0,0,0,0,0
Meghalaya,2006,Cruelty By Husband Or Relative Of Husband,0,0,0,0,0,0,0,0,0,0,0,0,0,0,0
Meghalaya,2006,Other Ipc Crimes,0,0,0,0,0,0,0,0,0,0,0,0,0,0,0
Meghalaya,2007,Murder,0,0,0,2,0,2,3,1,4,1,0,1,6,1,7
Meghalaya,2007,Attempt To Commit Murder,0,0,0,0,0,0,0,0,0,0,0,0,0,0,0
Meghalaya,2007,C.H. Not Amounting To Murder,0,0,0,0,0,0,0,0,0,0,0,0,0,0,0
Meghalaya,2007,Rape,0,0,0,5,0,5,13,0,13,0,0,0,18,0,18
Meghalaya,2007,Kidnapping And Abduction,0,0,0,1,0,1,1,0,1,0,0,0,2,0,2
Meghalaya,2007,Dacoity,0,0,0,0,0,0,2,0,2,0,0,0,2,0,2
Meghalaya,2007,Prep. And Assembly For Dacoity,0,0,0,0,0,0,0,0,0,0,0,0,0,0,0
Meghalaya,2007,Robbery,0,0,0,3,0,3,7,0,7,0,0,0,10,0,10
Meghalaya,2007,Burglary,0,0,0,0,0,0,0,0,0,0,0,0,0,0,0
Meghalaya,2007,Thefts,0,0,0,1,0,1,0,0,0,0,0,0,1,0,1
Meghalaya,2007,Extortion,0,0,0,0,0,0,0,0,0,0,0,0,0,0,0
Meghalaya,2007,Riots,0,0,0,0,0,0,0,0,0,0,0,0,0,0,0
Meghalaya,2007,Arson,0,0,0,0,0,0,2,0,2,0,0,0,2,0,2
Meghalaya,2007,Criminal Breach Of Trust,0,0,0,0,0,0,0,0,0,0,0,0,0,0,0
Meghalaya,2007,Cheating,0,0,0,0,0,0,0,0,0,0,0,0,0,0,0
Meghalaya,2007,Counter Feiting,0,0,0,0,0,0,0,0,0,0,0,0,0,0,0
Meghalaya,2007,Dowry Deaths,0,0,0,0,0,0,0,0,0,0,0,0,0,0,0
Meghalaya,2007,Molestation,0,0,0,0,0,0,1,0,1,0,0,0,1,0,1
Meghalaya,2007,Eve-Teasing,0,0,0,0,0,0,0,0,0,0,0,0,0,0,0
Meghalaya,2007,Cruelty By Husband Or Relative Of Husband,0,0,0,0,0,0,0,0,0,0,0,0,0,0,0
Meghalaya,2007,Other Ipc Crimes,0,0,0,0,0,0,0,0,0,0,0,0,0,0,0
Meghalaya,2008,Murder,0,0,0,2,0,2,22,0,22,0,0,0,24,0,24
Meghalaya,2008,Attempt To Commit Murder,0,0,0,2,0,2,1,0,1,0,0,0,3,0,3
Meghalaya,2008,C.H. Not Amounting To Murder,0,0,0,0,0,0,1,0,1,0,0,0,1,0,1
Meghalaya,2008,Rape,0,0,0,0,0,0,6,0,6,0,0,0,6,0,6
Meghalaya,2008,Kidnapping And Abduction,0,0,0,1,0,1,2,0,2,0,0,0,3,0,3
Meghalaya,2008,Dacoity,0,0,0,2,0,2,1,0,1,0,0,0,3,0,3
Meghalaya,2008,Prep. And Assembly For Dacoity,0,0,0,0,0,0,0,0,0,0,0,0,0,0,0
Meghalaya,2008,Robbery,0,0,0,2,0,2,5,0,5,0,0,0,7,0,7
Meghalaya,2008,Burglary,0,0,0,1,0,1,2,0,2,0,0,0,3,0,3
Meghalaya,2008,Thefts,0,0,0,2,0,2,3,0,3,0,0,0,5,0,5
Meghalaya,2008,Extortion,0,0,0,3,0,3,2,0,2,0,0,0,5,0,5
Meghalaya,2008,Riots,0,0,0,0,0,0,0,0,0,0,0,0,0,0,0
Meghalaya,2008,Arson,0,0,0,0,0,0,0,0,0,0,0,0,0,0,0
Meghalaya,2008,Criminal Breach Of Trust,0,0,0,0,0,0,0,0,0,0,0,0,0,0,0
Meghalaya,2008,Cheating,0,0,0,0,0,0,0,0,0,0,0,0,0,0,0
Meghalaya,2008,Counter Feiting,0,0,0,0,0,0,0,0,0,0,0,0,0,0,0
Meghalaya,2008,Dowry Deaths,0,0,0,0,0,0,0,0,0,0,0,0,0,0,0
Meghalaya,2008,Molestation,0,0,0,0,0,0,0,0,0,0,0,0,0,0,0
Meghalaya,2008,Eve-Teasing,0,0,0,0,0,0,0,0,0,0,0,0,0,0,0
Meghalaya,2008,Cruelty By Husband Or Relative Of Husband,0,0,0,0,0,0,0,0,0,0,0,0,0,0,0
Meghalaya,2008,Other Ipc Crimes,0,0,0,0,0,0,0,0,0,0,0,0,0,0,0
Meghalaya,2009,Murder,0,0,0,2,0,2,13,0,13,0,0,0,15,0,15
Meghalaya,2009,Attempt To Commit Murder,0,0,0,1,0,1,4,0,4,0,0,0,5,0,5
Meghalaya,2009,C.H. Not Amounting To Murder,0,0,0,0,0,0,1,0,1,0,0,0,1,0,1
Meghalaya,2009,Rape,0,0,0,11,0,11,9,0,9,0,0,0,20,0,20
Meghalaya,2009,Kidnapping And Abduction,0,0,0,1,0,1,3,0,3,0,0,0,4,0,4
Meghalaya,2009,Dacoity,0,0,0,8,0,8,4,0,4,0,0,0,12,0,12
Meghalaya,2009,Prep. And Assembly For Dacoity,0,0,0,0,0,0,0,0,0,0,0,0,0,0,0
Meghalaya,2009,Robbery,0,0,0,4,0,4,3,0,3,0,0,0,7,0,7
Meghalaya,2009,Burglary,0,0,0,0,0,0,0,0,0,0,0,0,0,0,0
Meghalaya,2009,Thefts,0,0,0,5,0,5,5,0,5,0,0,0,10,0,10
Meghalaya,2009,Extortion,0,0,0,0,0,0,0,0,0,0,0,0,0,0,0
Meghalaya,2009,Riots,0,0,0,0,0,0,0,0,0,0,0,0,0,0,0
Meghalaya,2009,Arson,0,0,0,0,0,0,0,0,0,0,0,0,0,0,0
Meghalaya,2009,Criminal Breach Of Trust,0,0,0,0,0,0,0,0,0,0,0,0,0,0,0
Meghalaya,2009,Cheating,0,0,0,0,0,0,0,0,0,0,0,0,0,0,0
Meghalaya,2009,Counter Feiting,0,0,0,0,0,0,0,0,0,0,0,0,0,0,0
Meghalaya,2009,Dowry Deaths,0,0,0,0,0,0,2,0,2,0,0,0,2,0,2
Meghalaya,2009,Molestation,0,0,0,0,0,0,0,0,0,0,0,0,0,0,0
Meghalaya,2009,Eve-Teasing,0,0,0,0,0,0,0,0,0,0,0,0,0,0,0
Meghalaya,2009,Cruelty By Husband Or Relative Of Husband,0,0,0,0,0,0,0,0,0,0,0,0,0,0,0
Meghalaya,2009,Other Ipc Crimes,0,0,0,0,0,0,1,0,1,0,0,0,1,0,1
Meghalaya,2010,Murder,0,0,0,7,0,7,6,0,6,3,0,3,16,0,16
Meghalaya,2010,Attempt To Commit Murder,0,0,0,1,0,1,0,0,0,0,0,0,1,0,1
Meghalaya,2010,C.H. Not Amounting To Murder,0,0,0,0,0,0,1,0,1,0,0,0,1,0,1
Meghalaya,2010,Rape,0,0,0,8,0,8,6,0,6,2,0,2,16,0,16
Meghalaya,2010,Kidnapping And Abduction,0,0,0,0,0,0,0,0,0,0,0,0,0,0,0
Meghalaya,2010,Dacoity,0,0,0,0,0,0,0,0,0,0,0,0,0,0,0
Meghalaya,2010,Prep. And Assembly For Dacoity,0,0,0,0,0,0,0,0,0,0,0,0,0,0,0
Meghalaya,2010,Robbery,0,0,0,0,0,0,0,0,0,0,0,0,0,0,0
Meghalaya,2010,Burglary,0,0,0,0,0,0,0,0,0,0,0,0,0,0,0
Meghalaya,2010,Thefts,0,0,0,0,0,0,6,0,6,0,0,0,6,0,6
Meghalaya,2010,Extortion,0,0,0,0,0,0,0,0,0,0,0,0,0,0,0
Meghalaya,2010,Riots,0,0,0,0,0,0,0,0,0,0,0,0,0,0,0
Meghalaya,2010,Arson,0,0,0,0,0,0,0,0,0,0,0,0,0,0,0
Meghalaya,2010,Criminal Breach Of Trust,0,0,0,0,0,0,0,0,0,0,0,0,0,0,0
Meghalaya,2010,Cheating,0,0,0,0,0,0,0,0,0,0,0,0,0,0,0
Meghalaya,2010,Counter Feiting,0,0,0,0,0,0,2,0,2,0,0,0,2,0,2
Meghalaya,2010,Dowry Deaths,0,0,0,0,0,0,0,0,0,0,0,0,0,0,0
Meghalaya,2010,Molestation,0,0,0,0,0,0,0,0,0,0,0,0,0,0,0
Meghalaya,2010,Eve-Teasing,0,0,0,0,0,0,0,0,0,0,0,0,0,0,0
Meghalaya,2010,Cruelty By Husband Or Relative Of Husband,0,0,0,0,0,0,0,0,0,0,0,0,0,0,0
Meghalaya,2010,Other Ipc Crimes,0,0,0,1,0,1,5,0,5,0,0,0,6,0,6
Meghalaya,2011,Murder,0,0,0,3,0,3,7,0,7,2,0,2,12,0,12
Meghalaya,2011,Attempt To Commit Murder,0,0,0,1,0,1,0,0,0,0,0,0,1,0,1
Meghalaya,2011,C.H. Not Amounting To Murder,0,0,0,0,0,0,2,0,2,0,0,0,2,0,2
Meghalaya,2011,Rape,0,0,0,16,0,16,6,0,6,1,0,1,23,0,23
Meghalaya,2011,Kidnapping And Abduction,0,0,0,2,0,2,1,0,1,0,0,0,3,0,3
Meghalaya,2011,Dacoity,0,0,0,2,0,2,0,0,0,0,0,0,2,0,2
Meghalaya,2011,Prep. And Assembly For Dacoity,0,0,0,0,0,0,0,0,0,0,0,0,0,0,0
Meghalaya,2011,Robbery,0,0,0,3,0,3,0,0,0,0,0,0,3,0,3
Meghalaya,2011,Burglary,0,0,0,0,0,0,0,0,0,0,0,0,0,0,0
Meghalaya,2011,Thefts,0,0,0,2,0,2,3,0,3,0,0,0,5,0,5
Meghalaya,2011,Extortion,0,0,0,0,0,0,0,0,0,0,0,0,0,0,0
Meghalaya,2011,Riots,0,0,0,0,0,0,0,0,0,0,0,0,0,0,0
Meghalaya,2011,Arson,0,0,0,0,0,0,0,0,0,0,0,0,0,0,0
Meghalaya,2011,Criminal Breach Of Trust,0,0,0,0,0,0,0,0,0,0,0,0,0,0,0
Meghalaya,2011,Cheating,0,0,0,0,0,0,0,0,0,0,0,0,0,0,0
Meghalaya,2011,Counter Feiting,0,0,0,0,0,0,1,0,1,1,0,1,2,0,2
Meghalaya,2011,Dowry Deaths,0,0,0,0,0,0,0,0,0,0,0,0,0,0,0
Meghalaya,2011,Molestation,0,0,0,0,0,0,0,0,0,0,0,0,0,0,0
Meghalaya,2011,Eve-Teasing,0,0,0,0,0,0,0,0,0,0,0,0,0,0,0
Meghalaya,2011,Cruelty By Husband Or Relative Of Husband,0,0,0,0,0,0,0,0,0,0,0,0,0,0,0
Meghalaya,2011,Other Ipc Crimes,0,0,0,1,0,1,0,0,0,0,0,0,1,0,1
Meghalaya,2012,Murder,0,0,0,12,0,12,10,0,10,4,0,4,26,0,26
Meghalaya,2012,Attempt To Commit Murder,0,0,0,0,0,0,0,0,0,0,0,0,0,0,0
Meghalaya,2012,C.H. Not Amounting To Murder,0,0,0,0,0,0,1,0,1,0,0,0,1,0,1
Meghalaya,2012,Rape,0,0,0,11,0,11,12,0,12,0,0,0,23,0,23
Meghalaya,2012,Kidnapping And Abduction,0,0,0,0,0,0,1,0,1,0,0,0,1,0,1
Meghalaya,2012,Dacoity,0,0,0,1,0,1,1,0,1,0,0,0,2,0,2
Meghalaya,2012,Prep. And Assembly For Dacoity,0,0,0,0,0,0,0,0,0,0,0,0,0,0,0
Meghalaya,2012,Robbery,0,0,0,1,0,1,1,0,1,0,0,0,2,0,2
Meghalaya,2012,Burglary,0,0,0,0,0,0,1,0,1,0,0,0,1,0,1
Meghalaya,2012,Thefts,0,0,0,5,0,5,1,0,1,0,0,0,6,0,6
Meghalaya,2012,Extortion,0,0,0,0,0,0,0,0,0,0,0,0,0,0,0
Meghalaya,2012,Riots,0,0,0,0,0,0,0,0,0,0,0,0,0,0,0
Meghalaya,2012,Arson,0,0,0,0,0,0,0,0,0,0,0,0,0,0,0
Meghalaya,2012,Criminal Breach Of Trust,0,0,0,0,0,0,0,0,0,0,0,0,0,0,0
Meghalaya,2012,Cheating,0,0,0,0,0,0,0,0,0,0,0,0,0,0,0
Meghalaya,2012,Counter Feiting,0,0,0,0,0,0,0,0,0,0,0,0,0,0,0
Meghalaya,2012,Dowry Deaths,0,0,0,0,0,0,0,0,0,0,0,0,0,0,0
Meghalaya,2012,Molestation,0,0,0,0,0,0,0,0,0,0,0,0,0,0,0
Meghalaya,2012,Eve-Teasing,0,0,0,0,0,0,0,0,0,0,0,0,0,0,0
Meghalaya,2012,Cruelty By Husband Or Relative Of Husband,0,0,0,0,0,0,0,0,0,0,0,0,0,0,0
Meghalaya,2012,Other Ipc Crimes,0,0,0,0,0,0,0,0,0,0,0,0,0,0,0
Mizoram,2001,Murder,0,0,0,6,0,6,5,0,5,0,0,0,11,0,11
Mizoram,2001,Attempt To Commit Murder,0,0,0,0,0,0,0,0,0,0,0,0,0,0,0
Mizoram,2001,C.H. Not Amounting To Murder,0,0,0,1,0,1,0,0,0,0,0,0,1,0,1
Mizoram,2001,Rape,0,0,0,8,0,8,5,0,5,0,0,0,13,0,13
Mizoram,2001,Kidnapping And Abduction,0,0,0,0,0,0,0,0,0,0,0,0,0,0,0
Mizoram,2001,Dacoity,0,0,0,0,0,0,0,0,0,0,0,0,0,0,0
Mizoram,2001,Prep. And Assembly For Dacoity,0,0,0,0,0,0,0,0,0,0,0,0,0,0,0
Mizoram,2001,Robbery,0,0,0,0,0,0,0,0,0,0,0,0,0,0,0
Mizoram,2001,Burglary,0,0,0,9,0,9,0,0,0,0,0,0,9,0,9
Mizoram,2001,Thefts,5,0,5,25,0,25,5,0,5,0,0,0,35,0,35
Mizoram,2001,Extortion,0,0,0,0,0,0,0,0,0,0,0,0,0,0,0
Mizoram,2001,Riots,0,0,0,0,0,0,0,0,0,0,0,0,0,0,0
Mizoram,2001,Arson,0,0,0,0,0,0,0,0,0,0,0,0,0,0,0
Mizoram,2001,Criminal Breach Of Trust,0,0,0,0,0,0,0,0,0,0,0,0,0,0,0
Mizoram,2001,Cheating,0,0,0,0,0,0,0,0,0,0,0,0,0,0,0
Mizoram,2001,Counter Feiting,0,0,0,0,0,0,0,0,0,0,0,0,0,0,0
Mizoram,2001,Dowry Deaths,0,0,0,0,0,0,0,0,0,0,0,0,0,0,0
Mizoram,2001,Molestation,0,0,0,0,0,0,0,0,0,0,0,0,0,0,0
Mizoram,2001,Eve-Teasing,0,0,0,0,0,0,0,0,0,0,0,0,0,0,0
Mizoram,2001,Cruelty By Husband Or Relative Of Husband,0,0,0,0,0,0,0,0,0,0,0,0,0,0,0
Mizoram,2001,Other Ipc Crimes,0,0,0,0,0,0,0,0,0,0,0,0,0,0,0
Mizoram,2002,Murder,0,0,0,6,0,6,6,0,6,0,0,0,12,0,12
Mizoram,2002,Attempt To Commit Murder,0,0,0,3,1,4,2,0,2,0,0,0,5,1,6
Mizoram,2002,C.H. Not Amounting To Murder,0,0,0,5,0,5,0,0,0,0,0,0,5,0,5
Mizoram,2002,Rape,0,0,0,8,0,8,6,0,6,0,0,0,14,0,14
Mizoram,2002,Kidnapping And Abduction,0,0,0,0,0,0,0,0,0,0,0,0,0,0,0
Mizoram,2002,Dacoity,0,0,0,0,0,0,0,0,0,0,0,0,0,0,0
Mizoram,2002,Prep. And Assembly For Dacoity,0,0,0,0,0,0,0,0,0,0,0,0,0,0,0
Mizoram,2002,Robbery,0,0,0,5,2,7,5,0,5,0,0,0,10,2,12
Mizoram,2002,Burglary,0,0,0,10,0,10,10,0,10,0,0,0,20,0,20
Mizoram,2002,Thefts,19,0,19,70,10,80,20,5,25,0,0,0,109,15,124
Mizoram,2002,Extortion,0,0,0,0,0,0,0,0,0,0,0,0,0,0,0
Mizoram,2002,Riots,0,0,0,0,0,0,0,0,0,0,0,0,0,0,0
Mizoram,2002,Arson,0,0,0,0,0,0,0,0,0,0,0,0,0,0,0
Mizoram,2002,Criminal Breach Of Trust,0,0,0,0,0,0,0,0,0,0,0,0,0,0,0
Mizoram,2002,Cheating,0,0,0,0,0,0,0,0,0,0,0,0,0,0,0
Mizoram,2002,Counter Feiting,0,0,0,0,0,0,0,0,0,0,0,0,0,0,0
Mizoram,2002,Dowry Deaths,0,0,0,0,0,0,0,0,0,0,0,0,0,0,0
Mizoram,2002,Molestation,0,0,0,0,0,0,0,0,0,0,0,0,0,0,0
Mizoram,2002,Eve-Teasing,0,0,0,0,0,0,0,0,0,0,0,0,0,0,0
Mizoram,2002,Cruelty By Husband Or Relative Of Husband,0,0,0,0,0,0,0,0,0,0,0,0,0,0,0
Mizoram,2002,Other Ipc Crimes,0,0,0,0,0,0,0,0,0,0,0,0,0,0,0
Mizoram,2003,Murder,0,0,0,8,0,8,8,0,8,0,0,0,16,0,16
Mizoram,2003,Attempt To Commit Murder,0,0,0,0,0,0,5,0,5,0,0,0,5,0,5
Mizoram,2003,C.H. Not Amounting To Murder,0,0,0,0,0,0,1,0,1,0,0,0,1,0,1
Mizoram,2003,Rape,0,0,0,7,0,7,9,0,9,0,0,0,16,0,16
Mizoram,2003,Kidnapping And Abduction,0,0,0,2,0,2,0,0,0,0,0,0,2,0,2
Mizoram,2003,Dacoity,0,0,0,0,0,0,0,0,0,0,0,0,0,0,0
Mizoram,2003,Prep. And Assembly For Dacoity,0,0,0,0,0,0,0,0,0,0,0,0,0,0,0
Mizoram,2003,Robbery,0,0,0,2,0,2,6,0,6,0,0,0,8,0,8
Mizoram,2003,Burglary,0,0,0,21,0,21,7,0,7,1,0,1,29,0,29
Mizoram,2003,Thefts,12,0,12,30,1,31,6,0,6,0,0,0,48,1,49
Mizoram,2003,Extortion,0,0,0,2,0,2,0,0,0,0,0,0,2,0,2
Mizoram,2003,Riots,0,0,0,0,0,0,0,0,0,0,0,0,0,0,0
Mizoram,2003,Arson,0,0,0,0,0,0,1,0,1,0,0,0,1,0,1
Mizoram,2003,Criminal Breach Of Trust,0,0,0,0,0,0,1,0,1,0,0,0,1,0,1
Mizoram,2003,Cheating,2,0,2,2,0,2,4,0,4,0,0,0,8,0,8
Mizoram,2003,Counter Feiting,0,0,0,0,0,0,0,0,0,0,0,0,0,0,0
Mizoram,2003,Dowry Deaths,0,0,0,0,0,0,0,0,0,0,0,0,0,0,0
Mizoram,2003,Molestation,0,0,0,2,0,2,1,0,1,0,0,0,3,0,3
Mizoram,2003,Eve-Teasing,0,0,0,0,0,0,0,0,0,0,0,0,0,0,0
Mizoram,2003,Cruelty By Husband Or Relative Of Husband,0,0,0,0,0,0,0,0,0,0,0,0,0,0,0
Mizoram,2003,Other Ipc Crimes,0,0,0,0,0,0,1,0,1,0,0,0,1,0,1
Mizoram,2004,Murder,0,0,0,5,0,5,13,0,13,0,0,0,18,0,18
Mizoram,2004,Attempt To Commit Murder,0,0,0,5,0,5,5,0,5,0,0,0,10,0,10
Mizoram,2004,C.H. Not Amounting To Murder,0,0,0,2,0,2,2,0,2,0,0,0,4,0,4
Mizoram,2004,Rape,0,0,0,12,0,12,11,0,11,0,0,0,23,0,23
Mizoram,2004,Kidnapping And Abduction,0,0,0,0,0,0,0,0,0,0,0,0,0,0,0
Mizoram,2004,Dacoity,0,0,0,0,0,0,0,0,0,0,0,0,0,0,0
Mizoram,2004,Prep. And Assembly For Dacoity,0,0,0,0,0,0,0,0,0,0,0,0,0,0,0
Mizoram,2004,Robbery,1,0,1,6,0,6,0,0,0,0,0,0,7,0,7
Mizoram,2004,Burglary,2,0,2,5,0,5,6,0,6,0,0,0,13,0,13
Mizoram,2004,Thefts,10,0,10,18,3,21,2,0,2,0,0,0,30,3,33
Mizoram,2004,Extortion,0,0,0,0,0,0,0,0,0,0,0,0,0,0,0
Mizoram,2004,Riots,0,0,0,0,0,0,0,0,0,0,0,0,0,0,0
Mizoram,2004,Arson,0,0,0,0,0,0,0,0,0,0,0,0,0,0,0
Mizoram,2004,Criminal Breach Of Trust,0,0,0,2,0,2,0,0,0,0,0,0,2,0,2
Mizoram,2004,Cheating,1,0,1,7,0,7,13,0,13,0,0,0,21,0,21
Mizoram,2004,Counter Feiting,0,0,0,0,0,0,0,0,0,0,0,0,0,0,0
Mizoram,2004,Dowry Deaths,0,0,0,0,0,0,0,0,0,0,0,0,0,0,0
Mizoram,2004,Molestation,0,0,0,0,0,0,0,0,0,0,0,0,0,0,0
Mizoram,2004,Eve-Teasing,0,0,0,0,0,0,0,0,0,0,0,0,0,0,0
Mizoram,2004,Cruelty By Husband Or Relative Of Husband,0,0,0,0,0,0,0,0,0,0,0,0,0,0,0
Mizoram,2004,Other Ipc Crimes,0,0,0,7,0,7,0,0,0,0,0,0,7,0,7
Mizoram,2005,Murder,0,0,0,6,0,6,8,0,8,0,0,0,14,0,14
Mizoram,2005,Attempt To Commit Murder,0,0,0,0,0,0,5,0,5,0,0,0,5,0,5
Mizoram,2005,C.H. Not Amounting To Murder,0,0,0,0,0,0,2,0,2,0,0,0,2,0,2
Mizoram,2005,Rape,0,0,0,6,0,6,8,0,8,0,0,0,14,0,14
Mizoram,2005,Kidnapping And Abduction,0,0,0,2,0,2,1,0,1,0,0,0,3,0,3
Mizoram,2005,Dacoity,0,0,0,0,0,0,0,0,0,0,0,0,0,0,0
Mizoram,2005,Prep. And Assembly For Dacoity,0,0,0,0,0,0,0,0,0,0,0,0,0,0,0
Mizoram,2005,Robbery,1,0,1,5,0,5,5,0,5,0,0,0,11,0,11
Mizoram,2005,Burglary,2,0,2,8,0,8,8,0,8,0,0,0,18,0,18
Mizoram,2005,Thefts,9,0,9,30,7,37,0,0,0,0,0,0,39,7,46
Mizoram,2005,Extortion,0,0,0,3,0,3,0,0,0,0,0,0,3,0,3
Mizoram,2005,Riots,0,0,0,0,0,0,0,0,0,0,0,0,0,0,0
Mizoram,2005,Arson,0,0,0,0,0,0,0,0,0,0,0,0,0,0,0
Mizoram,2005,Criminal Breach Of Trust,0,0,0,2,0,2,0,0,0,0,0,0,2,0,2
Mizoram,2005,Cheating,1,0,1,8,0,8,3,9,12,0,0,0,12,9,21
Mizoram,2005,Counter Feiting,0,0,0,0,0,0,0,0,0,0,0,0,0,0,0
Mizoram,2005,Dowry Deaths,0,0,0,0,0,0,0,0,0,0,0,0,0,0,0
Mizoram,2005,Molestation,0,0,0,0,0,0,0,0,0,0,0,0,0,0,0
Mizoram,2005,Eve-Teasing,0,0,0,0,0,0,0,0,0,0,0,0,0,0,0
Mizoram,2005,Cruelty By Husband Or Relative Of Husband,0,0,0,0,0,0,0,0,0,0,0,0,0,0,0
Mizoram,2005,Other Ipc Crimes,0,0,0,0,0,0,0,0,0,0,0,0,0,0,0
Mizoram,2006,Murder,0,0,0,7,0,7,14,0,14,0,0,0,21,0,21
Mizoram,2006,Attempt To Commit Murder,0,0,0,1,0,1,0,0,0,0,0,0,1,0,1
Mizoram,2006,C.H. Not Amounting To Murder,0,0,0,0,0,0,0,0,0,0,0,0,0,0,0
Mizoram,2006,Rape,0,0,0,6,0,6,16,0,16,0,0,0,22,0,22
Mizoram,2006,Kidnapping And Abduction,0,0,0,2,0,2,0,0,0,0,0,0,2,0,2
Mizoram,2006,Dacoity,0,0,0,0,0,0,0,0,0,0,0,0,0,0,0
Mizoram,2006,Prep. And Assembly For Dacoity,0,0,0,0,0,0,0,0,0,0,0,0,0,0,0
Mizoram,2006,Robbery,0,0,0,15,4,19,2,0,2,0,0,0,17,4,21
Mizoram,2006,Burglary,0,0,0,0,0,0,0,0,0,0,0,0,0,0,0
Mizoram,2006,Thefts,0,0,0,21,0,21,12,0,12,0,0,0,33,0,33
Mizoram,2006,Extortion,0,0,0,0,0,0,0,0,0,0,0,0,0,0,0
Mizoram,2006,Riots,0,0,0,0,0,0,0,0,0,0,0,0,0,0,0
Mizoram,2006,Arson,0,0,0,0,0,0,0,0,0,0,0,0,0,0,0
Mizoram,2006,Criminal Breach Of Trust,0,0,0,0,0,0,0,0,0,0,0,0,0,0,0
Mizoram,2006,Cheating,0,0,0,0,0,0,5,1,6,0,0,0,5,1,6
Mizoram,2006,Counter Feiting,0,0,0,0,0,0,0,0,0,0,0,0,0,0,0
Mizoram,2006,Dowry Deaths,0,0,0,0,0,0,0,0,0,0,0,0,0,0,0
Mizoram,2006,Molestation,0,0,0,1,0,1,0,0,0,0,0,0,1,0,1
Mizoram,2006,Eve-Teasing,0,0,0,0,0,0,0,0,0,0,0,0,0,0,0
Mizoram,2006,Cruelty By Husband Or Relative Of Husband,0,0,0,0,0,0,0,0,0,0,0,0,0,0,0
Mizoram,2006,Other Ipc Crimes,0,0,0,11,4,15,1,3,4,0,0,0,12,7,19
Mizoram,2007,Murder,0,0,0,8,0,8,3,0,3,2,0,2,13,0,13
Mizoram,2007,Attempt To Commit Murder,0,0,0,1,0,1,1,0,1,0,0,0,2,0,2
Mizoram,2007,C.H. Not Amounting To Murder,0,0,0,0,0,0,3,1,4,0,0,0,3,1,4
Mizoram,2007,Rape,0,0,0,5,0,5,10,0,10,3,0,3,18,0,18
Mizoram,2007,Kidnapping And Abduction,0,0,0,0,0,0,0,0,0,0,0,0,0,0,0
Mizoram,2007,Dacoity,0,0,0,0,0,0,0,0,0,0,0,0,0,0,0
Mizoram,2007,Prep. And Assembly For Dacoity,0,0,0,0,0,0,0,0,0,0,0,0,0,0,0
Mizoram,2007,Robbery,0,0,0,7,0,7,3,0,3,0,0,0,10,0,10
Mizoram,2007,Burglary,0,0,0,7,0,7,0,0,0,0,0,0,7,0,7
Mizoram,2007,Thefts,0,0,0,63,4,67,25,0,25,1,0,1,89,4,93
Mizoram,2007,Extortion,0,0,0,0,0,0,1,0,1,0,0,0,1,0,1
Mizoram,2007,Riots,0,0,0,0,0,0,0,0,0,0,0,0,0,0,0
Mizoram,2007,Arson,0,0,0,0,0,0,0,0,0,0,0,0,0,0,0
Mizoram,2007,Criminal Breach Of Trust,0,0,0,0,0,0,0,0,0,0,0,0,0,0,0
Mizoram,2007,Cheating,0,0,0,0,0,0,3,1,4,0,0,0,3,1,4
Mizoram,2007,Counter Feiting,0,0,0,0,0,0,0,0,0,0,0,0,0,0,0
Mizoram,2007,Dowry Deaths,0,0,0,0,0,0,0,0,0,0,0,0,0,0,0
Mizoram,2007,Molestation,0,0,0,0,0,0,2,0,2,0,0,0,2,0,2
Mizoram,2007,Eve-Teasing,0,0,0,0,0,0,0,0,0,0,0,0,0,0,0
Mizoram,2007,Cruelty By Husband Or Relative Of Husband,0,0,0,0,0,0,0,0,0,0,0,0,0,0,0
Mizoram,2007,Other Ipc Crimes,0,0,0,11,1,12,2,0,2,0,0,0,13,1,14
Mizoram,2008,Murder,0,0,0,6,0,6,1,0,1,2,0,2,9,0,9
Mizoram,2008,Attempt To Commit Murder,0,0,0,9,0,9,7,0,7,4,0,4,20,0,20
Mizoram,2008,C.H. Not Amounting To Murder,0,0,0,0,0,0,0,0,0,0,0,0,0,0,0
Mizoram,2008,Rape,0,0,0,10,0,10,15,0,15,0,0,0,25,0,25
Mizoram,2008,Kidnapping And Abduction,0,0,0,2,0,2,0,0,0,0,0,0,2,0,2
Mizoram,2008,Dacoity,0,0,0,0,0,0,0,0,0,0,0,0,0,0,0
Mizoram,2008,Prep. And Assembly For Dacoity,0,0,0,0,0,0,0,0,0,0,0,0,0,0,0
Mizoram,2008,Robbery,0,0,0,0,0,0,0,0,0,0,0,0,0,0,0
Mizoram,2008,Burglary,0,0,0,9,0,9,0,0,0,0,0,0,9,0,9
Mizoram,2008,Thefts,0,0,0,65,1,66,49,0,49,0,0,0,114,1,115
Mizoram,2008,Extortion,0,0,0,0,0,0,0,0,0,0,0,0,0,0,0
Mizoram,2008,Riots,0,0,0,0,0,0,0,0,0,0,0,0,0,0,0
Mizoram,2008,Arson,0,0,0,0,0,0,0,0,0,0,0,0,0,0,0
Mizoram,2008,Criminal Breach Of Trust,0,0,0,0,0,0,0,0,0,0,0,0,0,0,0
Mizoram,2008,Cheating,0,0,0,5,0,5,1,1,2,0,0,0,6,1,7
Mizoram,2008,Counter Feiting,0,0,0,0,0,0,0,0,0,0,0,0,0,0,0
Mizoram,2008,Dowry Deaths,0,0,0,0,0,0,0,0,0,0,0,0,0,0,0
Mizoram,2008,Molestation,0,0,0,0,0,0,1,0,1,0,0,0,1,0,1
Mizoram,2008,Eve-Teasing,0,0,0,0,0,0,0,0,0,0,0,0,0,0,0
Mizoram,2008,Cruelty By Husband Or Relative Of Husband,0,0,0,0,0,0,0,0,0,0,0,0,0,0,0
Mizoram,2008,Other Ipc Crimes,0,0,0,9,0,9,11,0,11,1,1,2,21,1,22
Mizoram,2009,Murder,0,0,0,7,0,7,4,0,4,0,0,0,11,0,11
Mizoram,2009,Attempt To Commit Murder,0,0,0,1,0,1,0,0,0,0,0,0,1,0,1
Mizoram,2009,C.H. Not Amounting To Murder,0,0,0,0,0,0,0,0,0,0,0,0,0,0,0
Mizoram,2009,Rape,0,0,0,15,0,15,13,0,13,2,0,2,30,0,30
Mizoram,2009,Kidnapping And Abduction,0,0,0,7,0,7,4,0,4,0,0,0,11,0,11
Mizoram,2009,Dacoity,0,0,0,0,0,0,0,0,0,0,0,0,0,0,0
Mizoram,2009,Prep. And Assembly For Dacoity,0,0,0,0,0,0,0,0,0,0,0,0,0,0,0
Mizoram,2009,Robbery,0,0,0,0,0,0,0,0,0,0,0,0,0,0,0
Mizoram,2009,Burglary,0,0,0,10,0,10,3,0,3,0,0,0,13,0,13
Mizoram,2009,Thefts,0,0,0,106,0,106,24,2,26,4,0,4,134,2,136
Mizoram,2009,Extortion,0,0,0,5,0,5,2,0,2,0,0,0,7,0,7
Mizoram,2009,Riots,0,0,0,0,0,0,0,0,0,0,0,0,0,0,0
Mizoram,2009,Arson,0,0,0,2,0,2,0,0,0,0,0,0,2,0,2
Mizoram,2009,Criminal Breach Of Trust,0,0,0,0,0,0,0,0,0,0,0,0,0,0,0
Mizoram,2009,Cheating,0,0,0,0,0,0,0,0,0,0,0,0,0,0,0
Mizoram,2009,Counter Feiting,0,0,0,0,0,0,0,0,0,0,0,0,0,0,0
Mizoram,2009,Dowry Deaths,0,0,0,0,0,0,0,0,0,0,0,0,0,0,0
Mizoram,2009,Molestation,0,0,0,1,0,1,1,0,1,0,0,0,2,0,2
Mizoram,2009,Eve-Teasing,0,0,0,2,0,2,0,0,0,0,0,0,2,0,2
Mizoram,2009,Cruelty By Husband Or Relative Of Husband,0,0,0,0,0,0,0,0,0,0,0,0,0,0,0
Mizoram,2009,Other Ipc Crimes,0,0,0,13,0,13,7,0,7,0,0,0,20,0,20
Mizoram,2010,Murder,0,0,0,14,0,14,11,0,11,2,0,2,27,0,27
Mizoram,2010,Attempt To Commit Murder,0,0,0,5,0,5,3,0,3,0,0,0,8,0,8
Mizoram,2010,C.H. Not Amounting To Murder,0,0,0,0,0,0,0,0,0,0,0,0,0,0,0
Mizoram,2010,Rape,0,0,0,20,0,20,25,0,25,4,0,4,49,0,49
Mizoram,2010,Kidnapping And Abduction,0,0,0,3,0,3,5,0,5,0,0,0,8,0,8
Mizoram,2010,Dacoity,0,0,0,0,0,0,0,0,0,0,0,0,0,0,0
Mizoram,2010,Prep. And Assembly For Dacoity,0,0,0,0,0,0,0,0,0,0,0,0,0,0,0
Mizoram,2010,Robbery,0,0,0,0,0,0,1,0,1,0,0,0,1,0,1
Mizoram,2010,Burglary,0,0,0,14,0,14,0,0,0,0,0,0,14,0,14
Mizoram,2010,Thefts,0,0,0,101,1,102,39,0,39,0,0,0,140,1,141
Mizoram,2010,Extortion,0,0,0,0,0,0,0,0,0,0,0,0,0,0,0
Mizoram,2010,Riots,0,0,0,0,0,0,0,0,0,0,0,0,0,0,0
Mizoram,2010,Arson,0,0,0,0,0,0,0,0,0,0,0,0,0,0,0
Mizoram,2010,Criminal Breach Of Trust,0,0,0,0,0,0,0,0,0,0,0,0,0,0,0
Mizoram,2010,Cheating,0,0,0,7,0,7,9,0,9,0,0,0,16,0,16
Mizoram,2010,Counter Feiting,0,0,0,0,0,0,0,0,0,0,0,0,0,0,0
Mizoram,2010,Dowry Deaths,0,0,0,0,0,0,0,0,0,0,0,0,0,0,0
Mizoram,2010,Molestation,0,0,0,0,0,0,0,0,0,1,0,1,1,0,1
Mizoram,2010,Eve-Teasing,0,0,0,0,0,0,0,0,0,0,0,0,0,0,0
Mizoram,2010,Cruelty By Husband Or Relative Of Husband,0,0,0,0,0,0,0,0,0,0,0,0,0,0,0
Mizoram,2010,Other Ipc Crimes,0,0,0,7,2,9,1,0,1,0,0,0,8,2,10
Mizoram,2011,Murder,0,0,0,17,0,17,15,0,15,3,0,3,35,0,35
Mizoram,2011,Attempt To Commit Murder,0,0,0,6,1,7,5,0,5,0,0,0,11,1,12
Mizoram,2011,C.H. Not Amounting To Murder,0,0,0,1,0,1,1,0,1,0,0,0,2,0,2
Mizoram,2011,Rape,0,0,0,14,0,14,10,0,10,12,0,12,36,0,36
Mizoram,2011,Kidnapping And Abduction,0,0,0,0,0,0,0,0,0,0,0,0,0,0,0
Mizoram,2011,Dacoity,0,0,0,0,0,0,0,0,0,0,0,0,0,0,0
Mizoram,2011,Prep. And Assembly For Dacoity,0,0,0,0,0,0,0,0,0,0,0,0,0,0,0
Mizoram,2011,Robbery,0,0,0,2,0,2,2,0,2,0,0,0,4,0,4
Mizoram,2011,Burglary,0,0,0,14,0,14,1,0,1,0,0,0,15,0,15
Mizoram,2011,Thefts,0,0,0,112,0,112,21,0,21,7,0,7,140,0,140
Mizoram,2011,Extortion,0,0,0,0,0,0,0,0,0,0,0,0,0,0,0
Mizoram,2011,Riots,0,0,0,0,0,0,0,0,0,0,0,0,0,0,0
Mizoram,2011,Arson,0,0,0,0,0,0,0,0,0,0,0,0,0,0,0
Mizoram,2011,Criminal Breach Of Trust,0,0,0,0,0,0,0,0,0,0,0,0,0,0,0
Mizoram,2011,Cheating,0,0,0,7,0,7,9,0,9,0,0,0,16,0,16
Mizoram,2011,Counter Feiting,0,0,0,0,0,0,0,0,0,0,0,0,0,0,0
Mizoram,2011,Dowry Deaths,0,0,0,0,0,0,0,0,0,0,0,0,0,0,0
Mizoram,2011,Molestation,0,0,0,1,0,1,0,0,0,0,0,0,1,0,1
Mizoram,2011,Eve-Teasing,0,0,0,0,0,0,0,0,0,0,0,0,0,0,0
Mizoram,2011,Cruelty By Husband Or Relative Of Husband,0,0,0,0,0,0,0,0,0,0,0,0,0,0,0
Mizoram,2011,Other Ipc Crimes,0,0,0,3,0,3,1,0,1,0,0,0,4,0,4
Mizoram,2012,Murder,0,0,0,18,0,18,20,0,20,5,0,5,43,0,43
Mizoram,2012,Attempt To Commit Murder,0,0,0,3,0,3,7,0,7,0,0,0,10,0,10
Mizoram,2012,C.H. Not Amounting To Murder,0,0,0,5,0,5,6,0,6,1,0,1,12,0,12
Mizoram,2012,Rape,0,0,0,18,0,18,36,0,36,9,0,9,63,0,63
Mizoram,2012,Kidnapping And Abduction,0,0,0,0,0,0,1,0,1,0,0,0,1,0,1
Mizoram,2012,Dacoity,0,0,0,0,0,0,0,0,0,0,0,0,0,0,0
Mizoram,2012,Prep. And Assembly For Dacoity,0,0,0,0,0,0,0,0,0,0,0,0,0,0,0
Mizoram,2012,Robbery,0,0,0,1,0,1,3,0,3,0,0,0,4,0,4
Mizoram,2012,Burglary,0,0,0,17,0,17,5,0,5,0,0,0,22,0,22
Mizoram,2012,Thefts,0,0,0,46,0,46,29,0,29,0,0,0,75,0,75
Mizoram,2012,Extortion,0,0,0,1,0,1,0,0,0,0,0,0,1,0,1
Mizoram,2012,Riots,0,0,0,0,0,0,0,0,0,0,0,0,0,0,0
Mizoram,2012,Arson,0,0,0,0,0,0,0,0,0,0,0,0,0,0,0
Mizoram,2012,Criminal Breach Of Trust,0,0,0,0,0,0,0,0,0,0,0,0,0,0,0
Mizoram,2012,Cheating,0,0,0,2,0,2,1,0,1,0,0,0,3,0,3
Mizoram,2012,Counter Feiting,0,0,0,0,0,0,0,0,0,0,0,0,0,0,0
Mizoram,2012,Dowry Deaths,0,0,0,0,0,0,0,0,0,0,0,0,0,0,0
Mizoram,2012,Molestation,0,0,0,1,0,1,2,0,2,0,0,0,3,0,3
Mizoram,2012,Eve-Teasing,0,0,0,0,0,0,1,0,1,0,0,0,1,0,1
Mizoram,2012,Cruelty By Husband Or Relative Of Husband,0,0,0,0,0,0,0,0,0,0,0,0,0,0,0
Mizoram,2012,Other Ipc Crimes,0,0,0,6,0,6,4,0,4,0,0,0,10,0,10
Nagaland,2001,Murder,0,0,0,2,0,2,1,0,1,0,0,0,3,0,3
Nagaland,2001,Attempt To Commit Murder,0,0,0,1,0,1,3,0,3,0,0,0,4,0,4
Nagaland,2001,C.H. Not Amounting To Murder,0,0,0,0,0,0,0,0,0,1,0,1,1,0,1
Nagaland,2001,Rape,0,0,0,2,0,2,0,0,0,0,0,0,2,0,2
Nagaland,2001,Kidnapping And Abduction,0,0,0,3,0,3,2,0,2,0,0,0,5,0,5
Nagaland,2001,Dacoity,0,0,0,3,0,3,0,0,0,0,0,0,3,0,3
Nagaland,2001,Prep. And Assembly For Dacoity,0,0,0,0,0,0,0,0,0,0,0,0,0,0,0
Nagaland,2001,Robbery,0,0,0,3,0,3,4,0,4,0,0,0,7,0,7
Nagaland,2001,Burglary,0,0,0,0,0,0,0,0,0,1,0,1,1,0,1
Nagaland,2001,Thefts,0,0,0,0,0,0,0,0,0,0,0,0,0,0,0
Nagaland,2001,Extortion,0,0,0,3,0,3,6,0,6,0,0,0,9,0,9
Nagaland,2001,Riots,0,0,0,0,0,0,0,0,0,0,0,0,0,0,0
Nagaland,2001,Arson,0,0,0,0,0,0,0,0,0,0,0,0,0,0,0
Nagaland,2001,Criminal Breach Of Trust,0,0,0,0,0,0,0,0,0,0,0,0,0,0,0
Nagaland,2001,Cheating,0,0,0,0,0,0,0,0,0,0,0,0,0,0,0
Nagaland,2001,Counter Feiting,0,0,0,0,0,0,0,0,0,0,0,0,0,0,0
Nagaland,2001,Dowry Deaths,0,0,0,0,0,0,0,0,0,0,0,0,0,0,0
Nagaland,2001,Molestation,0,0,0,0,0,0,0,0,0,0,0,0,0,0,0
Nagaland,2001,Eve-Teasing,0,0,0,0,0,0,0,0,0,0,0,0,0,0,0
Nagaland,2001,Cruelty By Husband Or Relative Of Husband,0,0,0,0,0,0,0,0,0,0,0,0,0,0,0
Nagaland,2001,Other Ipc Crimes,0,0,0,0,0,0,0,0,0,0,0,0,0,0,0
Nagaland,2002,Murder,0,0,0,2,0,2,1,0,1,0,0,0,3,0,3
Nagaland,2002,Attempt To Commit Murder,0,0,0,1,0,1,1,0,1,0,0,0,2,0,2
Nagaland,2002,C.H. Not Amounting To Murder,0,0,0,0,0,0,0,0,0,0,0,0,0,0,0
Nagaland,2002,Rape,0,0,0,0,0,0,0,0,0,0,0,0,0,0,0
Nagaland,2002,Kidnapping And Abduction,0,0,0,1,0,1,0,0,0,0,0,0,1,0,1
Nagaland,2002,Dacoity,0,0,0,2,0,2,0,0,0,0,0,0,2,0,2
Nagaland,2002,Prep. And Assembly For Dacoity,0,0,0,0,0,0,0,0,0,0,0,0,0,0,0
Nagaland,2002,Robbery,0,0,0,2,0,2,1,0,1,0,0,0,3,0,3
Nagaland,2002,Burglary,0,0,0,0,0,0,0,0,0,0,0,0,0,0,0
Nagaland,2002,Thefts,0,0,0,0,0,0,0,0,0,0,0,0,0,0,0
Nagaland,2002,Extortion,0,0,0,1,0,1,0,0,0,3,0,3,4,0,4
Nagaland,2002,Riots,0,0,0,0,0,0,0,0,0,0,0,0,0,0,0
Nagaland,2002,Arson,0,0,0,0,0,0,0,0,0,0,0,0,0,0,0
Nagaland,2002,Criminal Breach Of Trust,0,0,0,0,0,0,0,0,0,0,0,0,0,0,0
Nagaland,2002,Cheating,0,0,0,4,0,4,1,1,2,0,0,0,5,1,6
Nagaland,2002,Counter Feiting,0,0,0,0,0,0,0,0,0,0,0,0,0,0,0
Nagaland,2002,Dowry Deaths,0,0,0,0,0,0,0,0,0,0,0,0,0,0,0
Nagaland,2002,Molestation,0,0,0,0,0,0,0,0,0,0,0,0,0,0,0
Nagaland,2002,Eve-Teasing,0,0,0,0,0,0,0,0,0,0,0,0,0,0,0
Nagaland,2002,Cruelty By Husband Or Relative Of Husband,0,0,0,0,0,0,0,0,0,0,0,0,0,0,0
Nagaland,2002,Other Ipc Crimes,0,0,0,0,0,0,0,0,0,0,0,0,0,0,0
Nagaland,2003,Murder,0,0,0,2,0,2,1,0,1,0,0,0,3,0,3
Nagaland,2003,Attempt To Commit Murder,0,0,0,1,0,1,1,0,1,1,0,1,3,0,3
Nagaland,2003,C.H. Not Amounting To Murder,0,0,0,0,0,0,0,0,0,0,0,0,0,0,0
Nagaland,2003,Rape,0,0,0,0,0,0,2,0,2,0,0,0,2,0,2
Nagaland,2003,Kidnapping And Abduction,0,0,0,0,0,0,3,0,3,0,0,0,3,0,3
Nagaland,2003,Dacoity,0,0,0,14,0,14,5,0,5,0,0,0,19,0,19
Nagaland,2003,Prep. And Assembly For Dacoity,0,0,0,0,0,0,0,0,0,0,0,0,0,0,0
Nagaland,2003,Robbery,0,0,0,10,0,10,3,0,3,0,0,0,13,0,13
Nagaland,2003,Burglary,0,0,0,0,0,0,0,0,0,0,0,0,0,0,0
Nagaland,2003,Thefts,0,0,0,0,0,0,0,0,0,0,0,0,0,0,0
Nagaland,2003,Extortion,0,0,0,4,0,4,4,0,4,3,0,3,11,0,11
Nagaland,2003,Riots,0,0,0,1,0,1,0,0,0,0,0,0,1,0,1
Nagaland,2003,Arson,0,0,0,0,0,0,0,0,0,0,0,0,0,0,0
Nagaland,2003,Criminal Breach Of Trust,0,0,0,0,0,0,0,0,0,0,0,0,0,0,0
Nagaland,2003,Cheating,0,0,0,3,0,3,2,0,2,2,0,2,7,0,7
Nagaland,2003,Counter Feiting,0,0,0,0,0,0,0,0,0,0,0,0,0,0,0
Nagaland,2003,Dowry Deaths,0,0,0,0,0,0,0,0,0,0,0,0,0,0,0
Nagaland,2003,Molestation,0,0,0,0,0,0,0,0,0,0,0,0,0,0,0
Nagaland,2003,Eve-Teasing,0,0,0,0,0,0,0,0,0,0,0,0,0,0,0
Nagaland,2003,Cruelty By Husband Or Relative Of Husband,0,0,0,0,0,0,0,0,0,0,0,0,0,0,0
Nagaland,2003,Other Ipc Crimes,0,0,0,0,0,0,0,0,0,0,0,0,0,0,0
Nagaland,2004,Murder,0,0,0,2,0,2,2,0,2,0,0,0,4,0,4
Nagaland,2004,Attempt To Commit Murder,0,0,0,1,0,1,3,0,3,2,0,2,6,0,6
Nagaland,2004,C.H. Not Amounting To Murder,0,0,0,0,0,0,0,0,0,0,0,0,0,0,0
Nagaland,2004,Rape,0,0,0,0,0,0,2,0,2,0,0,0,2,0,2
Nagaland,2004,Kidnapping And Abduction,0,0,0,0,0,0,0,0,0,0,0,0,0,0,0
Nagaland,2004,Dacoity,0,0,0,16,0,16,8,0,8,0,0,0,24,0,24
Nagaland,2004,Prep. And Assembly For Dacoity,0,0,0,0,0,0,0,0,0,0,0,0,0,0,0
Nagaland,2004,Robbery,0,0,0,10,0,10,5,0,5,0,0,0,15,0,15
Nagaland,2004,Burglary,0,0,0,0,0,0,0,0,0,0,0,0,0,0,0
Nagaland,2004,Thefts,0,0,0,4,0,4,7,0,7,0,0,0,11,0,11
Nagaland,2004,Extortion,0,0,0,7,0,7,21,0,21,7,0,7,35,0,35
Nagaland,2004,Riots,0,0,0,0,0,0,0,0,0,0,0,0,0,0,0
Nagaland,2004,Arson,0,0,0,0,0,0,0,0,0,0,0,0,0,0,0
Nagaland,2004,Criminal Breach Of Trust,0,0,0,0,0,0,0,0,0,0,0,0,0,0,0
Nagaland,2004,Cheating,0,0,0,0,0,0,15,0,15,5,0,5,20,0,20
Nagaland,2004,Counter Feiting,0,0,0,0,0,0,0,0,0,0,0,0,0,0,0
Nagaland,2004,Dowry Deaths,0,0,0,0,0,0,0,0,0,0,0,0,0,0,0
Nagaland,2004,Molestation,0,0,0,0,0,0,0,0,0,0,0,0,0,0,0
Nagaland,2004,Eve-Teasing,0,0,0,0,0,0,0,0,0,0,0,0,0,0,0
Nagaland,2004,Cruelty By Husband Or Relative Of Husband,0,0,0,0,0,0,0,0,0,0,0,0,0,0,0
Nagaland,2004,Other Ipc Crimes,0,0,0,0,0,0,0,0,0,0,0,0,0,0,0
Nagaland,2005,Murder,0,0,0,2,0,2,2,2,4,5,0,5,9,2,11
Nagaland,2005,Attempt To Commit Murder,0,0,0,0,0,0,3,0,3,0,0,0,3,0,3
Nagaland,2005,C.H. Not Amounting To Murder,0,0,0,0,0,0,0,0,0,0,0,0,0,0,0
Nagaland,2005,Rape,0,0,0,1,0,1,1,0,1,0,0,0,2,0,2
Nagaland,2005,Kidnapping And Abduction,0,0,0,0,0,0,0,0,0,0,0,0,0,0,0
Nagaland,2005,Dacoity,0,0,0,0,0,0,0,0,0,0,0,0,0,0,0
Nagaland,2005,Prep. And Assembly For Dacoity,0,0,0,0,0,0,0,0,0,4,0,4,4,0,4
Nagaland,2005,Robbery,0,0,0,4,0,4,10,0,10,0,0,0,14,0,14
Nagaland,2005,Burglary,0,0,0,0,0,0,0,0,0,0,0,0,0,0,0
Nagaland,2005,Thefts,0,0,0,7,2,9,0,0,0,0,0,0,7,2,9
Nagaland,2005,Extortion,0,0,0,10,0,10,15,0,15,10,0,10,35,0,35
Nagaland,2005,Riots,0,0,0,0,0,0,0,0,0,0,0,0,0,0,0
Nagaland,2005,Arson,0,0,0,0,0,0,0,0,0,0,0,0,0,0,0
Nagaland,2005,Criminal Breach Of Trust,0,0,0,0,0,0,0,0,0,0,0,0,0,0,0
Nagaland,2005,Cheating,0,0,0,10,0,10,15,0,15,0,0,0,25,0,25
Nagaland,2005,Counter Feiting,0,0,0,0,0,0,0,0,0,0,0,0,0,0,0
Nagaland,2005,Dowry Deaths,0,0,0,0,0,0,0,0,0,0,0,0,0,0,0
Nagaland,2005,Molestation,0,0,0,0,0,0,0,0,0,0,0,0,0,0,0
Nagaland,2005,Eve-Teasing,0,0,0,0,0,0,0,0,0,0,0,0,0,0,0
Nagaland,2005,Cruelty By Husband Or Relative Of Husband,0,0,0,0,0,0,0,0,0,0,0,0,0,0,0
Nagaland,2005,Other Ipc Crimes,0,0,0,0,0,0,0,0,0,0,0,0,0,0,0
Nagaland,2006,Murder,0,0,0,2,0,2,10,0,10,5,0,5,17,0,17
Nagaland,2006,Attempt To Commit Murder,0,0,0,3,0,3,0,2,2,0,0,0,3,2,5
Nagaland,2006,C.H. Not Amounting To Murder,0,0,0,0,0,0,0,0,0,0,0,0,0,0,0
Nagaland,2006,Rape,0,0,0,2,0,2,2,0,2,0,0,0,4,0,4
Nagaland,2006,Kidnapping And Abduction,0,0,0,0,0,0,0,0,0,0,0,0,0,0,0
Nagaland,2006,Dacoity,0,0,0,0,0,0,0,0,0,0,0,0,0,0,0
Nagaland,2006,Prep. And Assembly For Dacoity,0,0,0,0,0,0,0,0,0,0,0,0,0,0,0
Nagaland,2006,Robbery,0,0,0,0,0,0,10,0,10,0,0,0,10,0,10
Nagaland,2006,Burglary,0,0,0,0,0,0,0,0,0,0,0,0,0,0,0
Nagaland,2006,Thefts,0,0,0,10,1,11,6,0,6,0,0,0,16,1,17
Nagaland,2006,Extortion,0,0,0,10,0,10,21,0,21,0,0,0,31,0,31
Nagaland,2006,Riots,0,0,0,0,0,0,0,0,0,0,0,0,0,0,0
Nagaland,2006,Arson,0,0,0,0,0,0,0,0,0,0,0,0,0,0,0
Nagaland,2006,Criminal Breach Of Trust,0,0,0,0,0,0,0,0,0,0,0,0,0,0,0
Nagaland,2006,Cheating,0,0,0,6,0,6,7,0,7,0,0,0,13,0,13
Nagaland,2006,Counter Feiting,0,0,0,0,0,0,0,0,0,0,0,0,0,0,0
Nagaland,2006,Dowry Deaths,0,0,0,0,0,0,0,0,0,0,0,0,0,0,0
Nagaland,2006,Molestation,0,0,0,0,0,0,0,0,0,0,0,0,0,0,0
Nagaland,2006,Eve-Teasing,0,0,0,0,0,0,0,0,0,0,0,0,0,0,0
Nagaland,2006,Cruelty By Husband Or Relative Of Husband,0,0,0,0,0,0,0,0,0,0,0,0,0,0,0
Nagaland,2006,Other Ipc Crimes,0,0,0,0,0,0,0,0,0,0,0,0,0,0,0
Nagaland,2007,Murder,0,0,0,0,0,0,5,1,6,2,0,2,7,1,8
Nagaland,2007,Attempt To Commit Murder,0,0,0,7,0,7,4,0,4,0,0,0,11,0,11
Nagaland,2007,C.H. Not Amounting To Murder,0,0,0,0,0,0,0,0,0,4,0,4,4,0,4
Nagaland,2007,Rape,0,0,0,3,0,3,4,0,4,0,0,0,7,0,7
Nagaland,2007,Kidnapping And Abduction,0,0,0,3,0,3,0,0,0,0,0,0,3,0,3
Nagaland,2007,Dacoity,0,0,0,0,0,0,0,0,0,0,0,0,0,0,0
Nagaland,2007,Prep. And Assembly For Dacoity,0,0,0,0,0,0,0,0,0,0,0,0,0,0,0
Nagaland,2007,Robbery,0,0,0,0,0,0,0,0,0,0,0,0,0,0,0
Nagaland,2007,Burglary,0,0,0,0,0,0,0,0,0,0,0,0,0,0,0
Nagaland,2007,Thefts,1,0,1,1,0,1,5,0,5,3,0,3,10,0,10
Nagaland,2007,Extortion,0,0,0,8,0,8,7,1,8,0,0,0,15,1,16
Nagaland,2007,Riots,0,0,0,0,0,0,0,0,0,0,0,0,0,0,0
Nagaland,2007,Arson,0,0,0,0,0,0,0,0,0,0,0,0,0,0,0
Nagaland,2007,Criminal Breach Of Trust,0,0,0,0,0,0,0,0,0,0,0,0,0,0,0
Nagaland,2007,Cheating,0,0,0,2,0,2,0,0,0,0,0,0,2,0,2
Nagaland,2007,Counter Feiting,0,0,0,0,0,0,0,0,0,0,0,0,0,0,0
Nagaland,2007,Dowry Deaths,0,0,0,0,0,0,0,0,0,0,0,0,0,0,0
Nagaland,2007,Molestation,0,0,0,0,0,0,0,0,0,0,0,0,0,0,0
Nagaland,2007,Eve-Teasing,0,0,0,0,0,0,0,0,0,0,0,0,0,0,0
Nagaland,2007,Cruelty By Husband Or Relative Of Husband,0,0,0,0,0,0,0,0,0,0,0,0,0,0,0
Nagaland,2007,Other Ipc Crimes,0,0,0,0,0,0,0,0,0,0,0,0,0,0,0
Nagaland,2008,Murder,0,0,0,0,0,0,5,1,6,2,0,2,7,1,8
Nagaland,2008,Attempt To Commit Murder,0,0,0,7,0,7,4,0,4,0,0,0,11,0,11
Nagaland,2008,C.H. Not Amounting To Murder,0,0,0,0,0,0,0,0,0,4,0,4,4,0,4
Nagaland,2008,Rape,0,0,0,2,0,2,1,0,1,2,0,2,5,0,5
Nagaland,2008,Kidnapping And Abduction,0,0,0,0,0,0,7,0,7,0,0,0,7,0,7
Nagaland,2008,Dacoity,0,0,0,0,0,0,0,0,0,0,0,0,0,0,0
Nagaland,2008,Prep. And Assembly For Dacoity,0,0,0,0,0,0,0,0,0,0,0,0,0,0,0
Nagaland,2008,Robbery,0,0,0,0,0,0,10,0,10,0,0,0,10,0,10
Nagaland,2008,Burglary,0,0,0,0,0,0,0,0,0,0,0,0,0,0,0
Nagaland,2008,Thefts,0,0,0,7,0,7,10,0,10,0,0,0,17,0,17
Nagaland,2008,Extortion,0,0,0,17,1,18,8,0,8,10,0,10,35,1,36
Nagaland,2008,Riots,0,0,0,4,0,4,0,0,0,4,0,4,8,0,8
Nagaland,2008,Arson,0,0,0,0,0,0,0,0,0,0,0,0,0,0,0
Nagaland,2008,Criminal Breach Of Trust,0,0,0,0,0,0,0,0,0,0,0,0,0,0,0
Nagaland,2008,Cheating,0,0,0,0,0,0,0,0,0,0,0,0,0,0,0
Nagaland,2008,Counter Feiting,0,0,0,0,0,0,0,0,0,0,0,0,0,0,0
Nagaland,2008,Dowry Deaths,0,0,0,0,0,0,0,0,0,0,0,0,0,0,0
Nagaland,2008,Molestation,0,0,0,0,0,0,0,0,0,0,0,0,0,0,0
Nagaland,2008,Eve-Teasing,0,0,0,0,0,0,0,0,0,0,0,0,0,0,0
Nagaland,2008,Cruelty By Husband Or Relative Of Husband,0,0,0,0,0,0,0,0,0,0,0,0,0,0,0
Nagaland,2008,Other Ipc Crimes,0,0,0,0,0,0,0,0,0,6,0,6,6,0,6
Nagaland,2009,Murder,0,0,0,5,0,5,9,0,9,1,0,1,15,0,15
Nagaland,2009,Attempt To Commit Murder,0,0,0,2,0,2,5,2,7,0,0,0,7,2,9
Nagaland,2009,C.H. Not Amounting To Murder,0,0,0,4,0,4,0,0,0,0,0,0,4,0,4
Nagaland,2009,Rape,0,0,0,2,0,2,3,0,3,1,0,1,6,0,6
Nagaland,2009,Kidnapping And Abduction,0,0,0,2,0,2,4,0,4,0,0,0,6,0,6
Nagaland,2009,Dacoity,0,0,0,0,0,0,0,0,0,0,0,0,0,0,0
Nagaland,2009,Prep. And Assembly For Dacoity,0,0,0,1,0,1,2,0,2,0,0,0,3,0,3
Nagaland,2009,Robbery,0,0,0,4,0,4,3,0,3,0,0,0,7,0,7
Nagaland,2009,Burglary,0,0,0,2,0,2,2,0,2,0,0,0,4,0,4
Nagaland,2009,Thefts,0,0,0,16,0,16,19,0,19,4,0,4,39,0,39
Nagaland,2009,Extortion,0,0,0,8,0,8,11,0,11,2,0,2,21,0,21
Nagaland,2009,Riots,0,0,0,0,0,0,0,0,0,0,0,0,0,0,0
Nagaland,2009,Arson,0,0,0,0,0,0,0,0,0,0,0,0,0,0,0
Nagaland,2009,Criminal Breach Of Trust,0,0,0,0,0,0,0,0,0,0,0,0,0,0,0
Nagaland,2009,Cheating,0,0,0,1,0,1,2,0,2,0,0,0,3,0,3
Nagaland,2009,Counter Feiting,0,0,0,0,0,0,0,0,0,0,0,0,0,0,0
Nagaland,2009,Dowry Deaths,0,0,0,0,0,0,0,0,0,0,0,0,0,0,0
Nagaland,2009,Molestation,0,0,0,0,0,0,2,0,2,0,0,0,2,0,2
Nagaland,2009,Eve-Teasing,0,0,0,0,0,0,0,0,0,0,0,0,0,0,0
Nagaland,2009,Cruelty By Husband Or Relative Of Husband,0,0,0,0,0,0,0,0,0,0,0,0,0,0,0
Nagaland,2009,Other Ipc Crimes,0,0,0,2,0,2,3,0,3,2,0,2,7,0,7
Nagaland,2010,Murder,0,0,0,5,0,5,2,0,2,2,0,2,9,0,9
Nagaland,2010,Attempt To Commit Murder,0,0,0,4,0,4,1,0,1,1,0,1,6,0,6
Nagaland,2010,C.H. Not Amounting To Murder,0,0,0,3,0,3,2,0,2,0,0,0,5,0,5
Nagaland,2010,Rape,0,0,0,8,0,8,2,0,2,1,0,1,11,0,11
Nagaland,2010,Kidnapping And Abduction,0,0,0,4,0,4,3,0,3,2,0,2,9,0,9
Nagaland,2010,Dacoity,0,0,0,0,0,0,2,0,2,0,0,0,2,0,2
Nagaland,2010,Prep. And Assembly For Dacoity,0,0,0,0,0,0,0,0,0,0,0,0,0,0,0
Nagaland,2010,Robbery,0,0,0,4,0,4,3,0,3,2,0,2,9,0,9
Nagaland,2010,Burglary,0,0,0,2,0,2,2,0,2,0,0,0,4,0,4
Nagaland,2010,Thefts,0,0,0,7,0,7,3,0,3,3,0,3,13,0,13
Nagaland,2010,Extortion,0,0,0,8,0,8,3,0,3,3,0,3,14,0,14
Nagaland,2010,Riots,0,0,0,0,0,0,0,0,0,0,0,0,0,0,0
Nagaland,2010,Arson,0,0,0,0,0,0,0,0,0,0,0,0,0,0,0
Nagaland,2010,Criminal Breach Of Trust,0,0,0,0,0,0,0,0,0,0,0,0,0,0,0
Nagaland,2010,Cheating,0,0,0,5,0,5,3,0,3,4,0,4,12,0,12
Nagaland,2010,Counter Feiting,0,0,0,0,0,0,0,0,0,0,0,0,0,0,0
Nagaland,2010,Dowry Deaths,0,0,0,0,0,0,0,0,0,0,0,0,0,0,0
Nagaland,2010,Molestation,0,0,0,2,0,2,2,0,2,1,0,1,5,0,5
Nagaland,2010,Eve-Teasing,0,0,0,0,0,0,0,0,0,0,0,0,0,0,0
Nagaland,2010,Cruelty By Husband Or Relative Of Husband,0,0,0,0,1,1,0,0,0,0,0,0,0,1,1
Nagaland,2010,Other Ipc Crimes,0,0,0,6,0,6,2,0,2,2,0,2,10,0,10
Nagaland,2011,Murder,0,0,0,20,0,20,15,5,20,4,0,4,39,5,44
Nagaland,2011,Attempt To Commit Murder,0,0,0,3,0,3,2,0,2,0,0,0,5,0,5
Nagaland,2011,C.H. Not Amounting To Murder,0,0,0,1,0,1,0,0,0,0,0,0,1,0,1
Nagaland,2011,Rape,0,0,0,7,0,7,2,0,2,1,0,1,10,0,10
Nagaland,2011,Kidnapping And Abduction,0,0,0,2,0,2,2,0,2,0,0,0,4,0,4
Nagaland,2011,Dacoity,0,0,0,0,0,0,0,0,0,0,0,0,0,0,0
Nagaland,2011,Prep. And Assembly For Dacoity,0,0,0,0,0,0,0,0,0,0,0,0,0,0,0
Nagaland,2011,Robbery,0,0,0,3,0,3,0,0,0,0,0,0,3,0,3
Nagaland,2011,Burglary,0,0,0,2,0,2,1,0,1,0,0,0,3,0,3
Nagaland,2011,Thefts,0,0,0,16,0,16,10,0,10,0,0,0,26,0,26
Nagaland,2011,Extortion,0,0,0,1,0,1,1,0,1,0,0,0,2,0,2
Nagaland,2011,Riots,0,0,0,0,0,0,0,0,0,0,0,0,0,0,0
Nagaland,2011,Arson,0,0,0,0,0,0,0,0,0,0,0,0,0,0,0
Nagaland,2011,Criminal Breach Of Trust,0,0,0,0,0,0,0,0,0,0,0,0,0,0,0
Nagaland,2011,Cheating,0,0,0,0,0,0,0,0,0,0,0,0,0,0,0
Nagaland,2011,Counter Feiting,0,0,0,0,0,0,0,0,0,0,0,0,0,0,0
Nagaland,2011,Dowry Deaths,0,0,0,0,0,0,0,0,0,0,0,0,0,0,0
Nagaland,2011,Molestation,0,0,0,0,0,0,0,0,0,0,0,0,0,0,0
Nagaland,2011,Eve-Teasing,0,0,0,0,0,0,0,0,0,0,0,0,0,0,0
Nagaland,2011,Cruelty By Husband Or Relative Of Husband,0,0,0,0,0,0,0,0,0,0,0,0,0,0,0
Nagaland,2011,Other Ipc Crimes,0,0,0,6,0,6,6,0,6,0,0,0,12,0,12
Nagaland,2012,Murder,0,0,0,11,0,11,17,2,19,3,0,3,31,2,33
Nagaland,2012,Attempt To Commit Murder,0,0,0,2,1,3,2,0,2,0,0,0,4,1,5
Nagaland,2012,C.H. Not Amounting To Murder,0,0,0,2,0,2,1,0,1,0,0,0,3,0,3
Nagaland,2012,Rape,0,0,0,5,0,5,5,0,5,0,0,0,10,0,10
Nagaland,2012,Kidnapping And Abduction,0,0,0,2,0,2,0,0,0,0,0,0,2,0,2
Nagaland,2012,Dacoity,0,0,0,0,0,0,0,0,0,0,0,0,0,0,0
Nagaland,2012,Prep. And Assembly For Dacoity,0,0,0,0,0,0,0,0,0,0,0,0,0,0,0
Nagaland,2012,Robbery,0,0,0,2,0,2,0,0,0,1,0,1,3,0,3
Nagaland,2012,Burglary,0,0,0,7,0,7,1,0,1,0,0,0,8,0,8
Nagaland,2012,Thefts,0,0,0,13,0,13,2,0,2,0,0,0,15,0,15
Nagaland,2012,Extortion,0,0,0,2,0,2,2,0,2,0,0,0,4,0,4
Nagaland,2012,Riots,0,0,0,0,0,0,0,0,0,0,0,0,0,0,0
Nagaland,2012,Arson,0,0,0,0,0,0,0,0,0,0,0,0,0,0,0
Nagaland,2012,Criminal Breach Of Trust,0,0,0,0,0,0,0,0,0,0,0,0,0,0,0
Nagaland,2012,Cheating,0,0,0,3,0,3,0,0,0,0,0,0,3,0,3
Nagaland,2012,Counter Feiting,0,0,0,0,0,0,0,0,0,0,0,0,0,0,0
Nagaland,2012,Dowry Deaths,0,0,0,0,0,0,0,0,0,0,0,0,0,0,0
Nagaland,2012,Molestation,0,0,0,0,0,0,1,0,1,0,0,0,1,0,1
Nagaland,2012,Eve-Teasing,0,0,0,0,0,0,0,0,0,0,0,0,0,0,0
Nagaland,2012,Cruelty By Husband Or Relative Of Husband,0,0,0,0,0,0,1,0,1,0,0,0,1,0,1
Nagaland,2012,Other Ipc Crimes,0,0,0,21,0,21,7,0,7,1,0,1,29,0,29
Orissa,2001,Murder,3,0,3,367,8,375,1023,18,1041,239,7,246,1632,33,1665
Orissa,2001,Attempt To Commit Murder,0,0,0,70,1,71,40,0,40,7,0,7,117,1,118
Orissa,2001,C.H. Not Amounting To Murder,0,0,0,24,1,25,20,2,22,1,2,3,45,5,50
Orissa,2001,Rape,0,0,0,81,0,81,70,0,70,10,0,10,161,0,161
Orissa,2001,Kidnapping And Abduction,0,0,0,5,1,6,16,0,16,2,0,2,23,1,24
Orissa,2001,Dacoity,0,0,0,29,0,29,33,0,33,8,0,8,70,0,70
Orissa,2001,Prep. And Assembly For Dacoity,0,0,0,12,0,12,9,6,15,4,0,4,25,6,31
Orissa,2001,Robbery,0,0,0,27,0,27,15,0,15,3,0,3,45,0,45
Orissa,2001,Burglary,0,0,0,13,0,13,23,0,23,5,0,5,41,0,41
Orissa,2001,Thefts,2,0,2,75,0,75,42,0,42,4,0,4,123,0,123
Orissa,2001,Extortion,0,0,0,5,0,5,0,0,0,0,0,0,5,0,5
Orissa,2001,Riots,0,0,0,22,0,22,12,0,12,3,0,3,37,0,37
Orissa,2001,Arson,0,0,0,4,0,4,4,0,4,0,0,0,8,0,8
Orissa,2001,Criminal Breach Of Trust,0,0,0,29,0,29,36,0,36,39,0,39,104,0,104
Orissa,2001,Cheating,0,0,0,5,1,6,12,0,12,0,0,0,17,1,18
Orissa,2001,Counter Feiting,0,0,0,1,0,1,0,0,0,0,0,0,1,0,1
Orissa,2001,Dowry Deaths,0,0,0,6,0,6,25,0,25,8,1,9,39,1,40
Orissa,2001,Molestation,0,0,0,3,0,3,12,0,12,0,0,0,15,0,15
Orissa,2001,Eve-Teasing,0,0,0,1,0,1,0,0,0,0,0,0,1,0,1
Orissa,2001,Cruelty By Husband Or Relative Of Husband,0,0,0,3,0,3,19,0,19,0,0,0,22,0,22
Orissa,2001,Other Ipc Crimes,0,0,0,35,0,35,17,0,17,7,3,10,59,3,62
Orissa,2002,Murder,3,0,3,504,6,510,986,15,1001,351,9,360,1844,30,1874
Orissa,2002,Attempt To Commit Murder,3,0,3,81,1,82,57,1,58,17,1,18,158,3,161
Orissa,2002,C.H. Not Amounting To Murder,0,0,0,10,0,10,25,0,25,15,0,15,50,0,50
Orissa,2002,Rape,0,0,0,52,0,52,63,0,63,8,0,8,123,0,123
Orissa,2002,Kidnapping And Abduction,0,0,0,9,0,9,8,0,8,4,0,4,21,0,21
Orissa,2002,Dacoity,0,0,0,23,0,23,27,0,27,18,0,18,68,0,68
Orissa,2002,Prep. And Assembly For Dacoity,0,0,0,9,0,9,1,0,1,3,0,3,13,0,13
Orissa,2002,Robbery,0,0,0,22,0,22,11,0,11,12,0,12,45,0,45
Orissa,2002,Burglary,0,0,0,18,0,18,16,0,16,0,0,0,34,0,34
Orissa,2002,Thefts,0,0,0,97,2,99,51,7,58,43,1,44,191,10,201
Orissa,2002,Extortion,0,0,0,3,0,3,2,0,2,1,0,1,6,0,6
Orissa,2002,Riots,0,0,0,11,0,11,27,0,27,9,0,9,47,0,47
Orissa,2002,Arson,0,0,0,3,0,3,2,0,2,0,0,0,5,0,5
Orissa,2002,Criminal Breach Of Trust,0,0,0,4,0,4,2,0,2,1,0,1,7,0,7
Orissa,2002,Cheating,0,0,0,5,0,5,10,0,10,14,0,14,29,0,29
Orissa,2002,Counter Feiting,0,0,0,0,0,0,10,0,10,0,0,0,10,0,10
Orissa,2002,Dowry Deaths,0,0,0,16,0,16,19,2,21,12,0,12,47,2,49
Orissa,2002,Molestation,0,0,0,2,0,2,5,0,5,0,0,0,7,0,7
Orissa,2002,Eve-Teasing,0,0,0,0,0,0,0,0,0,0,0,0,0,0,0
Orissa,2002,Cruelty By Husband Or Relative Of Husband,0,0,0,6,0,6,16,0,16,0,0,0,22,0,22
Orissa,2002,Other Ipc Crimes,0,0,0,31,0,31,17,2,19,31,1,32,79,3,82
Orissa,2003,Murder,3,0,3,531,8,539,1006,24,1030,324,8,332,1864,40,1904
Orissa,2003,Attempt To Commit Murder,0,0,0,73,2,75,81,2,83,22,2,24,176,6,182
Orissa,2003,C.H. Not Amounting To Murder,0,0,0,12,0,12,28,0,28,13,0,13,53,0,53
Orissa,2003,Rape,0,0,0,47,0,47,94,0,94,10,0,10,151,0,151
Orissa,2003,Kidnapping And Abduction,0,0,0,8,0,8,13,0,13,5,0,5,26,0,26
Orissa,2003,Dacoity,0,0,0,24,0,24,48,0,48,18,0,18,90,0,90
Orissa,2003,Prep. And Assembly For Dacoity,0,0,0,11,0,11,7,0,7,4,0,4,22,0,22
Orissa,2003,Robbery,0,0,0,29,0,29,21,0,21,14,0,14,64,0,64
Orissa,2003,Burglary,0,0,0,16,0,16,36,0,36,0,0,0,52,0,52
Orissa,2003,Thefts,1,0,1,56,3,59,124,13,137,48,0,48,229,16,245
Orissa,2003,Extortion,0,0,0,3,0,3,7,0,7,0,0,0,10,0,10
Orissa,2003,Riots,0,0,0,10,0,10,51,0,51,8,0,8,69,0,69
Orissa,2003,Arson,0,0,0,2,0,2,13,0,13,0,0,0,15,0,15
Orissa,2003,Criminal Breach Of Trust,0,0,0,2,0,2,7,0,7,0,0,0,9,0,9
Orissa,2003,Cheating,0,0,0,5,0,5,22,0,22,15,0,15,42,0,42
Orissa,2003,Counter Feiting,0,0,0,0,0,0,3,0,3,0,0,0,3,0,3
Orissa,2003,Dowry Deaths,0,0,0,18,0,18,25,0,25,18,0,18,61,0,61
Orissa,2003,Molestation,0,0,0,1,0,1,4,0,4,0,0,0,5,0,5
Orissa,2003,Eve-Teasing,0,0,0,0,0,0,0,0,0,0,0,0,0,0,0
Orissa,2003,Cruelty By Husband Or Relative Of Husband,0,0,0,8,0,8,33,0,33,0,0,0,41,0,41
Orissa,2003,Other Ipc Crimes,0,0,0,24,0,24,41,0,41,21,0,21,86,0,86
Orissa,2004,Murder,4,0,4,722,3,725,1301,33,1334,284,8,292,2311,44,2355
Orissa,2004,Attempt To Commit Murder,0,0,0,46,0,46,72,0,72,11,1,12,129,1,130
Orissa,2004,C.H. Not Amounting To Murder,0,0,0,53,1,54,67,6,73,13,0,13,133,7,140
Orissa,2004,Rape,0,0,0,116,0,116,60,0,60,12,0,12,188,0,188
Orissa,2004,Kidnapping And Abduction,0,0,0,30,0,30,9,1,10,5,0,5,44,1,45
Orissa,2004,Dacoity,0,0,0,91,1,92,39,0,39,4,0,4,134,1,135
Orissa,2004,Prep. And Assembly For Dacoity,0,0,0,21,0,21,7,1,8,9,0,9,37,1,38
Orissa,2004,Robbery,0,0,0,37,0,37,35,0,35,2,0,2,74,0,74
Orissa,2004,Burglary,0,0,0,46,1,47,11,1,12,0,0,0,57,2,59
Orissa,2004,Thefts,0,0,0,87,1,88,37,0,37,2,0,2,126,1,127
Orissa,2004,Extortion,0,0,0,4,0,4,0,0,0,0,0,0,4,0,4
Orissa,2004,Riots,0,0,0,7,0,7,10,0,10,2,0,2,19,0,19
Orissa,2004,Arson,0,0,0,6,0,6,1,0,1,0,0,0,7,0,7
Orissa,2004,Criminal Breach Of Trust,0,0,0,7,0,7,1,0,1,0,0,0,8,0,8
Orissa,2004,Cheating,0,0,0,34,0,34,10,0,10,0,0,0,44,0,44
Orissa,2004,Counter Feiting,0,0,0,0,0,0,0,0,0,0,0,0,0,0,0
Orissa,2004,Dowry Deaths,0,0,0,23,0,23,35,4,39,3,0,3,61,4,65
Orissa,2004,Molestation,0,0,0,7,0,7,7,0,7,0,0,0,14,0,14
Orissa,2004,Eve-Teasing,0,0,0,5,0,5,2,0,2,0,0,0,7,0,7
Orissa,2004,Cruelty By Husband Or Relative Of Husband,0,0,0,13,0,13,4,0,4,0,0,0,17,0,17
Orissa,2004,Other Ipc Crimes,0,0,0,35,2,37,47,0,47,11,0,11,93,2,95
Orissa,2005,Murder,0,0,0,668,6,674,1411,41,1452,349,19,368,2428,66,2494
Orissa,2005,Attempt To Commit Murder,0,0,0,160,1,161,185,0,185,97,0,97,442,1,443
Orissa,2005,C.H. Not Amounting To Murder,0,0,0,88,1,89,42,3,45,31,0,31,161,4,165
Orissa,2005,Rape,0,0,0,140,0,140,46,0,46,12,0,12,198,0,198
Orissa,2005,Kidnapping And Abduction,0,0,0,16,2,18,6,1,7,0,0,0,22,3,25
Orissa,2005,Dacoity,0,0,0,96,0,96,87,0,87,12,0,12,195,0,195
Orissa,2005,Prep. And Assembly For Dacoity,0,0,0,1,0,1,2,0,2,0,0,0,3,0,3
Orissa,2005,Robbery,0,0,0,29,0,29,18,0,18,0,0,0,47,0,47
Orissa,2005,Burglary,0,0,0,39,0,39,18,0,18,4,0,4,61,0,61
Orissa,2005,Thefts,0,0,0,47,0,47,62,0,62,14,0,14,123,0,123
Orissa,2005,Extortion,0,0,0,0,0,0,3,0,3,5,0,5,8,0,8
Orissa,2005,Riots,0,0,0,0,0,0,7,0,7,0,0,0,7,0,7
Orissa,2005,Arson,0,0,0,3,0,3,4,0,4,0,0,0,7,0,7
Orissa,2005,Criminal Breach Of Trust,0,0,0,0,0,0,5,0,5,0,0,0,5,0,5
Orissa,2005,Cheating,0,0,0,2,0,2,1,0,1,0,0,0,3,0,3
Orissa,2005,Counter Feiting,0,0,0,0,0,0,1,0,1,0,0,0,1,0,1
Orissa,2005,Dowry Deaths,0,0,0,34,0,34,30,2,32,33,2,35,97,4,101
Orissa,2005,Molestation,0,0,0,12,0,12,13,0,13,1,0,1,26,0,26
Orissa,2005,Eve-Teasing,0,0,0,1,0,1,0,0,0,0,0,0,1,0,1
Orissa,2005,Cruelty By Husband Or Relative Of Husband,0,0,0,8,1,9,2,0,2,0,0,0,10,1,11
Orissa,2005,Other Ipc Crimes,0,0,0,48,1,49,41,2,43,27,0,27,116,3,119
Orissa,2006,Murder,0,0,0,757,11,768,1502,42,1544,371,10,381,2630,63,2693
Orissa,2006,Attempt To Commit Murder,0,0,0,145,1,146,178,0,178,84,0,84,407,1,408
Orissa,2006,C.H. Not Amounting To Murder,0,0,0,92,1,93,41,2,43,28,0,28,161,3,164
Orissa,2006,Rape,0,0,0,153,0,153,62,0,62,12,0,12,227,0,227
Orissa,2006,Kidnapping And Abduction,0,0,0,10,1,11,8,0,8,5,0,5,23,1,24
Orissa,2006,Dacoity,0,0,0,103,0,103,79,0,79,5,0,5,187,0,187
Orissa,2006,Prep. And Assembly For Dacoity,0,0,0,1,0,1,1,0,1,0,0,0,2,0,2
Orissa,2006,Robbery,0,0,0,36,0,36,22,0,22,0,0,0,58,0,58
Orissa,2006,Burglary,0,0,0,45,0,45,13,0,13,2,0,2,60,0,60
Orissa,2006,Thefts,0,0,0,68,0,68,74,0,74,8,0,8,150,0,150
Orissa,2006,Extortion,0,0,0,0,0,0,3,0,3,0,0,0,3,0,3
Orissa,2006,Riots,0,0,0,0,0,0,2,0,2,0,0,0,2,0,2
Orissa,2006,Arson,0,0,0,2,0,2,2,0,2,0,0,0,4,0,4
Orissa,2006,Criminal Breach Of Trust,0,0,0,0,0,0,4,0,4,0,0,0,4,0,4
Orissa,2006,Cheating,0,0,0,2,0,2,1,0,1,0,0,0,3,0,3
Orissa,2006,Counter Feiting,0,0,0,0,0,0,0,0,0,0,0,0,0,0,0
Orissa,2006,Dowry Deaths,0,0,0,18,0,18,25,2,27,1,0,1,44,2,46
Orissa,2006,Molestation,0,0,0,10,0,10,13,0,13,1,0,1,24,0,24
Orissa,2006,Eve-Teasing,0,0,0,0,0,0,0,0,0,0,0,0,0,0,0
Orissa,2006,Cruelty By Husband Or Relative Of Husband,0,0,0,12,1,13,16,2,18,5,0,5,33,3,36
Orissa,2006,Other Ipc Crimes,0,0,0,31,5,36,52,8,60,18,1,19,101,14,115
Orissa,2007,Murder,0,0,0,778,12,790,1475,48,1523,395,10,405,2648,70,2718
Orissa,2007,Attempt To Commit Murder,0,0,0,148,1,149,151,0,151,84,0,84,383,1,384
Orissa,2007,C.H. Not Amounting To Murder,0,0,0,95,1,96,40,6,46,28,0,28,163,7,170
Orissa,2007,Rape,0,0,0,160,0,160,59,0,59,14,0,14,233,0,233
Orissa,2007,Kidnapping And Abduction,0,0,0,11,0,11,5,0,5,5,0,5,21,0,21
Orissa,2007,Dacoity,0,0,0,113,0,113,68,0,68,6,0,6,187,0,187
Orissa,2007,Prep. And Assembly For Dacoity,0,0,0,1,0,1,1,0,1,0,0,0,2,0,2
Orissa,2007,Robbery,0,0,0,40,0,40,20,0,20,0,0,0,60,0,60
Orissa,2007,Burglary,0,0,0,44,0,44,13,0,13,2,0,2,59,0,59
Orissa,2007,Thefts,0,0,0,76,0,76,62,0,62,12,0,12,150,0,150
Orissa,2007,Extortion,0,0,0,0,0,0,3,0,3,0,0,0,3,0,3
Orissa,2007,Riots,0,0,0,0,0,0,2,0,2,0,0,0,2,0,2
Orissa,2007,Arson,0,0,0,2,0,2,2,0,2,0,0,0,4,0,4
Orissa,2007,Criminal Breach Of Trust,0,0,0,0,0,0,4,0,4,0,0,0,4,0,4
Orissa,2007,Cheating,0,0,0,3,0,3,1,0,1,0,0,0,4,0,4
Orissa,2007,Counter Feiting,0,0,0,0,0,0,0,0,0,0,0,0,0,0,0
Orissa,2007,Dowry Deaths,0,0,0,19,0,19,28,2,30,2,0,2,49,2,51
Orissa,2007,Molestation,0,0,0,10,0,10,8,0,8,1,0,1,19,0,19
Orissa,2007,Eve-Teasing,0,0,0,0,0,0,0,0,0,0,0,0,0,0,0
Orissa,2007,Cruelty By Husband Or Relative Of Husband,0,0,0,15,1,16,18,6,24,8,0,8,41,7,48
Orissa,2007,Other Ipc Crimes,0,0,0,32,1,33,22,10,32,18,1,19,72,12,84
Orissa,2008,Murder,0,0,0,775,17,792,1467,49,1516,382,10,392,2624,76,2700
Orissa,2008,Attempt To Commit Murder,0,0,0,146,2,148,148,2,150,82,0,82,376,4,380
Orissa,2008,C.H. Not Amounting To Murder,0,0,0,93,1,94,40,5,45,26,0,26,159,6,165
Orissa,2008,Rape,0,0,0,159,0,159,57,0,57,14,0,14,230,0,230
Orissa,2008,Kidnapping And Abduction,0,0,0,10,0,10,5,0,5,5,0,5,20,0,20
Orissa,2008,Dacoity,0,0,0,112,0,112,62,0,62,6,0,6,180,0,180
Orissa,2008,Prep. And Assembly For Dacoity,0,0,0,1,0,1,1,0,1,0,0,0,2,0,2
Orissa,2008,Robbery,0,0,0,38,0,38,20,0,20,0,0,0,58,0,58
Orissa,2008,Burglary,0,0,0,43,0,43,13,0,13,2,0,2,58,0,58
Orissa,2008,Thefts,0,0,0,75,2,77,60,8,68,11,2,13,146,12,158
Orissa,2008,Extortion,0,0,0,0,0,0,3,0,3,0,0,0,3,0,3
Orissa,2008,Riots,0,0,0,0,0,0,2,0,2,0,0,0,2,0,2
Orissa,2008,Arson,0,0,0,1,0,1,2,0,2,0,0,0,3,0,3
Orissa,2008,Criminal Breach Of Trust,0,0,0,0,0,0,4,0,4,0,0,0,4,0,4
Orissa,2008,Cheating,0,0,0,2,0,2,1,0,1,0,0,0,3,0,3
Orissa,2008,Counter Feiting,0,0,0,0,0,0,0,0,0,0,0,0,0,0,0
Orissa,2008,Dowry Deaths,0,0,0,17,0,17,29,2,31,2,0,2,48,2,50
Orissa,2008,Molestation,0,0,0,9,0,9,8,0,8,1,0,1,18,0,18
Orissa,2008,Eve-Teasing,0,0,0,0,0,0,0,0,0,0,0,0,0,0,0
Orissa,2008,Cruelty By Husband Or Relative Of Husband,0,0,0,18,1,19,18,6,24,8,0,8,44,7,51
Orissa,2008,Other Ipc Crimes,0,0,0,29,0,29,24,10,34,19,2,21,72,12,84
Orissa,2009,Murder,0,0,0,742,17,759,1449,44,1493,350,8,358,2541,69,2610
Orissa,2009,Attempt To Commit Murder,0,0,0,141,2,143,153,2,155,78,0,78,372,4,376
Orissa,2009,C.H. Not Amounting To Murder,0,0,0,93,1,94,39,3,42,23,0,23,155,4,159
Orissa,2009,Rape,0,0,0,149,0,149,51,0,51,9,0,9,209,0,209
Orissa,2009,Kidnapping And Abduction,0,0,0,10,0,10,5,0,5,3,0,3,18,0,18
Orissa,2009,Dacoity,0,0,0,98,0,98,52,0,52,5,0,5,155,0,155
Orissa,2009,Prep. And Assembly For Dacoity,0,0,0,1,0,1,1,0,1,0,0,0,2,0,2
Orissa,2009,Robbery,0,0,0,33,0,33,18,0,18,0,0,0,51,0,51
Orissa,2009,Burglary,0,0,0,42,0,42,13,0,13,2,0,2,57,0,57
Orissa,2009,Thefts,0,0,0,63,1,64,45,5,50,8,2,10,116,8,124
Orissa,2009,Extortion,0,0,0,0,0,0,3,0,3,0,0,0,3,0,3
Orissa,2009,Riots,0,0,0,0,0,0,2,0,2,0,0,0,2,0,2
Orissa,2009,Arson,0,0,0,1,0,1,2,0,2,0,0,0,3,0,3
Orissa,2009,Criminal Breach Of Trust,0,0,0,0,0,0,3,0,3,0,0,0,3,0,3
Orissa,2009,Cheating,0,0,0,2,0,2,1,0,1,0,0,0,3,0,3
Orissa,2009,Counter Feiting,0,0,0,0,0,0,0,0,0,0,0,0,0,0,0
Orissa,2009,Dowry Deaths,0,0,0,14,0,14,22,2,24,2,0,2,38,2,40
Orissa,2009,Molestation,0,0,0,6,0,6,5,0,5,1,0,1,12,0,12
Orissa,2009,Eve-Teasing,0,0,0,0,0,0,0,0,0,0,0,0,0,0,0
Orissa,2009,Cruelty By Husband Or Relative Of Husband,0,0,0,12,1,13,11,6,17,6,0,6,29,7,36
Orissa,2009,Other Ipc Crimes,0,0,0,20,0,20,19,10,29,12,2,14,51,12,63
Orissa,2010,Murder,0,0,0,728,15,743,1419,48,1467,340,8,348,2487,71,2558
Orissa,2010,Attempt To Commit Murder,0,0,0,135,3,138,149,4,153,76,0,76,360,7,367
Orissa,2010,C.H. Not Amounting To Murder,0,0,0,91,1,92,39,3,42,23,0,23,153,4,157
Orissa,2010,Rape,0,0,0,140,0,140,48,0,48,9,0,9,197,0,197
Orissa,2010,Kidnapping And Abduction,0,0,0,10,1,11,8,0,8,3,0,3,21,1,22
Orissa,2010,Dacoity,0,0,0,97,0,97,50,0,50,5,0,5,152,0,152
Orissa,2010,Prep. And Assembly For Dacoity,0,0,0,1,0,1,3,0,3,0,0,0,4,0,4
Orissa,2010,Robbery,0,0,0,34,0,34,16,0,16,0,0,0,50,0,50
Orissa,2010,Burglary,0,0,0,41,0,41,15,0,15,2,0,2,58,0,58
Orissa,2010,Thefts,0,0,0,64,1,65,44,5,49,8,2,10,116,8,124
Orissa,2010,Extortion,0,0,0,0,0,0,4,0,4,0,0,0,4,0,4
Orissa,2010,Riots,0,0,0,0,0,0,1,0,1,0,0,0,1,0,1
Orissa,2010,Arson,0,0,0,0,0,0,3,0,3,0,0,0,3,0,3
Orissa,2010,Criminal Breach Of Trust,0,0,0,0,0,0,4,0,4,0,0,0,4,0,4
Orissa,2010,Cheating,0,0,0,2,0,2,2,0,2,0,0,0,4,0,4
Orissa,2010,Counter Feiting,0,0,0,0,0,0,0,0,0,0,0,0,0,0,0
Orissa,2010,Dowry Deaths,0,0,0,15,0,15,24,2,26,2,0,2,41,2,43
Orissa,2010,Molestation,0,0,0,5,0,5,2,0,2,1,0,1,8,0,8
Orissa,2010,Eve-Teasing,0,0,0,0,0,0,0,0,0,0,0,0,0,0,0
Orissa,2010,Cruelty By Husband Or Relative Of Husband,0,0,0,11,1,12,14,6,20,6,0,6,31,7,38
Orissa,2010,Other Ipc Crimes,0,0,0,21,0,21,15,10,25,12,2,14,48,12,60
Orissa,2011,Murder,0,0,0,517,5,522,915,45,960,293,10,303,1725,60,1785
Orissa,2011,Attempt To Commit Murder,0,0,0,139,4,143,152,24,176,79,0,79,370,28,398
Orissa,2011,C.H. Not Amounting To Murder,0,0,0,97,1,98,140,8,148,25,0,25,262,9,271
Orissa,2011,Rape,0,0,0,146,0,146,150,0,150,12,0,12,308,0,308
Orissa,2011,Kidnapping And Abduction,0,0,0,13,0,13,10,0,10,5,0,5,28,0,28
Orissa,2011,Dacoity,0,0,0,106,0,106,123,0,123,8,0,8,237,0,237
Orissa,2011,Prep. And Assembly For Dacoity,0,0,0,0,0,0,0,0,0,0,0,0,0,0,0
Orissa,2011,Robbery,0,0,0,40,0,40,16,0,16,0,0,0,56,0,56
Orissa,2011,Burglary,0,0,0,57,0,57,17,0,17,4,0,4,78,0,78
Orissa,2011,Thefts,0,0,0,70,0,70,49,0,49,13,0,13,132,0,132
Orissa,2011,Extortion,0,0,0,0,0,0,0,0,0,0,0,0,0,0,0
Orissa,2011,Riots,0,0,0,0,0,0,0,0,0,0,0,0,0,0,0
Orissa,2011,Arson,0,0,0,6,0,6,3,0,3,2,0,2,11,0,11
Orissa,2011,Criminal Breach Of Trust,0,0,0,9,0,9,7,0,7,4,0,4,20,0,20
Orissa,2011,Cheating,0,0,0,7,0,7,4,0,4,1,0,1,12,0,12
Orissa,2011,Counter Feiting,0,0,0,0,0,0,0,0,0,0,0,0,0,0,0
Orissa,2011,Dowry Deaths,0,0,0,20,0,20,28,2,30,7,0,7,55,2,57
Orissa,2011,Molestation,0,0,0,7,0,7,3,0,3,1,0,1,11,0,11
Orissa,2011,Eve-Teasing,0,0,0,0,0,0,0,0,0,0,0,0,0,0,0
Orissa,2011,Cruelty By Husband Or Relative Of Husband,0,0,0,27,1,28,17,3,20,6,0,6,50,4,54
Orissa,2011,Other Ipc Crimes,0,0,0,29,0,29,24,0,24,10,0,10,63,0,63
Orissa,2012,Murder,0,0,0,604,4,608,864,46,910,459,22,481,1927,72,1999
Orissa,2012,Attempt To Commit Murder,0,0,0,139,4,143,152,4,156,79,0,79,370,8,378
Orissa,2012,C.H. Not Amounting To Murder,0,0,0,97,1,98,40,4,44,25,0,25,162,5,167
Orissa,2012,Rape,0,0,0,146,0,146,50,0,50,12,0,12,208,0,208
Orissa,2012,Kidnapping And Abduction,0,0,0,13,0,13,10,0,10,5,0,5,28,0,28
Orissa,2012,Dacoity,0,0,0,106,0,106,57,0,57,8,0,8,171,0,171
Orissa,2012,Prep. And Assembly For Dacoity,0,0,0,0,0,0,0,0,0,0,0,0,0,0,0
Orissa,2012,Robbery,0,0,0,35,0,35,16,0,16,0,0,0,51,0,51
Orissa,2012,Burglary,0,0,0,48,0,48,23,0,23,4,0,4,75,0,75
Orissa,2012,Thefts,0,0,0,84,0,84,43,0,43,13,0,13,140,0,140
Orissa,2012,Extortion,0,0,0,0,0,0,0,0,0,0,0,0,0,0,0
Orissa,2012,Riots,0,0,0,0,0,0,0,0,0,0,0,0,0,0,0
Orissa,2012,Arson,0,0,0,9,0,9,1,0,1,2,0,2,12,0,12
Orissa,2012,Criminal Breach Of Trust,0,0,0,7,0,7,11,0,11,4,0,4,22,0,22
Orissa,2012,Cheating,0,0,0,11,0,11,2,0,2,1,0,1,14,0,14
Orissa,2012,Counter Feiting,0,0,0,0,0,0,0,0,0,0,0,0,0,0,0
Orissa,2012,Dowry Deaths,0,0,0,7,0,7,24,2,26,7,0,7,38,2,40
Orissa,2012,Molestation,0,0,0,6,0,6,5,0,5,1,0,1,12,0,12
Orissa,2012,Eve-Teasing,0,0,0,0,0,0,0,0,0,0,0,0,0,0,0
Orissa,2012,Cruelty By Husband Or Relative Of Husband,0,0,0,29,1,30,15,3,18,6,0,6,50,4,54
Orissa,2012,Other Ipc Crimes,0,0,0,27,0,27,28,0,28,10,0,10,65,0,65
Punjab,2001,Murder,0,0,0,458,9,467,205,8,213,203,6,209,866,23,889
Punjab,2001,Attempt To Commit Murder,0,0,0,76,7,83,26,5,31,65,2,67,167,14,181
Punjab,2001,C.H. Not Amounting To Murder,0,0,0,0,0,0,85,8,93,36,5,41,121,13,134
Punjab,2001,Rape,0,0,0,65,12,77,0,0,0,5,0,5,70,12,82
Punjab,2001,Kidnapping And Abduction,0,0,0,42,0,42,38,16,54,38,2,40,118,18,136
Punjab,2001,Dacoity,0,0,0,28,0,28,52,20,72,12,0,12,92,20,112
Punjab,2001,Prep. And Assembly For Dacoity,0,0,0,22,0,22,12,0,12,8,0,8,42,0,42
Punjab,2001,Robbery,0,0,0,26,0,26,20,0,20,25,0,25,71,0,71
Punjab,2001,Burglary,0,0,0,15,0,15,25,0,25,9,0,9,49,0,49
Punjab,2001,Thefts,0,0,0,125,0,125,102,5,107,18,0,18,245,5,250
Punjab,2001,Extortion,0,0,0,26,0,26,6,0,6,4,0,4,36,0,36
Punjab,2001,Riots,0,0,0,12,0,12,4,0,4,7,0,7,23,0,23
Punjab,2001,Arson,0,0,0,16,0,16,9,0,9,11,0,11,36,0,36
Punjab,2001,Criminal Breach Of Trust,0,0,0,8,0,8,7,0,7,9,0,9,24,0,24
Punjab,2001,Cheating,0,0,0,35,0,35,40,0,40,46,0,46,121,0,121
Punjab,2001,Counter Feiting,0,0,0,10,0,10,8,0,8,7,0,7,25,0,25
Punjab,2001,Dowry Deaths,0,0,0,6,0,6,4,10,14,16,0,16,26,10,36
Punjab,2001,Molestation,0,0,0,27,0,27,35,0,35,48,0,48,110,0,110
Punjab,2001,Eve-Teasing,0,0,0,4,0,4,3,0,3,2,0,2,9,0,9
Punjab,2001,Cruelty By Husband Or Relative Of Husband,0,0,0,8,0,8,12,0,12,8,0,8,28,0,28
Punjab,2001,Other Ipc Crimes,0,0,0,26,6,32,32,6,38,45,0,45,103,12,115
Punjab,2002,Murder,0,0,0,324,15,339,364,28,392,38,19,57,726,62,788
Punjab,2002,Attempt To Commit Murder,0,0,0,154,1,155,71,6,77,23,3,26,248,10,258
Punjab,2002,C.H. Not Amounting To Murder,0,0,0,96,1,97,90,1,91,15,0,15,201,2,203
Punjab,2002,Rape,0,0,0,65,20,85,30,0,30,0,0,0,95,20,115
Punjab,2002,Kidnapping And Abduction,0,0,0,44,0,44,14,0,14,1,0,1,59,0,59
Punjab,2002,Dacoity,0,0,0,30,0,30,15,0,15,3,0,3,48,0,48
Punjab,2002,Prep. And Assembly For Dacoity,0,0,0,25,0,25,5,0,5,0,0,0,30,0,30
Punjab,2002,Robbery,0,0,0,25,0,25,8,0,8,0,0,0,33,0,33
Punjab,2002,Burglary,0,0,0,23,0,23,9,0,9,0,0,0,32,0,32
Punjab,2002,Thefts,0,0,0,340,0,340,369,0,369,2,0,2,711,0,711
Punjab,2002,Extortion,0,0,0,0,0,0,0,0,0,0,0,0,0,0,0
Punjab,2002,Riots,0,0,0,25,0,25,0,0,0,0,0,0,25,0,25
Punjab,2002,Arson,0,0,0,35,0,35,15,0,15,10,0,10,60,0,60
Punjab,2002,Criminal Breach Of Trust,0,0,0,21,0,21,18,1,19,4,0,4,43,1,44
Punjab,2002,Cheating,0,0,0,32,0,32,25,0,25,0,0,0,57,0,57
Punjab,2002,Counter Feiting,0,0,0,0,0,0,15,0,15,3,0,3,18,0,18
Punjab,2002,Dowry Deaths,0,0,0,18,0,18,16,0,16,4,0,4,38,0,38
Punjab,2002,Molestation,0,0,0,6,1,7,8,2,10,15,4,19,29,7,36
Punjab,2002,Eve-Teasing,0,0,0,4,0,4,6,0,6,3,0,3,13,0,13
Punjab,2002,Cruelty By Husband Or Relative Of Husband,0,0,0,12,3,15,16,3,19,21,4,25,49,10,59
Punjab,2002,Other Ipc Crimes,0,0,0,60,6,66,25,0,25,3,2,5,88,8,96
Punjab,2003,Murder,0,0,0,442,5,447,410,26,436,167,12,179,1019,43,1062
Punjab,2003,Attempt To Commit Murder,0,0,0,158,3,161,166,4,170,36,4,40,360,11,371
Punjab,2003,C.H. Not Amounting To Murder,0,0,0,112,1,113,86,1,87,11,0,11,209,2,211
Punjab,2003,Rape,0,0,0,109,24,133,60,2,62,0,0,0,169,26,195
Punjab,2003,Kidnapping And Abduction,0,0,0,32,0,32,9,0,9,0,0,0,41,0,41
Punjab,2003,Dacoity,0,0,0,33,0,33,20,0,20,2,0,2,55,0,55
Punjab,2003,Prep. And Assembly For Dacoity,0,0,0,28,0,28,8,0,8,0,0,0,36,0,36
Punjab,2003,Robbery,0,0,0,19,0,19,4,0,4,0,0,0,23,0,23
Punjab,2003,Burglary,0,0,0,10,0,10,4,0,4,0,0,0,14,0,14
Punjab,2003,Thefts,0,0,0,172,0,172,73,2,75,82,10,92,327,12,339
Punjab,2003,Extortion,0,0,0,0,0,0,0,0,0,0,0,0,0,0,0
Punjab,2003,Riots,0,0,0,22,0,22,0,0,0,0,0,0,22,0,22
Punjab,2003,Arson,0,0,0,33,0,33,12,0,12,8,0,8,53,0,53
Punjab,2003,Criminal Breach Of Trust,0,0,0,22,0,22,19,1,20,3,0,3,44,1,45
Punjab,2003,Cheating,0,0,0,90,0,90,24,0,24,8,0,8,122,0,122
Punjab,2003,Counter Feiting,0,0,0,2,0,2,5,0,5,0,0,0,7,0,7
Punjab,2003,Dowry Deaths,0,0,0,8,0,8,17,0,17,5,0,5,30,0,30
Punjab,2003,Molestation,0,0,0,4,1,5,9,2,11,13,2,15,26,5,31
Punjab,2003,Eve-Teasing,0,0,0,3,0,3,5,0,5,2,0,2,10,0,10
Punjab,2003,Cruelty By Husband Or Relative Of Husband,0,0,0,10,3,13,14,2,16,10,3,13,34,8,42
Punjab,2003,Other Ipc Crimes,0,0,0,106,0,106,50,0,50,61,0,61,217,0,217
Punjab,2004,Murder,0,0,0,455,5,460,420,24,444,199,10,209,1074,39,1113
Punjab,2004,Attempt To Commit Murder,0,0,0,170,4,174,175,5,180,40,6,46,385,15,400
Punjab,2004,C.H. Not Amounting To Murder,0,0,0,120,2,122,90,1,91,15,0,15,225,3,228
Punjab,2004,Rape,0,0,0,125,26,151,65,3,68,0,0,0,190,29,219
Punjab,2004,Kidnapping And Abduction,0,0,0,30,0,30,10,0,10,0,0,0,40,0,40
Punjab,2004,Dacoity,0,0,0,35,0,35,28,0,28,3,0,3,66,0,66
Punjab,2004,Prep. And Assembly For Dacoity,0,0,0,31,0,31,12,0,12,0,0,0,43,0,43
Punjab,2004,Robbery,0,0,0,28,0,28,5,0,5,0,0,0,33,0,33
Punjab,2004,Burglary,0,0,0,11,0,11,5,0,5,0,0,0,16,0,16
Punjab,2004,Thefts,0,0,0,180,0,180,83,2,85,96,10,106,359,12,371
Punjab,2004,Extortion,0,0,0,0,0,0,0,0,0,0,0,0,0,0,0
Punjab,2004,Riots,0,0,0,25,0,25,0,1,1,0,0,0,25,1,26
Punjab,2004,Arson,0,0,0,36,0,36,21,0,21,12,0,12,69,0,69
Punjab,2004,Criminal Breach Of Trust,0,0,0,30,0,30,29,1,30,5,0,5,64,1,65
Punjab,2004,Cheating,0,0,0,98,0,98,29,0,29,16,0,16,143,0,143
Punjab,2004,Counter Feiting,0,0,0,4,0,4,6,0,6,0,0,0,10,0,10
Punjab,2004,Dowry Deaths,0,0,0,10,1,11,28,0,28,14,0,14,52,1,53
Punjab,2004,Molestation,0,0,0,9,1,10,17,2,19,25,3,28,51,6,57
Punjab,2004,Eve-Teasing,0,0,0,5,0,5,6,0,6,3,3,6,14,3,17
Punjab,2004,Cruelty By Husband Or Relative Of Husband,0,0,0,15,4,19,26,0,26,18,5,23,59,9,68
Punjab,2004,Other Ipc Crimes,0,0,0,122,0,122,65,0,65,79,0,79,266,0,266
Punjab,2005,Murder,0,0,0,275,6,281,431,22,453,395,10,405,1101,38,1139
Punjab,2005,Attempt To Commit Murder,0,0,0,115,19,134,181,4,185,78,6,84,374,29,403
Punjab,2005,C.H. Not Amounting To Murder,0,0,0,88,4,92,88,1,89,36,0,36,212,5,217
Punjab,2005,Rape,0,0,0,102,27,129,66,4,70,0,0,0,168,31,199
Punjab,2005,Kidnapping And Abduction,0,0,0,21,4,25,14,0,14,0,0,0,35,4,39
Punjab,2005,Dacoity,0,0,0,25,0,25,30,0,30,16,0,16,71,0,71
Punjab,2005,Prep. And Assembly For Dacoity,0,0,0,28,0,28,14,0,14,0,0,0,42,0,42
Punjab,2005,Robbery,0,0,0,20,0,20,6,0,6,58,0,58,84,0,84
Punjab,2005,Burglary,0,0,0,12,0,12,7,0,7,0,0,0,19,0,19
Punjab,2005,Thefts,0,0,0,102,0,102,84,1,85,196,2,198,382,3,385
Punjab,2005,Extortion,0,0,0,0,0,0,0,0,0,0,0,0,0,0,0
Punjab,2005,Riots,0,0,0,21,0,21,7,0,7,0,0,0,28,0,28
Punjab,2005,Arson,0,0,0,38,0,38,20,0,20,52,6,58,110,6,116
Punjab,2005,Criminal Breach Of Trust,0,0,0,28,0,28,27,1,28,24,0,24,79,1,80
Punjab,2005,Cheating,0,0,0,80,0,80,24,0,24,38,0,38,142,0,142
Punjab,2005,Counter Feiting,0,0,0,3,0,3,5,0,5,0,0,0,8,0,8
Punjab,2005,Dowry Deaths,0,0,0,11,8,19,27,0,27,25,0,25,63,8,71
Punjab,2005,Molestation,0,0,0,10,2,12,15,3,18,34,3,37,59,8,67
Punjab,2005,Eve-Teasing,0,0,0,4,5,9,5,0,5,13,4,17,22,9,31
Punjab,2005,Cruelty By Husband Or Relative Of Husband,0,0,0,12,2,14,25,0,25,37,8,45,74,10,84
Punjab,2005,Other Ipc Crimes,0,0,0,60,0,60,56,0,56,80,0,80,196,0,196
Punjab,2006,Murder,0,0,0,281,9,290,265,16,281,66,20,86,612,45,657
Punjab,2006,Attempt To Commit Murder,0,0,0,194,11,205,200,17,217,57,27,84,451,55,506
Punjab,2006,C.H. Not Amounting To Murder,0,0,0,71,5,76,166,9,175,60,0,60,297,14,311
Punjab,2006,Rape,0,0,0,192,6,198,167,13,180,6,0,6,365,19,384
Punjab,2006,Kidnapping And Abduction,0,0,0,60,0,60,26,0,26,0,0,0,86,0,86
Punjab,2006,Dacoity,0,0,0,75,0,75,10,0,10,18,0,18,103,0,103
Punjab,2006,Prep. And Assembly For Dacoity,0,0,0,43,0,43,12,0,12,0,0,0,55,0,55
Punjab,2006,Robbery,0,0,0,90,0,90,19,0,19,22,0,22,131,0,131
Punjab,2006,Burglary,0,0,0,33,0,33,20,0,20,0,0,0,53,0,53
Punjab,2006,Thefts,0,0,0,162,0,162,56,19,75,44,0,44,262,19,281
Punjab,2006,Extortion,0,0,0,0,0,0,0,0,0,0,0,0,0,0,0
Punjab,2006,Riots,0,0,0,27,0,27,0,0,0,0,0,0,27,0,27
Punjab,2006,Arson,0,0,0,13,0,13,5,0,5,0,0,0,18,0,18
Punjab,2006,Criminal Breach Of Trust,0,0,0,7,0,7,5,2,7,27,0,27,39,2,41
Punjab,2006,Cheating,0,0,0,43,0,43,3,0,3,7,0,7,53,0,53
Punjab,2006,Counter Feiting,0,0,0,9,0,9,2,0,2,0,0,0,11,0,11
Punjab,2006,Dowry Deaths,0,0,0,47,2,49,21,0,21,3,0,3,71,2,73
Punjab,2006,Molestation,0,0,0,6,2,8,2,0,2,3,2,5,11,4,15
Punjab,2006,Eve-Teasing,0,0,0,7,2,9,9,0,9,0,0,0,16,2,18
Punjab,2006,Cruelty By Husband Or Relative Of Husband,0,0,0,55,10,65,8,0,8,8,7,15,71,17,88
Punjab,2006,Other Ipc Crimes,0,0,0,173,0,173,81,0,81,131,0,131,385,0,385
Punjab,2007,Murder,0,0,0,232,18,250,264,9,273,186,12,198,682,39,721
Punjab,2007,Attempt To Commit Murder,0,0,0,161,19,180,199,10,209,267,18,285,627,47,674
Punjab,2007,C.H. Not Amounting To Murder,0,0,0,29,4,33,160,4,164,180,0,180,369,8,377
Punjab,2007,Rape,0,0,0,82,6,88,166,8,174,4,0,4,252,14,266
Punjab,2007,Kidnapping And Abduction,0,0,0,18,0,18,25,0,25,0,0,0,43,0,43
Punjab,2007,Dacoity,0,0,0,73,0,73,10,0,10,13,0,13,96,0,96
Punjab,2007,Prep. And Assembly For Dacoity,0,0,0,12,0,12,12,0,12,0,0,0,24,0,24
Punjab,2007,Robbery,0,0,0,28,0,28,18,0,18,18,0,18,64,0,64
Punjab,2007,Burglary,0,0,0,20,0,20,19,0,19,0,0,0,39,0,39
Punjab,2007,Thefts,0,0,0,59,0,59,55,15,70,39,0,39,153,15,168
Punjab,2007,Extortion,0,0,0,0,0,0,0,0,0,0,0,0,0,0,0
Punjab,2007,Riots,0,0,0,15,0,15,0,0,0,0,0,0,15,0,15
Punjab,2007,Arson,0,0,0,12,0,12,4,0,4,0,0,0,16,0,16
Punjab,2007,Criminal Breach Of Trust,0,0,0,5,0,5,5,1,6,23,0,23,33,1,34
Punjab,2007,Cheating,0,0,0,42,0,42,2,0,2,2,0,2,46,0,46
Punjab,2007,Counter Feiting,0,0,0,8,0,8,2,0,2,0,0,0,10,0,10
Punjab,2007,Dowry Deaths,0,0,0,25,7,32,20,0,20,1,0,1,46,7,53
Punjab,2007,Molestation,0,0,0,5,2,7,2,0,2,1,0,1,8,2,10
Punjab,2007,Eve-Teasing,0,0,0,6,2,8,8,0,8,0,0,0,14,2,16
Punjab,2007,Cruelty By Husband Or Relative Of Husband,0,0,0,21,4,25,7,0,7,4,0,4,32,4,36
Punjab,2007,Other Ipc Crimes,0,0,0,71,0,71,77,0,77,227,0,227,375,0,375
Punjab,2008,Murder,0,0,0,242,19,261,254,12,266,198,22,220,694,53,747
Punjab,2008,Attempt To Commit Murder,0,0,0,165,20,185,223,12,235,287,24,311,675,56,731
Punjab,2008,C.H. Not Amounting To Murder,0,0,0,33,5,38,180,4,184,185,0,185,398,9,407
Punjab,2008,Rape,0,0,0,87,8,95,186,9,195,4,0,4,277,17,294
Punjab,2008,Kidnapping And Abduction,0,0,0,23,0,23,16,0,16,0,0,0,39,0,39
Punjab,2008,Dacoity,0,0,0,69,0,69,9,0,9,14,0,14,92,0,92
Punjab,2008,Prep. And Assembly For Dacoity,0,0,0,11,0,11,13,0,13,0,0,0,24,0,24
Punjab,2008,Robbery,0,0,0,19,0,19,16,0,16,21,0,21,56,0,56
Punjab,2008,Burglary,0,0,0,33,0,33,29,0,29,0,0,0,62,0,62
Punjab,2008,Thefts,0,0,0,70,0,70,75,17,92,41,0,41,186,17,203
Punjab,2008,Extortion,0,0,0,0,0,0,0,0,0,0,0,0,0,0,0
Punjab,2008,Riots,0,0,0,13,0,13,0,0,0,0,0,0,13,0,13
Punjab,2008,Arson,0,0,0,13,0,13,3,0,3,0,0,0,16,0,16
Punjab,2008,Criminal Breach Of Trust,0,0,0,9,0,9,6,1,7,24,0,24,39,1,40
Punjab,2008,Cheating,0,0,0,65,0,65,8,0,8,6,3,9,79,3,82
Punjab,2008,Counter Feiting,0,0,0,11,0,11,3,0,3,0,0,0,14,0,14
Punjab,2008,Dowry Deaths,0,0,0,31,6,37,16,0,16,4,0,4,51,6,57
Punjab,2008,Molestation,0,0,0,6,2,8,1,0,1,2,0,2,9,2,11
Punjab,2008,Eve-Teasing,0,0,0,7,3,10,7,0,7,0,0,0,14,3,17
Punjab,2008,Cruelty By Husband Or Relative Of Husband,0,0,0,23,4,27,8,0,8,5,0,5,36,4,40
Punjab,2008,Other Ipc Crimes,0,0,0,91,0,91,97,0,97,259,5,264,447,5,452
Punjab,2009,Murder,0,0,0,469,32,501,291,19,310,33,9,42,793,60,853
Punjab,2009,Attempt To Commit Murder,0,0,0,319,39,358,239,22,261,13,2,15,571,63,634
Punjab,2009,C.H. Not Amounting To Murder,0,0,0,129,8,137,42,4,46,7,1,8,178,13,191
Punjab,2009,Rape,0,0,0,216,0,216,97,3,100,0,0,0,313,3,316
Punjab,2009,Kidnapping And Abduction,0,0,0,96,9,105,62,3,65,0,0,0,158,12,170
Punjab,2009,Dacoity,0,0,0,83,0,83,16,0,16,15,0,15,114,0,114
Punjab,2009,Prep. And Assembly For Dacoity,0,0,0,14,0,14,19,0,19,0,0,0,33,0,33
Punjab,2009,Robbery,0,0,0,27,0,27,21,0,21,7,0,7,55,0,55
Punjab,2009,Burglary,0,0,0,76,0,76,67,0,67,0,0,0,143,0,143
Punjab,2009,Thefts,0,0,0,116,0,116,89,21,110,9,0,9,214,21,235
Punjab,2009,Extortion,0,0,0,0,0,0,0,0,0,0,0,0,0,0,0
Punjab,2009,Riots,0,0,0,28,0,28,8,0,8,0,0,0,36,0,36
Punjab,2009,Arson,0,0,0,44,0,44,10,2,12,0,0,0,54,2,56
Punjab,2009,Criminal Breach Of Trust,0,0,0,109,0,109,69,0,69,3,0,3,181,0,181
Punjab,2009,Cheating,0,0,0,180,0,180,98,3,101,0,1,1,278,4,282
Punjab,2009,Counter Feiting,0,0,0,33,0,33,19,2,21,0,0,0,52,2,54
Punjab,2009,Dowry Deaths,0,0,0,63,21,84,31,17,48,11,0,11,105,38,143
Punjab,2009,Molestation,0,0,0,11,3,14,9,1,10,2,0,2,22,4,26
Punjab,2009,Eve-Teasing,0,0,0,15,4,19,11,0,11,0,0,0,26,4,30
Punjab,2009,Cruelty By Husband Or Relative Of Husband,0,0,0,37,9,46,18,2,20,3,6,9,58,17,75
Punjab,2009,Other Ipc Crimes,0,0,0,219,0,219,103,0,103,0,0,0,322,0,322
Punjab,2010,Murder,0,0,0,485,33,518,316,18,334,32,8,40,833,59,892
Punjab,2010,Attempt To Commit Murder,0,0,0,340,37,377,264,20,284,13,2,15,617,59,676
Punjab,2010,C.H. Not Amounting To Murder,0,0,0,142,8,150,90,4,94,7,1,8,239,13,252
Punjab,2010,Rape,0,0,0,237,0,237,112,0,112,0,0,0,349,0,349
Punjab,2010,Kidnapping And Abduction,0,0,0,112,10,122,115,5,120,0,0,0,227,15,242
Punjab,2010,Dacoity,0,0,0,104,0,104,31,0,31,16,0,16,151,0,151
Punjab,2010,Prep. And Assembly For Dacoity,0,0,0,18,0,18,29,0,29,0,0,0,47,0,47
Punjab,2010,Robbery,0,0,0,45,0,45,37,0,37,8,0,8,90,0,90
Punjab,2010,Burglary,0,0,0,97,0,97,86,0,86,0,0,0,183,0,183
Punjab,2010,Thefts,0,0,0,152,0,152,179,18,197,14,0,14,345,18,363
Punjab,2010,Extortion,0,0,0,0,0,0,0,0,0,0,0,0,0,0,0
Punjab,2010,Riots,0,0,0,49,0,49,18,0,18,0,0,0,67,0,67
Punjab,2010,Arson,0,0,0,65,0,65,20,1,21,0,0,0,85,1,86
Punjab,2010,Criminal Breach Of Trust,0,0,0,130,0,130,89,0,89,5,0,5,224,0,224
Punjab,2010,Cheating,0,0,0,216,0,216,156,2,158,2,1,3,374,3,377
Punjab,2010,Counter Feiting,0,0,0,54,0,54,39,2,41,0,0,0,93,2,95
Punjab,2010,Dowry Deaths,0,0,0,84,23,107,84,15,99,10,2,12,178,40,218
Punjab,2010,Molestation,0,0,0,32,3,35,29,1,30,0,0,0,61,4,65
Punjab,2010,Eve-Teasing,0,0,0,36,3,39,22,0,22,0,0,0,58,3,61
Punjab,2010,Cruelty By Husband Or Relative Of Husband,0,0,0,58,8,66,51,2,53,1,4,5,110,14,124
Punjab,2010,Other Ipc Crimes,0,0,0,249,0,249,254,0,254,2,0,2,505,0,505
Punjab,2011,Murder,0,0,0,463,40,503,320,20,340,34,10,44,817,70,887
Punjab,2011,Attempt To Commit Murder,0,0,0,310,40,350,265,25,290,15,1,16,590,66,656
Punjab,2011,C.H. Not Amounting To Murder,0,0,0,130,10,140,190,20,210,10,0,10,330,30,360
Punjab,2011,Rape,0,0,0,154,0,154,115,0,115,0,0,0,269,0,269
Punjab,2011,Kidnapping And Abduction,0,0,0,115,20,135,130,15,145,0,0,0,245,35,280
Punjab,2011,Dacoity,0,0,0,209,0,209,35,0,35,6,0,6,250,0,250
Punjab,2011,Prep. And Assembly For Dacoity,0,0,0,20,0,20,129,0,129,0,0,0,149,0,149
Punjab,2011,Robbery,0,0,0,62,0,62,140,0,140,0,0,0,202,0,202
Punjab,2011,Burglary,0,0,0,120,0,120,70,0,70,0,0,0,190,0,190
Punjab,2011,Thefts,0,0,0,170,0,170,0,0,0,0,0,0,170,0,170
Punjab,2011,Extortion,0,0,0,0,0,0,180,24,204,5,0,5,185,24,209
Punjab,2011,Riots,0,0,0,152,0,152,120,0,120,0,0,0,272,0,272
Punjab,2011,Arson,0,0,0,70,0,70,25,0,25,2,0,2,97,0,97
Punjab,2011,Criminal Breach Of Trust,0,0,0,150,0,150,60,0,60,0,0,0,210,0,210
Punjab,2011,Cheating,0,0,0,216,0,216,190,5,195,5,0,5,411,5,416
Punjab,2011,Counter Feiting,0,0,0,117,0,117,145,5,150,5,0,5,267,5,272
Punjab,2011,Dowry Deaths,0,0,0,90,30,120,90,20,110,10,2,12,190,52,242
Punjab,2011,Molestation,0,0,0,40,30,70,31,0,31,0,2,2,71,32,103
Punjab,2011,Eve-Teasing,0,0,0,40,2,42,25,0,25,0,0,0,65,2,67
Punjab,2011,Cruelty By Husband Or Relative Of Husband,0,0,0,60,3,63,55,5,60,2,1,3,117,9,126
Punjab,2011,Other Ipc Crimes,0,0,0,104,16,120,20,6,26,6,3,9,130,25,155
Punjab,2012,Murder,0,0,0,405,18,423,742,33,775,251,19,270,1398,70,1468
Punjab,2012,Attempt To Commit Murder,0,0,0,84,5,89,170,7,177,83,2,85,337,14,351
Punjab,2012,C.H. Not Amounting To Murder,0,0,0,68,4,72,114,0,114,48,2,50,230,6,236
Punjab,2012,Rape,0,0,0,97,2,99,118,3,121,42,1,43,257,6,263
Punjab,2012,Kidnapping And Abduction,0,0,0,72,5,77,98,7,105,29,4,33,199,16,215
Punjab,2012,Dacoity,0,0,0,63,0,63,67,0,67,26,0,26,156,0,156
Punjab,2012,Prep. And Assembly For Dacoity,0,0,0,46,0,46,72,0,72,15,0,15,133,0,133
Punjab,2012,Robbery,0,0,0,82,0,82,107,0,107,33,0,33,222,0,222
Punjab,2012,Burglary,0,0,0,81,0,81,54,0,54,18,0,18,153,0,153
Punjab,2012,Thefts,0,0,0,142,3,145,155,3,158,28,0,28,325,6,331
Punjab,2012,Extortion,0,0,0,42,3,45,54,3,57,15,1,16,111,7,118
Punjab,2012,Riots,0,0,0,34,1,35,34,1,35,16,0,16,84,2,86
Punjab,2012,Arson,0,0,0,5,0,5,25,0,25,7,0,7,37,0,37
Punjab,2012,Criminal Breach Of Trust,0,0,0,23,0,23,65,1,66,16,1,17,104,2,106
Punjab,2012,Cheating,0,0,0,45,0,45,73,3,76,32,1,33,150,4,154
Punjab,2012,Counter Feiting,0,0,0,35,0,35,47,0,47,17,1,18,99,1,100
Punjab,2012,Dowry Deaths,0,0,0,116,20,136,201,32,233,81,20,101,398,72,470
Punjab,2012,Molestation,0,0,0,2,0,2,5,0,5,3,0,3,10,0,10
Punjab,2012,Eve-Teasing,0,0,0,8,0,8,5,0,5,2,0,2,15,0,15
Punjab,2012,Cruelty By Husband Or Relative Of Husband,0,0,0,14,0,14,58,0,58,18,0,18,90,0,90
Punjab,2012,Other Ipc Crimes,0,0,0,63,12,75,75,11,86,28,2,30,166,25,191
Rajasthan,2001,Murder,4,0,4,636,5,641,1234,29,1263,338,8,346,2212,42,2254
Rajasthan,2001,Attempt To Commit Murder,0,0,0,110,1,111,104,8,112,40,1,41,254,10,264
Rajasthan,2001,C.H. Not Amounting To Murder,0,0,0,34,0,34,56,9,65,10,3,13,100,12,112
Rajasthan,2001,Rape,2,0,2,110,0,110,140,1,141,30,0,30,282,1,283
Rajasthan,2001,Kidnapping And Abduction,0,0,0,23,0,23,19,0,19,1,0,1,43,0,43
Rajasthan,2001,Dacoity,0,0,0,15,0,15,28,0,28,1,0,1,44,0,44
Rajasthan,2001,Prep. And Assembly For Dacoity,0,0,0,4,0,4,0,0,0,0,0,0,4,0,4
Rajasthan,2001,Robbery,0,0,0,14,0,14,12,0,12,0,0,0,26,0,26
Rajasthan,2001,Burglary,1,0,1,15,0,15,17,0,17,2,0,2,35,0,35
Rajasthan,2001,Thefts,0,0,0,39,0,39,34,0,34,8,0,8,81,0,81
Rajasthan,2001,Extortion,0,0,0,0,0,0,0,0,0,0,0,0,0,0,0
Rajasthan,2001,Riots,0,0,0,7,0,7,5,0,5,1,0,1,13,0,13
Rajasthan,2001,Arson,0,0,0,1,0,1,7,0,7,0,0,0,8,0,8
Rajasthan,2001,Criminal Breach Of Trust,0,0,0,0,0,0,0,0,0,0,0,0,0,0,0
Rajasthan,2001,Cheating,0,0,0,5,0,5,11,0,11,1,0,1,17,0,17
Rajasthan,2001,Counter Feiting,0,0,0,3,0,3,4,1,5,1,0,1,8,1,9
Rajasthan,2001,Dowry Deaths,0,0,0,60,0,60,90,16,106,24,4,28,174,20,194
Rajasthan,2001,Molestation,0,0,0,0,0,0,0,0,0,0,0,0,0,0,0
Rajasthan,2001,Eve-Teasing,0,0,0,0,0,0,0,0,0,0,0,0,0,0,0
Rajasthan,2001,Cruelty By Husband Or Relative Of Husband,2,0,2,42,3,45,20,2,22,0,0,0,64,5,69
Rajasthan,2001,Other Ipc Crimes,0,0,0,35,1,36,63,0,63,19,0,19,117,1,118
Rajasthan,2002,Murder,0,0,0,1059,27,1086,1396,79,1475,433,2,435,2888,108,2996
Rajasthan,2002,Attempt To Commit Murder,0,0,0,84,5,89,117,19,136,49,5,54,250,29,279
Rajasthan,2002,C.H. Not Amounting To Murder,0,0,0,27,1,28,31,2,33,8,0,8,66,3,69
Rajasthan,2002,Rape,0,0,0,178,0,178,115,2,117,25,0,25,318,2,320
Rajasthan,2002,Kidnapping And Abduction,0,0,0,13,0,13,24,0,24,1,0,1,38,0,38
Rajasthan,2002,Dacoity,0,0,0,62,0,62,59,0,59,6,0,6,127,0,127
Rajasthan,2002,Prep. And Assembly For Dacoity,0,0,0,0,0,0,0,0,0,0,0,0,0,0,0
Rajasthan,2002,Robbery,0,0,0,17,0,17,16,0,16,5,0,5,38,0,38
Rajasthan,2002,Burglary,0,0,0,9,0,9,6,0,6,0,0,0,15,0,15
Rajasthan,2002,Thefts,0,0,0,71,2,73,64,4,68,4,0,4,139,6,145
Rajasthan,2002,Extortion,0,0,0,2,0,2,2,0,2,0,0,0,4,0,4
Rajasthan,2002,Riots,0,0,0,13,0,13,11,0,11,2,0,2,26,0,26
Rajasthan,2002,Arson,0,0,0,0,0,0,0,0,0,0,0,0,0,0,0
Rajasthan,2002,Criminal Breach Of Trust,0,0,0,3,0,3,6,0,6,0,0,0,9,0,9
Rajasthan,2002,Cheating,0,0,0,8,1,9,5,2,7,1,0,1,14,3,17
Rajasthan,2002,Counter Feiting,0,0,0,12,0,12,14,0,14,4,0,4,30,0,30
Rajasthan,2002,Dowry Deaths,0,0,0,81,3,84,76,4,80,54,3,57,211,10,221
Rajasthan,2002,Molestation,0,0,0,3,0,3,2,0,2,0,0,0,5,0,5
Rajasthan,2002,Eve-Teasing,0,0,0,0,0,0,0,0,0,0,0,0,0,0,0
Rajasthan,2002,Cruelty By Husband Or Relative Of Husband,0,0,0,2,1,3,5,2,7,0,1,1,7,4,11
Rajasthan,2002,Other Ipc Crimes,0,0,0,25,0,25,29,1,30,2,0,2,56,1,57
Rajasthan,2003,Murder,0,0,0,1427,24,1451,1727,60,1787,583,12,595,3737,96,3833
Rajasthan,2003,Attempt To Commit Murder,0,0,0,158,8,166,113,22,135,51,4,55,322,34,356
Rajasthan,2003,C.H. Not Amounting To Murder,0,0,0,36,7,43,51,8,59,19,0,19,106,15,121
Rajasthan,2003,Rape,0,0,0,224,0,224,111,0,111,25,0,25,360,0,360
Rajasthan,2003,Kidnapping And Abduction,0,0,0,11,0,11,15,0,15,0,0,0,26,0,26
Rajasthan,2003,Dacoity,0,0,0,73,0,73,45,0,45,6,0,6,124,0,124
Rajasthan,2003,Prep. And Assembly For Dacoity,0,0,0,10,0,10,0,0,0,0,0,0,10,0,10
Rajasthan,2003,Robbery,0,0,0,13,0,13,10,0,10,3,0,3,26,0,26
Rajasthan,2003,Burglary,0,0,0,18,0,18,7,0,7,1,0,1,26,0,26
Rajasthan,2003,Thefts,0,0,0,89,4,93,47,2,49,6,0,6,142,6,148
Rajasthan,2003,Extortion,0,0,0,8,0,8,2,0,2,1,0,1,11,0,11
Rajasthan,2003,Riots,0,0,0,14,0,14,33,0,33,6,0,6,53,0,53
Rajasthan,2003,Arson,0,0,0,0,0,0,0,0,0,0,0,0,0,0,0
Rajasthan,2003,Criminal Breach Of Trust,0,0,0,4,0,4,4,0,4,1,0,1,9,0,9
Rajasthan,2003,Cheating,0,0,0,15,0,15,13,2,15,5,0,5,33,2,35
Rajasthan,2003,Counter Feiting,0,0,0,10,0,10,14,0,14,6,0,6,30,0,30
Rajasthan,2003,Dowry Deaths,0,0,0,73,3,76,84,7,91,39,2,41,196,12,208
Rajasthan,2003,Molestation,0,0,0,0,0,0,0,0,0,0,0,0,0,0,0
Rajasthan,2003,Eve-Teasing,0,0,0,0,0,0,0,0,0,0,0,0,0,0,0
Rajasthan,2003,Cruelty By Husband Or Relative Of Husband,0,0,0,5,1,6,4,1,5,1,0,1,10,2,12
Rajasthan,2003,Other Ipc Crimes,0,0,0,48,0,48,36,0,36,10,0,10,94,0,94
Rajasthan,2004,Murder,0,0,0,1382,13,1395,1578,40,1618,552,16,568,3512,69,3581
Rajasthan,2004,Attempt To Commit Murder,0,0,0,69,4,73,132,12,144,55,6,61,256,22,278
Rajasthan,2004,C.H. Not Amounting To Murder,0,0,0,9,0,9,41,0,41,8,0,8,58,0,58
Rajasthan,2004,Rape,0,0,0,124,0,124,129,1,130,41,1,42,294,2,296
Rajasthan,2004,Kidnapping And Abduction,0,0,0,28,0,28,25,0,25,1,0,1,54,0,54
Rajasthan,2004,Dacoity,0,0,0,119,0,119,82,3,85,21,3,24,222,6,228
Rajasthan,2004,Prep. And Assembly For Dacoity,0,0,0,88,2,90,49,3,52,23,0,23,160,5,165
Rajasthan,2004,Robbery,0,0,0,36,0,36,19,1,20,6,2,8,61,3,64
Rajasthan,2004,Burglary,0,0,0,10,0,10,15,0,15,4,0,4,29,0,29
Rajasthan,2004,Thefts,0,0,0,76,2,78,59,5,64,14,4,18,149,11,160
Rajasthan,2004,Extortion,0,0,0,4,0,4,2,0,2,3,0,3,9,0,9
Rajasthan,2004,Riots,0,0,0,7,0,7,6,0,6,0,0,0,13,0,13
Rajasthan,2004,Arson,0,0,0,0,0,0,0,0,0,0,0,0,0,0,0
Rajasthan,2004,Criminal Breach Of Trust,0,0,0,0,1,1,0,2,2,1,1,2,1,4,5
Rajasthan,2004,Cheating,0,0,0,1,0,1,9,0,9,3,0,3,13,0,13
Rajasthan,2004,Counter Feiting,0,0,0,18,0,18,9,1,10,3,0,3,30,1,31
Rajasthan,2004,Dowry Deaths,0,0,0,49,4,53,75,14,89,38,4,42,162,22,184
Rajasthan,2004,Molestation,0,0,0,1,0,1,4,0,4,0,0,0,5,0,5
Rajasthan,2004,Eve-Teasing,0,0,0,0,0,0,0,0,0,0,0,0,0,0,0
Rajasthan,2004,Cruelty By Husband Or Relative Of Husband,0,0,0,9,0,9,5,2,7,6,1,7,20,3,23
Rajasthan,2004,Other Ipc Crimes,0,0,0,13,3,16,25,9,34,17,4,21,55,16,71
Rajasthan,2005,Murder,0,0,0,1187,29,1216,1657,73,1730,415,10,425,3259,112,3371
Rajasthan,2005,Attempt To Commit Murder,0,0,0,97,1,98,105,2,107,23,1,24,225,4,229
Rajasthan,2005,C.H. Not Amounting To Murder,0,0,0,29,1,30,41,2,43,18,1,19,88,4,92
Rajasthan,2005,Rape,0,0,0,221,0,221,141,3,144,41,1,42,403,4,407
Rajasthan,2005,Kidnapping And Abduction,0,0,0,11,0,11,11,1,12,2,0,2,24,1,25
Rajasthan,2005,Dacoity,0,0,0,58,0,58,48,0,48,12,0,12,118,0,118
Rajasthan,2005,Prep. And Assembly For Dacoity,0,0,0,0,0,0,0,0,0,0,0,0,0,0,0
Rajasthan,2005,Robbery,0,0,0,22,0,22,20,0,20,2,0,2,44,0,44
Rajasthan,2005,Burglary,0,0,0,11,0,11,8,0,8,7,0,7,26,0,26
Rajasthan,2005,Thefts,0,0,0,97,1,98,54,0,54,7,0,7,158,1,159
Rajasthan,2005,Extortion,0,0,0,3,0,3,1,0,1,0,0,0,4,0,4
Rajasthan,2005,Riots,0,0,0,1,0,1,2,0,2,1,0,1,4,0,4
Rajasthan,2005,Arson,0,0,0,1,0,1,0,0,0,0,0,0,1,0,1
Rajasthan,2005,Criminal Breach Of Trust,0,0,0,2,0,2,3,0,3,1,0,1,6,0,6
Rajasthan,2005,Cheating,0,0,0,5,0,5,12,0,12,5,0,5,22,0,22
Rajasthan,2005,Counter Feiting,0,0,0,7,0,7,7,0,7,4,0,4,18,0,18
Rajasthan,2005,Dowry Deaths,0,0,0,90,0,90,100,0,100,26,0,26,216,0,216
Rajasthan,2005,Molestation,0,0,0,1,0,1,1,0,1,1,0,1,3,0,3
Rajasthan,2005,Eve-Teasing,0,0,0,1,0,1,2,0,2,0,1,1,3,1,4
Rajasthan,2005,Cruelty By Husband Or Relative Of Husband,0,0,0,6,0,6,4,1,5,2,0,2,12,1,13
Rajasthan,2005,Other Ipc Crimes,0,0,0,34,0,34,25,2,27,9,1,10,68,3,71
Rajasthan,2006,Murder,0,0,0,835,17,852,1937,62,1999,489,31,520,3261,110,3371
Rajasthan,2006,Attempt To Commit Murder,0,0,0,87,1,88,112,0,112,26,0,26,225,1,226
Rajasthan,2006,C.H. Not Amounting To Murder,0,0,0,26,0,26,37,0,37,7,0,7,70,0,70
Rajasthan,2006,Rape,0,0,0,195,0,195,117,1,118,32,0,32,344,1,345
Rajasthan,2006,Kidnapping And Abduction,0,0,0,26,0,26,21,0,21,3,0,3,50,0,50
Rajasthan,2006,Dacoity,0,0,0,84,0,84,61,0,61,9,0,9,154,0,154
Rajasthan,2006,Prep. And Assembly For Dacoity,0,0,0,0,0,0,0,0,0,0,0,0,0,0,0
Rajasthan,2006,Robbery,0,0,0,35,0,35,17,0,17,2,0,2,54,0,54
Rajasthan,2006,Burglary,0,0,0,7,0,7,1,0,1,0,0,0,8,0,8
Rajasthan,2006,Thefts,0,0,0,132,1,133,99,3,102,14,0,14,245,4,249
Rajasthan,2006,Extortion,0,0,0,1,0,1,0,0,0,0,0,0,1,0,1
Rajasthan,2006,Riots,0,0,0,9,0,9,2,0,2,0,0,0,11,0,11
Rajasthan,2006,Arson,0,0,0,0,0,0,0,0,0,0,0,0,0,0,0
Rajasthan,2006,Criminal Breach Of Trust,0,0,0,0,0,0,2,0,2,0,0,0,2,0,2
Rajasthan,2006,Cheating,0,0,0,14,0,14,12,0,12,1,0,1,27,0,27
Rajasthan,2006,Counter Feiting,0,0,0,9,0,9,10,0,10,4,0,4,23,0,23
Rajasthan,2006,Dowry Deaths,0,0,0,107,7,114,135,27,162,22,22,44,264,56,320
Rajasthan,2006,Molestation,0,0,0,0,0,0,0,0,0,0,0,0,0,0,0
Rajasthan,2006,Eve-Teasing,0,0,0,0,0,0,1,0,1,0,0,0,1,0,1
Rajasthan,2006,Cruelty By Husband Or Relative Of Husband,0,0,0,2,0,2,3,0,3,0,0,0,5,0,5
Rajasthan,2006,Other Ipc Crimes,0,0,0,61,0,61,67,0,67,3,0,3,131,0,131
Rajasthan,2007,Murder,0,0,0,924,14,938,1977,76,2053,600,27,627,3501,117,3618
Rajasthan,2007,Attempt To Commit Murder,0,0,0,68,2,70,86,2,88,14,0,14,168,4,172
Rajasthan,2007,C.H. Not Amounting To Murder,0,0,0,26,0,26,77,0,77,17,0,17,120,0,120
Rajasthan,2007,Rape,0,0,0,171,2,173,127,1,128,26,0,26,324,3,327
Rajasthan,2007,Kidnapping And Abduction,0,0,0,28,2,30,25,0,25,10,1,11,63,3,66
Rajasthan,2007,Dacoity,0,0,0,58,0,58,69,0,69,8,0,8,135,0,135
Rajasthan,2007,Prep. And Assembly For Dacoity,0,0,0,12,0,12,3,0,3,1,0,1,16,0,16
Rajasthan,2007,Robbery,0,0,0,44,0,44,17,0,17,16,0,16,77,0,77
Rajasthan,2007,Burglary,0,0,0,6,0,6,1,0,1,0,0,0,7,0,7
Rajasthan,2007,Thefts,0,0,0,187,5,192,112,0,112,39,0,39,338,5,343
Rajasthan,2007,Extortion,0,0,0,0,0,0,1,0,1,0,0,0,1,0,1
Rajasthan,2007,Riots,0,0,0,4,0,4,0,0,0,0,0,0,4,0,4
Rajasthan,2007,Arson,0,0,0,0,0,0,0,0,0,0,0,0,0,0,0
Rajasthan,2007,Criminal Breach Of Trust,0,0,0,6,0,6,7,0,7,4,0,4,17,0,17
Rajasthan,2007,Cheating,0,0,0,22,0,22,16,0,16,14,0,14,52,0,52
Rajasthan,2007,Counter Feiting,0,0,0,4,0,4,4,0,4,2,0,2,10,0,10
Rajasthan,2007,Dowry Deaths,0,0,0,86,16,102,85,9,94,10,17,27,181,42,223
Rajasthan,2007,Molestation,0,0,0,0,0,0,2,0,2,0,0,0,2,0,2
Rajasthan,2007,Eve-Teasing,0,0,0,1,0,1,0,0,0,0,0,0,1,0,1
Rajasthan,2007,Cruelty By Husband Or Relative Of Husband,0,0,0,7,0,7,11,0,11,4,0,4,22,0,22
Rajasthan,2007,Other Ipc Crimes,0,0,0,25,1,26,67,0,67,9,1,10,101,2,103
Rajasthan,2008,Murder,0,0,0,948,10,958,1902,85,1987,560,31,591,3410,126,3536
Rajasthan,2008,Attempt To Commit Murder,0,0,0,88,0,88,112,2,114,21,1,22,221,3,224
Rajasthan,2008,C.H. Not Amounting To Murder,0,0,0,31,0,31,71,1,72,13,2,15,115,3,118
Rajasthan,2008,Rape,0,0,0,202,4,206,144,1,145,38,0,38,384,5,389
Rajasthan,2008,Kidnapping And Abduction,0,0,0,42,1,43,41,3,44,10,0,10,93,4,97
Rajasthan,2008,Dacoity,0,0,0,40,0,40,35,0,35,11,0,11,86,0,86
Rajasthan,2008,Prep. And Assembly For Dacoity,0,0,0,21,0,21,18,0,18,11,0,11,50,0,50
Rajasthan,2008,Robbery,0,0,0,27,0,27,21,0,21,8,0,8,56,0,56
Rajasthan,2008,Burglary,0,0,0,21,0,21,6,0,6,13,0,13,40,0,40
Rajasthan,2008,Thefts,0,0,0,155,1,156,77,0,77,8,0,8,240,1,241
Rajasthan,2008,Extortion,0,0,0,22,0,22,18,0,18,11,0,11,51,0,51
Rajasthan,2008,Riots,0,0,0,10,0,10,24,0,24,6,0,6,40,0,40
Rajasthan,2008,Arson,0,0,0,8,0,8,2,0,2,0,0,0,10,0,10
Rajasthan,2008,Criminal Breach Of Trust,0,0,0,8,0,8,6,0,6,0,0,0,14,0,14
Rajasthan,2008,Cheating,0,0,0,29,0,29,22,1,23,6,0,6,57,1,58
Rajasthan,2008,Counter Feiting,0,0,0,15,0,15,8,0,8,7,0,7,30,0,30
Rajasthan,2008,Dowry Deaths,0,0,0,75,1,76,92,31,123,24,18,42,191,50,241
Rajasthan,2008,Molestation,0,0,0,2,0,2,1,0,1,1,0,1,4,0,4
Rajasthan,2008,Eve-Teasing,0,0,0,4,0,4,3,0,3,0,0,0,7,0,7
Rajasthan,2008,Cruelty By Husband Or Relative Of Husband,0,0,0,22,0,22,32,0,32,5,0,5,59,0,59
Rajasthan,2008,Other Ipc Crimes,0,0,0,62,1,63,43,0,43,14,0,14,119,1,120
Rajasthan,2009,Murder,0,0,0,1014,41,1055,1994,90,2084,663,27,690,3671,158,3829
Rajasthan,2009,Attempt To Commit Murder,0,0,0,94,0,94,123,1,124,26,0,26,243,1,244
Rajasthan,2009,C.H. Not Amounting To Murder,0,0,0,34,0,34,50,0,50,14,0,14,98,0,98
Rajasthan,2009,Rape,0,0,0,202,2,204,171,5,176,47,0,47,420,7,427
Rajasthan,2009,Kidnapping And Abduction,0,0,0,44,2,46,63,3,66,8,1,9,115,6,121
Rajasthan,2009,Dacoity,0,0,0,37,0,37,68,0,68,10,0,10,115,0,115
Rajasthan,2009,Prep. And Assembly For Dacoity,0,0,0,8,0,8,6,0,6,4,0,4,18,0,18
Rajasthan,2009,Robbery,0,0,0,30,0,30,26,0,26,10,0,10,66,0,66
Rajasthan,2009,Burglary,0,0,0,1,0,1,0,0,0,0,0,0,1,0,1
Rajasthan,2009,Thefts,0,0,0,110,0,110,128,2,130,14,0,14,252,2,254
Rajasthan,2009,Extortion,0,0,0,6,0,6,3,0,3,0,0,0,9,0,9
Rajasthan,2009,Riots,0,0,0,2,0,2,1,0,1,0,0,0,3,0,3
Rajasthan,2009,Arson,0,0,0,0,0,0,1,0,1,0,0,0,1,0,1
Rajasthan,2009,Criminal Breach Of Trust,0,0,0,5,0,5,3,0,3,0,0,0,8,0,8
Rajasthan,2009,Cheating,0,0,0,35,0,35,40,0,40,18,0,18,93,0,93
Rajasthan,2009,Counter Feiting,0,0,0,9,0,9,15,1,16,5,0,5,29,1,30
Rajasthan,2009,Dowry Deaths,0,0,0,63,0,63,92,23,115,38,0,38,193,23,216
Rajasthan,2009,Molestation,0,0,0,1,0,1,5,0,5,0,0,0,6,0,6
Rajasthan,2009,Eve-Teasing,0,0,0,0,0,0,0,0,0,0,0,0,0,0,0
Rajasthan,2009,Cruelty By Husband Or Relative Of Husband,0,0,0,5,0,5,17,0,17,6,0,6,28,0,28
Rajasthan,2009,Other Ipc Crimes,0,0,0,37,8,45,61,0,61,12,0,12,110,8,118
Rajasthan,2010,Murder,0,0,0,1113,32,1145,1886,81,1967,556,41,597,3555,154,3709
Rajasthan,2010,Attempt To Commit Murder,0,0,0,45,1,46,75,1,76,11,0,11,131,2,133
Rajasthan,2010,C.H. Not Amounting To Murder,0,0,0,33,0,33,45,0,45,25,0,25,103,0,103
Rajasthan,2010,Rape,0,0,0,120,2,122,143,2,145,38,0,38,301,4,305
Rajasthan,2010,Kidnapping And Abduction,0,0,0,26,0,26,33,2,35,11,0,11,70,2,72
Rajasthan,2010,Dacoity,0,0,0,52,0,52,57,0,57,13,0,13,122,0,122
Rajasthan,2010,Prep. And Assembly For Dacoity,0,0,0,7,0,7,7,0,7,6,0,6,20,0,20
Rajasthan,2010,Robbery,0,0,0,34,0,34,34,0,34,5,0,5,73,0,73
Rajasthan,2010,Burglary,0,0,0,6,0,6,0,0,0,0,0,0,6,0,6
Rajasthan,2010,Thefts,0,0,0,113,0,113,94,2,96,17,0,17,224,2,226
Rajasthan,2010,Extortion,0,0,0,3,0,3,2,0,2,0,0,0,5,0,5
Rajasthan,2010,Riots,0,0,0,8,0,8,3,0,3,1,0,1,12,0,12
Rajasthan,2010,Arson,0,0,0,0,0,0,1,0,1,0,0,0,1,0,1
Rajasthan,2010,Criminal Breach Of Trust,0,0,0,3,0,3,2,0,2,0,0,0,5,0,5
Rajasthan,2010,Cheating,0,0,0,17,0,17,38,2,40,11,0,11,66,2,68
Rajasthan,2010,Counter Feiting,0,0,0,7,0,7,11,1,12,4,0,4,22,1,23
Rajasthan,2010,Dowry Deaths,0,0,0,83,0,83,74,15,89,29,18,47,186,33,219
Rajasthan,2010,Molestation,0,0,0,6,0,6,2,0,2,2,0,2,10,0,10
Rajasthan,2010,Eve-Teasing,0,0,0,0,0,0,0,3,3,0,0,0,0,3,3
Rajasthan,2010,Cruelty By Husband Or Relative Of Husband,0,0,0,5,0,5,10,0,10,3,0,3,18,0,18
Rajasthan,2010,Other Ipc Crimes,0,0,0,52,0,52,78,0,78,22,0,22,152,0,152
Rajasthan,2011,Murder,0,0,0,1011,30,1041,1708,83,1791,523,39,562,3242,152,3394
Rajasthan,2011,Attempt To Commit Murder,0,0,0,96,0,96,62,0,62,49,1,50,207,1,208
Rajasthan,2011,C.H. Not Amounting To Murder,0,0,0,28,0,28,54,0,54,36,0,36,118,0,118
Rajasthan,2011,Rape,0,0,0,166,0,166,76,7,83,39,0,39,281,7,288
Rajasthan,2011,Kidnapping And Abduction,0,0,0,33,0,33,41,3,44,26,0,26,100,3,103
Rajasthan,2011,Dacoity,0,0,0,51,0,51,39,0,39,7,0,7,97,0,97
Rajasthan,2011,Prep. And Assembly For Dacoity,0,0,0,7,0,7,19,0,19,9,0,9,35,0,35
Rajasthan,2011,Robbery,0,0,0,36,0,36,28,0,28,10,0,10,74,0,74
Rajasthan,2011,Burglary,0,0,0,12,0,12,6,0,6,8,0,8,26,0,26
Rajasthan,2011,Thefts,0,0,0,142,1,143,54,3,57,6,0,6,202,4,206
Rajasthan,2011,Extortion,0,0,0,4,0,4,2,0,2,0,0,0,6,0,6
Rajasthan,2011,Riots,0,0,0,4,0,4,5,0,5,0,0,0,9,0,9
Rajasthan,2011,Arson,0,0,0,4,0,4,4,0,4,0,0,0,8,0,8
Rajasthan,2011,Criminal Breach Of Trust,0,0,0,0,0,0,1,0,1,0,0,0,1,0,1
Rajasthan,2011,Cheating,0,0,0,26,0,26,27,0,27,16,0,16,69,0,69
Rajasthan,2011,Counter Feiting,0,0,0,4,0,4,9,1,10,11,0,11,24,1,25
Rajasthan,2011,Dowry Deaths,0,0,0,158,3,161,88,12,100,54,21,75,300,36,336
Rajasthan,2011,Molestation,0,0,0,5,0,5,4,0,4,1,0,1,10,0,10
Rajasthan,2011,Eve-Teasing,0,0,0,1,0,1,0,0,0,0,0,0,1,0,1
Rajasthan,2011,Cruelty By Husband Or Relative Of Husband,0,0,0,14,0,14,15,0,15,21,1,22,50,1,51
Rajasthan,2011,Other Ipc Crimes,0,0,0,37,0,37,59,0,59,8,0,8,104,0,104
Rajasthan,2012,Murder,0,0,0,893,65,958,1720,71,1791,475,42,517,3088,178,3266
Rajasthan,2012,Attempt To Commit Murder,0,0,0,85,0,85,88,2,90,23,0,23,196,2,198
Rajasthan,2012,C.H. Not Amounting To Murder,0,0,0,31,0,31,56,0,56,12,0,12,99,0,99
Rajasthan,2012,Rape,0,0,0,176,7,183,144,2,146,22,1,23,342,10,352
Rajasthan,2012,Kidnapping And Abduction,0,0,0,34,0,34,40,3,43,12,0,12,86,3,89
Rajasthan,2012,Dacoity,0,0,0,36,0,36,43,0,43,12,0,12,91,0,91
Rajasthan,2012,Prep. And Assembly For Dacoity,0,0,0,18,0,18,18,0,18,8,0,8,44,0,44
Rajasthan,2012,Robbery,0,0,0,36,0,36,60,0,60,6,0,6,102,0,102
Rajasthan,2012,Burglary,0,0,0,20,0,20,10,0,10,2,0,2,32,0,32
Rajasthan,2012,Thefts,0,0,0,91,2,93,98,3,101,9,0,9,198,5,203
Rajasthan,2012,Extortion,0,0,0,10,0,10,15,0,15,2,0,2,27,0,27
Rajasthan,2012,Riots,0,0,0,14,0,14,14,0,14,4,0,4,32,0,32
Rajasthan,2012,Arson,0,0,0,3,0,3,5,0,5,1,0,1,9,0,9
Rajasthan,2012,Criminal Breach Of Trust,0,0,0,1,0,1,0,0,0,1,0,1,2,0,2
Rajasthan,2012,Cheating,0,0,0,14,0,14,29,0,29,5,0,5,48,0,48
Rajasthan,2012,Counter Feiting,0,0,0,7,0,7,14,0,14,0,0,0,21,0,21
Rajasthan,2012,Dowry Deaths,0,0,0,59,2,61,103,14,117,26,5,31,188,21,209
Rajasthan,2012,Molestation,0,0,0,3,0,3,4,0,4,1,0,1,8,0,8
Rajasthan,2012,Eve-Teasing,0,0,0,5,0,5,6,0,6,0,0,0,11,0,11
Rajasthan,2012,Cruelty By Husband Or Relative Of Husband,0,0,0,4,0,4,3,4,7,1,2,3,8,6,14
Rajasthan,2012,Other Ipc Crimes,0,0,0,46,0,46,42,0,42,11,0,11,99,0,99
Sikkim,2001,Murder,0,0,0,6,0,6,5,0,5,4,0,4,15,0,15
Sikkim,2001,Attempt To Commit Murder,0,0,0,1,0,1,2,0,2,0,0,0,3,0,3
Sikkim,2001,C.H. Not Amounting To Murder,0,0,0,3,0,3,0,0,0,4,0,4,7,0,7
Sikkim,2001,Rape,0,0,0,8,0,8,3,0,3,1,0,1,12,0,12
Sikkim,2001,Kidnapping And Abduction,0,0,0,0,0,0,2,0,2,0,0,0,2,0,2
Sikkim,2001,Dacoity,0,0,0,0,0,0,0,0,0,0,0,0,0,0,0
Sikkim,2001,Prep. And Assembly For Dacoity,0,0,0,0,0,0,0,0,0,0,0,0,0,0,0
Sikkim,2001,Robbery,0,0,0,0,0,0,0,0,0,0,0,0,0,0,0
Sikkim,2001,Burglary,0,0,0,0,0,0,1,0,1,0,0,0,1,0,1
Sikkim,2001,Thefts,0,0,0,7,0,7,3,0,3,1,0,1,11,0,11
Sikkim,2001,Extortion,0,0,0,5,0,5,0,0,0,0,0,0,5,0,5
Sikkim,2001,Riots,0,0,0,0,0,0,0,0,0,0,0,0,0,0,0
Sikkim,2001,Arson,0,0,0,0,0,0,0,0,0,0,0,0,0,0,0
Sikkim,2001,Criminal Breach Of Trust,0,0,0,0,0,0,1,0,1,0,0,0,1,0,1
Sikkim,2001,Cheating,0,0,0,0,0,0,5,0,5,2,0,2,7,0,7
Sikkim,2001,Counter Feiting,0,0,0,0,0,0,0,0,0,0,0,0,0,0,0
Sikkim,2001,Dowry Deaths,0,0,0,0,0,0,0,0,0,0,0,0,0,0,0
Sikkim,2001,Molestation,0,0,0,0,0,0,0,0,0,0,0,0,0,0,0
Sikkim,2001,Eve-Teasing,0,0,0,0,0,0,0,0,0,0,0,0,0,0,0
Sikkim,2001,Cruelty By Husband Or Relative Of Husband,0,0,0,0,0,0,0,0,0,0,0,0,0,0,0
Sikkim,2001,Other Ipc Crimes,0,0,0,5,0,5,4,0,4,4,0,4,13,0,13
Sikkim,2002,Murder,0,0,0,8,0,8,5,0,5,2,0,2,15,0,15
Sikkim,2002,Attempt To Commit Murder,0,0,0,2,0,2,3,0,3,0,0,0,5,0,5
Sikkim,2002,C.H. Not Amounting To Murder,0,0,0,1,0,1,2,0,2,3,0,3,6,0,6
Sikkim,2002,Rape,0,0,0,2,0,2,3,0,3,2,0,2,7,0,7
Sikkim,2002,Kidnapping And Abduction,0,0,0,0,0,0,0,0,0,0,0,0,0,0,0
Sikkim,2002,Dacoity,0,0,0,0,0,0,0,0,0,0,0,0,0,0,0
Sikkim,2002,Prep. And Assembly For Dacoity,0,0,0,0,0,0,0,0,0,0,0,0,0,0,0
Sikkim,2002,Robbery,0,0,0,8,0,8,2,0,2,0,0,0,10,0,10
Sikkim,2002,Burglary,0,0,0,2,0,2,0,0,0,0,0,0,2,0,2
Sikkim,2002,Thefts,0,0,0,10,0,10,5,0,5,4,0,4,19,0,19
Sikkim,2002,Extortion,0,0,0,0,0,0,0,0,0,0,0,0,0,0,0
Sikkim,2002,Riots,0,0,0,0,0,0,0,0,0,0,0,0,0,0,0
Sikkim,2002,Arson,0,0,0,0,0,0,0,0,0,0,0,0,0,0,0
Sikkim,2002,Criminal Breach Of Trust,0,0,0,0,0,0,0,0,0,0,0,0,0,0,0
Sikkim,2002,Cheating,0,0,0,0,0,0,2,0,2,0,0,0,2,0,2
Sikkim,2002,Counter Feiting,0,0,0,0,0,0,0,0,0,0,0,0,0,0,0
Sikkim,2002,Dowry Deaths,0,0,0,0,0,0,0,0,0,0,0,0,0,0,0
Sikkim,2002,Molestation,0,0,0,0,0,0,0,0,0,0,0,0,0,0,0
Sikkim,2002,Eve-Teasing,0,0,0,0,0,0,0,0,0,0,0,0,0,0,0
Sikkim,2002,Cruelty By Husband Or Relative Of Husband,0,0,0,0,0,0,0,0,0,0,0,0,0,0,0
Sikkim,2002,Other Ipc Crimes,0,0,0,2,0,2,1,0,1,4,0,4,7,0,7
Sikkim,2003,Murder,0,0,0,17,1,18,8,0,8,2,0,2,27,1,28
Sikkim,2003,Attempt To Commit Murder,0,0,0,4,0,4,2,0,2,0,0,0,6,0,6
Sikkim,2003,C.H. Not Amounting To Murder,0,0,0,0,0,0,0,0,0,0,0,0,0,0,0
Sikkim,2003,Rape,0,0,0,0,0,0,0,0,0,0,0,0,0,0,0
Sikkim,2003,Kidnapping And Abduction,0,0,0,0,0,0,0,0,0,0,0,0,0,0,0
Sikkim,2003,Dacoity,0,0,0,0,0,0,0,0,0,0,0,0,0,0,0
Sikkim,2003,Prep. And Assembly For Dacoity,0,0,0,0,0,0,0,0,0,0,0,0,0,0,0
Sikkim,2003,Robbery,0,0,0,0,0,0,0,0,0,0,0,0,0,0,0
Sikkim,2003,Burglary,0,0,0,6,0,6,0,0,0,0,0,0,6,0,6
Sikkim,2003,Thefts,2,0,2,10,0,10,6,0,6,5,0,5,23,0,23
Sikkim,2003,Extortion,0,0,0,0,0,0,0,0,0,0,0,0,0,0,0
Sikkim,2003,Riots,0,0,0,0,0,0,0,0,0,0,0,0,0,0,0
Sikkim,2003,Arson,0,0,0,0,0,0,0,0,0,0,0,0,0,0,0
Sikkim,2003,Criminal Breach Of Trust,0,0,0,0,0,0,0,0,0,0,0,0,0,0,0
Sikkim,2003,Cheating,0,0,0,0,0,0,0,1,1,0,0,0,0,1,1
Sikkim,2003,Counter Feiting,0,0,0,0,0,0,0,0,0,0,0,0,0,0,0
Sikkim,2003,Dowry Deaths,0,0,0,0,0,0,0,0,0,0,0,0,0,0,0
Sikkim,2003,Molestation,0,0,0,0,0,0,0,0,0,0,0,0,0,0,0
Sikkim,2003,Eve-Teasing,0,0,0,0,0,0,0,0,0,0,0,0,0,0,0
Sikkim,2003,Cruelty By Husband Or Relative Of Husband,0,0,0,0,0,0,0,0,0,0,0,0,0,0,0
Sikkim,2003,Other Ipc Crimes,0,0,0,7,0,7,9,0,9,0,0,0,16,0,16
Sikkim,2004,Murder,0,0,0,12,0,12,14,1,15,1,0,1,27,1,28
Sikkim,2004,Attempt To Commit Murder,0,0,0,1,0,1,0,0,0,0,0,0,1,0,1
Sikkim,2004,C.H. Not Amounting To Murder,0,0,0,7,1,8,3,0,3,0,0,0,10,1,11
Sikkim,2004,Rape,0,0,0,8,0,8,2,0,2,1,0,1,11,0,11
Sikkim,2004,Kidnapping And Abduction,0,0,0,0,0,0,0,0,0,0,0,0,0,0,0
Sikkim,2004,Dacoity,0,0,0,0,0,0,0,0,0,0,0,0,0,0,0
Sikkim,2004,Prep. And Assembly For Dacoity,0,0,0,0,0,0,0,0,0,0,0,0,0,0,0
Sikkim,2004,Robbery,0,0,0,0,0,0,0,0,0,0,0,0,0,0,0
Sikkim,2004,Burglary,0,0,0,4,0,4,0,0,0,0,0,0,4,0,4
Sikkim,2004,Thefts,0,0,0,1,0,1,2,0,2,0,0,0,3,0,3
Sikkim,2004,Extortion,0,0,0,0,0,0,0,0,0,0,0,0,0,0,0
Sikkim,2004,Riots,0,0,0,0,0,0,0,0,0,0,0,0,0,0,0
Sikkim,2004,Arson,0,0,0,0,0,0,0,0,0,0,0,0,0,0,0
Sikkim,2004,Criminal Breach Of Trust,0,0,0,0,0,0,0,0,0,0,0,0,0,0,0
Sikkim,2004,Cheating,0,0,0,0,0,0,0,0,0,0,0,0,0,0,0
Sikkim,2004,Counter Feiting,0,0,0,0,0,0,0,0,0,0,0,0,0,0,0
Sikkim,2004,Dowry Deaths,0,0,0,0,0,0,0,0,0,0,0,0,0,0,0
Sikkim,2004,Molestation,0,0,0,0,0,0,0,0,0,0,0,0,0,0,0
Sikkim,2004,Eve-Teasing,0,0,0,0,0,0,0,0,0,0,0,0,0,0,0
Sikkim,2004,Cruelty By Husband Or Relative Of Husband,0,0,0,0,0,0,0,0,0,0,0,0,0,0,0
Sikkim,2004,Other Ipc Crimes,0,0,0,2,0,2,2,0,2,1,0,1,5,0,5
Sikkim,2005,Murder,0,0,0,13,0,13,14,1,15,1,0,1,28,1,29
Sikkim,2005,Attempt To Commit Murder,0,0,0,1,0,1,0,0,0,0,0,0,1,0,1
Sikkim,2005,C.H. Not Amounting To Murder,0,0,0,7,1,8,3,0,3,0,0,0,10,1,11
Sikkim,2005,Rape,0,0,0,9,0,9,3,0,3,1,0,1,13,0,13
Sikkim,2005,Kidnapping And Abduction,0,0,0,0,0,0,0,0,0,0,0,0,0,0,0
Sikkim,2005,Dacoity,0,0,0,0,0,0,0,0,0,0,0,0,0,0,0
Sikkim,2005,Prep. And Assembly For Dacoity,0,0,0,0,0,0,0,0,0,0,0,0,0,0,0
Sikkim,2005,Robbery,0,0,0,4,0,4,0,0,0,0,0,0,4,0,4
Sikkim,2005,Burglary,0,0,0,6,0,6,2,0,2,0,0,0,8,0,8
Sikkim,2005,Thefts,0,0,0,0,0,0,0,0,0,0,0,0,0,0,0
Sikkim,2005,Extortion,0,0,0,0,0,0,0,0,0,0,0,0,0,0,0
Sikkim,2005,Riots,0,0,0,0,0,0,0,0,0,0,0,0,0,0,0
Sikkim,2005,Arson,0,0,0,0,0,0,0,0,0,1,0,1,1,0,1
Sikkim,2005,Criminal Breach Of Trust,0,0,0,0,0,0,0,0,0,0,0,0,0,0,0
Sikkim,2005,Cheating,0,0,0,0,0,0,0,0,0,0,0,0,0,0,0
Sikkim,2005,Counter Feiting,0,0,0,0,0,0,0,0,0,0,0,0,0,0,0
Sikkim,2005,Dowry Deaths,0,0,0,0,0,0,0,0,0,0,0,0,0,0,0
Sikkim,2005,Molestation,0,0,0,0,0,0,0,0,0,0,0,0,0,0,0
Sikkim,2005,Eve-Teasing,0,0,0,0,0,0,0,0,0,0,0,0,0,0,0
Sikkim,2005,Cruelty By Husband Or Relative Of Husband,0,0,0,0,0,0,0,0,0,0,0,0,0,0,0
Sikkim,2005,Other Ipc Crimes,0,0,0,3,0,3,2,0,2,1,0,1,6,0,6
Sikkim,2006,Murder,0,0,0,16,0,16,12,0,12,2,0,2,30,0,30
Sikkim,2006,Attempt To Commit Murder,0,0,0,0,0,0,0,0,0,0,0,0,0,0,0
Sikkim,2006,C.H. Not Amounting To Murder,0,0,0,8,1,9,5,0,5,0,0,0,13,1,14
Sikkim,2006,Rape,0,0,0,7,0,7,1,0,1,1,0,1,9,0,9
Sikkim,2006,Kidnapping And Abduction,0,0,0,0,0,0,0,0,0,0,0,0,0,0,0
Sikkim,2006,Dacoity,0,0,0,0,0,0,0,0,0,0,0,0,0,0,0
Sikkim,2006,Prep. And Assembly For Dacoity,0,0,0,0,0,0,0,0,0,0,0,0,0,0,0
Sikkim,2006,Robbery,0,0,0,1,0,1,0,0,0,0,0,0,1,0,1
Sikkim,2006,Burglary,0,0,0,17,0,17,2,0,2,0,0,0,19,0,19
Sikkim,2006,Thefts,0,0,0,12,0,12,1,0,1,0,0,0,13,0,13
Sikkim,2006,Extortion,0,0,0,0,0,0,0,0,0,0,0,0,0,0,0
Sikkim,2006,Riots,0,0,0,0,0,0,0,0,0,0,0,0,0,0,0
Sikkim,2006,Arson,0,0,0,0,0,0,0,0,0,0,0,0,0,0,0
Sikkim,2006,Criminal Breach Of Trust,0,0,0,0,0,0,0,0,0,0,0,0,0,0,0
Sikkim,2006,Cheating,0,0,0,0,0,0,1,0,1,0,0,0,1,0,1
Sikkim,2006,Counter Feiting,0,0,0,0,0,0,0,0,0,0,0,0,0,0,0
Sikkim,2006,Dowry Deaths,0,0,0,0,0,0,0,0,0,0,0,0,0,0,0
Sikkim,2006,Molestation,0,0,0,0,0,0,0,0,0,0,0,0,0,0,0
Sikkim,2006,Eve-Teasing,0,0,0,0,0,0,0,0,0,0,0,0,0,0,0
Sikkim,2006,Cruelty By Husband Or Relative Of Husband,0,0,0,0,0,0,0,0,0,0,0,0,0,0,0
Sikkim,2006,Other Ipc Crimes,0,0,0,2,0,2,0,0,0,0,0,0,2,0,2
Sikkim,2007,Murder,0,0,0,12,0,12,13,0,13,4,0,4,29,0,29
Sikkim,2007,Attempt To Commit Murder,0,0,0,0,0,0,0,0,0,0,0,0,0,0,0
Sikkim,2007,C.H. Not Amounting To Murder,0,0,0,9,0,9,8,1,9,0,0,0,17,1,18
Sikkim,2007,Rape,0,0,0,2,0,2,4,0,4,1,0,1,7,0,7
Sikkim,2007,Kidnapping And Abduction,0,0,0,0,0,0,0,0,0,0,0,0,0,0,0
Sikkim,2007,Dacoity,0,0,0,0,0,0,0,0,0,0,0,0,0,0,0
Sikkim,2007,Prep. And Assembly For Dacoity,0,0,0,0,0,0,0,0,0,0,0,0,0,0,0
Sikkim,2007,Robbery,0,0,0,3,0,3,0,0,0,0,0,0,3,0,3
Sikkim,2007,Burglary,0,0,0,12,0,12,0,0,0,0,0,0,12,0,12
Sikkim,2007,Thefts,0,0,0,4,0,4,1,0,1,1,0,1,6,0,6
Sikkim,2007,Extortion,0,0,0,0,0,0,0,0,0,0,0,0,0,0,0
Sikkim,2007,Riots,0,0,0,0,0,0,0,0,0,0,0,0,0,0,0
Sikkim,2007,Arson,0,0,0,0,0,0,0,0,0,0,0,0,0,0,0
Sikkim,2007,Criminal Breach Of Trust,0,0,0,0,0,0,0,0,0,0,0,0,0,0,0
Sikkim,2007,Cheating,0,0,0,3,0,3,0,0,0,0,0,0,3,0,3
Sikkim,2007,Counter Feiting,0,0,0,0,0,0,0,0,0,0,0,0,0,0,0
Sikkim,2007,Dowry Deaths,0,0,0,0,0,0,0,0,0,0,0,0,0,0,0
Sikkim,2007,Molestation,0,0,0,0,0,0,0,0,0,0,0,0,0,0,0
Sikkim,2007,Eve-Teasing,0,0,0,0,0,0,0,0,0,0,0,0,0,0,0
Sikkim,2007,Cruelty By Husband Or Relative Of Husband,0,0,0,0,0,0,0,0,0,0,0,0,0,0,0
Sikkim,2007,Other Ipc Crimes,0,0,0,0,0,0,0,0,0,0,0,0,0,0,0
Sikkim,2008,Murder,0,0,0,12,0,12,14,0,14,5,0,5,31,0,31
Sikkim,2008,Attempt To Commit Murder,0,0,0,0,0,0,0,0,0,0,0,0,0,0,0
Sikkim,2008,C.H. Not Amounting To Murder,0,0,0,6,0,6,3,1,4,0,0,0,9,1,10
Sikkim,2008,Rape,0,0,0,4,0,4,2,0,2,1,0,1,7,0,7
Sikkim,2008,Kidnapping And Abduction,0,0,0,0,0,0,0,0,0,0,0,0,0,0,0
Sikkim,2008,Dacoity,0,0,0,0,0,0,0,0,0,0,0,0,0,0,0
Sikkim,2008,Prep. And Assembly For Dacoity,0,0,0,0,0,0,0,0,0,0,0,0,0,0,0
Sikkim,2008,Robbery,0,0,0,0,0,0,0,0,0,0,0,0,0,0,0
Sikkim,2008,Burglary,0,0,0,8,0,8,0,0,0,0,0,0,8,0,8
Sikkim,2008,Thefts,0,0,0,2,0,2,1,0,1,1,0,1,4,0,4
Sikkim,2008,Extortion,0,0,0,0,0,0,0,0,0,0,0,0,0,0,0
Sikkim,2008,Riots,0,0,0,0,0,0,0,0,0,0,0,0,0,0,0
Sikkim,2008,Arson,0,0,0,0,0,0,0,0,0,0,0,0,0,0,0
Sikkim,2008,Criminal Breach Of Trust,0,0,0,0,0,0,0,0,0,0,0,0,0,0,0
Sikkim,2008,Cheating,0,0,0,0,0,0,0,0,0,0,0,0,0,0,0
Sikkim,2008,Counter Feiting,0,0,0,0,0,0,0,0,0,0,0,0,0,0,0
Sikkim,2008,Dowry Deaths,0,0,0,0,0,0,0,0,0,0,0,0,0,0,0
Sikkim,2008,Molestation,0,0,0,0,0,0,0,0,0,0,0,0,0,0,0
Sikkim,2008,Eve-Teasing,0,0,0,0,0,0,0,0,0,0,0,0,0,0,0
Sikkim,2008,Cruelty By Husband Or Relative Of Husband,0,0,0,0,0,0,0,0,0,0,0,0,0,0,0
Sikkim,2008,Other Ipc Crimes,0,0,0,1,0,1,1,0,1,0,0,0,2,0,2
Sikkim,2009,Murder,0,0,0,14,0,14,13,0,13,5,0,5,32,0,32
Sikkim,2009,Attempt To Commit Murder,0,0,0,0,0,0,0,0,0,0,0,0,0,0,0
Sikkim,2009,C.H. Not Amounting To Murder,0,0,0,3,0,3,1,1,2,1,0,1,5,1,6
Sikkim,2009,Rape,0,0,0,4,0,4,3,0,3,1,0,1,8,0,8
Sikkim,2009,Kidnapping And Abduction,0,0,0,0,0,0,0,0,0,0,0,0,0,0,0
Sikkim,2009,Dacoity,0,0,0,0,0,0,0,0,0,0,0,0,0,0,0
Sikkim,2009,Prep. And Assembly For Dacoity,0,0,0,0,0,0,0,0,0,0,0,0,0,0,0
Sikkim,2009,Robbery,0,0,0,0,0,0,0,0,0,0,0,0,0,0,0
Sikkim,2009,Burglary,0,0,0,9,0,9,1,0,1,0,0,0,10,0,10
Sikkim,2009,Thefts,0,0,0,3,0,3,3,0,3,0,0,0,6,0,6
Sikkim,2009,Extortion,0,0,0,0,0,0,0,0,0,0,0,0,0,0,0
Sikkim,2009,Riots,0,0,0,0,0,0,0,0,0,0,0,0,0,0,0
Sikkim,2009,Arson,0,0,0,0,0,0,0,0,0,0,0,0,0,0,0
Sikkim,2009,Criminal Breach Of Trust,0,0,0,0,0,0,0,0,0,0,0,0,0,0,0
Sikkim,2009,Cheating,0,0,0,0,0,0,0,0,0,0,0,0,0,0,0
Sikkim,2009,Counter Feiting,0,0,0,0,0,0,0,0,0,0,0,0,0,0,0
Sikkim,2009,Dowry Deaths,0,0,0,0,0,0,0,0,0,0,0,0,0,0,0
Sikkim,2009,Molestation,0,0,0,0,0,0,0,0,0,0,0,0,0,0,0
Sikkim,2009,Eve-Teasing,0,0,0,0,0,0,0,0,0,0,0,0,0,0,0
Sikkim,2009,Cruelty By Husband Or Relative Of Husband,0,0,0,0,0,0,0,0,0,0,0,0,0,0,0
Sikkim,2009,Other Ipc Crimes,0,0,0,2,0,2,1,0,1,0,0,0,3,0,3
Sikkim,2010,Murder,0,0,0,8,1,9,19,0,19,4,0,4,31,1,32
Sikkim,2010,Attempt To Commit Murder,0,0,0,0,0,0,0,0,0,0,0,0,0,0,0
Sikkim,2010,C.H. Not Amounting To Murder,0,0,0,3,0,3,0,0,0,1,1,2,4,1,5
Sikkim,2010,Rape,0,0,0,1,0,1,3,0,3,1,0,1,5,0,5
Sikkim,2010,Kidnapping And Abduction,0,0,0,1,0,1,0,0,0,0,0,0,1,0,1
Sikkim,2010,Dacoity,0,0,0,0,0,0,0,0,0,0,0,0,0,0,0
Sikkim,2010,Prep. And Assembly For Dacoity,0,0,0,0,0,0,0,0,0,0,0,0,0,0,0
Sikkim,2010,Robbery,0,0,0,0,0,0,0,0,0,0,0,0,0,0,0
Sikkim,2010,Burglary,0,0,0,10,0,10,0,0,0,0,0,0,10,0,10
Sikkim,2010,Thefts,0,0,0,2,0,2,2,0,2,0,0,0,4,0,4
Sikkim,2010,Extortion,0,0,0,1,0,1,0,0,0,0,0,0,1,0,1
Sikkim,2010,Riots,0,0,0,0,0,0,0,0,0,0,0,0,0,0,0
Sikkim,2010,Arson,0,0,0,0,0,0,0,0,0,0,0,0,0,0,0
Sikkim,2010,Criminal Breach Of Trust,0,0,0,0,0,0,0,0,0,0,0,0,0,0,0
Sikkim,2010,Cheating,0,0,0,0,0,0,0,0,0,0,0,0,0,0,0
Sikkim,2010,Counter Feiting,0,0,0,0,0,0,0,0,0,0,0,0,0,0,0
Sikkim,2010,Dowry Deaths,0,0,0,0,0,0,0,0,0,0,0,0,0,0,0
Sikkim,2010,Molestation,0,0,0,2,0,2,3,0,3,0,0,0,5,0,5
Sikkim,2010,Eve-Teasing,0,0,0,0,0,0,0,0,0,0,0,0,0,0,0
Sikkim,2010,Cruelty By Husband Or Relative Of Husband,0,0,0,0,0,0,0,0,0,0,0,0,0,0,0
Sikkim,2010,Other Ipc Crimes,0,0,0,2,0,2,2,0,2,0,0,0,4,0,4
Sikkim,2011,Murder,0,0,0,4,1,5,28,0,28,5,0,5,37,1,38
Sikkim,2011,Attempt To Commit Murder,0,0,0,0,0,0,0,0,0,0,0,0,0,0,0
Sikkim,2011,C.H. Not Amounting To Murder,0,0,0,2,0,2,2,0,2,0,0,0,4,0,4
Sikkim,2011,Rape,0,0,0,0,0,0,4,0,4,0,0,0,4,0,4
Sikkim,2011,Kidnapping And Abduction,0,0,0,0,0,0,0,0,0,0,0,0,0,0,0
Sikkim,2011,Dacoity,0,0,0,0,0,0,0,0,0,0,0,0,0,0,0
Sikkim,2011,Prep. And Assembly For Dacoity,0,0,0,0,0,0,0,0,0,0,0,0,0,0,0
Sikkim,2011,Robbery,0,0,0,0,0,0,0,0,0,0,0,0,0,0,0
Sikkim,2011,Burglary,0,0,0,3,0,3,0,0,0,0,0,0,3,0,3
Sikkim,2011,Thefts,0,0,0,7,0,7,1,0,1,0,0,0,8,0,8
Sikkim,2011,Extortion,0,0,0,0,0,0,0,0,0,0,0,0,0,0,0
Sikkim,2011,Riots,0,0,0,0,0,0,0,0,0,0,0,0,0,0,0
Sikkim,2011,Arson,0,0,0,0,0,0,0,0,0,0,0,0,0,0,0
Sikkim,2011,Criminal Breach Of Trust,0,0,0,0,0,0,0,0,0,0,0,0,0,0,0
Sikkim,2011,Cheating,0,0,0,0,0,0,1,0,1,0,0,0,1,0,1
Sikkim,2011,Counter Feiting,0,0,0,0,0,0,0,0,0,0,0,0,0,0,0
Sikkim,2011,Dowry Deaths,0,0,0,0,0,0,0,0,0,0,0,0,0,0,0
Sikkim,2011,Molestation,0,0,0,0,0,0,0,0,0,0,0,0,0,0,0
Sikkim,2011,Eve-Teasing,0,0,0,0,0,0,0,0,0,0,0,0,0,0,0
Sikkim,2011,Cruelty By Husband Or Relative Of Husband,0,0,0,0,0,0,0,0,0,0,0,0,0,0,0
Sikkim,2011,Other Ipc Crimes,0,0,0,3,0,3,2,0,2,0,0,0,5,0,5
Sikkim,2012,Murder,0,0,0,8,0,8,24,1,25,5,0,5,37,1,38
Sikkim,2012,Attempt To Commit Murder,0,0,0,1,0,1,0,0,0,0,0,0,1,0,1
Sikkim,2012,C.H. Not Amounting To Murder,0,0,0,4,0,4,6,0,6,0,0,0,10,0,10
Sikkim,2012,Rape,0,0,0,7,0,7,3,0,3,0,0,0,10,0,10
Sikkim,2012,Kidnapping And Abduction,0,0,0,1,0,1,0,0,0,0,0,0,1,0,1
Sikkim,2012,Dacoity,0,0,0,0,0,0,0,0,0,0,0,0,0,0,0
Sikkim,2012,Prep. And Assembly For Dacoity,0,0,0,0,0,0,0,0,0,0,0,0,0,0,0
Sikkim,2012,Robbery,0,0,0,0,0,0,0,0,0,0,0,0,0,0,0
Sikkim,2012,Burglary,0,0,0,0,0,0,0,0,0,0,0,0,0,0,0
Sikkim,2012,Thefts,0,0,0,6,0,6,2,0,2,0,0,0,8,0,8
Sikkim,2012,Extortion,0,0,0,0,0,0,1,0,1,0,0,0,1,0,1
Sikkim,2012,Riots,0,0,0,0,0,0,0,0,0,0,0,0,0,0,0
Sikkim,2012,Arson,0,0,0,0,0,0,0,0,0,0,0,0,0,0,0
Sikkim,2012,Criminal Breach Of Trust,0,0,0,0,0,0,1,0,1,1,0,1,2,0,2
Sikkim,2012,Cheating,0,0,0,0,0,0,0,0,0,2,0,2,2,0,2
Sikkim,2012,Counter Feiting,0,0,0,1,0,1,0,0,0,0,0,0,1,0,1
Sikkim,2012,Dowry Deaths,0,0,0,0,0,0,0,0,0,0,0,0,0,0,0
Sikkim,2012,Molestation,0,0,0,0,0,0,0,0,0,0,0,0,0,0,0
Sikkim,2012,Eve-Teasing,0,0,0,0,0,0,0,0,0,0,0,0,0,0,0
Sikkim,2012,Cruelty By Husband Or Relative Of Husband,0,0,0,1,0,1,0,0,0,0,0,0,1,0,1
Sikkim,2012,Other Ipc Crimes,0,0,0,0,0,0,0,0,0,0,0,0,0,0,0
Tamilnadu,2001,Murder,29,0,29,1290,16,1306,1090,74,1164,352,16,368,2761,106,2867
Tamilnadu,2001,Attempt To Commit Murder,4,0,4,148,2,150,38,1,39,12,0,12,202,3,205
Tamilnadu,2001,C.H. Not Amounting To Murder,0,0,0,34,5,39,43,7,50,3,0,3,80,12,92
Tamilnadu,2001,Rape,4,0,4,204,0,204,14,0,14,4,0,4,226,0,226
Tamilnadu,2001,Kidnapping And Abduction,0,0,0,4,0,4,4,0,4,1,0,1,9,0,9
Tamilnadu,2001,Dacoity,1,0,1,42,0,42,25,0,25,5,0,5,73,0,73
Tamilnadu,2001,Prep. And Assembly For Dacoity,0,0,0,9,0,9,7,0,7,1,0,1,17,0,17
Tamilnadu,2001,Robbery,0,0,0,107,0,107,52,0,52,5,0,5,164,0,164
Tamilnadu,2001,Burglary,0,0,0,52,0,52,61,0,61,2,0,2,115,0,115
Tamilnadu,2001,Thefts,22,0,22,162,4,166,82,1,83,13,0,13,279,5,284
Tamilnadu,2001,Extortion,0,0,0,0,0,0,6,0,6,0,0,0,6,0,6
Tamilnadu,2001,Riots,0,0,0,13,0,13,0,0,0,0,0,0,13,0,13
Tamilnadu,2001,Arson,0,0,0,0,0,0,0,0,0,0,0,0,0,0,0
Tamilnadu,2001,Criminal Breach Of Trust,0,0,0,2,0,2,0,0,0,0,0,0,2,0,2
Tamilnadu,2001,Cheating,0,0,0,26,0,26,11,1,12,0,0,0,37,1,38
Tamilnadu,2001,Counter Feiting,0,0,0,8,0,8,4,0,4,0,0,0,12,0,12
Tamilnadu,2001,Dowry Deaths,0,0,0,4,0,4,0,0,0,0,0,0,4,0,4
Tamilnadu,2001,Molestation,0,0,0,0,0,0,0,0,0,0,0,0,0,0,0
Tamilnadu,2001,Eve-Teasing,0,0,0,0,0,0,0,0,0,0,0,0,0,0,0
Tamilnadu,2001,Cruelty By Husband Or Relative Of Husband,0,0,0,0,0,0,0,0,0,2,1,3,2,1,3
Tamilnadu,2001,Other Ipc Crimes,0,0,0,20,5,25,5,9,14,2,2,4,27,16,43
Tamilnadu,2002,Murder,13,0,13,1580,25,1605,1538,76,1614,296,17,313,3427,118,3545
Tamilnadu,2002,Attempt To Commit Murder,3,0,3,175,0,175,59,0,59,17,0,17,254,0,254
Tamilnadu,2002,C.H. Not Amounting To Murder,6,0,6,32,2,34,33,9,42,5,2,7,76,13,89
Tamilnadu,2002,Rape,0,0,0,82,0,82,15,0,15,4,0,4,101,0,101
Tamilnadu,2002,Kidnapping And Abduction,0,0,0,14,3,17,16,2,18,14,1,15,44,6,50
Tamilnadu,2002,Dacoity,0,0,0,38,0,38,12,0,12,4,0,4,54,0,54
Tamilnadu,2002,Prep. And Assembly For Dacoity,0,0,0,13,0,13,12,0,12,10,0,10,35,0,35
Tamilnadu,2002,Robbery,0,0,0,195,3,198,93,0,93,12,0,12,300,3,303
Tamilnadu,2002,Burglary,0,0,0,30,0,30,34,1,35,30,0,30,94,1,95
Tamilnadu,2002,Thefts,28,0,28,448,2,450,86,8,94,33,0,33,595,10,605
Tamilnadu,2002,Extortion,0,0,0,0,0,0,0,0,0,0,0,0,0,0,0
Tamilnadu,2002,Riots,0,0,0,0,0,0,0,0,0,0,0,0,0,0,0
Tamilnadu,2002,Arson,0,0,0,0,0,0,0,0,0,0,0,0,0,0,0
Tamilnadu,2002,Criminal Breach Of Trust,0,0,0,0,0,0,0,0,0,0,0,0,0,0,0
Tamilnadu,2002,Cheating,0,0,0,7,0,7,8,0,8,0,0,0,15,0,15
Tamilnadu,2002,Counter Feiting,0,0,0,15,0,15,2,0,2,0,0,0,17,0,17
Tamilnadu,2002,Dowry Deaths,0,0,0,3,0,3,0,3,3,0,0,0,3,3,6
Tamilnadu,2002,Molestation,0,0,0,0,0,0,0,0,0,0,0,0,0,0,0
Tamilnadu,2002,Eve-Teasing,0,0,0,0,0,0,0,0,0,0,0,0,0,0,0
Tamilnadu,2002,Cruelty By Husband Or Relative Of Husband,0,0,0,6,0,6,0,1,1,0,0,0,6,1,7
Tamilnadu,2002,Other Ipc Crimes,0,0,0,21,3,24,7,5,12,2,1,3,30,9,39
Tamilnadu,2003,Murder,0,0,0,1626,22,1648,1680,78,1758,272,22,294,3578,122,3700
Tamilnadu,2003,Attempt To Commit Murder,0,0,0,195,0,195,68,0,68,20,0,20,283,0,283
Tamilnadu,2003,C.H. Not Amounting To Murder,0,0,0,43,4,47,41,11,52,7,2,9,91,17,108
Tamilnadu,2003,Rape,0,0,0,86,0,86,17,0,17,6,0,6,109,0,109
Tamilnadu,2003,Kidnapping And Abduction,0,0,0,16,4,20,19,4,23,18,2,20,53,10,63
Tamilnadu,2003,Dacoity,0,0,0,42,0,42,14,0,14,6,0,6,62,0,62
Tamilnadu,2003,Prep. And Assembly For Dacoity,0,0,0,15,0,15,14,0,14,15,0,15,44,0,44
Tamilnadu,2003,Robbery,0,0,0,198,5,203,97,0,97,16,0,16,311,5,316
Tamilnadu,2003,Burglary,0,0,0,37,0,37,37,2,39,17,0,17,91,2,93
Tamilnadu,2003,Thefts,0,0,0,366,7,373,450,7,457,45,0,45,861,14,875
Tamilnadu,2003,Extortion,0,0,0,0,0,0,0,0,0,0,0,0,0,0,0
Tamilnadu,2003,Riots,0,0,0,0,0,0,0,0,0,0,0,0,0,0,0
Tamilnadu,2003,Arson,0,0,0,0,0,0,0,0,0,0,0,0,0,0,0
Tamilnadu,2003,Criminal Breach Of Trust,0,0,0,0,0,0,0,0,0,0,0,0,0,0,0
Tamilnadu,2003,Cheating,0,0,0,9,0,9,9,0,9,0,0,0,18,0,18
Tamilnadu,2003,Counter Feiting,0,0,0,17,0,17,4,0,4,0,0,0,21,0,21
Tamilnadu,2003,Dowry Deaths,0,0,0,5,0,5,0,0,0,0,0,0,5,0,5
Tamilnadu,2003,Molestation,0,0,0,0,0,0,0,0,0,0,0,0,0,0,0
Tamilnadu,2003,Eve-Teasing,0,0,0,0,0,0,0,0,0,0,0,0,0,0,0
Tamilnadu,2003,Cruelty By Husband Or Relative Of Husband,0,0,0,8,0,8,0,0,0,0,0,0,8,0,8
Tamilnadu,2003,Other Ipc Crimes,0,0,0,25,3,28,10,3,13,7,1,8,42,7,49
Tamilnadu,2004,Murder,0,0,0,1724,23,1747,1710,83,1793,476,9,485,3910,115,4025
Tamilnadu,2004,Attempt To Commit Murder,0,0,0,206,4,210,212,3,215,31,1,32,449,8,457
Tamilnadu,2004,C.H. Not Amounting To Murder,0,0,0,148,3,151,132,12,144,17,2,19,297,17,314
Tamilnadu,2004,Rape,0,0,0,45,0,45,70,0,70,0,0,0,115,0,115
Tamilnadu,2004,Kidnapping And Abduction,0,0,0,9,0,9,9,0,9,0,0,0,18,0,18
Tamilnadu,2004,Dacoity,0,0,0,176,0,176,208,0,208,0,0,0,384,0,384
Tamilnadu,2004,Prep. And Assembly For Dacoity,0,0,0,16,0,16,17,0,17,0,0,0,33,0,33
Tamilnadu,2004,Robbery,0,0,0,215,0,215,177,0,177,0,0,0,392,0,392
Tamilnadu,2004,Burglary,0,0,0,18,0,18,16,0,16,0,0,0,34,0,34
Tamilnadu,2004,Thefts,0,0,0,226,4,230,157,3,160,8,0,8,391,7,398
Tamilnadu,2004,Extortion,0,0,0,0,0,0,0,0,0,0,0,0,0,0,0
Tamilnadu,2004,Riots,0,0,0,0,0,0,0,0,0,0,0,0,0,0,0
Tamilnadu,2004,Arson,0,0,0,0,0,0,0,0,0,0,0,0,0,0,0
Tamilnadu,2004,Criminal Breach Of Trust,0,0,0,0,0,0,0,0,0,0,0,0,0,0,0
Tamilnadu,2004,Cheating,0,0,0,47,3,50,35,1,36,0,0,0,82,4,86
Tamilnadu,2004,Counter Feiting,0,0,0,7,1,8,8,0,8,0,0,0,15,1,16
Tamilnadu,2004,Dowry Deaths,0,0,0,11,3,14,7,5,12,0,0,0,18,8,26
Tamilnadu,2004,Molestation,0,0,0,0,0,0,0,0,0,0,0,0,0,0,0
Tamilnadu,2004,Eve-Teasing,0,0,0,0,0,0,0,0,0,0,0,0,0,0,0
Tamilnadu,2004,Cruelty By Husband Or Relative Of Husband,0,0,0,0,2,2,0,4,4,0,0,0,0,6,6
Tamilnadu,2004,Other Ipc Crimes,0,0,0,141,0,141,101,0,101,0,0,0,242,0,242
Tamilnadu,2005,Murder,0,0,0,768,0,768,1490,89,1579,439,11,450,2697,100,2797
Tamilnadu,2005,Attempt To Commit Murder,0,0,0,244,15,259,465,52,517,76,15,91,785,82,867
Tamilnadu,2005,C.H. Not Amounting To Murder,0,0,0,128,3,131,116,3,119,40,0,40,284,6,290
Tamilnadu,2005,Rape,0,0,0,162,0,162,125,0,125,13,0,13,300,0,300
Tamilnadu,2005,Kidnapping And Abduction,0,0,0,70,0,70,83,4,87,16,0,16,169,4,173
Tamilnadu,2005,Dacoity,0,0,0,140,2,142,78,2,80,3,0,3,221,4,225
Tamilnadu,2005,Prep. And Assembly For Dacoity,0,0,0,0,0,0,2,2,4,1,0,1,3,2,5
Tamilnadu,2005,Robbery,0,0,0,190,0,190,158,7,165,20,0,20,368,7,375
Tamilnadu,2005,Burglary,0,0,0,60,0,60,286,6,292,0,0,0,346,6,352
Tamilnadu,2005,Thefts,0,0,0,396,2,398,369,8,377,174,2,176,939,12,951
Tamilnadu,2005,Extortion,0,0,0,0,0,0,1,0,1,0,0,0,1,0,1
Tamilnadu,2005,Riots,0,0,0,0,0,0,4,0,4,2,0,2,6,0,6
Tamilnadu,2005,Arson,0,0,0,0,0,0,1,0,1,0,0,0,1,0,1
Tamilnadu,2005,Criminal Breach Of Trust,0,0,0,0,0,0,0,0,0,0,0,0,0,0,0
Tamilnadu,2005,Cheating,0,0,0,46,0,46,64,0,64,11,0,11,121,0,121
Tamilnadu,2005,Counter Feiting,0,0,0,0,0,0,0,0,0,0,0,0,0,0,0
Tamilnadu,2005,Dowry Deaths,0,0,0,5,0,5,2,0,2,0,0,0,7,0,7
Tamilnadu,2005,Molestation,0,0,0,0,0,0,0,0,0,0,0,0,0,0,0
Tamilnadu,2005,Eve-Teasing,0,0,0,0,0,0,0,0,0,0,0,0,0,0,0
Tamilnadu,2005,Cruelty By Husband Or Relative Of Husband,0,0,0,10,0,10,0,5,5,0,2,2,10,7,17
Tamilnadu,2005,Other Ipc Crimes,0,0,0,137,0,137,81,8,89,74,0,74,292,8,300
Tamilnadu,2006,Murder,0,0,0,668,7,675,1315,64,1379,337,16,353,2320,87,2407
Tamilnadu,2006,Attempt To Commit Murder,0,0,0,242,5,247,440,12,452,72,5,77,754,22,776
Tamilnadu,2006,C.H. Not Amounting To Murder,0,0,0,107,2,109,85,3,88,45,0,45,237,5,242
Tamilnadu,2006,Rape,0,0,0,145,0,145,116,0,116,12,0,12,273,0,273
Tamilnadu,2006,Kidnapping And Abduction,0,0,0,65,0,65,76,0,76,16,0,16,157,0,157
Tamilnadu,2006,Dacoity,0,0,0,120,2,122,65,2,67,3,0,3,188,4,192
Tamilnadu,2006,Prep. And Assembly For Dacoity,0,0,0,0,0,0,0,0,0,0,0,0,0,0,0
Tamilnadu,2006,Robbery,0,0,0,195,0,195,147,5,152,31,0,31,373,5,378
Tamilnadu,2006,Burglary,0,0,0,0,0,0,176,4,180,0,0,0,176,4,180
Tamilnadu,2006,Thefts,0,0,0,416,2,418,332,7,339,135,4,139,883,13,896
Tamilnadu,2006,Extortion,0,0,0,0,0,0,1,0,1,0,0,0,1,0,1
Tamilnadu,2006,Riots,0,0,0,0,0,0,4,0,4,0,0,0,4,0,4
Tamilnadu,2006,Arson,0,0,0,0,0,0,1,0,1,0,0,0,1,0,1
Tamilnadu,2006,Criminal Breach Of Trust,0,0,0,0,0,0,0,0,0,0,0,0,0,0,0
Tamilnadu,2006,Cheating,0,0,0,32,0,32,56,0,56,7,1,8,95,1,96
Tamilnadu,2006,Counter Feiting,0,0,0,0,0,0,0,0,0,0,0,0,0,0,0
Tamilnadu,2006,Dowry Deaths,0,0,0,5,0,5,3,0,3,0,0,0,8,0,8
Tamilnadu,2006,Molestation,0,0,0,0,0,0,0,0,0,0,0,0,0,0,0
Tamilnadu,2006,Eve-Teasing,0,0,0,0,0,0,0,0,0,0,0,0,0,0,0
Tamilnadu,2006,Cruelty By Husband Or Relative Of Husband,0,0,0,0,0,0,0,0,0,0,0,0,0,0,0
Tamilnadu,2006,Other Ipc Crimes,0,0,0,125,0,125,96,0,96,6,3,9,227,3,230
Tamilnadu,2007,Murder,0,0,0,677,11,688,2310,88,2398,258,10,268,3245,109,3354
Tamilnadu,2007,Attempt To Commit Murder,0,0,0,104,13,117,718,12,730,31,3,34,853,28,881
Tamilnadu,2007,C.H. Not Amounting To Murder,0,0,0,15,0,15,125,7,132,28,0,28,168,7,175
Tamilnadu,2007,Rape,0,0,0,30,0,30,29,0,29,14,0,14,73,0,73
Tamilnadu,2007,Kidnapping And Abduction,0,0,0,0,0,0,0,0,0,0,0,0,0,0,0
Tamilnadu,2007,Dacoity,0,0,0,49,0,49,66,1,67,42,0,42,157,1,158
Tamilnadu,2007,Prep. And Assembly For Dacoity,0,0,0,0,0,0,57,0,57,0,0,0,57,0,57
Tamilnadu,2007,Robbery,0,0,0,294,0,294,79,0,79,72,0,72,445,0,445
Tamilnadu,2007,Burglary,0,0,0,47,0,47,15,0,15,0,0,0,62,0,62
Tamilnadu,2007,Thefts,0,0,0,298,2,300,397,6,403,46,8,54,741,16,757
Tamilnadu,2007,Extortion,0,0,0,0,0,0,0,0,0,0,0,0,0,0,0
Tamilnadu,2007,Riots,0,0,0,0,0,0,0,0,0,0,0,0,0,0,0
Tamilnadu,2007,Arson,0,0,0,0,0,0,0,0,0,0,0,0,0,0,0
Tamilnadu,2007,Criminal Breach Of Trust,0,0,0,0,0,0,2,0,2,2,0,2,4,0,4
Tamilnadu,2007,Cheating,0,0,0,0,0,0,0,0,0,0,1,1,0,1,1
Tamilnadu,2007,Counter Feiting,0,0,0,15,0,15,30,0,30,0,1,1,45,1,46
Tamilnadu,2007,Dowry Deaths,0,0,0,18,0,18,16,2,18,0,0,0,34,2,36
Tamilnadu,2007,Molestation,0,0,0,0,0,0,0,0,0,0,0,0,0,0,0
Tamilnadu,2007,Eve-Teasing,0,0,0,0,0,0,0,0,0,0,0,0,0,0,0
Tamilnadu,2007,Cruelty By Husband Or Relative Of Husband,0,0,0,0,0,0,4,0,4,0,8,8,4,8,12
Tamilnadu,2007,Other Ipc Crimes,0,0,0,0,0,0,4,0,4,0,1,1,4,1,5
Tamilnadu,2008,Murder,0,0,0,979,18,997,1367,78,1445,246,8,254,2592,104,2696
Tamilnadu,2008,Attempt To Commit Murder,0,0,0,49,0,49,95,4,99,20,1,21,164,5,169
Tamilnadu,2008,C.H. Not Amounting To Murder,0,0,0,61,0,61,63,6,69,62,3,65,186,9,195
Tamilnadu,2008,Rape,0,0,0,45,0,45,33,0,33,6,0,6,84,0,84
Tamilnadu,2008,Kidnapping And Abduction,0,0,0,14,0,14,7,0,7,4,0,4,25,0,25
Tamilnadu,2008,Dacoity,0,0,0,63,1,64,64,1,65,12,0,12,139,2,141
Tamilnadu,2008,Prep. And Assembly For Dacoity,0,0,0,13,0,13,15,1,16,6,0,6,34,1,35
Tamilnadu,2008,Robbery,0,0,0,97,2,99,85,0,85,13,0,13,195,2,197
Tamilnadu,2008,Burglary,0,0,0,23,1,24,9,0,9,7,0,7,39,1,40
Tamilnadu,2008,Thefts,0,0,0,164,2,166,173,4,177,39,0,39,376,6,382
Tamilnadu,2008,Extortion,0,0,0,7,0,7,8,0,8,2,1,3,17,1,18
Tamilnadu,2008,Riots,0,0,0,8,0,8,5,0,5,8,0,8,21,0,21
Tamilnadu,2008,Arson,0,0,0,2,0,2,2,0,2,1,0,1,5,0,5
Tamilnadu,2008,Criminal Breach Of Trust,0,0,0,0,0,0,3,0,3,0,0,0,3,0,3
Tamilnadu,2008,Cheating,0,0,0,13,1,14,44,0,44,7,1,8,64,2,66
Tamilnadu,2008,Counter Feiting,0,0,0,0,0,0,0,0,0,0,0,0,0,0,0
Tamilnadu,2008,Dowry Deaths,0,0,0,8,0,8,6,0,6,6,4,10,20,4,24
Tamilnadu,2008,Molestation,0,0,0,2,0,2,1,0,1,1,0,1,4,0,4
Tamilnadu,2008,Eve-Teasing,0,0,0,2,0,2,3,0,3,1,0,1,6,0,6
Tamilnadu,2008,Cruelty By Husband Or Relative Of Husband,0,0,0,15,1,16,21,0,21,2,2,4,38,3,41
Tamilnadu,2008,Other Ipc Crimes,0,0,0,326,9,335,458,13,471,12,1,13,796,23,819
Tamilnadu,2009,Murder,0,0,0,945,24,969,1592,64,1656,387,9,396,2924,97,3021
Tamilnadu,2009,Attempt To Commit Murder,0,0,0,55,0,55,86,2,88,48,1,49,189,3,192
Tamilnadu,2009,C.H. Not Amounting To Murder,0,0,0,51,0,51,75,0,75,85,1,86,211,1,212
Tamilnadu,2009,Rape,0,0,0,55,0,55,28,3,31,5,0,5,88,3,91
Tamilnadu,2009,Kidnapping And Abduction,0,0,0,26,0,26,10,0,10,3,0,3,39,0,39
Tamilnadu,2009,Dacoity,0,0,0,63,1,64,41,2,43,26,0,26,130,3,133
Tamilnadu,2009,Prep. And Assembly For Dacoity,0,0,0,36,0,36,30,0,30,18,0,18,84,0,84
Tamilnadu,2009,Robbery,0,0,0,129,1,130,79,2,81,49,1,50,257,4,261
Tamilnadu,2009,Burglary,0,0,0,37,0,37,19,0,19,28,0,28,84,0,84
Tamilnadu,2009,Thefts,0,0,0,145,8,153,127,9,136,73,1,74,345,18,363
Tamilnadu,2009,Extortion,0,0,0,17,0,17,9,0,9,7,0,7,33,0,33
Tamilnadu,2009,Riots,0,0,0,2,0,2,0,0,0,10,0,10,12,0,12
Tamilnadu,2009,Arson,0,0,0,0,0,0,5,0,5,3,0,3,8,0,8
Tamilnadu,2009,Criminal Breach Of Trust,0,0,0,2,0,2,2,0,2,0,0,0,4,0,4
Tamilnadu,2009,Cheating,0,0,0,28,2,30,17,2,19,14,1,15,59,5,64
Tamilnadu,2009,Counter Feiting,0,0,0,2,0,2,7,2,9,4,0,4,13,2,15
Tamilnadu,2009,Dowry Deaths,0,0,0,21,2,23,7,9,16,8,3,11,36,14,50
Tamilnadu,2009,Molestation,0,0,0,0,0,0,0,0,0,0,0,0,0,0,0
Tamilnadu,2009,Eve-Teasing,0,0,0,2,0,2,3,0,3,1,0,1,6,0,6
Tamilnadu,2009,Cruelty By Husband Or Relative Of Husband,0,0,0,19,1,20,23,2,25,13,5,18,55,8,63
Tamilnadu,2009,Other Ipc Crimes,0,0,0,15,0,15,10,1,11,10,0,10,35,1,36
Tamilnadu,2010,Murder,0,0,0,891,54,945,1575,43,1618,388,14,402,2854,111,2965
Tamilnadu,2010,Attempt To Commit Murder,0,0,0,102,0,102,127,3,130,54,2,56,283,5,288
Tamilnadu,2010,C.H. Not Amounting To Murder,0,0,0,11,0,11,47,8,55,75,3,78,133,11,144
Tamilnadu,2010,Rape,0,0,0,31,1,32,68,0,68,20,0,20,119,1,120
Tamilnadu,2010,Kidnapping And Abduction,0,0,0,15,0,15,28,2,30,1,0,1,44,2,46
Tamilnadu,2010,Dacoity,0,0,0,63,0,63,91,0,91,26,0,26,180,0,180
Tamilnadu,2010,Prep. And Assembly For Dacoity,0,0,0,6,0,6,2,0,2,17,0,17,25,0,25
Tamilnadu,2010,Robbery,0,0,0,93,3,96,105,0,105,41,0,41,239,3,242
Tamilnadu,2010,Burglary,0,0,0,47,4,51,69,0,69,22,0,22,138,4,142
Tamilnadu,2010,Thefts,0,0,0,102,10,112,87,5,92,50,0,50,239,15,254
Tamilnadu,2010,Extortion,0,0,0,17,0,17,33,2,35,0,0,0,50,2,52
Tamilnadu,2010,Riots,0,0,0,37,0,37,46,0,46,22,0,22,105,0,105
Tamilnadu,2010,Arson,0,0,0,0,0,0,70,0,70,1,0,1,71,0,71
Tamilnadu,2010,Criminal Breach Of Trust,0,0,0,0,0,0,4,0,4,0,0,0,4,0,4
Tamilnadu,2010,Cheating,0,0,0,8,0,8,94,1,95,4,0,4,106,1,107
Tamilnadu,2010,Counter Feiting,0,0,0,0,0,0,1,0,1,0,0,0,1,0,1
Tamilnadu,2010,Dowry Deaths,0,0,0,1,0,1,14,0,14,2,0,2,17,0,17
Tamilnadu,2010,Molestation,0,0,0,3,0,3,16,0,16,0,0,0,19,0,19
Tamilnadu,2010,Eve-Teasing,0,0,0,0,0,0,18,0,18,0,0,0,18,0,18
Tamilnadu,2010,Cruelty By Husband Or Relative Of Husband,0,0,0,4,0,4,39,4,43,2,3,5,45,7,52
Tamilnadu,2010,Other Ipc Crimes,0,0,0,9,0,9,8,1,9,3,0,3,20,1,21
Tamilnadu,2011,Murder,0,0,0,586,22,608,1393,98,1491,385,15,400,2364,135,2499
Tamilnadu,2011,Attempt To Commit Murder,0,0,0,314,0,314,462,4,466,145,0,145,921,4,925
Tamilnadu,2011,C.H. Not Amounting To Murder,0,0,0,36,1,37,62,8,70,45,2,47,143,11,154
Tamilnadu,2011,Rape,0,0,0,27,0,27,80,0,80,18,0,18,125,0,125
Tamilnadu,2011,Kidnapping And Abduction,0,0,0,15,1,16,37,0,37,19,0,19,71,1,72
Tamilnadu,2011,Dacoity,0,0,0,37,0,37,88,0,88,52,0,52,177,0,177
Tamilnadu,2011,Prep. And Assembly For Dacoity,0,0,0,4,0,4,8,0,8,23,0,23,35,0,35
Tamilnadu,2011,Robbery,0,0,0,73,0,73,113,1,114,36,0,36,222,1,223
Tamilnadu,2011,Burglary,0,0,0,23,0,23,52,0,52,23,0,23,98,0,98
Tamilnadu,2011,Thefts,0,0,0,83,5,88,117,0,117,59,0,59,259,5,264
Tamilnadu,2011,Extortion,0,0,0,0,0,0,12,0,12,9,0,9,21,0,21
Tamilnadu,2011,Riots,0,0,0,23,0,23,16,0,16,8,0,8,47,0,47
Tamilnadu,2011,Arson,0,0,0,0,0,0,1,0,1,1,0,1,2,0,2
Tamilnadu,2011,Criminal Breach Of Trust,0,0,0,0,0,0,11,0,11,0,0,0,11,0,11
Tamilnadu,2011,Cheating,0,0,0,17,0,17,8,1,9,1,2,3,26,3,29
Tamilnadu,2011,Counter Feiting,0,0,0,3,0,3,19,0,19,0,0,0,22,0,22
Tamilnadu,2011,Dowry Deaths,0,0,0,1,0,1,13,2,15,3,0,3,17,2,19
Tamilnadu,2011,Molestation,0,0,0,2,0,2,3,0,3,4,0,4,9,0,9
Tamilnadu,2011,Eve-Teasing,0,0,0,2,0,2,2,0,2,0,0,0,4,0,4
Tamilnadu,2011,Cruelty By Husband Or Relative Of Husband,0,0,0,8,0,8,58,0,58,11,2,13,77,2,79
Tamilnadu,2011,Other Ipc Crimes,0,0,0,0,0,0,0,1,1,0,0,0,0,1,1
Tamilnadu,2012,Murder,0,0,0,732,24,756,1657,76,1733,501,23,524,2890,123,3013
Tamilnadu,2012,Attempt To Commit Murder,0,0,0,70,0,70,83,0,83,40,0,40,193,0,193
Tamilnadu,2012,C.H. Not Amounting To Murder,0,0,0,31,2,33,28,7,35,32,1,33,91,10,101
Tamilnadu,2012,Rape,0,0,0,13,0,13,29,0,29,3,0,3,45,0,45
Tamilnadu,2012,Kidnapping And Abduction,0,0,0,56,0,56,56,1,57,39,0,39,151,1,152
Tamilnadu,2012,Dacoity,0,0,0,53,0,53,65,1,66,28,0,28,146,1,147
Tamilnadu,2012,Prep. And Assembly For Dacoity,0,0,0,12,0,12,3,0,3,6,0,6,21,0,21
Tamilnadu,2012,Robbery,0,0,0,76,2,78,38,0,38,32,0,32,146,2,148
Tamilnadu,2012,Burglary,0,0,0,71,0,71,89,0,89,46,0,46,206,0,206
Tamilnadu,2012,Thefts,0,0,0,83,1,84,94,4,98,45,0,45,222,5,227
Tamilnadu,2012,Extortion,0,0,0,4,0,4,2,0,2,10,0,10,16,0,16
Tamilnadu,2012,Riots,0,0,0,3,0,3,0,0,0,0,1,1,3,1,4
Tamilnadu,2012,Arson,0,0,0,0,0,0,0,0,0,0,0,0,0,0,0
Tamilnadu,2012,Criminal Breach Of Trust,0,0,0,7,0,7,13,0,13,0,0,0,20,0,20
Tamilnadu,2012,Cheating,0,0,0,23,0,23,10,0,10,7,0,7,40,0,40
Tamilnadu,2012,Counter Feiting,0,0,0,6,0,6,11,0,11,0,0,0,17,0,17
Tamilnadu,2012,Dowry Deaths,0,0,0,12,2,14,17,2,19,3,0,3,32,4,36
Tamilnadu,2012,Molestation,0,0,0,0,0,0,0,0,0,0,0,0,0,0,0
Tamilnadu,2012,Eve-Teasing,0,0,0,2,0,2,0,0,0,0,0,0,2,0,2
Tamilnadu,2012,Cruelty By Husband Or Relative Of Husband,0,0,0,17,0,17,67,5,72,12,0,12,96,5,101
Tamilnadu,2012,Other Ipc Crimes,0,0,0,12,1,13,0,1,1,2,3,5,14,5,19
Tripura,2001,Murder,1,0,1,12,1,13,8,1,9,10,0,10,31,2,33
Tripura,2001,Attempt To Commit Murder,0,0,0,7,0,7,7,0,7,1,0,1,15,0,15
Tripura,2001,C.H. Not Amounting To Murder,0,0,0,10,0,10,14,0,14,0,0,0,24,0,24
Tripura,2001,Rape,0,0,0,26,0,26,14,0,14,0,0,0,40,0,40
Tripura,2001,Kidnapping And Abduction,0,0,0,14,0,14,17,0,17,0,0,0,31,0,31
Tripura,2001,Dacoity,0,0,0,18,0,18,9,0,9,0,0,0,27,0,27
Tripura,2001,Prep. And Assembly For Dacoity,0,0,0,0,0,0,0,0,0,0,0,0,0,0,0
Tripura,2001,Robbery,0,0,0,0,0,0,4,0,4,0,0,0,4,0,4
Tripura,2001,Burglary,0,0,0,0,0,0,0,0,0,0,0,0,0,0,0
Tripura,2001,Thefts,0,0,0,7,0,7,4,0,4,0,0,0,11,0,11
Tripura,2001,Extortion,0,0,0,1,0,1,1,0,1,0,0,0,2,0,2
Tripura,2001,Riots,0,0,0,7,0,7,3,0,3,0,0,0,10,0,10
Tripura,2001,Arson,0,0,0,8,0,8,4,0,4,0,0,0,12,0,12
Tripura,2001,Criminal Breach Of Trust,0,0,0,0,0,0,0,0,0,0,0,0,0,0,0
Tripura,2001,Cheating,0,0,0,1,0,1,1,0,1,0,0,0,2,0,2
Tripura,2001,Counter Feiting,0,0,0,0,0,0,0,0,0,0,0,0,0,0,0
Tripura,2001,Dowry Deaths,0,0,0,0,0,0,0,0,0,0,0,0,0,0,0
Tripura,2001,Molestation,0,0,0,1,0,1,3,0,3,0,0,0,4,0,4
Tripura,2001,Eve-Teasing,0,0,0,0,0,0,0,0,0,0,0,0,0,0,0
Tripura,2001,Cruelty By Husband Or Relative Of Husband,0,0,0,2,0,2,4,1,5,2,0,2,8,1,9
Tripura,2001,Other Ipc Crimes,0,0,0,20,0,20,14,0,14,0,0,0,34,0,34
Tripura,2002,Murder,6,0,6,42,2,44,60,0,60,12,0,12,120,2,122
Tripura,2002,Attempt To Commit Murder,2,0,2,13,0,13,11,0,11,3,0,3,29,0,29
Tripura,2002,C.H. Not Amounting To Murder,6,1,7,10,0,10,0,0,0,0,0,0,16,1,17
Tripura,2002,Rape,8,0,8,24,1,25,17,0,17,1,0,1,50,1,51
Tripura,2002,Kidnapping And Abduction,3,0,3,22,0,22,33,0,33,0,0,0,58,0,58
Tripura,2002,Dacoity,0,0,0,9,0,9,11,0,11,3,0,3,23,0,23
Tripura,2002,Prep. And Assembly For Dacoity,0,0,0,0,0,0,2,0,2,0,0,0,2,0,2
Tripura,2002,Robbery,0,0,0,2,0,2,2,0,2,0,0,0,4,0,4
Tripura,2002,Burglary,0,0,0,2,0,2,0,0,0,0,0,0,2,0,2
Tripura,2002,Thefts,2,0,2,8,0,8,13,0,13,0,0,0,23,0,23
Tripura,2002,Extortion,0,0,0,0,0,0,0,0,0,0,0,0,0,0,0
Tripura,2002,Riots,0,0,0,8,0,8,16,0,16,0,0,0,24,0,24
Tripura,2002,Arson,0,0,0,2,0,2,3,0,3,1,0,1,6,0,6
Tripura,2002,Criminal Breach Of Trust,0,0,0,0,0,0,1,0,1,0,0,0,1,0,1
Tripura,2002,Cheating,0,0,0,1,0,1,2,0,2,0,0,0,3,0,3
Tripura,2002,Counter Feiting,0,0,0,0,0,0,0,0,0,0,0,0,0,0,0
Tripura,2002,Dowry Deaths,0,0,0,2,1,3,3,0,3,0,0,0,5,1,6
Tripura,2002,Molestation,0,0,0,0,0,0,5,0,5,0,0,0,5,0,5
Tripura,2002,Eve-Teasing,0,0,0,5,0,5,0,0,0,2,0,2,7,0,7
Tripura,2002,Cruelty By Husband Or Relative Of Husband,0,0,0,9,0,9,10,0,10,1,0,1,20,0,20
Tripura,2002,Other Ipc Crimes,0,0,0,9,0,9,13,0,13,2,0,2,24,0,24
Tripura,2003,Murder,1,0,1,105,0,105,125,2,127,24,1,25,255,3,258
Tripura,2003,Attempt To Commit Murder,1,0,1,6,0,6,6,0,6,0,0,0,13,0,13
Tripura,2003,C.H. Not Amounting To Murder,0,0,0,1,0,1,7,0,7,2,1,3,10,1,11
Tripura,2003,Rape,0,0,0,24,0,24,30,0,30,3,0,3,57,0,57
Tripura,2003,Kidnapping And Abduction,1,0,1,16,0,16,34,0,34,5,0,5,56,0,56
Tripura,2003,Dacoity,0,0,0,2,0,2,9,0,9,2,0,2,13,0,13
Tripura,2003,Prep. And Assembly For Dacoity,0,0,0,1,0,1,2,0,2,0,0,0,3,0,3
Tripura,2003,Robbery,0,0,0,0,0,0,2,0,2,2,0,2,4,0,4
Tripura,2003,Burglary,0,0,0,1,0,1,4,0,4,0,0,0,5,0,5
Tripura,2003,Thefts,0,0,0,5,0,5,6,0,6,0,0,0,11,0,11
Tripura,2003,Extortion,0,0,0,0,0,0,0,0,0,0,0,0,0,0,0
Tripura,2003,Riots,0,0,0,0,0,0,1,0,1,0,0,0,1,0,1
Tripura,2003,Arson,0,0,0,2,0,2,6,0,6,0,0,0,8,0,8
Tripura,2003,Criminal Breach Of Trust,0,0,0,0,0,0,0,0,0,0,0,0,0,0,0
Tripura,2003,Cheating,0,0,0,0,0,0,2,0,2,1,0,1,3,0,3
Tripura,2003,Counter Feiting,0,0,0,1,0,1,5,0,5,1,0,1,7,0,7
Tripura,2003,Dowry Deaths,0,0,0,0,0,0,0,0,0,1,2,3,1,2,3
Tripura,2003,Molestation,0,0,0,0,0,0,1,0,1,0,0,0,1,0,1
Tripura,2003,Eve-Teasing,0,0,0,0,0,0,2,0,2,3,0,3,5,0,5
Tripura,2003,Cruelty By Husband Or Relative Of Husband,0,0,0,6,0,6,11,1,12,4,0,4,21,1,22
Tripura,2003,Other Ipc Crimes,0,0,0,2,0,2,3,0,3,2,0,2,7,0,7
Tripura,2004,Murder,1,0,1,74,0,74,173,4,177,29,0,29,277,4,281
Tripura,2004,Attempt To Commit Murder,1,0,1,15,0,15,18,2,20,1,0,1,35,2,37
Tripura,2004,C.H. Not Amounting To Murder,0,0,0,0,0,0,0,0,0,0,0,0,0,0,0
Tripura,2004,Rape,0,0,0,31,0,31,30,0,30,8,0,8,69,0,69
Tripura,2004,Kidnapping And Abduction,0,0,0,23,0,23,38,3,41,2,0,2,63,3,66
Tripura,2004,Dacoity,0,0,0,0,0,0,1,0,1,0,0,0,1,0,1
Tripura,2004,Prep. And Assembly For Dacoity,0,0,0,0,0,0,0,0,0,0,0,0,0,0,0
Tripura,2004,Robbery,0,0,0,4,0,4,5,0,5,0,0,0,9,0,9
Tripura,2004,Burglary,0,0,0,3,0,3,3,0,3,0,0,0,6,0,6
Tripura,2004,Thefts,0,0,0,1,0,1,0,0,0,0,0,0,1,0,1
Tripura,2004,Extortion,0,0,0,0,0,0,0,0,0,0,0,0,0,0,0
Tripura,2004,Riots,0,0,0,5,0,5,2,0,2,1,0,1,8,0,8
Tripura,2004,Arson,0,0,0,4,0,4,10,0,10,0,0,0,14,0,14
Tripura,2004,Criminal Breach Of Trust,0,0,0,0,0,0,0,0,0,0,0,0,0,0,0
Tripura,2004,Cheating,0,0,0,3,0,3,1,0,1,0,0,0,4,0,4
Tripura,2004,Counter Feiting,0,0,0,2,0,2,2,0,2,0,0,0,4,0,4
Tripura,2004,Dowry Deaths,0,0,0,4,0,4,2,1,3,1,0,1,7,1,8
Tripura,2004,Molestation,0,0,0,0,0,0,4,0,4,0,0,0,4,0,4
Tripura,2004,Eve-Teasing,0,0,0,0,0,0,0,0,0,0,0,0,0,0,0
Tripura,2004,Cruelty By Husband Or Relative Of Husband,0,0,0,2,0,2,0,0,0,0,0,0,2,0,2
Tripura,2004,Other Ipc Crimes,0,0,0,12,0,12,6,2,8,2,0,2,20,2,22
Tripura,2005,Murder,0,0,0,99,0,99,207,3,210,67,4,71,373,7,380
Tripura,2005,Attempt To Commit Murder,1,0,1,7,0,7,12,0,12,0,0,0,20,0,20
Tripura,2005,C.H. Not Amounting To Murder,0,0,0,9,0,9,18,0,18,0,0,0,27,0,27
Tripura,2005,Rape,0,0,0,32,0,32,47,0,47,10,0,10,89,0,89
Tripura,2005,Kidnapping And Abduction,0,0,0,36,1,37,47,4,51,0,0,0,83,5,88
Tripura,2005,Dacoity,0,0,0,5,0,5,9,0,9,0,0,0,14,0,14
Tripura,2005,Prep. And Assembly For Dacoity,0,0,0,1,0,1,3,0,3,0,0,0,4,0,4
Tripura,2005,Robbery,0,0,0,7,0,7,8,0,8,0,0,0,15,0,15
Tripura,2005,Burglary,0,0,0,2,0,2,2,0,2,0,0,0,4,0,4
Tripura,2005,Thefts,0,0,0,9,0,9,1,0,1,0,0,0,10,0,10
Tripura,2005,Extortion,0,0,0,0,0,0,0,0,0,0,0,0,0,0,0
Tripura,2005,Riots,0,0,0,2,0,2,6,0,6,1,0,1,9,0,9
Tripura,2005,Arson,0,0,0,1,0,1,8,0,8,2,0,2,11,0,11
Tripura,2005,Criminal Breach Of Trust,0,0,0,2,0,2,1,0,1,0,0,0,3,0,3
Tripura,2005,Cheating,0,0,0,0,0,0,1,0,1,0,0,0,1,0,1
Tripura,2005,Counter Feiting,0,0,0,4,0,4,0,0,0,0,0,0,4,0,4
Tripura,2005,Dowry Deaths,0,0,0,0,0,0,0,0,0,1,0,1,1,0,1
Tripura,2005,Molestation,0,0,0,1,0,1,0,0,0,0,0,0,1,0,1
Tripura,2005,Eve-Teasing,0,0,0,1,0,1,0,0,0,0,0,0,1,0,1
Tripura,2005,Cruelty By Husband Or Relative Of Husband,0,0,0,8,0,8,10,0,10,1,1,2,19,1,20
Tripura,2005,Other Ipc Crimes,0,0,0,18,0,18,17,0,17,3,1,4,38,1,39
Tripura,2006,Murder,2,0,2,84,0,84,170,3,173,51,3,54,307,6,313
Tripura,2006,Attempt To Commit Murder,0,0,0,6,0,6,10,0,10,0,0,0,16,0,16
Tripura,2006,C.H. Not Amounting To Murder,4,0,4,11,0,11,3,0,3,0,0,0,18,0,18
Tripura,2006,Rape,2,0,2,25,0,25,50,0,50,10,0,10,87,0,87
Tripura,2006,Kidnapping And Abduction,2,0,2,45,1,46,43,4,47,4,0,4,94,5,99
Tripura,2006,Dacoity,0,0,0,5,0,5,3,0,3,0,0,0,8,0,8
Tripura,2006,Prep. And Assembly For Dacoity,0,0,0,0,0,0,0,0,0,0,0,0,0,0,0
Tripura,2006,Robbery,0,0,0,7,0,7,5,0,5,0,0,0,12,0,12
Tripura,2006,Burglary,0,0,0,0,0,0,4,0,4,0,0,0,4,0,4
Tripura,2006,Thefts,0,0,0,4,0,4,3,0,3,0,0,0,7,0,7
Tripura,2006,Extortion,0,0,0,6,0,6,1,0,1,0,0,0,7,0,7
Tripura,2006,Riots,1,0,1,13,0,13,25,0,25,9,0,9,48,0,48
Tripura,2006,Arson,0,0,0,1,0,1,6,0,6,2,0,2,9,0,9
Tripura,2006,Criminal Breach Of Trust,0,0,0,0,0,0,2,0,2,0,0,0,2,0,2
Tripura,2006,Cheating,0,0,0,0,0,0,0,0,0,0,0,0,0,0,0
Tripura,2006,Counter Feiting,0,0,0,6,0,6,0,0,0,0,0,0,6,0,6
Tripura,2006,Dowry Deaths,0,0,0,8,0,8,19,0,19,2,0,2,29,0,29
Tripura,2006,Molestation,0,0,0,3,0,3,0,0,0,0,0,0,3,0,3
Tripura,2006,Eve-Teasing,0,0,0,0,0,0,0,0,0,0,0,0,0,0,0
Tripura,2006,Cruelty By Husband Or Relative Of Husband,0,0,0,10,0,10,10,0,10,0,5,5,20,5,25
Tripura,2006,Other Ipc Crimes,0,0,0,18,0,18,23,1,24,3,0,3,44,1,45
Tripura,2007,Murder,0,0,0,105,1,106,201,8,209,59,0,59,365,9,374
Tripura,2007,Attempt To Commit Murder,0,0,0,7,0,7,7,0,7,2,0,2,16,0,16
Tripura,2007,C.H. Not Amounting To Murder,0,0,0,17,0,17,24,0,24,7,0,7,48,0,48
Tripura,2007,Rape,7,0,7,31,0,31,72,0,72,8,0,8,118,0,118
Tripura,2007,Kidnapping And Abduction,0,0,0,13,1,14,43,1,44,2,2,4,58,4,62
Tripura,2007,Dacoity,0,0,0,2,0,2,4,0,4,2,0,2,8,0,8
Tripura,2007,Prep. And Assembly For Dacoity,0,0,0,2,0,2,0,0,0,0,0,0,2,0,2
Tripura,2007,Robbery,0,0,0,4,0,4,8,0,8,1,0,1,13,0,13
Tripura,2007,Burglary,0,0,0,2,0,2,1,0,1,0,0,0,3,0,3
Tripura,2007,Thefts,0,0,0,3,0,3,2,0,2,1,0,1,6,0,6
Tripura,2007,Extortion,0,0,0,6,0,6,3,0,3,1,0,1,10,0,10
Tripura,2007,Riots,0,0,0,4,0,4,0,0,0,0,0,0,4,0,4
Tripura,2007,Arson,0,0,0,4,0,4,5,0,5,2,0,2,11,0,11
Tripura,2007,Criminal Breach Of Trust,0,0,0,1,0,1,3,0,3,1,0,1,5,0,5
Tripura,2007,Cheating,0,0,0,1,0,1,0,0,0,0,0,0,1,0,1
Tripura,2007,Counter Feiting,0,0,0,1,0,1,1,0,1,0,9,9,2,9,11
Tripura,2007,Dowry Deaths,0,0,0,9,0,9,20,0,20,2,0,2,31,0,31
Tripura,2007,Molestation,0,0,0,1,0,1,1,0,1,1,0,1,3,0,3
Tripura,2007,Eve-Teasing,0,0,0,0,0,0,0,0,0,0,0,0,0,0,0
Tripura,2007,Cruelty By Husband Or Relative Of Husband,0,0,0,24,1,25,14,0,14,1,0,1,39,1,40
Tripura,2007,Other Ipc Crimes,0,0,0,10,0,10,14,0,14,6,0,6,30,0,30
Tripura,2008,Murder,0,0,0,87,1,88,198,3,201,10,3,13,295,7,302
Tripura,2008,Attempt To Commit Murder,0,0,0,3,1,4,18,0,18,1,0,1,22,1,23
Tripura,2008,C.H. Not Amounting To Murder,0,0,0,0,0,0,2,0,2,1,1,2,3,1,4
Tripura,2008,Rape,1,0,1,35,0,35,47,0,47,10,0,10,93,0,93
Tripura,2008,Kidnapping And Abduction,0,0,0,31,0,31,34,2,36,3,0,3,68,2,70
Tripura,2008,Dacoity,0,0,0,1,0,1,2,0,2,2,0,2,5,0,5
Tripura,2008,Prep. And Assembly For Dacoity,0,0,0,0,0,0,0,0,0,0,0,0,0,0,0
Tripura,2008,Robbery,0,0,0,2,0,2,2,0,2,1,0,1,5,0,5
Tripura,2008,Burglary,0,0,0,0,0,0,1,0,1,1,0,1,2,0,2
Tripura,2008,Thefts,0,0,0,10,0,10,18,0,18,1,0,1,29,0,29
Tripura,2008,Extortion,0,0,0,5,0,5,4,0,4,0,0,0,9,0,9
Tripura,2008,Riots,0,0,0,5,0,5,10,0,10,1,0,1,16,0,16
Tripura,2008,Arson,0,0,0,3,0,3,8,0,8,1,0,1,12,0,12
Tripura,2008,Criminal Breach Of Trust,0,0,0,2,0,2,3,0,3,0,0,0,5,0,5
Tripura,2008,Cheating,0,0,0,1,0,1,0,0,0,0,0,0,1,0,1
Tripura,2008,Counter Feiting,0,0,0,6,0,6,4,0,4,0,0,0,10,0,10
Tripura,2008,Dowry Deaths,0,0,0,12,0,12,14,1,15,4,3,7,30,4,34
Tripura,2008,Molestation,0,0,0,0,0,0,1,0,1,0,0,0,1,0,1
Tripura,2008,Eve-Teasing,0,0,0,0,0,0,1,0,1,0,0,0,1,0,1
Tripura,2008,Cruelty By Husband Or Relative Of Husband,0,0,0,30,0,30,36,0,36,7,4,11,73,4,77
Tripura,2008,Other Ipc Crimes,2,0,2,56,0,56,36,0,36,13,0,13,107,0,107
Tripura,2009,Murder,0,0,0,56,0,56,198,2,200,50,2,52,304,4,308
Tripura,2009,Attempt To Commit Murder,0,0,0,4,1,5,8,0,8,1,0,1,13,1,14
Tripura,2009,C.H. Not Amounting To Murder,0,0,0,11,0,11,25,1,26,5,0,5,41,1,42
Tripura,2009,Rape,0,0,0,34,0,34,58,0,58,3,0,3,95,0,95
Tripura,2009,Kidnapping And Abduction,0,0,0,10,0,10,21,0,21,3,0,3,34,0,34
Tripura,2009,Dacoity,0,0,0,1,0,1,3,0,3,1,0,1,5,0,5
Tripura,2009,Prep. And Assembly For Dacoity,0,0,0,0,0,0,0,0,0,0,0,0,0,0,0
Tripura,2009,Robbery,0,0,0,1,0,1,3,0,3,0,0,0,4,0,4
Tripura,2009,Burglary,0,0,0,2,0,2,1,0,1,0,0,0,3,0,3
Tripura,2009,Thefts,0,0,0,6,0,6,1,0,1,0,0,0,7,0,7
Tripura,2009,Extortion,0,0,0,2,0,2,1,0,1,0,0,0,3,0,3
Tripura,2009,Riots,0,0,0,0,0,0,4,0,4,2,0,2,6,0,6
Tripura,2009,Arson,0,0,0,1,0,1,0,0,0,0,0,0,1,0,1
Tripura,2009,Criminal Breach Of Trust,0,0,0,1,0,1,0,0,0,0,0,0,1,0,1
Tripura,2009,Cheating,0,0,0,0,0,0,0,0,0,0,0,0,0,0,0
Tripura,2009,Counter Feiting,0,0,0,0,0,0,0,0,0,0,0,0,0,0,0
Tripura,2009,Dowry Deaths,0,0,0,7,0,7,18,0,18,6,1,7,31,1,32
Tripura,2009,Molestation,0,0,0,0,0,0,1,0,1,0,0,0,1,0,1
Tripura,2009,Eve-Teasing,0,0,0,0,0,0,0,0,0,0,0,0,0,0,0
Tripura,2009,Cruelty By Husband Or Relative Of Husband,0,0,0,10,1,11,13,2,15,2,4,6,25,7,32
Tripura,2009,Other Ipc Crimes,0,0,0,13,0,13,15,0,15,8,0,8,36,0,36
Tripura,2010,Murder,0,0,0,49,1,50,191,2,193,37,3,40,277,6,283
Tripura,2010,Attempt To Commit Murder,0,0,0,2,0,2,8,1,9,3,0,3,13,1,14
Tripura,2010,C.H. Not Amounting To Murder,0,0,0,8,0,8,25,1,26,2,0,2,35,1,36
Tripura,2010,Rape,0,0,0,20,0,20,55,0,55,8,0,8,83,0,83
Tripura,2010,Kidnapping And Abduction,0,0,0,9,0,9,21,0,21,3,0,3,33,0,33
Tripura,2010,Dacoity,0,0,0,0,0,0,1,0,1,2,0,2,3,0,3
Tripura,2010,Prep. And Assembly For Dacoity,0,0,0,0,0,0,0,0,0,0,0,0,0,0,0
Tripura,2010,Robbery,0,0,0,0,0,0,2,0,2,0,0,0,2,0,2
Tripura,2010,Burglary,0,0,0,1,0,1,2,0,2,0,0,0,3,0,3
Tripura,2010,Thefts,0,0,0,3,0,3,1,0,1,0,0,0,4,0,4
Tripura,2010,Extortion,0,0,0,0,0,0,0,0,0,0,0,0,0,0,0
Tripura,2010,Riots,0,0,0,3,0,3,1,0,1,0,0,0,4,0,4
Tripura,2010,Arson,0,0,0,1,0,1,0,0,0,0,0,0,1,0,1
Tripura,2010,Criminal Breach Of Trust,0,0,0,0,0,0,1,0,1,1,0,1,2,0,2
Tripura,2010,Cheating,0,0,0,1,0,1,0,0,0,0,0,0,1,0,1
Tripura,2010,Counter Feiting,0,0,0,0,0,0,3,0,3,0,0,0,3,0,3
Tripura,2010,Dowry Deaths,0,0,0,6,0,6,11,0,11,1,1,2,18,1,19
Tripura,2010,Molestation,0,0,0,6,0,6,12,0,12,2,0,2,20,0,20
Tripura,2010,Eve-Teasing,0,0,0,0,0,0,2,0,2,1,0,1,3,0,3
Tripura,2010,Cruelty By Husband Or Relative Of Husband,0,0,0,7,0,7,11,0,11,1,1,2,19,1,20
Tripura,2010,Other Ipc Crimes,0,0,0,5,0,5,5,0,5,3,0,3,13,0,13
Tripura,2011,Murder,0,0,0,46,1,47,183,4,187,52,3,55,281,8,289
Tripura,2011,Attempt To Commit Murder,0,0,0,1,0,1,4,1,5,1,0,1,6,1,7
Tripura,2011,C.H. Not Amounting To Murder,0,0,0,17,0,17,20,1,21,5,0,5,42,1,43
Tripura,2011,Rape,0,0,0,29,0,29,58,0,58,6,0,6,93,0,93
Tripura,2011,Kidnapping And Abduction,0,0,0,10,0,10,23,0,23,3,0,3,36,0,36
Tripura,2011,Dacoity,0,0,0,0,0,0,2,0,2,2,0,2,4,0,4
Tripura,2011,Prep. And Assembly For Dacoity,0,0,0,2,0,2,1,0,1,0,0,0,3,0,3
Tripura,2011,Robbery,0,0,0,1,0,1,1,0,1,0,0,0,2,0,2
Tripura,2011,Burglary,0,0,0,0,0,0,1,0,1,0,0,0,1,0,1
Tripura,2011,Thefts,0,0,0,5,0,5,1,0,1,0,0,0,6,0,6
Tripura,2011,Extortion,0,0,0,0,0,0,0,0,0,0,0,0,0,0,0
Tripura,2011,Riots,0,0,0,0,0,0,4,0,4,1,0,1,5,0,5
Tripura,2011,Arson,0,0,0,0,0,0,1,0,1,0,0,0,1,0,1
Tripura,2011,Criminal Breach Of Trust,0,0,0,0,0,0,0,0,0,0,0,0,0,0,0
Tripura,2011,Cheating,0,0,0,0,0,0,3,0,3,0,0,0,3,0,3
Tripura,2011,Counter Feiting,0,0,0,1,0,1,1,0,1,0,0,0,2,0,2
Tripura,2011,Dowry Deaths,0,0,0,3,0,3,9,0,9,1,3,4,13,3,16
Tripura,2011,Molestation,0,0,0,0,0,0,0,0,0,1,0,1,1,0,1
Tripura,2011,Eve-Teasing,0,0,0,0,0,0,0,0,0,0,0,0,0,0,0
Tripura,2011,Cruelty By Husband Or Relative Of Husband,0,0,0,5,0,5,8,0,8,1,0,1,14,0,14
Tripura,2011,Other Ipc Crimes,0,0,0,1,0,1,2,0,2,0,0,0,3,0,3
Tripura,2012,Murder,0,0,0,44,1,45,187,4,191,47,2,49,278,7,285
Tripura,2012,Attempt To Commit Murder,0,0,0,0,0,0,3,0,3,2,0,2,5,0,5
Tripura,2012,C.H. Not Amounting To Murder,0,0,0,6,0,6,15,0,15,3,0,3,24,0,24
Tripura,2012,Rape,0,0,0,35,1,36,70,0,70,8,0,8,113,1,114
Tripura,2012,Kidnapping And Abduction,0,0,0,13,1,14,20,0,20,2,0,2,35,1,36
Tripura,2012,Dacoity,0,0,0,0,0,0,0,0,0,0,0,0,0,0,0
Tripura,2012,Prep. And Assembly For Dacoity,0,0,0,0,0,0,0,0,0,0,0,0,0,0,0
Tripura,2012,Robbery,0,0,0,0,0,0,0,0,0,0,0,0,0,0,0
Tripura,2012,Burglary,0,0,0,0,0,0,1,0,1,0,0,0,1,0,1
Tripura,2012,Thefts,0,0,0,5,0,5,1,1,2,0,0,0,6,1,7
Tripura,2012,Extortion,0,0,0,0,0,0,0,0,0,0,0,0,0,0,0
Tripura,2012,Riots,0,0,0,0,0,0,5,0,5,2,0,2,7,0,7
Tripura,2012,Arson,0,0,0,0,0,0,0,0,0,0,0,0,0,0,0
Tripura,2012,Criminal Breach Of Trust,0,0,0,0,0,0,0,0,0,0,0,0,0,0,0
Tripura,2012,Cheating,0,0,0,1,0,1,1,0,1,1,0,1,3,0,3
Tripura,2012,Counter Feiting,0,0,0,0,0,0,1,0,1,0,0,0,1,0,1
Tripura,2012,Dowry Deaths,0,0,0,5,1,6,11,0,11,2,0,2,18,1,19
Tripura,2012,Molestation,0,0,0,2,0,2,1,0,1,1,0,1,4,0,4
Tripura,2012,Eve-Teasing,0,0,0,0,0,0,0,0,0,0,0,0,0,0,0
Tripura,2012,Cruelty By Husband Or Relative Of Husband,0,0,0,7,0,7,9,1,10,1,0,1,17,1,18
Tripura,2012,Other Ipc Crimes,0,0,0,2,0,2,3,0,3,1,0,1,6,0,6
Uttar Pradesh,2001,Murder,1,0,1,582,7,589,1429,40,1469,544,28,572,2556,75,2631
Uttar Pradesh,2001,Attempt To Commit Murder,0,0,0,89,0,89,150,2,152,36,0,36,275,2,277
Uttar Pradesh,2001,C.H. Not Amounting To Murder,0,0,0,63,0,63,94,0,94,27,3,30,184,3,187
Uttar Pradesh,2001,Rape,2,0,2,134,0,134,97,0,97,16,0,16,249,0,249
Uttar Pradesh,2001,Kidnapping And Abduction,0,0,0,52,1,53,82,6,88,14,1,15,148,8,156
Uttar Pradesh,2001,Dacoity,2,0,2,21,0,21,51,1,52,11,0,11,85,1,86
Uttar Pradesh,2001,Prep. And Assembly For Dacoity,0,0,0,3,0,3,7,0,7,2,0,2,12,0,12
Uttar Pradesh,2001,Robbery,0,0,0,37,0,37,29,0,29,7,0,7,73,0,73
Uttar Pradesh,2001,Burglary,1,0,1,10,0,10,4,0,4,1,0,1,16,0,16
Uttar Pradesh,2001,Thefts,5,0,5,97,0,97,61,0,61,11,0,11,174,0,174
Uttar Pradesh,2001,Extortion,0,0,0,0,0,0,6,0,6,0,0,0,6,0,6
Uttar Pradesh,2001,Riots,0,0,0,2,0,2,4,0,4,0,0,0,6,0,6
Uttar Pradesh,2001,Arson,0,0,0,0,0,0,0,0,0,0,0,0,0,0,0
Uttar Pradesh,2001,Criminal Breach Of Trust,0,0,0,1,0,1,1,0,1,1,0,1,3,0,3
Uttar Pradesh,2001,Cheating,0,0,0,2,0,2,5,0,5,0,0,0,7,0,7
Uttar Pradesh,2001,Counter Feiting,0,0,0,2,0,2,5,0,5,0,0,0,7,0,7
Uttar Pradesh,2001,Dowry Deaths,0,0,0,74,0,74,67,2,69,30,1,31,171,3,174
Uttar Pradesh,2001,Molestation,0,0,0,1,0,1,3,0,3,0,0,0,4,0,4
Uttar Pradesh,2001,Eve-Teasing,0,0,0,0,0,0,0,0,0,0,0,0,0,0,0
Uttar Pradesh,2001,Cruelty By Husband Or Relative Of Husband,0,0,0,10,0,10,8,0,8,1,0,1,19,0,19
Uttar Pradesh,2001,Other Ipc Crimes,2,0,2,44,0,44,59,1,60,2,0,2,107,1,108
Uttar Pradesh,2002,Murder,1,0,1,546,9,555,1346,46,1392,515,5,520,2408,60,2468
Uttar Pradesh,2002,Attempt To Commit Murder,0,0,0,134,0,134,154,2,156,56,1,57,344,3,347
Uttar Pradesh,2002,C.H. Not Amounting To Murder,0,0,0,66,3,69,52,6,58,57,0,57,175,9,184
Uttar Pradesh,2002,Rape,7,0,7,87,0,87,164,0,164,19,0,19,277,0,277
Uttar Pradesh,2002,Kidnapping And Abduction,0,0,0,60,0,60,65,3,68,16,0,16,141,3,144
Uttar Pradesh,2002,Dacoity,0,0,0,61,0,61,69,0,69,22,0,22,152,0,152
Uttar Pradesh,2002,Prep. And Assembly For Dacoity,0,0,0,42,0,42,25,0,25,2,0,2,69,0,69
Uttar Pradesh,2002,Robbery,0,0,0,31,0,31,38,0,38,3,0,3,72,0,72
Uttar Pradesh,2002,Burglary,0,0,0,36,0,36,25,0,25,3,0,3,64,0,64
Uttar Pradesh,2002,Thefts,5,0,5,123,2,125,60,0,60,49,0,49,237,2,239
Uttar Pradesh,2002,Extortion,0,0,0,0,0,0,0,0,0,0,0,0,0,0,0
Uttar Pradesh,2002,Riots,0,0,0,5,0,5,15,0,15,23,0,23,43,0,43
Uttar Pradesh,2002,Arson,0,0,0,13,0,13,14,0,14,0,0,0,27,0,27
Uttar Pradesh,2002,Criminal Breach Of Trust,0,0,0,4,0,4,3,0,3,3,0,3,10,0,10
Uttar Pradesh,2002,Cheating,0,0,0,1,0,1,5,0,5,0,0,0,6,0,6
Uttar Pradesh,2002,Counter Feiting,0,0,0,8,0,8,9,0,9,3,0,3,20,0,20
Uttar Pradesh,2002,Dowry Deaths,0,0,0,53,0,53,60,6,66,31,1,32,144,7,151
Uttar Pradesh,2002,Molestation,0,0,0,3,0,3,3,0,3,2,0,2,8,0,8
Uttar Pradesh,2002,Eve-Teasing,0,0,0,9,0,9,3,0,3,6,0,6,18,0,18
Uttar Pradesh,2002,Cruelty By Husband Or Relative Of Husband,0,0,0,23,0,23,24,0,24,16,0,16,63,0,63
Uttar Pradesh,2002,Other Ipc Crimes,0,0,0,0,0,0,0,0,0,0,0,0,0,0,0
Uttar Pradesh,2003,Murder,40,0,40,541,9,550,806,19,825,723,15,738,2110,43,2153
Uttar Pradesh,2003,Attempt To Commit Murder,0,1,1,196,2,198,334,0,334,154,1,155,684,4,688
Uttar Pradesh,2003,C.H. Not Amounting To Murder,3,0,3,140,1,141,172,6,178,93,2,95,408,9,417
Uttar Pradesh,2003,Rape,0,0,0,187,1,188,141,2,143,43,0,43,371,3,374
Uttar Pradesh,2003,Kidnapping And Abduction,0,0,0,127,1,128,71,10,81,52,1,53,250,12,262
Uttar Pradesh,2003,Dacoity,0,0,0,86,0,86,108,0,108,28,0,28,222,0,222
Uttar Pradesh,2003,Prep. And Assembly For Dacoity,0,0,0,35,0,35,36,0,36,9,0,9,80,0,80
Uttar Pradesh,2003,Robbery,2,0,2,93,0,93,109,0,109,32,0,32,236,0,236
Uttar Pradesh,2003,Burglary,0,0,0,25,1,26,17,0,17,5,0,5,47,1,48
Uttar Pradesh,2003,Thefts,2,0,2,141,0,141,71,0,71,38,0,38,252,0,252
Uttar Pradesh,2003,Extortion,0,0,0,8,0,8,0,0,0,2,0,2,10,0,10
Uttar Pradesh,2003,Riots,0,0,0,1,1,2,8,0,8,0,0,0,9,1,10
Uttar Pradesh,2003,Arson,0,0,0,1,0,1,12,0,12,0,0,0,13,0,13
Uttar Pradesh,2003,Criminal Breach Of Trust,0,0,0,2,0,2,31,2,33,2,0,2,35,2,37
Uttar Pradesh,2003,Cheating,0,0,0,14,2,16,20,0,20,6,0,6,40,2,42
Uttar Pradesh,2003,Counter Feiting,0,0,0,18,0,18,14,2,16,4,2,6,36,4,40
Uttar Pradesh,2003,Dowry Deaths,4,1,5,75,3,78,87,29,116,126,18,144,292,51,343
Uttar Pradesh,2003,Molestation,0,0,0,7,0,7,3,0,3,0,0,0,10,0,10
Uttar Pradesh,2003,Eve-Teasing,0,0,0,0,0,0,0,0,0,0,0,0,0,0,0
Uttar Pradesh,2003,Cruelty By Husband Or Relative Of Husband,0,0,0,24,0,24,71,2,73,40,2,42,135,4,139
Uttar Pradesh,2003,Other Ipc Crimes,0,0,0,0,0,0,0,0,0,0,0,0,0,0,0
Uttar Pradesh,2004,Murder,0,0,0,522,15,537,907,24,931,664,19,683,2093,58,2151
Uttar Pradesh,2004,Attempt To Commit Murder,0,0,0,196,2,198,448,7,455,856,6,862,1500,15,1515
Uttar Pradesh,2004,C.H. Not Amounting To Murder,0,0,0,100,2,102,183,6,189,78,0,78,361,8,369
Uttar Pradesh,2004,Rape,0,0,0,172,0,172,158,1,159,41,0,41,371,1,372
Uttar Pradesh,2004,Kidnapping And Abduction,40,0,40,169,2,171,195,6,201,23,0,23,427,8,435
Uttar Pradesh,2004,Dacoity,0,0,0,73,0,73,92,1,93,14,0,14,179,1,180
Uttar Pradesh,2004,Prep. And Assembly For Dacoity,0,0,0,18,0,18,13,0,13,2,0,2,33,0,33
Uttar Pradesh,2004,Robbery,0,0,0,66,0,66,84,0,84,13,0,13,163,0,163
Uttar Pradesh,2004,Burglary,0,0,0,58,1,59,49,2,51,17,0,17,124,3,127
Uttar Pradesh,2004,Thefts,0,0,0,89,2,91,71,0,71,20,0,20,180,2,182
Uttar Pradesh,2004,Extortion,0,0,0,2,0,2,0,0,0,0,0,0,2,0,2
Uttar Pradesh,2004,Riots,0,0,0,7,0,7,12,0,12,0,0,0,19,0,19
Uttar Pradesh,2004,Arson,0,0,0,6,0,6,2,0,2,1,0,1,9,0,9
Uttar Pradesh,2004,Criminal Breach Of Trust,0,0,0,9,3,12,11,1,12,0,0,0,20,4,24
Uttar Pradesh,2004,Cheating,0,0,0,5,0,5,3,1,4,4,0,4,12,1,13
Uttar Pradesh,2004,Counter Feiting,0,0,0,19,0,19,23,0,23,29,0,29,71,0,71
Uttar Pradesh,2004,Dowry Deaths,0,0,0,149,8,157,142,18,160,73,21,94,364,47,411
Uttar Pradesh,2004,Molestation,0,0,0,1,0,1,3,0,3,0,0,0,4,0,4
Uttar Pradesh,2004,Eve-Teasing,0,0,0,0,0,0,1,0,1,0,0,0,1,0,1
Uttar Pradesh,2004,Cruelty By Husband Or Relative Of Husband,0,0,0,6,0,6,4,2,6,3,0,3,13,2,15
Uttar Pradesh,2004,Other Ipc Crimes,0,0,0,24,1,25,14,3,17,8,0,8,46,4,50
Uttar Pradesh,2005,Murder,0,0,0,359,5,364,1758,79,1837,991,24,1015,3108,108,3216
Uttar Pradesh,2005,Attempt To Commit Murder,0,0,0,334,3,337,779,2,781,722,1,723,1835,6,1841
Uttar Pradesh,2005,C.H. Not Amounting To Murder,0,0,0,160,0,160,225,4,229,106,1,107,491,5,496
Uttar Pradesh,2005,Rape,12,0,12,324,1,325,304,2,306,71,0,71,711,3,714
Uttar Pradesh,2005,Kidnapping And Abduction,1,0,1,163,2,165,175,5,180,54,1,55,393,8,401
Uttar Pradesh,2005,Dacoity,0,0,0,65,0,65,115,0,115,28,0,28,208,0,208
Uttar Pradesh,2005,Prep. And Assembly For Dacoity,0,0,0,14,0,14,27,0,27,7,0,7,48,0,48
Uttar Pradesh,2005,Robbery,0,0,0,61,0,61,101,0,101,48,0,48,210,0,210
Uttar Pradesh,2005,Burglary,0,0,0,22,0,22,23,0,23,9,0,9,54,0,54
Uttar Pradesh,2005,Thefts,10,0,10,181,2,183,237,1,238,66,0,66,494,3,497
Uttar Pradesh,2005,Extortion,0,0,0,8,0,8,9,0,9,3,0,3,20,0,20
Uttar Pradesh,2005,Riots,0,0,0,0,0,0,5,0,5,0,0,0,5,0,5
Uttar Pradesh,2005,Arson,0,0,0,1,0,1,0,0,0,9,0,9,10,0,10
Uttar Pradesh,2005,Criminal Breach Of Trust,0,0,0,2,0,2,4,0,4,3,0,3,9,0,9
Uttar Pradesh,2005,Cheating,1,0,1,4,0,4,5,0,5,7,0,7,17,0,17
Uttar Pradesh,2005,Counter Feiting,0,0,0,3,0,3,6,0,6,8,0,8,17,0,17
Uttar Pradesh,2005,Dowry Deaths,0,0,0,292,10,302,466,41,507,253,12,265,1011,63,1074
Uttar Pradesh,2005,Molestation,0,0,0,1,0,1,6,0,6,2,0,2,9,0,9
Uttar Pradesh,2005,Eve-Teasing,0,0,0,3,0,3,2,0,2,1,0,1,6,0,6
Uttar Pradesh,2005,Cruelty By Husband Or Relative Of Husband,0,0,0,7,2,9,30,2,32,28,0,28,65,4,69
Uttar Pradesh,2005,Other Ipc Crimes,0,0,0,43,0,43,38,5,43,6,0,6,87,5,92
Uttar Pradesh,2006,Murder,18,0,18,1301,22,1323,2813,107,2920,1384,46,1430,5516,175,5691
Uttar Pradesh,2006,Attempt To Commit Murder,3,0,3,695,16,711,1243,22,1265,638,3,641,2579,41,2620
Uttar Pradesh,2006,C.H. Not Amounting To Murder,7,0,7,147,3,150,301,7,308,116,6,122,571,16,587
Uttar Pradesh,2006,Rape,0,0,0,505,0,505,348,3,351,52,0,52,905,3,908
Uttar Pradesh,2006,Kidnapping And Abduction,0,0,0,231,4,235,298,14,312,59,3,62,588,21,609
Uttar Pradesh,2006,Dacoity,0,0,0,74,0,74,109,0,109,28,0,28,211,0,211
Uttar Pradesh,2006,Prep. And Assembly For Dacoity,0,0,0,45,0,45,59,3,62,14,0,14,118,3,121
Uttar Pradesh,2006,Robbery,0,0,0,80,0,80,99,2,101,40,0,40,219,2,221
Uttar Pradesh,2006,Burglary,0,0,0,22,0,22,35,0,35,9,0,9,66,0,66
Uttar Pradesh,2006,Thefts,0,0,0,185,5,190,247,4,251,69,1,70,501,10,511
Uttar Pradesh,2006,Extortion,0,0,0,37,0,37,24,0,24,14,0,14,75,0,75
Uttar Pradesh,2006,Riots,0,0,0,8,0,8,4,0,4,0,0,0,12,0,12
Uttar Pradesh,2006,Arson,0,0,0,3,0,3,3,0,3,0,0,0,6,0,6
Uttar Pradesh,2006,Criminal Breach Of Trust,0,0,0,1,0,1,5,0,5,2,0,2,8,0,8
Uttar Pradesh,2006,Cheating,0,0,0,144,0,144,91,2,93,43,0,43,278,2,280
Uttar Pradesh,2006,Counter Feiting,0,0,0,18,0,18,26,0,26,30,0,30,74,0,74
Uttar Pradesh,2006,Dowry Deaths,0,0,0,265,35,300,306,65,371,151,18,169,722,118,840
Uttar Pradesh,2006,Molestation,0,0,0,5,0,5,4,0,4,6,0,6,15,0,15
Uttar Pradesh,2006,Eve-Teasing,0,0,0,2,0,2,0,0,0,0,0,0,2,0,2
Uttar Pradesh,2006,Cruelty By Husband Or Relative Of Husband,0,0,0,16,1,17,15,1,16,11,1,12,42,3,45
Uttar Pradesh,2006,Other Ipc Crimes,0,0,0,111,2,113,89,6,95,34,2,36,234,10,244
Uttar Pradesh,2007,Murder,0,0,0,1662,32,1694,4281,105,4386,1997,70,2067,7940,207,8147
Uttar Pradesh,2007,Attempt To Commit Murder,0,0,0,602,10,612,2014,26,2040,1022,5,1027,3638,41,3679
Uttar Pradesh,2007,C.H. Not Amounting To Murder,0,0,0,192,1,193,372,17,389,196,4,200,760,22,782
Uttar Pradesh,2007,Rape,0,0,0,669,1,670,444,1,445,85,0,85,1198,2,1200
Uttar Pradesh,2007,Kidnapping And Abduction,0,0,0,347,8,355,359,15,374,113,2,115,819,25,844
Uttar Pradesh,2007,Dacoity,0,0,0,109,0,109,162,1,163,55,0,55,326,1,327
Uttar Pradesh,2007,Prep. And Assembly For Dacoity,0,0,0,25,0,25,30,0,30,6,0,6,61,0,61
Uttar Pradesh,2007,Robbery,0,0,0,85,0,85,102,0,102,28,0,28,215,0,215
Uttar Pradesh,2007,Burglary,0,0,0,13,0,13,36,0,36,4,0,4,53,0,53
Uttar Pradesh,2007,Thefts,2,0,2,147,0,147,141,1,142,44,0,44,334,1,335
Uttar Pradesh,2007,Extortion,0,0,0,0,0,0,0,0,0,0,0,0,0,0,0
Uttar Pradesh,2007,Riots,0,0,0,0,0,0,1,0,1,2,0,2,3,0,3
Uttar Pradesh,2007,Arson,0,0,0,9,0,9,9,0,9,3,0,3,21,0,21
Uttar Pradesh,2007,Criminal Breach Of Trust,0,0,0,12,0,12,11,0,11,1,0,1,24,0,24
Uttar Pradesh,2007,Cheating,0,0,0,0,0,0,23,2,25,4,0,4,27,2,29
Uttar Pradesh,2007,Counter Feiting,0,0,0,30,0,30,44,0,44,37,0,37,111,0,111
Uttar Pradesh,2007,Dowry Deaths,0,0,0,416,23,439,367,104,471,197,39,236,980,166,1146
Uttar Pradesh,2007,Molestation,0,0,0,5,1,6,4,0,4,0,0,0,9,1,10
Uttar Pradesh,2007,Eve-Teasing,0,0,0,0,0,0,0,0,0,0,0,0,0,0,0
Uttar Pradesh,2007,Cruelty By Husband Or Relative Of Husband,0,0,0,43,1,44,96,4,100,53,0,53,192,5,197
Uttar Pradesh,2007,Other Ipc Crimes,0,0,0,50,3,53,80,4,84,21,0,21,151,7,158
Uttar Pradesh,2008,Murder,0,0,0,1054,26,1080,3941,90,4031,1850,85,1935,6845,201,7046
Uttar Pradesh,2008,Attempt To Commit Murder,0,0,0,589,3,592,1910,11,1921,1128,4,1132,3627,18,3645
Uttar Pradesh,2008,C.H. Not Amounting To Murder,0,0,0,279,5,284,456,24,480,233,20,253,968,49,1017
Uttar Pradesh,2008,Rape,0,0,0,603,0,603,643,2,645,180,2,182,1426,4,1430
Uttar Pradesh,2008,Kidnapping And Abduction,0,0,0,294,10,304,241,13,254,105,3,108,640,26,666
Uttar Pradesh,2008,Dacoity,0,0,0,101,0,101,168,1,169,98,0,98,367,1,368
Uttar Pradesh,2008,Prep. And Assembly For Dacoity,0,0,0,22,0,22,27,0,27,11,0,11,60,0,60
Uttar Pradesh,2008,Robbery,0,0,0,118,0,118,128,0,128,25,0,25,271,0,271
Uttar Pradesh,2008,Burglary,0,0,0,56,0,56,40,0,40,24,0,24,120,0,120
Uttar Pradesh,2008,Thefts,0,0,0,248,5,253,179,3,182,50,1,51,477,9,486
Uttar Pradesh,2008,Extortion,0,0,0,12,0,12,14,0,14,6,0,6,32,0,32
Uttar Pradesh,2008,Riots,0,0,0,5,0,5,2,0,2,0,0,0,7,0,7
Uttar Pradesh,2008,Arson,0,0,0,12,0,12,13,0,13,3,0,3,28,0,28
Uttar Pradesh,2008,Criminal Breach Of Trust,0,0,0,3,0,3,11,5,16,10,0,10,24,5,29
Uttar Pradesh,2008,Cheating,0,0,0,15,0,15,10,1,11,5,0,5,30,1,31
Uttar Pradesh,2008,Counter Feiting,0,0,0,14,0,14,40,3,43,9,1,10,63,4,67
Uttar Pradesh,2008,Dowry Deaths,0,0,0,454,23,477,563,94,657,349,77,426,1366,194,1560
Uttar Pradesh,2008,Molestation,0,0,0,8,0,8,7,1,8,6,1,7,21,2,23
Uttar Pradesh,2008,Eve-Teasing,0,0,0,2,0,2,1,0,1,0,0,0,3,0,3
Uttar Pradesh,2008,Cruelty By Husband Or Relative Of Husband,0,0,0,56,4,60,62,4,66,64,1,65,182,9,191
Uttar Pradesh,2008,Other Ipc Crimes,0,0,0,156,1,157,756,9,765,185,15,200,1097,25,1122
Uttar Pradesh,2009,Murder,0,0,0,2226,44,2270,5921,120,6041,3222,89,3311,11369,253,11622
Uttar Pradesh,2009,Attempt To Commit Murder,0,0,0,771,3,774,837,9,846,296,1,297,1904,13,1917
Uttar Pradesh,2009,C.H. Not Amounting To Murder,0,0,0,240,6,246,401,23,424,254,6,260,895,35,930
Uttar Pradesh,2009,Rape,0,0,0,664,0,664,785,4,789,273,0,273,1722,4,1726
Uttar Pradesh,2009,Kidnapping And Abduction,0,0,0,222,8,230,411,17,428,205,5,210,838,30,868
Uttar Pradesh,2009,Dacoity,0,0,0,88,0,88,209,0,209,78,0,78,375,0,375
Uttar Pradesh,2009,Prep. And Assembly For Dacoity,0,0,0,28,0,28,42,0,42,33,0,33,103,0,103
Uttar Pradesh,2009,Robbery,0,0,0,126,0,126,164,0,164,69,0,69,359,0,359
Uttar Pradesh,2009,Burglary,0,0,0,45,0,45,59,1,60,35,0,35,139,1,140
Uttar Pradesh,2009,Thefts,0,0,0,224,1,225,276,2,278,94,1,95,594,4,598
Uttar Pradesh,2009,Extortion,0,0,0,17,0,17,29,0,29,16,0,16,62,0,62
Uttar Pradesh,2009,Riots,0,0,0,4,0,4,8,0,8,5,1,6,17,1,18
Uttar Pradesh,2009,Arson,0,0,0,11,0,11,9,0,9,5,0,5,25,0,25
Uttar Pradesh,2009,Criminal Breach Of Trust,0,0,0,11,0,11,16,0,16,17,0,17,44,0,44
Uttar Pradesh,2009,Cheating,0,0,0,8,0,8,21,1,22,9,0,9,38,1,39
Uttar Pradesh,2009,Counter Feiting,0,0,0,19,0,19,56,0,56,26,2,28,101,2,103
Uttar Pradesh,2009,Dowry Deaths,0,0,0,465,35,500,867,147,1014,624,105,729,1956,287,2243
Uttar Pradesh,2009,Molestation,0,0,0,6,0,6,4,0,4,7,0,7,17,0,17
Uttar Pradesh,2009,Eve-Teasing,0,0,0,0,0,0,0,0,0,0,0,0,0,0,0
Uttar Pradesh,2009,Cruelty By Husband Or Relative Of Husband,0,0,0,78,1,79,201,11,212,205,6,211,484,18,502
Uttar Pradesh,2009,Other Ipc Crimes,0,0,0,51,0,51,84,2,86,43,1,44,178,3,181
Uttar Pradesh,2010,Murder,0,0,0,2176,51,2227,5971,132,6103,3270,91,3361,11417,274,11691
Uttar Pradesh,2010,Attempt To Commit Murder,0,0,0,721,4,725,857,11,868,302,2,304,1880,17,1897
Uttar Pradesh,2010,C.H. Not Amounting To Murder,0,0,0,229,7,236,412,25,437,287,7,294,928,39,967
Uttar Pradesh,2010,Rape,0,0,0,644,0,644,810,5,815,287,0,287,1741,5,1746
Uttar Pradesh,2010,Kidnapping And Abduction,0,0,0,212,10,222,421,18,439,215,6,221,848,34,882
Uttar Pradesh,2010,Dacoity,0,0,0,83,0,83,307,0,307,81,0,81,471,0,471
Uttar Pradesh,2010,Prep. And Assembly For Dacoity,0,0,0,25,0,25,52,0,52,62,0,62,139,0,139
Uttar Pradesh,2010,Robbery,0,0,0,116,0,116,193,0,193,72,0,72,381,0,381
Uttar Pradesh,2010,Burglary,0,0,0,43,0,43,76,2,78,56,0,56,175,2,177
Uttar Pradesh,2010,Thefts,0,0,0,214,2,216,302,3,305,125,2,127,641,7,648
Uttar Pradesh,2010,Extortion,0,0,0,16,0,16,35,0,35,22,0,22,73,0,73
Uttar Pradesh,2010,Riots,0,0,0,5,0,5,10,0,10,7,2,9,22,2,24
Uttar Pradesh,2010,Arson,0,0,0,13,0,13,11,0,11,6,0,6,30,0,30
Uttar Pradesh,2010,Criminal Breach Of Trust,0,0,0,13,0,13,18,0,18,17,0,17,48,0,48
Uttar Pradesh,2010,Cheating,0,0,0,10,0,10,23,2,25,11,0,11,44,2,46
Uttar Pradesh,2010,Counter Feiting,0,0,0,19,0,19,58,0,58,32,3,35,109,3,112
Uttar Pradesh,2010,Dowry Deaths,0,0,0,435,36,471,930,149,1079,734,108,842,2099,293,2392
Uttar Pradesh,2010,Molestation,0,0,0,6,0,6,6,0,6,9,0,9,21,0,21
Uttar Pradesh,2010,Eve-Teasing,0,0,0,0,0,0,0,0,0,0,0,0,0,0,0
Uttar Pradesh,2010,Cruelty By Husband Or Relative Of Husband,0,0,0,95,1,96,212,15,227,236,10,246,543,26,569
Uttar Pradesh,2010,Other Ipc Crimes,0,0,0,274,0,274,294,4,298,59,3,62,627,7,634
Uttar Pradesh,2011,Murder,0,0,0,2188,53,2241,6102,137,6239,3291,96,3387,11581,286,11867
Uttar Pradesh,2011,Attempt To Commit Murder,0,0,0,743,5,748,903,17,920,312,3,315,1958,25,1983
Uttar Pradesh,2011,C.H. Not Amounting To Murder,0,0,0,233,7,240,433,29,462,296,8,304,962,44,1006
Uttar Pradesh,2011,Rape,0,0,0,654,0,654,822,9,831,292,0,292,1768,9,1777
Uttar Pradesh,2011,Kidnapping And Abduction,0,0,0,217,11,228,437,22,459,219,6,225,873,39,912
Uttar Pradesh,2011,Dacoity,0,0,0,89,0,89,313,0,313,87,0,87,489,0,489
Uttar Pradesh,2011,Prep. And Assembly For Dacoity,0,0,0,27,0,27,57,0,57,67,0,67,151,0,151
Uttar Pradesh,2011,Robbery,0,0,0,123,0,123,203,0,203,76,0,76,402,0,402
Uttar Pradesh,2011,Burglary,0,0,0,47,0,47,91,4,95,57,0,57,195,4,199
Uttar Pradesh,2011,Thefts,0,0,0,225,3,228,362,5,367,131,2,133,718,10,728
Uttar Pradesh,2011,Extortion,0,0,0,17,0,17,36,0,36,24,0,24,77,0,77
Uttar Pradesh,2011,Riots,0,0,0,6,0,6,21,0,21,9,2,11,36,2,38
Uttar Pradesh,2011,Arson,0,0,0,15,0,15,13,0,13,8,0,8,36,0,36
Uttar Pradesh,2011,Criminal Breach Of Trust,0,0,0,16,0,16,21,0,21,22,0,22,59,0,59
Uttar Pradesh,2011,Cheating,0,0,0,11,0,11,37,3,40,13,0,13,61,3,64
Uttar Pradesh,2011,Counter Feiting,0,0,0,21,0,21,62,0,62,33,3,36,116,3,119
Uttar Pradesh,2011,Dowry Deaths,0,0,0,439,47,486,952,178,1130,797,118,915,2188,343,2531
Uttar Pradesh,2011,Molestation,0,0,0,7,0,7,9,0,9,12,0,12,28,0,28
Uttar Pradesh,2011,Eve-Teasing,0,0,0,0,0,0,0,0,0,0,0,0,0,0,0
Uttar Pradesh,2011,Cruelty By Husband Or Relative Of Husband,0,0,0,99,2,101,231,15,246,274,13,287,604,30,634
Uttar Pradesh,2011,Other Ipc Crimes,0,0,0,361,0,361,312,4,316,130,3,133,803,7,810
Uttar Pradesh,2012,Murder,0,0,0,2090,46,2136,6006,135,6141,3047,93,3140,11143,274,11417
Uttar Pradesh,2012,Attempt To Commit Murder,0,0,0,705,4,709,800,15,815,300,2,302,1805,21,1826
Uttar Pradesh,2012,C.H. Not Amounting To Murder,0,0,0,225,5,230,323,27,350,285,7,292,833,39,872
Uttar Pradesh,2012,Rape,0,0,0,590,0,590,750,8,758,276,0,276,1616,8,1624
Uttar Pradesh,2012,Kidnapping And Abduction,0,0,0,210,9,219,400,20,420,202,6,208,812,35,847
Uttar Pradesh,2012,Dacoity,0,0,0,85,0,85,285,0,285,85,0,85,455,0,455
Uttar Pradesh,2012,Prep. And Assembly For Dacoity,0,0,0,26,0,26,58,0,58,66,0,66,150,0,150
Uttar Pradesh,2012,Robbery,0,0,0,122,0,122,200,0,200,74,0,74,396,0,396
Uttar Pradesh,2012,Burglary,0,0,0,45,0,45,85,3,88,53,0,53,183,3,186
Uttar Pradesh,2012,Thefts,0,0,0,225,2,227,355,4,359,130,2,132,710,8,718
Uttar Pradesh,2012,Extortion,0,0,0,17,0,17,36,0,36,23,0,23,76,0,76
Uttar Pradesh,2012,Riots,0,0,0,5,0,5,20,0,20,8,2,10,33,2,35
Uttar Pradesh,2012,Arson,0,0,0,4,0,4,12,0,12,7,0,7,23,0,23
Uttar Pradesh,2012,Criminal Breach Of Trust,0,0,0,12,0,12,20,0,20,20,0,20,52,0,52
Uttar Pradesh,2012,Cheating,0,0,0,9,0,9,36,2,38,12,0,12,57,2,59
Uttar Pradesh,2012,Counter Feiting,0,0,0,15,0,15,60,0,60,32,2,34,107,2,109
Uttar Pradesh,2012,Dowry Deaths,0,0,0,358,43,401,952,173,1125,751,118,869,2061,334,2395
Uttar Pradesh,2012,Molestation,0,0,0,6,0,6,10,0,10,11,0,11,27,0,27
Uttar Pradesh,2012,Eve-Teasing,0,0,0,0,0,0,0,0,0,0,0,0,0,0,0
Uttar Pradesh,2012,Cruelty By Husband Or Relative Of Husband,0,0,0,82,1,83,231,13,244,225,13,238,538,27,565
Uttar Pradesh,2012,Other Ipc Crimes,0,0,0,325,0,325,312,3,315,125,2,127,762,5,767
Uttaranchal,2001,Murder,0,0,0,42,0,42,232,0,232,38,0,38,312,0,312
Uttaranchal,2001,Attempt To Commit Murder,0,0,0,8,1,9,9,0,9,1,0,1,18,1,19
Uttaranchal,2001,C.H. Not Amounting To Murder,0,0,0,2,0,2,2,0,2,1,0,1,5,0,5
Uttaranchal,2001,Rape,0,0,0,4,0,4,3,0,3,1,0,1,8,0,8
Uttaranchal,2001,Kidnapping And Abduction,0,0,0,0,0,0,3,0,3,0,0,0,3,0,3
Uttaranchal,2001,Dacoity,0,0,0,2,0,2,5,0,5,0,0,0,7,0,7
Uttaranchal,2001,Prep. And Assembly For Dacoity,0,0,0,0,0,0,0,0,0,0,0,0,0,0,0
Uttaranchal,2001,Robbery,5,0,5,0,0,0,1,0,1,0,0,0,6,0,6
Uttaranchal,2001,Burglary,1,0,1,0,0,0,2,0,2,4,0,4,7,0,7
Uttaranchal,2001,Thefts,7,0,7,6,0,6,8,0,8,1,0,1,22,0,22
Uttaranchal,2001,Extortion,0,0,0,0,0,0,0,0,0,0,0,0,0,0,0
Uttaranchal,2001,Riots,0,0,0,0,0,0,0,0,0,0,0,0,0,0,0
Uttaranchal,2001,Arson,0,0,0,0,0,0,0,0,0,0,0,0,0,0,0
Uttaranchal,2001,Criminal Breach Of Trust,0,0,0,0,0,0,0,0,0,3,0,3,3,0,3
Uttaranchal,2001,Cheating,0,0,0,0,0,0,0,0,0,0,0,0,0,0,0
Uttaranchal,2001,Counter Feiting,0,0,0,0,0,0,0,0,0,3,0,3,3,0,3
Uttaranchal,2001,Dowry Deaths,2,0,2,9,1,10,11,0,11,3,0,3,25,1,26
Uttaranchal,2001,Molestation,1,0,1,0,0,0,0,0,0,0,0,0,1,0,1
Uttaranchal,2001,Eve-Teasing,0,0,0,0,0,0,0,0,0,0,0,0,0,0,0
Uttaranchal,2001,Cruelty By Husband Or Relative Of Husband,0,0,0,6,0,6,0,0,0,0,0,0,6,0,6
Uttaranchal,2001,Other Ipc Crimes,0,0,0,0,0,0,0,0,0,0,0,0,0,0,0
Uttaranchal,2002,Murder,0,0,0,65,0,65,242,6,248,54,0,54,361,6,367
Uttaranchal,2002,Attempt To Commit Murder,0,0,0,9,0,9,20,0,20,3,0,3,32,0,32
Uttaranchal,2002,C.H. Not Amounting To Murder,0,0,0,2,0,2,6,0,6,4,0,4,12,0,12
Uttaranchal,2002,Rape,1,0,1,13,0,13,3,2,5,0,0,0,17,2,19
Uttaranchal,2002,Kidnapping And Abduction,0,0,0,2,0,2,2,0,2,1,0,1,5,0,5
Uttaranchal,2002,Dacoity,0,0,0,3,0,3,6,0,6,1,0,1,10,0,10
Uttaranchal,2002,Prep. And Assembly For Dacoity,0,0,0,0,0,0,1,0,1,4,0,4,5,0,5
Uttaranchal,2002,Robbery,0,0,0,3,0,3,2,0,2,0,0,0,5,0,5
Uttaranchal,2002,Burglary,0,0,0,4,0,4,4,0,4,0,0,0,8,0,8
Uttaranchal,2002,Thefts,2,0,2,13,0,13,23,0,23,12,0,12,50,0,50
Uttaranchal,2002,Extortion,0,0,0,4,0,4,0,0,0,0,0,0,4,0,4
Uttaranchal,2002,Riots,0,0,0,0,0,0,0,0,0,0,0,0,0,0,0
Uttaranchal,2002,Arson,0,0,0,0,0,0,0,0,0,0,0,0,0,0,0
Uttaranchal,2002,Criminal Breach Of Trust,0,0,0,0,0,0,0,0,0,0,0,0,0,0,0
Uttaranchal,2002,Cheating,0,0,0,0,1,1,0,0,0,0,0,0,0,1,1
Uttaranchal,2002,Counter Feiting,0,0,0,0,0,0,0,0,0,0,0,0,0,0,0
Uttaranchal,2002,Dowry Deaths,0,0,0,8,0,8,3,2,5,3,0,3,14,2,16
Uttaranchal,2002,Molestation,0,0,0,0,0,0,0,0,0,0,0,0,0,0,0
Uttaranchal,2002,Eve-Teasing,0,0,0,0,0,0,0,0,0,0,0,0,0,0,0
Uttaranchal,2002,Cruelty By Husband Or Relative Of Husband,0,0,0,0,1,1,0,0,0,0,0,0,0,1,1
Uttaranchal,2002,Other Ipc Crimes,0,0,0,1,0,1,0,0,0,0,0,0,1,0,1
Uttaranchal,2003,Murder,0,0,0,51,0,51,234,2,236,102,3,105,387,5,392
Uttaranchal,2003,Attempt To Commit Murder,0,0,0,12,0,12,21,0,21,9,0,9,42,0,42
Uttaranchal,2003,C.H. Not Amounting To Murder,0,0,0,3,0,3,0,0,0,0,0,0,3,0,3
Uttaranchal,2003,Rape,1,0,1,21,0,21,20,0,20,0,0,0,42,0,42
Uttaranchal,2003,Kidnapping And Abduction,0,0,0,5,0,5,1,0,1,0,0,0,6,0,6
Uttaranchal,2003,Dacoity,0,0,0,7,0,7,5,0,5,2,0,2,14,0,14
Uttaranchal,2003,Prep. And Assembly For Dacoity,0,0,0,2,0,2,0,0,0,6,0,6,8,0,8
Uttaranchal,2003,Robbery,0,0,0,7,0,7,1,0,1,0,0,0,8,0,8
Uttaranchal,2003,Burglary,0,0,0,1,0,1,3,0,3,0,0,0,4,0,4
Uttaranchal,2003,Thefts,2,0,2,8,0,8,14,0,14,5,0,5,29,0,29
Uttaranchal,2003,Extortion,0,0,0,1,0,1,1,0,1,0,0,0,2,0,2
Uttaranchal,2003,Riots,0,0,0,0,0,0,0,0,0,0,0,0,0,0,0
Uttaranchal,2003,Arson,0,0,0,1,0,1,0,0,0,0,0,0,1,0,1
Uttaranchal,2003,Criminal Breach Of Trust,0,0,0,0,0,0,0,0,0,0,0,0,0,0,0
Uttaranchal,2003,Cheating,0,0,0,0,0,0,1,0,1,0,0,0,1,0,1
Uttaranchal,2003,Counter Feiting,0,0,0,0,0,0,1,0,1,0,0,0,1,0,1
Uttaranchal,2003,Dowry Deaths,0,0,0,14,2,16,7,1,8,2,1,3,23,4,27
Uttaranchal,2003,Molestation,0,0,0,0,0,0,1,0,1,0,0,0,1,0,1
Uttaranchal,2003,Eve-Teasing,0,0,0,0,0,0,0,0,0,0,0,0,0,0,0
Uttaranchal,2003,Cruelty By Husband Or Relative Of Husband,0,0,0,0,0,0,0,2,2,0,1,1,0,3,3
Uttaranchal,2003,Other Ipc Crimes,0,0,0,1,0,1,1,0,1,1,0,1,3,0,3
Uttaranchal,2004,Murder,0,0,0,22,1,23,175,1,176,71,0,71,268,2,270
Uttaranchal,2004,Attempt To Commit Murder,0,0,0,15,0,15,27,0,27,10,0,10,52,0,52
Uttaranchal,2004,C.H. Not Amounting To Murder,0,0,0,1,0,1,3,0,3,2,0,2,6,0,6
Uttaranchal,2004,Rape,0,0,0,2,0,2,2,3,5,0,0,0,4,3,7
Uttaranchal,2004,Kidnapping And Abduction,0,0,0,3,0,3,13,0,13,0,0,0,16,0,16
Uttaranchal,2004,Dacoity,0,0,0,0,0,0,0,0,0,0,0,0,0,0,0
Uttaranchal,2004,Prep. And Assembly For Dacoity,0,0,0,4,0,4,12,0,12,5,0,5,21,0,21
Uttaranchal,2004,Robbery,0,0,0,0,0,0,0,0,0,0,0,0,0,0,0
Uttaranchal,2004,Burglary,0,0,0,1,0,1,1,0,1,0,0,0,2,0,2
Uttaranchal,2004,Thefts,0,0,0,3,0,3,5,0,5,4,0,4,12,0,12
Uttaranchal,2004,Extortion,0,0,0,0,0,0,0,0,0,0,0,0,0,0,0
Uttaranchal,2004,Riots,0,0,0,2,0,2,3,0,3,2,2,4,7,2,9
Uttaranchal,2004,Arson,0,0,0,0,0,0,0,0,0,0,0,0,0,0,0
Uttaranchal,2004,Criminal Breach Of Trust,0,0,0,3,0,3,4,0,4,5,0,5,12,0,12
Uttaranchal,2004,Cheating,0,0,0,2,0,2,3,0,3,0,0,0,5,0,5
Uttaranchal,2004,Counter Feiting,0,0,0,9,3,12,5,0,5,16,0,16,30,3,33
Uttaranchal,2004,Dowry Deaths,0,0,0,0,0,0,0,0,0,0,0,0,0,0,0
Uttaranchal,2004,Molestation,0,0,0,3,0,3,5,0,5,0,0,0,8,0,8
Uttaranchal,2004,Eve-Teasing,0,0,0,1,0,1,0,0,0,1,0,1,2,0,2
Uttaranchal,2004,Cruelty By Husband Or Relative Of Husband,0,0,0,7,0,7,8,3,11,7,0,7,22,3,25
Uttaranchal,2004,Other Ipc Crimes,0,0,0,0,0,0,0,0,0,0,0,0,0,0,0
Uttaranchal,2005,Murder,0,0,0,86,1,87,256,4,260,138,1,139,480,6,486
Uttaranchal,2005,Attempt To Commit Murder,0,0,0,14,0,14,4,0,4,1,0,1,19,0,19
Uttaranchal,2005,C.H. Not Amounting To Murder,0,0,0,12,0,12,9,1,10,3,1,4,24,2,26
Uttaranchal,2005,Rape,0,0,0,27,0,27,9,0,9,2,0,2,38,0,38
Uttaranchal,2005,Kidnapping And Abduction,0,0,0,3,1,4,3,0,3,1,1,2,7,2,9
Uttaranchal,2005,Dacoity,0,0,0,3,0,3,6,0,6,1,0,1,10,0,10
Uttaranchal,2005,Prep. And Assembly For Dacoity,0,0,0,0,0,0,0,0,0,0,0,0,0,0,0
Uttaranchal,2005,Robbery,0,0,0,3,0,3,1,0,1,0,0,0,4,0,4
Uttaranchal,2005,Burglary,0,0,0,10,0,10,1,0,1,0,0,0,11,0,11
Uttaranchal,2005,Thefts,0,0,0,11,0,11,7,0,7,0,0,0,18,0,18
Uttaranchal,2005,Extortion,0,0,0,0,0,0,0,0,0,0,0,0,0,0,0
Uttaranchal,2005,Riots,0,0,0,0,0,0,0,0,0,0,0,0,0,0,0
Uttaranchal,2005,Arson,0,0,0,0,0,0,0,0,0,0,0,0,0,0,0
Uttaranchal,2005,Criminal Breach Of Trust,0,0,0,0,0,0,2,0,2,0,0,0,2,0,2
Uttaranchal,2005,Cheating,0,0,0,0,0,0,0,0,0,0,0,0,0,0,0
Uttaranchal,2005,Counter Feiting,0,0,0,0,0,0,0,0,0,0,0,0,0,0,0
Uttaranchal,2005,Dowry Deaths,0,0,0,3,0,3,4,0,4,1,0,1,8,0,8
Uttaranchal,2005,Molestation,0,0,0,0,0,0,0,0,0,0,0,0,0,0,0
Uttaranchal,2005,Eve-Teasing,0,0,0,0,0,0,0,0,0,0,0,0,0,0,0
Uttaranchal,2005,Cruelty By Husband Or Relative Of Husband,0,0,0,0,0,0,1,1,2,0,0,0,1,1,2
Uttaranchal,2005,Other Ipc Crimes,0,0,0,0,0,0,0,0,0,0,0,0,0,0,0
Uttaranchal,2006,Murder,1,0,1,131,0,131,240,7,247,151,3,154,523,10,533
Uttaranchal,2006,Attempt To Commit Murder,0,0,0,17,0,17,13,1,14,7,0,7,37,1,38
Uttaranchal,2006,C.H. Not Amounting To Murder,0,0,0,16,0,16,10,0,10,8,2,10,34,2,36
Uttaranchal,2006,Rape,0,0,0,35,0,35,18,0,18,9,0,9,62,0,62
Uttaranchal,2006,Kidnapping And Abduction,0,0,0,2,1,3,2,0,2,1,0,1,5,1,6
Uttaranchal,2006,Dacoity,0,0,0,4,0,4,4,0,4,2,0,2,10,0,10
Uttaranchal,2006,Prep. And Assembly For Dacoity,0,0,0,4,0,4,0,0,0,0,0,0,4,0,4
Uttaranchal,2006,Robbery,0,0,0,3,0,3,1,0,1,1,0,1,5,0,5
Uttaranchal,2006,Burglary,0,0,0,4,0,4,7,0,7,3,0,3,14,0,14
Uttaranchal,2006,Thefts,4,0,4,21,0,21,10,0,10,1,0,1,36,0,36
Uttaranchal,2006,Extortion,0,0,0,0,0,0,0,0,0,0,0,0,0,0,0
Uttaranchal,2006,Riots,0,0,0,3,0,3,2,0,2,3,0,3,8,0,8
Uttaranchal,2006,Arson,0,0,0,0,0,0,0,0,0,0,0,0,0,0,0
Uttaranchal,2006,Criminal Breach Of Trust,0,0,0,0,0,0,0,0,0,1,0,1,1,0,1
Uttaranchal,2006,Cheating,0,0,0,0,0,0,1,0,1,0,0,0,1,0,1
Uttaranchal,2006,Counter Feiting,0,0,0,2,0,2,3,1,4,0,0,0,5,1,6
Uttaranchal,2006,Dowry Deaths,0,0,0,11,0,11,6,0,6,6,1,7,23,1,24
Uttaranchal,2006,Molestation,0,0,0,1,0,1,3,0,3,1,0,1,5,0,5
Uttaranchal,2006,Eve-Teasing,0,0,0,0,0,0,0,0,0,0,0,0,0,0,0
Uttaranchal,2006,Cruelty By Husband Or Relative Of Husband,0,0,0,0,0,0,0,0,0,0,0,0,0,0,0
Uttaranchal,2006,Other Ipc Crimes,0,0,0,0,0,0,0,0,0,1,0,1,1,0,1
Uttaranchal,2007,Murder,0,0,0,157,0,157,128,12,140,244,3,247,529,15,544
Uttaranchal,2007,Attempt To Commit Murder,0,0,0,21,0,21,12,1,13,10,0,10,43,1,44
Uttaranchal,2007,C.H. Not Amounting To Murder,0,0,0,16,0,16,13,2,15,9,1,10,38,3,41
Uttaranchal,2007,Rape,0,0,0,42,0,42,19,0,19,13,1,14,74,1,75
Uttaranchal,2007,Kidnapping And Abduction,0,0,0,17,1,18,11,0,11,2,0,2,30,1,31
Uttaranchal,2007,Dacoity,0,0,0,8,0,8,6,0,6,6,0,6,20,0,20
Uttaranchal,2007,Prep. And Assembly For Dacoity,0,0,0,0,0,0,0,0,0,0,0,0,0,0,0
Uttaranchal,2007,Robbery,0,0,0,5,0,5,3,0,3,0,0,0,8,0,8
Uttaranchal,2007,Burglary,0,0,0,3,0,3,4,0,4,4,0,4,11,0,11
Uttaranchal,2007,Thefts,0,0,0,10,0,10,4,0,4,0,0,0,14,0,14
Uttaranchal,2007,Extortion,0,0,0,0,0,0,0,0,0,0,0,0,0,0,0
Uttaranchal,2007,Riots,0,0,0,5,0,5,2,0,2,1,0,1,8,0,8
Uttaranchal,2007,Arson,0,0,0,0,0,0,0,0,0,0,0,0,0,0,0
Uttaranchal,2007,Criminal Breach Of Trust,0,0,0,0,0,0,0,0,0,0,0,0,0,0,0
Uttaranchal,2007,Cheating,0,0,0,0,0,0,3,0,3,0,0,0,3,0,3
Uttaranchal,2007,Counter Feiting,0,0,0,7,0,7,2,1,3,1,1,2,10,2,12
Uttaranchal,2007,Dowry Deaths,0,0,0,15,0,15,9,0,9,2,0,2,26,0,26
Uttaranchal,2007,Molestation,0,0,0,1,0,1,0,0,0,0,0,0,1,0,1
Uttaranchal,2007,Eve-Teasing,0,0,0,0,0,0,0,0,0,0,0,0,0,0,0
Uttaranchal,2007,Cruelty By Husband Or Relative Of Husband,0,0,0,0,3,3,0,0,0,0,0,0,0,3,3
Uttaranchal,2007,Other Ipc Crimes,0,0,0,3,0,3,0,0,0,0,0,0,3,0,3
Uttaranchal,2008,Murder,0,0,0,181,1,182,276,11,287,239,1,240,696,13,709
Uttaranchal,2008,Attempt To Commit Murder,0,0,0,27,1,28,56,0,56,14,0,14,97,1,98
Uttaranchal,2008,C.H. Not Amounting To Murder,0,0,0,14,0,14,20,4,24,4,0,4,38,4,42
Uttaranchal,2008,Rape,0,0,0,29,0,29,17,0,17,1,0,1,47,0,47
Uttaranchal,2008,Kidnapping And Abduction,0,0,0,13,0,13,18,0,18,1,0,1,32,0,32
Uttaranchal,2008,Dacoity,0,0,0,4,0,4,5,0,5,3,0,3,12,0,12
Uttaranchal,2008,Prep. And Assembly For Dacoity,0,0,0,0,0,0,0,0,0,0,0,0,0,0,0
Uttaranchal,2008,Robbery,0,0,0,5,0,5,1,0,1,0,0,0,6,0,6
Uttaranchal,2008,Burglary,0,0,0,0,0,0,0,0,0,0,0,0,0,0,0
Uttaranchal,2008,Thefts,0,0,0,0,0,0,0,0,0,0,0,0,0,0,0
Uttaranchal,2008,Extortion,0,0,0,0,0,0,0,0,0,0,0,0,0,0,0
Uttaranchal,2008,Riots,0,0,0,0,0,0,0,0,0,0,0,0,0,0,0
Uttaranchal,2008,Arson,0,0,0,0,0,0,0,0,0,0,0,0,0,0,0
Uttaranchal,2008,Criminal Breach Of Trust,0,0,0,0,0,0,0,0,0,0,0,0,0,0,0
Uttaranchal,2008,Cheating,0,0,0,0,0,0,0,0,0,0,0,0,0,0,0
Uttaranchal,2008,Counter Feiting,0,0,0,2,0,2,1,2,3,0,0,0,3,2,5
Uttaranchal,2008,Dowry Deaths,0,0,0,25,5,30,18,4,22,4,1,5,47,10,57
Uttaranchal,2008,Molestation,0,0,0,0,0,0,0,0,0,0,0,0,0,0,0
Uttaranchal,2008,Eve-Teasing,0,0,0,0,0,0,0,0,0,0,0,0,0,0,0
Uttaranchal,2008,Cruelty By Husband Or Relative Of Husband,0,0,0,0,0,0,0,0,0,0,0,0,0,0,0
Uttaranchal,2008,Other Ipc Crimes,0,0,0,6,0,6,13,0,13,4,0,4,23,0,23
Uttaranchal,2009,Murder,0,0,0,130,0,130,233,4,237,207,6,213,570,10,580
Uttaranchal,2009,Attempt To Commit Murder,0,0,0,31,1,32,19,0,19,31,0,31,81,1,82
Uttaranchal,2009,C.H. Not Amounting To Murder,0,0,0,36,3,39,21,0,21,20,1,21,77,4,81
Uttaranchal,2009,Rape,0,0,0,21,0,21,30,0,30,11,0,11,62,0,62
Uttaranchal,2009,Kidnapping And Abduction,0,0,0,10,0,10,16,2,18,13,0,13,39,2,41
Uttaranchal,2009,Dacoity,0,0,0,11,1,12,12,0,12,8,0,8,31,1,32
Uttaranchal,2009,Prep. And Assembly For Dacoity,0,0,0,0,0,0,0,0,0,0,0,0,0,0,0
Uttaranchal,2009,Robbery,0,0,0,4,0,4,11,0,11,0,0,0,15,0,15
Uttaranchal,2009,Burglary,0,0,0,7,0,7,14,3,17,5,0,5,26,3,29
Uttaranchal,2009,Thefts,0,0,0,17,2,19,25,1,26,0,0,0,42,3,45
Uttaranchal,2009,Extortion,0,0,0,0,0,0,0,0,0,0,0,0,0,0,0
Uttaranchal,2009,Riots,0,0,0,6,0,6,12,2,14,0,0,0,18,2,20
Uttaranchal,2009,Arson,0,0,0,0,0,0,0,0,0,2,0,2,2,0,2
Uttaranchal,2009,Criminal Breach Of Trust,0,0,0,0,0,0,16,0,16,4,0,4,20,0,20
Uttaranchal,2009,Cheating,0,0,0,0,0,0,2,0,2,0,0,0,2,0,2
Uttaranchal,2009,Counter Feiting,0,0,0,2,0,2,3,0,3,0,0,0,5,0,5
Uttaranchal,2009,Dowry Deaths,0,0,0,21,1,22,18,5,23,7,0,7,46,6,52
Uttaranchal,2009,Molestation,0,0,0,0,0,0,6,0,6,0,0,0,6,0,6
Uttaranchal,2009,Eve-Teasing,0,0,0,0,0,0,0,0,0,0,0,0,0,0,0
Uttaranchal,2009,Cruelty By Husband Or Relative Of Husband,0,0,0,0,0,0,4,0,4,4,0,4,8,0,8
Uttaranchal,2009,Other Ipc Crimes,0,0,0,6,0,6,5,0,5,5,0,5,16,0,16
Uttaranchal,2010,Murder,0,0,0,132,1,133,276,8,284,205,4,209,613,13,626
Uttaranchal,2010,Attempt To Commit Murder,0,0,0,39,0,39,33,1,34,28,0,28,100,1,101
Uttaranchal,2010,C.H. Not Amounting To Murder,0,0,0,18,0,18,22,2,24,15,2,17,55,4,59
Uttaranchal,2010,Rape,0,0,0,41,0,41,17,0,17,15,0,15,73,0,73
Uttaranchal,2010,Kidnapping And Abduction,0,0,0,10,0,10,16,0,16,10,0,10,36,0,36
Uttaranchal,2010,Dacoity,0,0,0,3,0,3,15,0,15,5,0,5,23,0,23
Uttaranchal,2010,Prep. And Assembly For Dacoity,0,0,0,0,0,0,0,0,0,0,0,0,0,0,0
Uttaranchal,2010,Robbery,0,0,0,4,0,4,17,0,17,7,0,7,28,0,28
Uttaranchal,2010,Burglary,0,0,0,11,0,11,1,5,6,0,0,0,12,5,17
Uttaranchal,2010,Thefts,0,0,0,37,0,37,22,1,23,4,0,4,63,1,64
Uttaranchal,2010,Extortion,0,0,0,0,0,0,0,0,0,0,0,0,0,0,0
Uttaranchal,2010,Riots,0,0,0,0,0,0,4,3,7,0,0,0,4,3,7
Uttaranchal,2010,Arson,0,0,0,0,0,0,2,0,2,0,0,0,2,0,2
Uttaranchal,2010,Criminal Breach Of Trust,0,0,0,8,0,8,6,0,6,3,2,5,17,2,19
Uttaranchal,2010,Cheating,0,0,0,0,0,0,0,0,0,1,0,1,1,0,1
Uttaranchal,2010,Counter Feiting,0,0,0,3,0,3,2,0,2,0,0,0,5,0,5
Uttaranchal,2010,Dowry Deaths,0,0,0,29,4,33,20,6,26,6,3,9,55,13,68
Uttaranchal,2010,Molestation,0,0,0,12,0,12,4,0,4,0,0,0,16,0,16
Uttaranchal,2010,Eve-Teasing,0,0,0,0,0,0,0,0,0,0,0,0,0,0,0
Uttaranchal,2010,Cruelty By Husband Or Relative Of Husband,0,0,0,21,3,24,3,0,3,0,0,0,24,3,27
Uttaranchal,2010,Other Ipc Crimes,0,0,0,8,0,8,3,0,3,0,0,0,11,0,11
Uttaranchal,2011,Murder,0,0,0,8,2,10,510,12,522,170,12,182,688,26,714
Uttaranchal,2011,Attempt To Commit Murder,0,0,0,12,0,12,117,2,119,70,1,71,199,3,202
Uttaranchal,2011,C.H. Not Amounting To Murder,0,0,0,12,0,12,59,2,61,62,1,63,133,3,136
Uttaranchal,2011,Rape,0,0,0,11,0,11,31,0,31,33,1,34,75,1,76
Uttaranchal,2011,Kidnapping And Abduction,0,0,0,13,0,13,32,1,33,24,1,25,69,2,71
Uttaranchal,2011,Dacoity,0,0,0,11,0,11,4,0,4,12,1,13,27,1,28
Uttaranchal,2011,Prep. And Assembly For Dacoity,0,0,0,0,0,0,5,0,5,4,1,5,9,1,10
Uttaranchal,2011,Robbery,0,0,0,0,0,0,2,0,2,0,0,0,2,0,2
Uttaranchal,2011,Burglary,0,0,0,0,0,0,3,2,5,3,1,4,6,3,9
Uttaranchal,2011,Thefts,0,0,0,4,0,4,3,1,4,4,1,5,11,2,13
Uttaranchal,2011,Extortion,0,0,0,0,0,0,0,0,0,0,0,0,0,0,0
Uttaranchal,2011,Riots,0,0,0,2,0,2,0,0,0,0,0,0,2,0,2
Uttaranchal,2011,Arson,0,0,0,0,0,0,0,0,0,0,0,0,0,0,0
Uttaranchal,2011,Criminal Breach Of Trust,0,0,0,0,0,0,0,0,0,0,0,0,0,0,0
Uttaranchal,2011,Cheating,0,0,0,0,0,0,0,0,0,0,0,0,0,0,0
Uttaranchal,2011,Counter Feiting,0,0,0,0,0,0,0,0,0,0,0,0,0,0,0
Uttaranchal,2011,Dowry Deaths,0,0,0,6,0,6,65,7,72,50,8,58,121,15,136
Uttaranchal,2011,Molestation,0,0,0,1,0,1,0,0,0,0,0,0,1,0,1
Uttaranchal,2011,Eve-Teasing,0,0,0,0,0,0,0,0,0,0,0,0,0,0,0
Uttaranchal,2011,Cruelty By Husband Or Relative Of Husband,0,0,0,2,0,2,0,0,0,3,0,3,5,0,5
Uttaranchal,2011,Other Ipc Crimes,0,0,0,0,0,0,0,0,0,0,0,0,0,0,0
Uttaranchal,2012,Murder,0,0,0,164,3,167,322,11,333,241,4,245,727,18,745
Uttaranchal,2012,Attempt To Commit Murder,0,0,0,52,0,52,39,0,39,25,0,25,116,0,116
Uttaranchal,2012,C.H. Not Amounting To Murder,0,0,0,22,0,22,23,3,26,12,0,12,57,3,60
Uttaranchal,2012,Rape,0,0,0,48,0,48,21,0,21,16,0,16,85,0,85
Uttaranchal,2012,Kidnapping And Abduction,0,0,0,12,0,12,18,0,18,11,0,11,41,0,41
Uttaranchal,2012,Dacoity,0,0,0,4,0,4,12,0,12,8,0,8,24,0,24
Uttaranchal,2012,Prep. And Assembly For Dacoity,0,0,0,2,0,2,0,0,0,0,0,0,2,0,2
Uttaranchal,2012,Robbery,0,0,0,8,0,8,22,0,22,9,0,9,39,0,39
Uttaranchal,2012,Burglary,0,0,0,12,0,12,11,0,11,3,0,3,26,0,26
Uttaranchal,2012,Thefts,0,0,0,42,0,42,22,4,26,8,0,8,72,4,76
Uttaranchal,2012,Extortion,0,0,0,0,0,0,0,0,0,0,0,0,0,0,0
Uttaranchal,2012,Riots,0,0,0,0,0,0,0,0,0,0,0,0,0,0,0
Uttaranchal,2012,Arson,0,0,0,2,0,2,0,0,0,0,0,0,2,0,2
Uttaranchal,2012,Criminal Breach Of Trust,0,0,0,10,0,10,8,0,8,5,3,8,23,3,26
Uttaranchal,2012,Cheating,0,0,0,0,0,0,3,0,3,0,0,0,3,0,3
Uttaranchal,2012,Counter Feiting,0,0,0,3,0,3,2,0,2,0,0,0,5,0,5
Uttaranchal,2012,Dowry Deaths,0,0,0,42,8,50,22,9,31,6,2,8,70,19,89
Uttaranchal,2012,Molestation,0,0,0,11,0,11,2,0,2,0,0,0,13,0,13
Uttaranchal,2012,Eve-Teasing,0,0,0,0,0,0,0,0,0,0,0,0,0,0,0
Uttaranchal,2012,Cruelty By Husband Or Relative Of Husband,0,0,0,24,5,29,3,0,3,0,0,0,27,5,32
Uttaranchal,2012,Other Ipc Crimes,0,0,0,3,0,3,0,0,0,0,0,0,3,0,3
West Bengal,2001,Murder,1,0,1,371,5,376,614,12,626,166,6,172,1152,23,1175
West Bengal,2001,Attempt To Commit Murder,2,0,2,37,2,39,51,6,57,4,0,4,94,8,102
West Bengal,2001,C.H. Not Amounting To Murder,0,0,0,35,2,37,43,7,50,12,0,12,90,9,99
West Bengal,2001,Rape,7,0,7,46,0,46,40,0,40,6,0,6,99,0,99
West Bengal,2001,Kidnapping And Abduction,0,0,0,8,0,8,8,0,8,1,0,1,17,0,17
West Bengal,2001,Dacoity,4,0,4,75,2,77,87,5,92,9,0,9,175,7,182
West Bengal,2001,Prep. And Assembly For Dacoity,0,0,0,4,0,4,3,0,3,1,0,1,8,0,8
West Bengal,2001,Robbery,0,0,0,11,0,11,12,0,12,1,0,1,24,0,24
West Bengal,2001,Burglary,0,0,0,1,0,1,3,0,3,0,0,0,4,0,4
West Bengal,2001,Thefts,5,0,5,51,5,56,41,5,46,15,0,15,112,10,122
West Bengal,2001,Extortion,0,0,0,5,0,5,2,0,2,0,0,0,7,0,7
West Bengal,2001,Riots,0,0,0,0,0,0,0,0,0,0,0,0,0,0,0
West Bengal,2001,Arson,0,0,0,2,0,2,3,0,3,0,0,0,5,0,5
West Bengal,2001,Criminal Breach Of Trust,0,0,0,0,0,0,0,0,0,0,0,0,0,0,0
West Bengal,2001,Cheating,0,0,0,2,0,2,3,0,3,0,0,0,5,0,5
West Bengal,2001,Counter Feiting,0,0,0,0,0,0,0,0,0,0,0,0,0,0,0
West Bengal,2001,Dowry Deaths,0,0,0,2,0,2,5,0,5,2,0,2,9,0,9
West Bengal,2001,Molestation,0,0,0,0,0,0,0,0,0,0,0,0,0,0,0
West Bengal,2001,Eve-Teasing,0,0,0,0,0,0,0,0,0,0,0,0,0,0,0
West Bengal,2001,Cruelty By Husband Or Relative Of Husband,0,0,0,10,0,10,13,3,16,2,0,2,25,3,28
West Bengal,2001,Other Ipc Crimes,0,0,0,20,0,20,13,7,20,1,0,1,34,7,41
West Bengal,2002,Murder,0,0,0,458,2,460,532,25,557,152,15,167,1142,42,1184
West Bengal,2002,Attempt To Commit Murder,0,0,0,47,0,47,85,2,87,4,1,5,136,3,139
West Bengal,2002,C.H. Not Amounting To Murder,0,0,0,32,0,32,39,6,45,4,0,4,75,6,81
West Bengal,2002,Rape,1,0,1,44,0,44,19,0,19,4,0,4,68,0,68
West Bengal,2002,Kidnapping And Abduction,0,0,0,9,0,9,10,2,12,1,0,1,20,2,22
West Bengal,2002,Dacoity,1,0,1,55,0,55,43,2,45,8,0,8,107,2,109
West Bengal,2002,Prep. And Assembly For Dacoity,0,0,0,7,0,7,3,0,3,1,0,1,11,0,11
West Bengal,2002,Robbery,0,0,0,15,0,15,20,0,20,0,0,0,35,0,35
West Bengal,2002,Burglary,0,0,0,2,0,2,1,0,1,0,0,0,3,0,3
West Bengal,2002,Thefts,0,0,0,23,0,23,30,2,32,1,0,1,54,2,56
West Bengal,2002,Extortion,0,0,0,3,0,3,2,0,2,0,0,0,5,0,5
West Bengal,2002,Riots,0,0,0,0,0,0,0,0,0,0,0,0,0,0,0
West Bengal,2002,Arson,0,0,0,0,0,0,0,0,0,0,0,0,0,0,0
West Bengal,2002,Criminal Breach Of Trust,0,0,0,0,0,0,0,0,0,0,0,0,0,0,0
West Bengal,2002,Cheating,0,0,0,2,0,2,1,0,1,0,0,0,3,0,3
West Bengal,2002,Counter Feiting,0,0,0,0,0,0,0,0,0,0,0,0,0,0,0
West Bengal,2002,Dowry Deaths,0,0,0,34,2,36,34,6,40,2,7,9,70,15,85
West Bengal,2002,Molestation,0,0,0,0,0,0,0,0,0,0,0,0,0,0,0
West Bengal,2002,Eve-Teasing,0,0,0,0,0,0,0,0,0,0,0,0,0,0,0
West Bengal,2002,Cruelty By Husband Or Relative Of Husband,0,0,0,18,0,18,18,1,19,11,2,13,47,3,50
West Bengal,2002,Other Ipc Crimes,0,0,0,29,7,36,24,0,24,3,0,3,56,7,63
West Bengal,2003,Murder,0,0,0,380,10,390,830,23,853,141,13,154,1351,46,1397
West Bengal,2003,Attempt To Commit Murder,0,0,0,108,2,110,96,3,99,26,0,26,230,5,235
West Bengal,2003,C.H. Not Amounting To Murder,0,0,0,33,0,33,49,6,55,12,2,14,94,8,102
West Bengal,2003,Rape,0,0,0,93,0,93,58,0,58,6,0,6,157,0,157
West Bengal,2003,Kidnapping And Abduction,0,0,0,30,1,31,25,4,29,5,0,5,60,5,65
West Bengal,2003,Dacoity,0,0,0,87,0,87,96,1,97,8,0,8,191,1,192
West Bengal,2003,Prep. And Assembly For Dacoity,0,0,0,4,0,4,6,0,6,0,0,0,10,0,10
West Bengal,2003,Robbery,0,0,0,19,0,19,33,1,34,4,0,4,56,1,57
West Bengal,2003,Burglary,0,0,0,1,0,1,1,0,1,0,0,0,2,0,2
West Bengal,2003,Thefts,0,0,0,56,3,59,32,2,34,1,0,1,89,5,94
West Bengal,2003,Extortion,0,0,0,0,0,0,2,0,2,0,0,0,2,0,2
West Bengal,2003,Riots,0,0,0,0,0,0,0,0,0,0,0,0,0,0,0
West Bengal,2003,Arson,0,0,0,0,0,0,0,0,0,0,0,0,0,0,0
West Bengal,2003,Criminal Breach Of Trust,0,0,0,0,0,0,2,0,2,0,0,0,2,0,2
West Bengal,2003,Cheating,0,0,0,2,0,2,8,0,8,0,0,0,10,0,10
West Bengal,2003,Counter Feiting,0,0,0,0,0,0,2,0,2,1,0,1,3,0,3
West Bengal,2003,Dowry Deaths,0,0,0,10,3,13,35,15,50,11,3,14,56,21,77
West Bengal,2003,Molestation,0,0,0,0,0,0,0,0,0,0,0,0,0,0,0
West Bengal,2003,Eve-Teasing,0,0,0,0,0,0,0,0,0,0,0,0,0,0,0
West Bengal,2003,Cruelty By Husband Or Relative Of Husband,0,0,0,56,3,59,76,6,82,18,4,22,150,13,163
West Bengal,2003,Other Ipc Crimes,0,0,0,31,0,31,14,0,14,3,0,3,48,0,48
West Bengal,2004,Murder,0,0,0,404,8,412,885,39,924,152,17,169,1441,64,1505
West Bengal,2004,Attempt To Commit Murder,0,0,0,87,0,87,97,0,97,22,0,22,206,0,206
West Bengal,2004,C.H. Not Amounting To Murder,0,0,0,54,2,56,65,2,67,11,0,11,130,4,134
West Bengal,2004,Rape,0,0,0,158,0,158,58,0,58,5,0,5,221,0,221
West Bengal,2004,Kidnapping And Abduction,0,0,0,30,2,32,26,3,29,3,0,3,59,5,64
West Bengal,2004,Dacoity,0,0,0,101,2,103,93,2,95,11,0,11,205,4,209
West Bengal,2004,Prep. And Assembly For Dacoity,0,0,0,3,0,3,5,0,5,0,0,0,8,0,8
West Bengal,2004,Robbery,0,0,0,32,0,32,16,1,17,2,0,2,50,1,51
West Bengal,2004,Burglary,0,0,0,11,0,11,3,0,3,0,0,0,14,0,14
West Bengal,2004,Thefts,0,0,0,44,2,46,23,1,24,3,0,3,70,3,73
West Bengal,2004,Extortion,0,0,0,1,0,1,2,0,2,0,0,0,3,0,3
West Bengal,2004,Riots,0,0,0,9,0,9,0,0,0,0,0,0,9,0,9
West Bengal,2004,Arson,0,0,0,0,0,0,0,0,0,0,0,0,0,0,0
West Bengal,2004,Criminal Breach Of Trust,0,0,0,0,0,0,0,0,0,2,0,2,2,0,2
West Bengal,2004,Cheating,0,0,0,3,0,3,13,0,13,2,0,2,18,0,18
West Bengal,2004,Counter Feiting,0,0,0,0,0,0,0,0,0,0,0,0,0,0,0
West Bengal,2004,Dowry Deaths,0,0,0,50,2,52,37,10,47,10,10,20,97,22,119
West Bengal,2004,Molestation,0,0,0,0,0,0,0,0,0,0,0,0,0,0,0
West Bengal,2004,Eve-Teasing,0,0,0,0,0,0,0,0,0,0,0,0,0,0,0
West Bengal,2004,Cruelty By Husband Or Relative Of Husband,0,0,0,77,4,81,55,6,61,20,6,26,152,16,168
West Bengal,2004,Other Ipc Crimes,0,0,0,25,0,25,32,1,33,0,0,0,57,1,58
West Bengal,2005,Murder,0,0,0,503,18,521,913,4,917,211,16,227,1627,38,1665
West Bengal,2005,Attempt To Commit Murder,0,0,0,90,0,90,98,0,98,34,0,34,222,0,222
West Bengal,2005,C.H. Not Amounting To Murder,0,0,0,54,2,56,68,0,68,31,0,31,153,2,155
West Bengal,2005,Rape,0,0,0,80,0,80,30,0,30,2,0,2,112,0,112
West Bengal,2005,Kidnapping And Abduction,0,0,0,44,6,50,45,4,49,4,0,4,93,10,103
West Bengal,2005,Dacoity,0,0,0,40,0,40,47,0,47,19,0,19,106,0,106
West Bengal,2005,Prep. And Assembly For Dacoity,0,0,0,10,0,10,12,0,12,0,0,0,22,0,22
West Bengal,2005,Robbery,0,0,0,28,0,28,23,0,23,0,0,0,51,0,51
West Bengal,2005,Burglary,0,0,0,4,0,4,0,0,0,2,0,2,6,0,6
West Bengal,2005,Thefts,3,0,3,66,4,70,30,10,40,10,0,10,109,14,123
West Bengal,2005,Extortion,0,0,0,4,0,4,9,0,9,0,0,0,13,0,13
West Bengal,2005,Riots,0,0,0,12,0,12,0,0,0,0,0,0,12,0,12
West Bengal,2005,Arson,0,0,0,0,0,0,0,0,0,0,0,0,0,0,0
West Bengal,2005,Criminal Breach Of Trust,0,0,0,0,0,0,0,0,0,0,0,0,0,0,0
West Bengal,2005,Cheating,4,0,4,36,0,36,45,0,45,0,0,0,85,0,85
West Bengal,2005,Counter Feiting,0,0,0,0,0,0,0,0,0,0,0,0,0,0,0
West Bengal,2005,Dowry Deaths,0,0,0,42,14,56,25,1,26,12,0,12,79,15,94
West Bengal,2005,Molestation,0,0,0,0,0,0,0,0,0,0,0,0,0,0,0
West Bengal,2005,Eve-Teasing,0,0,0,0,0,0,0,0,0,0,0,0,0,0,0
West Bengal,2005,Cruelty By Husband Or Relative Of Husband,0,0,0,62,23,85,75,14,89,31,4,35,168,41,209
West Bengal,2005,Other Ipc Crimes,0,0,0,0,0,0,0,0,0,0,0,0,0,0,0
West Bengal,2006,Murder,0,0,0,374,19,393,1034,28,1062,235,19,254,1643,66,1709
West Bengal,2006,Attempt To Commit Murder,0,0,0,68,2,70,131,7,138,41,4,45,240,13,253
West Bengal,2006,C.H. Not Amounting To Murder,0,0,0,67,4,71,45,6,51,26,6,32,138,16,154
West Bengal,2006,Rape,0,0,0,103,0,103,91,0,91,19,0,19,213,0,213
West Bengal,2006,Kidnapping And Abduction,0,0,0,34,5,39,31,6,37,6,4,10,71,15,86
West Bengal,2006,Dacoity,0,0,0,55,1,56,81,2,83,11,0,11,147,3,150
West Bengal,2006,Prep. And Assembly For Dacoity,0,0,0,13,0,13,39,0,39,3,0,3,55,0,55
West Bengal,2006,Robbery,0,0,0,17,0,17,16,0,16,0,0,0,33,0,33
West Bengal,2006,Burglary,0,0,0,0,0,0,1,0,1,0,0,0,1,0,1
West Bengal,2006,Thefts,0,0,0,45,1,46,19,1,20,6,0,6,70,2,72
West Bengal,2006,Extortion,0,0,0,13,0,13,8,0,8,2,0,2,23,0,23
West Bengal,2006,Riots,0,0,0,0,0,0,0,0,0,0,0,0,0,0,0
West Bengal,2006,Arson,0,0,0,0,0,0,0,0,0,0,0,0,0,0,0
West Bengal,2006,Criminal Breach Of Trust,0,0,0,0,0,0,0,0,0,2,0,2,2,0,2
West Bengal,2006,Cheating,0,0,0,4,0,4,16,0,16,3,1,4,23,1,24
West Bengal,2006,Counter Feiting,0,0,0,1,0,1,3,0,3,0,0,0,4,0,4
West Bengal,2006,Dowry Deaths,0,0,0,35,4,39,90,10,100,22,4,26,147,18,165
West Bengal,2006,Molestation,0,0,0,0,0,0,1,0,1,0,0,0,1,0,1
West Bengal,2006,Eve-Teasing,0,0,0,0,0,0,0,0,0,0,0,0,0,0,0
West Bengal,2006,Cruelty By Husband Or Relative Of Husband,0,0,0,28,4,32,145,13,158,25,5,30,198,22,220
West Bengal,2006,Other Ipc Crimes,0,0,0,7,0,7,20,0,20,0,0,0,27,0,27
West Bengal,2007,Murder,0,0,0,310,18,328,1185,53,1238,358,19,377,1853,90,1943
West Bengal,2007,Attempt To Commit Murder,0,0,0,116,3,119,104,7,111,68,7,75,288,17,305
West Bengal,2007,C.H. Not Amounting To Murder,0,0,0,57,2,59,71,5,76,31,0,31,159,7,166
West Bengal,2007,Rape,0,0,0,120,0,120,102,0,102,22,0,22,244,0,244
West Bengal,2007,Kidnapping And Abduction,0,0,0,27,2,29,32,2,34,8,0,8,67,4,71
West Bengal,2007,Dacoity,0,0,0,69,0,69,81,0,81,11,0,11,161,0,161
West Bengal,2007,Prep. And Assembly For Dacoity,0,0,0,13,0,13,25,0,25,3,0,3,41,0,41
West Bengal,2007,Robbery,0,0,0,31,0,31,26,0,26,2,0,2,59,0,59
West Bengal,2007,Burglary,0,0,0,0,0,0,0,0,0,0,0,0,0,0,0
West Bengal,2007,Thefts,0,0,0,62,0,62,17,0,17,10,0,10,89,0,89
West Bengal,2007,Extortion,0,0,0,13,0,13,11,0,11,3,0,3,27,0,27
West Bengal,2007,Riots,0,0,0,0,0,0,0,0,0,0,0,0,0,0,0
West Bengal,2007,Arson,0,0,0,1,0,1,10,0,10,0,0,0,11,0,11
West Bengal,2007,Criminal Breach Of Trust,0,0,0,13,0,13,5,0,5,0,0,0,18,0,18
West Bengal,2007,Cheating,0,0,0,5,0,5,15,0,15,2,0,2,22,0,22
West Bengal,2007,Counter Feiting,0,0,0,2,0,2,2,0,2,0,0,0,4,0,4
West Bengal,2007,Dowry Deaths,1,1,2,25,12,37,47,4,51,35,4,39,108,21,129
West Bengal,2007,Molestation,0,0,0,0,0,0,0,0,0,0,0,0,0,0,0
West Bengal,2007,Eve-Teasing,0,0,0,0,0,0,0,0,0,0,0,0,0,0,0
West Bengal,2007,Cruelty By Husband Or Relative Of Husband,1,1,2,36,6,42,55,12,67,24,5,29,116,24,140
West Bengal,2007,Other Ipc Crimes,0,0,0,18,0,18,19,0,19,2,1,3,39,1,40
West Bengal,2008,Murder,0,0,0,345,6,351,1514,42,1556,440,29,469,2299,77,2376
West Bengal,2008,Attempt To Commit Murder,0,0,0,84,1,85,154,8,162,51,1,52,289,10,299
West Bengal,2008,C.H. Not Amounting To Murder,0,0,0,48,1,49,88,1,89,27,1,28,163,3,166
West Bengal,2008,Rape,0,0,0,137,0,137,134,2,136,36,0,36,307,2,309
West Bengal,2008,Kidnapping And Abduction,0,0,0,46,9,55,38,16,54,9,1,10,93,26,119
West Bengal,2008,Dacoity,0,0,0,76,2,78,134,0,134,12,0,12,222,2,224
West Bengal,2008,Prep. And Assembly For Dacoity,0,0,0,15,0,15,24,0,24,0,0,0,39,0,39
West Bengal,2008,Robbery,0,0,0,35,3,38,63,0,63,9,0,9,107,3,110
West Bengal,2008,Burglary,0,0,0,0,0,0,0,0,0,0,0,0,0,0,0
West Bengal,2008,Thefts,0,0,0,65,7,72,43,0,43,18,0,18,126,7,133
West Bengal,2008,Extortion,0,0,0,8,0,8,6,0,6,0,0,0,14,0,14
West Bengal,2008,Riots,0,0,0,0,0,0,0,0,0,0,0,0,0,0,0
West Bengal,2008,Arson,0,0,0,0,0,0,0,0,0,0,0,0,0,0,0
West Bengal,2008,Criminal Breach Of Trust,0,0,0,2,0,2,4,0,4,0,0,0,6,0,6
West Bengal,2008,Cheating,0,0,0,11,0,11,18,0,18,1,0,1,30,0,30
West Bengal,2008,Counter Feiting,0,0,0,2,0,2,5,1,6,1,1,2,8,2,10
West Bengal,2008,Dowry Deaths,0,0,0,32,6,38,54,14,68,15,12,27,101,32,133
West Bengal,2008,Molestation,0,0,0,0,0,0,0,0,0,0,0,0,0,0,0
West Bengal,2008,Eve-Teasing,0,0,0,0,0,0,0,0,0,0,0,0,0,0,0
West Bengal,2008,Cruelty By Husband Or Relative Of Husband,0,0,0,120,12,132,166,16,182,71,11,82,357,39,396
West Bengal,2008,Other Ipc Crimes,0,0,0,79,0,79,74,0,74,23,0,23,176,0,176
West Bengal,2009,Murder,0,0,0,428,21,449,1449,51,1500,482,35,517,2359,107,2466
West Bengal,2009,Attempt To Commit Murder,0,0,0,54,6,60,129,10,139,63,4,67,246,20,266
West Bengal,2009,C.H. Not Amounting To Murder,0,0,0,72,3,75,75,5,80,27,1,28,174,9,183
West Bengal,2009,Rape,0,0,0,131,0,131,163,0,163,63,0,63,357,0,357
West Bengal,2009,Kidnapping And Abduction,0,0,0,64,12,76,42,14,56,7,1,8,113,27,140
West Bengal,2009,Dacoity,0,0,0,53,2,55,85,1,86,13,0,13,151,3,154
West Bengal,2009,Prep. And Assembly For Dacoity,0,0,0,13,0,13,24,0,24,7,0,7,44,0,44
West Bengal,2009,Robbery,0,0,0,39,0,39,30,0,30,10,0,10,79,0,79
West Bengal,2009,Burglary,0,0,0,0,0,0,0,0,0,0,0,0,0,0,0
West Bengal,2009,Thefts,0,0,0,33,0,33,21,0,21,7,0,7,61,0,61
West Bengal,2009,Extortion,0,0,0,8,5,13,3,2,5,0,0,0,11,7,18
West Bengal,2009,Riots,0,0,0,2,0,2,8,0,8,0,0,0,10,0,10
West Bengal,2009,Arson,0,0,0,0,0,0,0,0,0,0,0,0,0,0,0
West Bengal,2009,Criminal Breach Of Trust,0,0,0,0,0,0,2,0,2,1,0,1,3,0,3
West Bengal,2009,Cheating,0,0,0,3,0,3,11,0,11,2,0,2,16,0,16
West Bengal,2009,Counter Feiting,0,0,0,0,0,0,4,1,5,1,1,2,5,2,7
West Bengal,2009,Dowry Deaths,0,0,0,45,6,51,36,9,45,16,4,20,97,19,116
West Bengal,2009,Molestation,0,0,0,0,0,0,0,0,0,0,0,0,0,0,0
West Bengal,2009,Eve-Teasing,0,0,0,0,0,0,0,0,0,0,0,0,0,0,0
West Bengal,2009,Cruelty By Husband Or Relative Of Husband,0,0,0,110,9,119,129,11,140,61,16,77,300,36,336
West Bengal,2009,Other Ipc Crimes,0,0,0,23,0,23,16,1,17,10,0,10,49,1,50
West Bengal,2010,Murder,0,0,0,404,12,416,1676,61,1737,582,36,618,2662,109,2771
West Bengal,2010,Attempt To Commit Murder,0,0,0,39,2,41,78,6,84,38,2,40,155,10,165
West Bengal,2010,C.H. Not Amounting To Murder,0,0,0,50,1,51,66,15,81,20,1,21,136,17,153
West Bengal,2010,Rape,0,0,0,162,0,162,81,0,81,18,0,18,261,0,261
West Bengal,2010,Kidnapping And Abduction,0,0,0,74,4,78,48,8,56,13,2,15,135,14,149
West Bengal,2010,Dacoity,0,0,0,53,2,55,99,10,109,14,3,17,166,15,181
West Bengal,2010,Prep. And Assembly For Dacoity,0,0,0,15,0,15,12,0,12,4,0,4,31,0,31
West Bengal,2010,Robbery,0,0,0,32,0,32,52,0,52,5,0,5,89,0,89
West Bengal,2010,Burglary,0,0,0,2,0,2,3,0,3,0,0,0,5,0,5
West Bengal,2010,Thefts,0,0,0,41,2,43,36,1,37,5,2,7,82,5,87
West Bengal,2010,Extortion,0,0,0,7,0,7,3,0,3,0,0,0,10,0,10
West Bengal,2010,Riots,0,0,0,3,0,3,5,0,5,0,0,0,8,0,8
West Bengal,2010,Arson,0,0,0,2,0,2,4,0,4,1,0,1,7,0,7
West Bengal,2010,Criminal Breach Of Trust,0,0,0,0,0,0,7,0,7,3,0,3,10,0,10
West Bengal,2010,Cheating,0,0,0,3,1,4,13,2,15,1,0,1,17,3,20
West Bengal,2010,Counter Feiting,0,0,0,0,0,0,0,0,0,1,0,1,1,0,1
West Bengal,2010,Dowry Deaths,0,0,0,34,5,39,43,14,57,18,23,41,95,42,137
West Bengal,2010,Molestation,0,0,0,0,0,0,0,0,0,0,0,0,0,0,0
West Bengal,2010,Eve-Teasing,0,0,0,4,0,4,0,0,0,0,0,0,4,0,4
West Bengal,2010,Cruelty By Husband Or Relative Of Husband,0,0,0,81,8,89,122,12,134,74,8,82,277,28,305
West Bengal,2010,Other Ipc Crimes,0,0,0,12,0,12,9,0,9,0,0,0,21,0,21
West Bengal,2011,Murder,0,0,0,678,21,699,1217,61,1278,543,43,586,2438,125,2563
West Bengal,2011,Attempt To Commit Murder,0,0,0,52,4,56,67,5,72,50,2,52,169,11,180
West Bengal,2011,C.H. Not Amounting To Murder,0,0,0,68,1,69,101,19,120,62,1,63,231,21,252
West Bengal,2011,Rape,0,0,0,117,0,117,132,0,132,33,0,33,282,0,282
West Bengal,2011,Kidnapping And Abduction,0,0,0,63,4,67,35,7,42,23,1,24,121,12,133
West Bengal,2011,Dacoity,0,0,0,73,0,73,78,7,85,38,3,41,189,10,199
West Bengal,2011,Prep. And Assembly For Dacoity,0,0,0,6,0,6,17,0,17,12,0,12,35,0,35
West Bengal,2011,Robbery,0,0,0,36,0,36,34,0,34,15,0,15,85,0,85
West Bengal,2011,Burglary,0,0,0,3,0,3,9,0,9,7,0,7,19,0,19
West Bengal,2011,Thefts,0,0,0,38,2,40,27,1,28,13,1,14,78,4,82
West Bengal,2011,Extortion,0,0,0,0,0,0,1,0,1,0,0,0,1,0,1
West Bengal,2011,Riots,0,0,0,13,0,13,66,0,66,0,0,0,79,0,79
West Bengal,2011,Arson,0,0,0,0,0,0,2,0,2,1,0,1,3,0,3
West Bengal,2011,Criminal Breach Of Trust,0,0,0,5,0,5,6,0,6,2,0,2,13,0,13
West Bengal,2011,Cheating,0,0,0,12,0,12,21,3,24,16,0,16,49,3,52
West Bengal,2011,Counter Feiting,0,0,0,2,0,2,3,0,3,1,0,1,6,0,6
West Bengal,2011,Dowry Deaths,0,0,0,48,5,53,57,26,83,41,31,72,146,62,208
West Bengal,2011,Molestation,0,0,0,1,0,1,5,0,5,2,0,2,8,0,8
West Bengal,2011,Eve-Teasing,0,0,0,0,0,0,0,0,0,0,0,0,0,0,0
West Bengal,2011,Cruelty By Husband Or Relative Of Husband,0,0,0,29,3,32,73,9,82,15,3,18,117,15,132
West Bengal,2011,Other Ipc Crimes,0,0,0,14,6,20,20,2,22,5,0,5,39,8,47
West Bengal,2012,Murder,0,0,0,693,38,731,1372,47,1419,465,44,509,2530,129,2659
West Bengal,2012,Attempt To Commit Murder,0,0,0,84,5,89,131,5,136,58,1,59,273,11,284
West Bengal,2012,C.H. Not Amounting To Murder,0,0,0,71,6,77,99,7,106,45,7,52,215,20,235
West Bengal,2012,Rape,0,0,0,181,1,182,127,0,127,26,1,27,334,2,336
West Bengal,2012,Kidnapping And Abduction,0,0,0,53,11,64,69,13,82,22,5,27,144,29,173
West Bengal,2012,Dacoity,0,0,0,71,1,72,101,0,101,14,0,14,186,1,187
West Bengal,2012,Prep. And Assembly For Dacoity,0,0,0,11,0,11,14,0,14,1,0,1,26,0,26
West Bengal,2012,Robbery,0,0,0,33,0,33,27,0,27,7,1,8,67,1,68
West Bengal,2012,Burglary,0,0,0,10,0,10,8,0,8,3,1,4,21,1,22
West Bengal,2012,Thefts,0,0,0,38,1,39,33,0,33,4,1,5,75,2,77
West Bengal,2012,Extortion,0,0,0,1,0,1,1,0,1,2,0,2,4,0,4
West Bengal,2012,Riots,0,0,0,21,0,21,3,0,3,1,0,1,25,0,25
West Bengal,2012,Arson,0,0,0,5,0,5,8,0,8,3,0,3,16,0,16
West Bengal,2012,Criminal Breach Of Trust,0,0,0,2,0,2,6,0,6,2,0,2,10,0,10
West Bengal,2012,Cheating,0,0,0,8,2,10,8,2,10,5,0,5,21,4,25
West Bengal,2012,Counter Feiting,0,0,0,57,1,58,47,0,47,1,0,1,105,1,106
West Bengal,2012,Dowry Deaths,0,0,0,27,7,34,34,21,55,30,29,59,91,57,148
West Bengal,2012,Molestation,0,0,0,0,0,0,0,0,0,0,0,0,0,0,0
West Bengal,2012,Eve-Teasing,0,0,0,0,0,0,0,0,0,0,0,0,0,0,0
West Bengal,2012,Cruelty By Husband Or Relative Of Husband,0,0,0,27,13,40,25,12,37,7,17,24,59,42,101
West Bengal,2012,Other Ipc Crimes,0,0,0,66,2,68,64,1,65,4,0,4,134,3,137
A & N Islands,2001,Murder,0,0,0,12,0,12,19,2,21,3,0,3,34,2,36
A & N Islands,2001,Attempt To Commit Murder,0,0,0,1,0,1,3,1,4,0,0,0,4,1,5
A & N Islands,2001,C.H. Not Amounting To Murder,0,0,0,1,0,1,1,0,1,0,0,0,2,0,2
A & N Islands,2001,Rape,0,0,0,0,0,0,0,0,0,0,0,0,0,0,0
A & N Islands,2001,Kidnapping And Abduction,0,0,0,1,0,1,2,0,2,0,0,0,3,0,3
A & N Islands,2001,Dacoity,0,0,0,0,0,0,0,0,0,0,0,0,0,0,0
A & N Islands,2001,Prep. And Assembly For Dacoity,0,0,0,0,0,0,0,0,0,0,0,0,0,0,0
A & N Islands,2001,Robbery,0,0,0,0,0,0,0,0,0,0,0,0,0,0,0
A & N Islands,2001,Burglary,0,0,0,0,0,0,0,0,0,0,0,0,0,0,0
A & N Islands,2001,Thefts,0,0,0,0,0,0,0,0,0,0,0,0,0,0,0
A & N Islands,2001,Extortion,0,0,0,0,0,0,0,0,0,0,0,0,0,0,0
A & N Islands,2001,Riots,0,0,0,1,0,1,6,0,6,0,0,0,7,0,7
A & N Islands,2001,Arson,0,0,0,0,0,0,0,0,0,0,0,0,0,0,0
A & N Islands,2001,Criminal Breach Of Trust,0,0,0,0,0,0,0,0,0,0,0,0,0,0,0
A & N Islands,2001,Cheating,0,0,0,0,0,0,0,0,0,0,0,0,0,0,0
A & N Islands,2001,Counter Feiting,0,0,0,0,0,0,0,0,0,0,0,0,0,0,0
A & N Islands,2001,Dowry Deaths,0,0,0,0,0,0,0,0,0,0,0,0,0,0,0
A & N Islands,2001,Molestation,0,0,0,0,0,0,0,0,0,0,0,0,0,0,0
A & N Islands,2001,Eve-Teasing,0,0,0,0,0,0,0,0,0,0,0,0,0,0,0
A & N Islands,2001,Cruelty By Husband Or Relative Of Husband,0,0,0,0,0,0,0,0,0,0,0,0,0,0,0
A & N Islands,2001,Other Ipc Crimes,0,0,0,2,0,2,7,0,7,2,0,2,11,0,11
A & N Islands,2002,Murder,0,0,0,12,0,12,17,2,19,3,0,3,32,2,34
A & N Islands,2002,Attempt To Commit Murder,0,0,0,1,0,1,3,1,4,0,0,0,4,1,5
A & N Islands,2002,C.H. Not Amounting To Murder,0,0,0,1,0,1,1,0,1,0,0,0,2,0,2
A & N Islands,2002,Rape,0,0,0,1,0,1,2,0,2,0,0,0,3,0,3
A & N Islands,2002,Kidnapping And Abduction,0,0,0,0,0,0,0,0,0,0,0,0,0,0,0
A & N Islands,2002,Dacoity,0,0,0,0,0,0,0,0,0,0,0,0,0,0,0
A & N Islands,2002,Prep. And Assembly For Dacoity,0,0,0,0,0,0,0,0,0,0,0,0,0,0,0
A & N Islands,2002,Robbery,0,0,0,0,0,0,0,0,0,0,0,0,0,0,0
A & N Islands,2002,Burglary,0,0,0,0,0,0,0,0,0,0,0,0,0,0,0
A & N Islands,2002,Thefts,0,0,0,0,0,0,0,0,0,0,0,0,0,0,0
A & N Islands,2002,Extortion,0,0,0,0,0,0,0,0,0,0,0,0,0,0,0
A & N Islands,2002,Riots,0,0,0,4,0,4,4,0,4,0,0,0,8,0,8
A & N Islands,2002,Arson,0,0,0,0,0,0,0,0,0,0,0,0,0,0,0
A & N Islands,2002,Criminal Breach Of Trust,0,0,0,0,0,0,0,0,0,0,0,0,0,0,0
A & N Islands,2002,Cheating,0,0,0,0,0,0,0,0,0,0,0,0,0,0,0
A & N Islands,2002,Counter Feiting,0,0,0,0,0,0,0,0,0,0,0,0,0,0,0
A & N Islands,2002,Dowry Deaths,0,0,0,0,0,0,0,0,0,0,0,0,0,0,0
A & N Islands,2002,Molestation,0,0,0,0,0,0,0,0,0,0,0,0,0,0,0
A & N Islands,2002,Eve-Teasing,0,0,0,0,0,0,0,0,0,0,0,0,0,0,0
A & N Islands,2002,Cruelty By Husband Or Relative Of Husband,0,0,0,0,0,0,0,0,0,0,0,0,0,0,0
A & N Islands,2002,Other Ipc Crimes,0,0,0,5,0,5,9,0,9,2,1,3,16,1,17
A & N Islands,2003,Murder,0,0,0,13,2,15,16,0,16,1,0,1,30,2,32
A & N Islands,2003,Attempt To Commit Murder,0,0,0,1,0,1,2,0,2,0,0,0,3,0,3
A & N Islands,2003,C.H. Not Amounting To Murder,0,0,0,5,0,5,2,0,2,0,0,0,7,0,7
A & N Islands,2003,Rape,0,0,0,0,0,0,3,0,3,0,0,0,3,0,3
A & N Islands,2003,Kidnapping And Abduction,0,0,0,0,0,0,0,0,0,0,0,0,0,0,0
A & N Islands,2003,Dacoity,0,0,0,0,0,0,0,0,0,0,0,0,0,0,0
A & N Islands,2003,Prep. And Assembly For Dacoity,0,0,0,0,0,0,0,0,0,0,0,0,0,0,0
A & N Islands,2003,Robbery,0,0,0,0,0,0,0,0,0,0,0,0,0,0,0
A & N Islands,2003,Burglary,0,0,0,0,0,0,0,0,0,0,0,0,0,0,0
A & N Islands,2003,Thefts,0,0,0,6,0,6,0,0,0,0,0,0,6,0,6
A & N Islands,2003,Extortion,0,0,0,0,0,0,0,0,0,0,0,0,0,0,0
A & N Islands,2003,Riots,0,0,0,0,0,0,0,0,0,0,0,0,0,0,0
A & N Islands,2003,Arson,0,0,0,0,0,0,0,0,0,0,0,0,0,0,0
A & N Islands,2003,Criminal Breach Of Trust,0,0,0,0,0,0,0,0,0,0,0,0,0,0,0
A & N Islands,2003,Cheating,0,0,0,0,0,0,0,0,0,0,0,0,0,0,0
A & N Islands,2003,Counter Feiting,0,0,0,0,0,0,0,0,0,0,0,0,0,0,0
A & N Islands,2003,Dowry Deaths,0,0,0,0,0,0,0,0,0,0,0,0,0,0,0
A & N Islands,2003,Molestation,0,0,0,0,0,0,0,0,0,0,0,0,0,0,0
A & N Islands,2003,Eve-Teasing,0,0,0,0,0,0,0,0,0,0,0,0,0,0,0
A & N Islands,2003,Cruelty By Husband Or Relative Of Husband,0,0,0,0,0,0,0,0,0,0,0,0,0,0,0
A & N Islands,2003,Other Ipc Crimes,0,0,0,12,0,12,6,0,6,1,0,1,19,0,19
A & N Islands,2004,Murder,0,0,0,13,2,15,17,0,17,0,0,0,30,2,32
A & N Islands,2004,Attempt To Commit Murder,0,0,0,3,0,3,1,0,1,0,0,0,4,0,4
A & N Islands,2004,C.H. Not Amounting To Murder,0,0,0,0,0,0,1,0,1,0,0,0,1,0,1
A & N Islands,2004,Rape,0,0,0,2,0,2,2,0,2,0,0,0,4,0,4
A & N Islands,2004,Kidnapping And Abduction,0,0,0,0,0,0,0,0,0,0,0,0,0,0,0
A & N Islands,2004,Dacoity,0,0,0,0,0,0,0,0,0,0,0,0,0,0,0
A & N Islands,2004,Prep. And Assembly For Dacoity,0,0,0,0,0,0,0,0,0,0,0,0,0,0,0
A & N Islands,2004,Robbery,0,0,0,0,0,0,0,0,0,0,0,0,0,0,0
A & N Islands,2004,Burglary,0,0,0,0,0,0,0,0,0,0,0,0,0,0,0
A & N Islands,2004,Thefts,0,0,0,5,0,5,0,0,0,0,0,0,5,0,5
A & N Islands,2004,Extortion,0,0,0,0,0,0,0,0,0,0,0,0,0,0,0
A & N Islands,2004,Riots,0,0,0,0,0,0,0,0,0,0,0,0,0,0,0
A & N Islands,2004,Arson,0,0,0,0,0,0,0,0,0,0,0,0,0,0,0
A & N Islands,2004,Criminal Breach Of Trust,0,0,0,0,0,0,0,0,0,0,0,0,0,0,0
A & N Islands,2004,Cheating,0,0,0,0,0,0,1,0,1,0,0,0,1,0,1
A & N Islands,2004,Counter Feiting,0,0,0,0,0,0,0,0,0,0,0,0,0,0,0
A & N Islands,2004,Dowry Deaths,0,0,0,0,0,0,0,0,0,0,0,0,0,0,0
A & N Islands,2004,Molestation,0,0,0,0,0,0,0,0,0,0,0,0,0,0,0
A & N Islands,2004,Eve-Teasing,0,0,0,0,0,0,0,0,0,0,0,0,0,0,0
A & N Islands,2004,Cruelty By Husband Or Relative Of Husband,0,0,0,0,0,0,0,0,0,0,0,0,0,0,0
A & N Islands,2004,Other Ipc Crimes,0,0,0,5,0,5,4,0,4,0,0,0,9,0,9
A & N Islands,2005,Murder,0,0,0,3,0,3,17,1,18,5,0,5,25,1,26
A & N Islands,2005,Attempt To Commit Murder,0,0,0,1,0,1,3,0,3,1,0,1,5,0,5
A & N Islands,2005,C.H. Not Amounting To Murder,0,0,0,0,0,0,1,0,1,0,0,0,1,0,1
A & N Islands,2005,Rape,0,0,0,0,0,0,2,0,2,1,0,1,3,0,3
A & N Islands,2005,Kidnapping And Abduction,0,0,0,0,0,0,0,0,0,0,0,0,0,0,0
A & N Islands,2005,Dacoity,0,0,0,0,0,0,0,0,0,0,0,0,0,0,0
A & N Islands,2005,Prep. And Assembly For Dacoity,0,0,0,0,0,0,0,0,0,0,0,0,0,0,0
A & N Islands,2005,Robbery,0,0,0,0,0,0,1,0,1,0,0,0,1,0,1
A & N Islands,2005,Burglary,0,0,0,2,0,2,3,0,3,0,0,0,5,0,5
A & N Islands,2005,Thefts,0,0,0,0,0,0,0,0,0,0,0,0,0,0,0
A & N Islands,2005,Extortion,0,0,0,0,0,0,0,0,0,0,0,0,0,0,0
A & N Islands,2005,Riots,0,0,0,0,0,0,0,0,0,0,0,0,0,0,0
A & N Islands,2005,Arson,0,0,0,0,0,0,0,0,0,0,0,0,0,0,0
A & N Islands,2005,Criminal Breach Of Trust,0,0,0,0,0,0,0,0,0,0,0,0,0,0,0
A & N Islands,2005,Cheating,0,0,0,0,0,0,0,0,0,0,0,0,0,0,0
A & N Islands,2005,Counter Feiting,0,0,0,0,0,0,0,0,0,0,0,0,0,0,0
A & N Islands,2005,Dowry Deaths,0,0,0,0,0,0,0,0,0,0,0,0,0,0,0
A & N Islands,2005,Molestation,0,0,0,0,0,0,0,0,0,0,0,0,0,0,0
A & N Islands,2005,Eve-Teasing,0,0,0,0,0,0,0,0,0,0,0,0,0,0,0
A & N Islands,2005,Cruelty By Husband Or Relative Of Husband,0,0,0,0,0,0,0,0,0,0,0,0,0,0,0
A & N Islands,2005,Other Ipc Crimes,0,0,0,0,0,0,0,0,0,0,0,0,0,0,0
A & N Islands,2006,Murder,0,0,0,3,0,3,19,1,20,3,0,3,25,1,26
A & N Islands,2006,Attempt To Commit Murder,0,0,0,1,0,1,3,0,3,1,0,1,5,0,5
A & N Islands,2006,C.H. Not Amounting To Murder,0,0,0,0,0,0,0,0,0,0,0,0,0,0,0
A & N Islands,2006,Rape,0,0,0,0,0,0,3,0,3,1,0,1,4,0,4
A & N Islands,2006,Kidnapping And Abduction,0,0,0,0,0,0,0,0,0,0,0,0,0,0,0
A & N Islands,2006,Dacoity,0,0,0,0,0,0,0,0,0,0,0,0,0,0,0
A & N Islands,2006,Prep. And Assembly For Dacoity,0,0,0,0,0,0,0,0,0,0,0,0,0,0,0
A & N Islands,2006,Robbery,0,0,0,0,0,0,1,0,1,0,0,0,1,0,1
A & N Islands,2006,Burglary,0,0,0,2,0,2,2,0,2,0,0,0,4,0,4
A & N Islands,2006,Thefts,0,0,0,0,0,0,2,0,2,0,0,0,2,0,2
A & N Islands,2006,Extortion,0,0,0,0,0,0,0,0,0,0,0,0,0,0,0
A & N Islands,2006,Riots,0,0,0,0,0,0,0,0,0,0,0,0,0,0,0
A & N Islands,2006,Arson,0,0,0,0,0,0,0,0,0,0,0,0,0,0,0
A & N Islands,2006,Criminal Breach Of Trust,0,0,0,0,0,0,0,0,0,0,0,0,0,0,0
A & N Islands,2006,Cheating,0,0,0,0,0,0,0,0,0,0,0,0,0,0,0
A & N Islands,2006,Counter Feiting,0,0,0,0,0,0,0,0,0,0,0,0,0,0,0
A & N Islands,2006,Dowry Deaths,0,0,0,0,0,0,0,0,0,0,0,0,0,0,0
A & N Islands,2006,Molestation,0,0,0,0,0,0,0,0,0,0,0,0,0,0,0
A & N Islands,2006,Eve-Teasing,0,0,0,0,0,0,0,0,0,0,0,0,0,0,0
A & N Islands,2006,Cruelty By Husband Or Relative Of Husband,0,0,0,0,0,0,0,0,0,0,0,0,0,0,0
A & N Islands,2006,Other Ipc Crimes,0,0,0,0,0,0,0,0,0,0,0,0,0,0,0
A & N Islands,2007,Murder,0,0,0,6,0,6,20,1,21,2,0,2,28,1,29
A & N Islands,2007,Attempt To Commit Murder,0,0,0,1,0,1,2,0,2,0,0,0,3,0,3
A & N Islands,2007,C.H. Not Amounting To Murder,0,0,0,0,0,0,0,0,0,0,0,0,0,0,0
A & N Islands,2007,Rape,0,0,0,0,0,0,2,0,2,1,0,1,3,0,3
A & N Islands,2007,Kidnapping And Abduction,0,0,0,0,0,0,0,0,0,0,0,0,0,0,0
A & N Islands,2007,Dacoity,0,0,0,0,0,0,2,0,2,0,0,0,2,0,2
A & N Islands,2007,Prep. And Assembly For Dacoity,0,0,0,0,0,0,0,0,0,0,0,0,0,0,0
A & N Islands,2007,Robbery,0,0,0,0,0,0,0,0,0,0,0,0,0,0,0
A & N Islands,2007,Burglary,0,0,0,2,0,2,1,0,1,0,0,0,3,0,3
A & N Islands,2007,Thefts,0,0,0,1,0,1,4,0,4,0,0,0,5,0,5
A & N Islands,2007,Extortion,0,0,0,0,0,0,0,0,0,0,0,0,0,0,0
A & N Islands,2007,Riots,0,0,0,0,0,0,0,0,0,0,0,0,0,0,0
A & N Islands,2007,Arson,0,0,0,0,0,0,0,0,0,0,0,0,0,0,0
A & N Islands,2007,Criminal Breach Of Trust,0,0,0,0,0,0,0,0,0,0,0,0,0,0,0
A & N Islands,2007,Cheating,0,0,0,0,0,0,0,0,0,0,0,0,0,0,0
A & N Islands,2007,Counter Feiting,0,0,0,0,0,0,0,0,0,0,0,0,0,0,0
A & N Islands,2007,Dowry Deaths,0,0,0,0,0,0,0,0,0,0,0,0,0,0,0
A & N Islands,2007,Molestation,0,0,0,0,0,0,0,0,0,0,0,0,0,0,0
A & N Islands,2007,Eve-Teasing,0,0,0,0,0,0,0,0,0,0,0,0,0,0,0
A & N Islands,2007,Cruelty By Husband Or Relative Of Husband,0,0,0,0,0,0,0,0,0,0,0,0,0,0,0
A & N Islands,2007,Other Ipc Crimes,0,0,0,6,0,6,9,0,9,0,0,0,15,0,15
A & N Islands,2008,Murder,0,0,0,1,0,1,25,0,25,5,0,5,31,0,31
A & N Islands,2008,Attempt To Commit Murder,0,0,0,0,0,0,1,0,1,0,0,0,1,0,1
A & N Islands,2008,C.H. Not Amounting To Murder,0,0,0,0,0,0,1,0,1,0,0,0,1,0,1
A & N Islands,2008,Rape,0,0,0,0,0,0,3,0,3,2,0,2,5,0,5
A & N Islands,2008,Kidnapping And Abduction,0,0,0,0,0,0,0,0,0,0,0,0,0,0,0
A & N Islands,2008,Dacoity,0,0,0,2,0,2,0,0,0,0,0,0,2,0,2
A & N Islands,2008,Prep. And Assembly For Dacoity,0,0,0,0,0,0,0,0,0,0,0,0,0,0,0
A & N Islands,2008,Robbery,0,0,0,1,0,1,0,0,0,0,0,0,1,0,1
A & N Islands,2008,Burglary,0,0,0,0,0,0,0,0,0,0,0,0,0,0,0
A & N Islands,2008,Thefts,0,0,0,1,0,1,2,0,2,0,0,0,3,0,3
A & N Islands,2008,Extortion,0,0,0,0,0,0,0,0,0,0,0,0,0,0,0
A & N Islands,2008,Riots,0,0,0,0,0,0,0,0,0,0,0,0,0,0,0
A & N Islands,2008,Arson,0,0,0,0,0,0,0,0,0,0,0,0,0,0,0
A & N Islands,2008,Criminal Breach Of Trust,0,0,0,0,0,0,0,0,0,0,0,0,0,0,0
A & N Islands,2008,Cheating,0,0,0,0,0,0,0,0,0,0,0,0,0,0,0
A & N Islands,2008,Counter Feiting,0,0,0,0,0,0,0,0,0,0,0,0,0,0,0
A & N Islands,2008,Dowry Deaths,0,0,0,0,0,0,0,0,0,0,0,0,0,0,0
A & N Islands,2008,Molestation,0,0,0,0,0,0,0,0,0,0,0,0,0,0,0
A & N Islands,2008,Eve-Teasing,0,0,0,0,0,0,0,0,0,0,0,0,0,0,0
A & N Islands,2008,Cruelty By Husband Or Relative Of Husband,0,0,0,0,0,0,0,0,0,0,0,0,0,0,0
A & N Islands,2008,Other Ipc Crimes,0,0,0,1,0,1,2,0,2,0,0,0,3,0,3
A & N Islands,2009,Murder,0,0,0,2,0,2,22,0,22,5,0,5,29,0,29
A & N Islands,2009,Attempt To Commit Murder,0,0,0,0,0,0,2,0,2,1,0,1,3,0,3
A & N Islands,2009,C.H. Not Amounting To Murder,0,0,0,0,0,0,2,0,2,0,0,0,2,0,2
A & N Islands,2009,Rape,0,0,0,0,0,0,3,0,3,1,0,1,4,0,4
A & N Islands,2009,Kidnapping And Abduction,0,0,0,0,0,0,0,0,0,0,0,0,0,0,0
A & N Islands,2009,Dacoity,0,0,0,0,0,0,0,0,0,0,0,0,0,0,0
A & N Islands,2009,Prep. And Assembly For Dacoity,0,0,0,0,0,0,0,0,0,0,0,0,0,0,0
A & N Islands,2009,Robbery,0,0,0,1,0,1,0,0,0,0,0,0,1,0,1
A & N Islands,2009,Burglary,0,0,0,0,0,0,0,0,0,0,0,0,0,0,0
A & N Islands,2009,Thefts,0,0,0,1,0,1,1,0,1,0,0,0,2,0,2
A & N Islands,2009,Extortion,0,0,0,0,0,0,0,0,0,0,0,0,0,0,0
A & N Islands,2009,Riots,0,0,0,0,0,0,0,0,0,0,0,0,0,0,0
A & N Islands,2009,Arson,0,0,0,0,0,0,0,0,0,0,0,0,0,0,0
A & N Islands,2009,Criminal Breach Of Trust,0,0,0,0,0,0,0,0,0,0,0,0,0,0,0
A & N Islands,2009,Cheating,0,0,0,0,0,0,0,0,0,0,0,0,0,0,0
A & N Islands,2009,Counter Feiting,0,0,0,0,0,0,0,0,0,0,0,0,0,0,0
A & N Islands,2009,Dowry Deaths,0,0,0,0,0,0,0,0,0,0,0,0,0,0,0
A & N Islands,2009,Molestation,0,0,0,0,0,0,0,0,0,0,0,0,0,0,0
A & N Islands,2009,Eve-Teasing,0,0,0,0,0,0,0,0,0,0,0,0,0,0,0
A & N Islands,2009,Cruelty By Husband Or Relative Of Husband,0,0,0,0,0,0,0,0,0,0,0,0,0,0,0
A & N Islands,2009,Other Ipc Crimes,0,0,0,1,0,1,0,0,0,0,0,0,1,0,1
A & N Islands,2010,Murder,0,0,0,0,0,0,22,0,22,7,0,7,29,0,29
A & N Islands,2010,Attempt To Commit Murder,0,0,0,2,0,2,0,0,0,0,0,0,2,0,2
A & N Islands,2010,C.H. Not Amounting To Murder,0,0,0,0,0,0,0,0,0,0,0,0,0,0,0
A & N Islands,2010,Rape,0,0,0,3,0,3,0,0,0,2,0,2,5,0,5
A & N Islands,2010,Kidnapping And Abduction,0,0,0,0,0,0,0,0,0,0,0,0,0,0,0
A & N Islands,2010,Dacoity,0,0,0,0,0,0,2,0,2,0,0,0,2,0,2
A & N Islands,2010,Prep. And Assembly For Dacoity,0,0,0,0,0,0,0,0,0,0,0,0,0,0,0
A & N Islands,2010,Robbery,0,0,0,0,0,0,0,0,0,0,0,0,0,0,0
A & N Islands,2010,Burglary,0,0,0,0,0,0,0,0,0,0,0,0,0,0,0
A & N Islands,2010,Thefts,0,0,0,1,0,1,2,0,2,2,0,2,5,0,5
A & N Islands,2010,Extortion,0,0,0,0,0,0,0,0,0,0,0,0,0,0,0
A & N Islands,2010,Riots,0,0,0,0,0,0,0,0,0,0,0,0,0,0,0
A & N Islands,2010,Arson,0,0,0,0,0,0,0,0,0,0,0,0,0,0,0
A & N Islands,2010,Criminal Breach Of Trust,0,0,0,0,0,0,0,0,0,0,0,0,0,0,0
A & N Islands,2010,Cheating,0,0,0,0,0,0,0,0,0,0,0,0,0,0,0
A & N Islands,2010,Counter Feiting,0,0,0,0,0,0,0,0,0,0,0,0,0,0,0
A & N Islands,2010,Dowry Deaths,0,0,0,0,0,0,0,0,0,0,0,0,0,0,0
A & N Islands,2010,Molestation,0,0,0,0,0,0,0,0,0,0,0,0,0,0,0
A & N Islands,2010,Eve-Teasing,0,0,0,0,0,0,0,0,0,0,0,0,0,0,0
A & N Islands,2010,Cruelty By Husband Or Relative Of Husband,0,0,0,0,0,0,0,0,0,0,0,0,0,0,0
A & N Islands,2010,Other Ipc Crimes,0,0,0,1,0,1,13,0,13,0,0,0,14,0,14
A & N Islands,2011,Murder,0,0,0,2,0,2,19,0,19,6,0,6,27,0,27
A & N Islands,2011,Attempt To Commit Murder,0,0,0,1,0,1,1,0,1,0,0,0,2,0,2
A & N Islands,2011,C.H. Not Amounting To Murder,0,0,0,0,0,0,4,0,4,0,0,0,4,0,4
A & N Islands,2011,Rape,0,0,0,1,0,1,4,0,4,2,0,2,7,0,7
A & N Islands,2011,Kidnapping And Abduction,0,0,0,0,0,0,0,0,0,0,0,0,0,0,0
A & N Islands,2011,Dacoity,0,0,0,0,0,0,0,0,0,0,0,0,0,0,0
A & N Islands,2011,Prep. And Assembly For Dacoity,0,0,0,0,0,0,0,0,0,0,0,0,0,0,0
A & N Islands,2011,Robbery,0,0,0,0,0,0,0,0,0,0,0,0,0,0,0
A & N Islands,2011,Burglary,0,0,0,0,0,0,0,0,0,0,0,0,0,0,0
A & N Islands,2011,Thefts,0,0,0,1,0,1,0,0,0,1,0,1,2,0,2
A & N Islands,2011,Extortion,0,0,0,0,0,0,0,0,0,0,0,0,0,0,0
A & N Islands,2011,Riots,0,0,0,0,0,0,0,0,0,0,0,0,0,0,0
A & N Islands,2011,Arson,0,0,0,0,0,0,0,0,0,0,0,0,0,0,0
A & N Islands,2011,Criminal Breach Of Trust,0,0,0,0,0,0,0,0,0,0,0,0,0,0,0
A & N Islands,2011,Cheating,0,0,0,0,0,0,0,0,0,0,0,0,0,0,0
A & N Islands,2011,Counter Feiting,0,0,0,0,0,0,0,0,0,0,0,0,0,0,0
A & N Islands,2011,Dowry Deaths,0,0,0,0,0,0,0,0,0,0,0,0,0,0,0
A & N Islands,2011,Molestation,0,0,0,0,0,0,0,0,0,0,0,0,0,0,0
A & N Islands,2011,Eve-Teasing,0,0,0,0,0,0,0,0,0,0,0,0,0,0,0
A & N Islands,2011,Cruelty By Husband Or Relative Of Husband,0,0,0,0,0,0,0,0,0,0,0,0,0,0,0
A & N Islands,2011,Other Ipc Crimes,0,0,0,1,0,1,6,0,6,9,0,9,16,0,16
A & N Islands,2012,Murder,0,0,0,6,0,6,15,0,15,8,0,8,29,0,29
A & N Islands,2012,Attempt To Commit Murder,0,0,0,0,0,0,1,0,1,0,0,0,1,0,1
A & N Islands,2012,C.H. Not Amounting To Murder,0,0,0,0,0,0,5,0,5,0,0,0,5,0,5
A & N Islands,2012,Rape,0,0,0,1,0,1,2,0,2,1,0,1,4,0,4
A & N Islands,2012,Kidnapping And Abduction,0,0,0,0,0,0,0,0,0,0,0,0,0,0,0
A & N Islands,2012,Dacoity,0,0,0,0,0,0,0,0,0,0,0,0,0,0,0
A & N Islands,2012,Prep. And Assembly For Dacoity,0,0,0,0,0,0,0,0,0,0,0,0,0,0,0
A & N Islands,2012,Robbery,0,0,0,0,0,0,0,0,0,0,0,0,0,0,0
A & N Islands,2012,Burglary,0,0,0,0,0,0,0,0,0,0,0,0,0,0,0
A & N Islands,2012,Thefts,0,0,0,0,0,0,1,0,1,1,0,1,2,0,2
A & N Islands,2012,Extortion,0,0,0,0,0,0,0,0,0,0,0,0,0,0,0
A & N Islands,2012,Riots,0,0,0,0,0,0,0,0,0,0,0,0,0,0,0
A & N Islands,2012,Arson,0,0,0,0,0,0,0,0,0,0,0,0,0,0,0
A & N Islands,2012,Criminal Breach Of Trust,0,0,0,0,0,0,0,0,0,0,0,0,0,0,0
A & N Islands,2012,Cheating,0,0,0,0,0,0,0,0,0,0,0,0,0,0,0
A & N Islands,2012,Counter Feiting,0,0,0,0,0,0,0,0,0,0,0,0,0,0,0
A & N Islands,2012,Dowry Deaths,0,0,0,0,0,0,0,0,0,0,0,0,0,0,0
A & N Islands,2012,Molestation,0,0,0,0,0,0,0,0,0,0,0,0,0,0,0
A & N Islands,2012,Eve-Teasing,0,0,0,0,0,0,0,0,0,0,0,0,0,0,0
A & N Islands,2012,Cruelty By Husband Or Relative Of Husband,0,0,0,0,0,0,0,0,0,0,0,0,0,0,0
A & N Islands,2012,Other Ipc Crimes,0,0,0,1,0,1,1,0,1,12,0,12,14,0,14
Chandigarh,2001,Murder,0,0,0,12,1,13,20,2,22,2,0,2,34,3,37
Chandigarh,2001,Attempt To Commit Murder,2,0,2,3,0,3,14,0,14,1,0,1,20,0,20
Chandigarh,2001,C.H. Not Amounting To Murder,0,0,0,0,0,0,0,0,0,0,0,0,0,0,0
Chandigarh,2001,Rape,0,0,0,2,0,2,4,0,4,0,0,0,6,0,6
Chandigarh,2001,Kidnapping And Abduction,0,0,0,1,0,1,0,0,0,0,0,0,1,0,1
Chandigarh,2001,Dacoity,0,0,0,0,0,0,0,0,0,0,0,0,0,0,0
Chandigarh,2001,Prep. And Assembly For Dacoity,0,0,0,0,0,0,3,0,3,0,0,0,3,0,3
Chandigarh,2001,Robbery,0,0,0,0,0,0,0,0,0,0,0,0,0,0,0
Chandigarh,2001,Burglary,0,0,0,0,0,0,0,0,0,0,0,0,0,0,0
Chandigarh,2001,Thefts,0,0,0,4,1,5,5,0,5,2,0,2,11,1,12
Chandigarh,2001,Extortion,0,0,0,0,0,0,0,0,0,0,0,0,0,0,0
Chandigarh,2001,Riots,0,0,0,0,0,0,0,0,0,0,0,0,0,0,0
Chandigarh,2001,Arson,0,0,0,0,0,0,0,0,0,0,0,0,0,0,0
Chandigarh,2001,Criminal Breach Of Trust,0,0,0,0,0,0,2,0,2,0,0,0,2,0,2
Chandigarh,2001,Cheating,0,0,0,0,0,0,1,0,1,0,0,0,1,0,1
Chandigarh,2001,Counter Feiting,0,0,0,0,0,0,0,0,0,0,0,0,0,0,0
Chandigarh,2001,Dowry Deaths,0,0,0,2,0,2,1,2,3,1,0,1,4,2,6
Chandigarh,2001,Molestation,0,0,0,0,0,0,0,0,0,0,0,0,0,0,0
Chandigarh,2001,Eve-Teasing,0,0,0,0,0,0,0,0,0,0,0,0,0,0,0
Chandigarh,2001,Cruelty By Husband Or Relative Of Husband,0,0,0,0,0,0,0,0,0,0,0,0,0,0,0
Chandigarh,2001,Other Ipc Crimes,0,0,0,0,0,0,0,0,0,0,0,0,0,0,0
Chandigarh,2002,Murder,0,0,0,18,1,19,26,3,29,6,1,7,50,5,55
Chandigarh,2002,Attempt To Commit Murder,0,0,0,3,1,4,2,0,2,3,0,3,8,1,9
Chandigarh,2002,C.H. Not Amounting To Murder,0,0,0,0,0,0,1,0,1,0,0,0,1,0,1
Chandigarh,2002,Rape,0,0,0,2,0,2,5,0,5,0,0,0,7,0,7
Chandigarh,2002,Kidnapping And Abduction,0,0,0,0,0,0,1,0,1,0,0,0,1,0,1
Chandigarh,2002,Dacoity,0,0,0,0,0,0,2,0,2,0,0,0,2,0,2
Chandigarh,2002,Prep. And Assembly For Dacoity,0,0,0,0,0,0,0,0,0,0,0,0,0,0,0
Chandigarh,2002,Robbery,0,0,0,1,0,1,0,0,0,0,0,0,1,0,1
Chandigarh,2002,Burglary,0,0,0,0,0,0,0,0,0,1,0,1,1,0,1
Chandigarh,2002,Thefts,0,0,0,2,0,2,4,0,4,0,0,0,6,0,6
Chandigarh,2002,Extortion,0,0,0,0,0,0,0,0,0,0,0,0,0,0,0
Chandigarh,2002,Riots,0,0,0,0,0,0,0,0,0,0,0,0,0,0,0
Chandigarh,2002,Arson,0,0,0,0,0,0,0,0,0,0,0,0,0,0,0
Chandigarh,2002,Criminal Breach Of Trust,0,0,0,0,0,0,0,0,0,0,0,0,0,0,0
Chandigarh,2002,Cheating,0,0,0,2,0,2,0,0,0,0,0,0,2,0,2
Chandigarh,2002,Counter Feiting,0,0,0,0,0,0,0,0,0,0,0,0,0,0,0
Chandigarh,2002,Dowry Deaths,0,0,0,1,0,1,2,1,3,0,0,0,3,1,4
Chandigarh,2002,Molestation,0,0,0,0,0,0,0,0,0,0,0,0,0,0,0
Chandigarh,2002,Eve-Teasing,0,0,0,0,0,0,0,0,0,0,0,0,0,0,0
Chandigarh,2002,Cruelty By Husband Or Relative Of Husband,0,0,0,0,0,0,1,0,1,0,0,0,1,0,1
Chandigarh,2002,Other Ipc Crimes,0,0,0,1,0,1,0,0,0,1,0,1,2,0,2
Chandigarh,2003,Murder,0,0,0,12,1,13,16,2,18,8,1,9,36,4,40
Chandigarh,2003,Attempt To Commit Murder,0,0,0,4,0,4,8,1,9,2,0,2,14,1,15
Chandigarh,2003,C.H. Not Amounting To Murder,0,0,0,2,0,2,3,0,3,0,0,0,5,0,5
Chandigarh,2003,Rape,0,0,0,3,0,3,6,0,6,0,0,0,9,0,9
Chandigarh,2003,Kidnapping And Abduction,0,0,0,2,0,2,3,0,3,3,0,3,8,0,8
Chandigarh,2003,Dacoity,0,0,0,2,0,2,4,0,4,0,0,0,6,0,6
Chandigarh,2003,Prep. And Assembly For Dacoity,0,0,0,0,0,0,2,0,2,0,0,0,2,0,2
Chandigarh,2003,Robbery,0,0,0,1,0,1,3,0,3,0,0,0,4,0,4
Chandigarh,2003,Burglary,0,0,0,0,0,0,6,1,7,0,0,0,6,1,7
Chandigarh,2003,Thefts,0,0,0,3,0,3,4,0,4,5,0,5,12,0,12
Chandigarh,2003,Extortion,0,0,0,0,0,0,0,0,0,0,0,0,0,0,0
Chandigarh,2003,Riots,0,0,0,0,0,0,0,0,0,0,0,0,0,0,0
Chandigarh,2003,Arson,0,0,0,0,0,0,0,0,0,0,0,0,0,0,0
Chandigarh,2003,Criminal Breach Of Trust,0,0,0,0,0,0,3,0,3,0,0,0,3,0,3
Chandigarh,2003,Cheating,0,0,0,0,0,0,2,0,2,0,0,0,2,0,2
Chandigarh,2003,Counter Feiting,0,0,0,0,0,0,0,0,0,0,0,0,0,0,0
Chandigarh,2003,Dowry Deaths,0,0,0,2,0,2,3,2,5,3,1,4,8,3,11
Chandigarh,2003,Molestation,0,0,0,0,0,0,0,0,0,0,0,0,0,0,0
Chandigarh,2003,Eve-Teasing,0,0,0,0,0,0,0,0,0,0,0,0,0,0,0
Chandigarh,2003,Cruelty By Husband Or Relative Of Husband,0,0,0,0,0,0,0,0,0,0,0,0,0,0,0
Chandigarh,2003,Other Ipc Crimes,0,0,0,0,0,0,0,0,0,0,0,0,0,0,0
Chandigarh,2004,Murder,0,0,0,11,1,12,21,4,25,10,0,10,42,5,47
Chandigarh,2004,Attempt To Commit Murder,0,0,0,2,0,2,3,0,3,2,1,3,7,1,8
Chandigarh,2004,C.H. Not Amounting To Murder,0,0,0,2,0,2,3,0,3,0,0,0,5,0,5
Chandigarh,2004,Rape,0,0,0,1,0,1,2,0,2,1,0,1,4,0,4
Chandigarh,2004,Kidnapping And Abduction,0,0,0,0,0,0,1,0,1,0,0,0,1,0,1
Chandigarh,2004,Dacoity,0,0,0,1,0,1,2,0,2,0,0,0,3,0,3
Chandigarh,2004,Prep. And Assembly For Dacoity,0,0,0,1,0,1,1,0,1,0,0,0,2,0,2
Chandigarh,2004,Robbery,0,0,0,0,0,0,2,0,2,0,0,0,2,0,2
Chandigarh,2004,Burglary,0,0,0,3,0,3,2,0,2,0,0,0,5,0,5
Chandigarh,2004,Thefts,0,0,0,1,0,1,4,1,5,0,0,0,5,1,6
Chandigarh,2004,Extortion,0,0,0,0,0,0,0,0,0,0,0,0,0,0,0
Chandigarh,2004,Riots,0,0,0,0,0,0,0,0,0,0,0,0,0,0,0
Chandigarh,2004,Arson,0,0,0,0,0,0,0,0,0,0,0,0,0,0,0
Chandigarh,2004,Criminal Breach Of Trust,0,0,0,0,0,0,4,0,4,3,0,3,7,0,7
Chandigarh,2004,Cheating,0,0,0,0,0,0,2,0,2,1,0,1,3,0,3
Chandigarh,2004,Counter Feiting,0,0,0,0,0,0,0,0,0,0,0,0,0,0,0
Chandigarh,2004,Dowry Deaths,0,0,0,0,0,0,0,0,0,0,0,0,0,0,0
Chandigarh,2004,Molestation,0,0,0,0,0,0,2,0,2,0,0,0,2,0,2
Chandigarh,2004,Eve-Teasing,0,0,0,0,0,0,0,0,0,0,0,0,0,0,0
Chandigarh,2004,Cruelty By Husband Or Relative Of Husband,0,0,0,0,0,0,0,0,0,0,0,0,0,0,0
Chandigarh,2004,Other Ipc Crimes,0,0,0,0,0,0,0,0,0,0,0,0,0,0,0
Chandigarh,2005,Murder,0,0,0,8,2,10,17,1,18,7,2,9,32,5,37
Chandigarh,2005,Attempt To Commit Murder,0,0,0,2,0,2,4,1,5,2,0,2,8,1,9
Chandigarh,2005,C.H. Not Amounting To Murder,0,0,0,1,0,1,2,0,2,0,0,0,3,0,3
Chandigarh,2005,Rape,0,0,0,1,0,1,4,0,4,0,0,0,5,0,5
Chandigarh,2005,Kidnapping And Abduction,0,0,0,0,0,0,2,0,2,0,0,0,2,0,2
Chandigarh,2005,Dacoity,0,0,0,0,0,0,2,0,2,0,0,0,2,0,2
Chandigarh,2005,Prep. And Assembly For Dacoity,0,0,0,1,0,1,0,0,0,0,0,0,1,0,1
Chandigarh,2005,Robbery,0,0,0,0,0,0,0,0,0,0,0,0,0,0,0
Chandigarh,2005,Burglary,0,0,0,1,0,1,0,0,0,1,0,1,2,0,2
Chandigarh,2005,Thefts,0,0,0,1,0,1,2,0,2,0,0,0,3,0,3
Chandigarh,2005,Extortion,0,0,0,0,0,0,0,0,0,1,0,1,1,0,1
Chandigarh,2005,Riots,0,0,0,0,0,0,0,0,0,0,0,0,0,0,0
Chandigarh,2005,Arson,0,0,0,0,0,0,1,0,1,1,0,1,2,0,2
Chandigarh,2005,Criminal Breach Of Trust,0,0,0,0,0,0,2,0,2,1,0,1,3,0,3
Chandigarh,2005,Cheating,0,0,0,0,0,0,0,0,0,1,0,1,1,0,1
Chandigarh,2005,Counter Feiting,0,0,0,0,0,0,0,0,0,0,0,0,0,0,0
Chandigarh,2005,Dowry Deaths,0,0,0,0,0,0,0,0,0,1,0,1,1,0,1
Chandigarh,2005,Molestation,0,0,0,0,0,0,0,0,0,0,0,0,0,0,0
Chandigarh,2005,Eve-Teasing,0,0,0,0,0,0,0,0,0,0,0,0,0,0,0
Chandigarh,2005,Cruelty By Husband Or Relative Of Husband,0,0,0,0,0,0,0,0,0,0,0,0,0,0,0
Chandigarh,2005,Other Ipc Crimes,0,0,0,0,0,0,0,0,0,0,0,0,0,0,0
Chandigarh,2006,Murder,0,0,0,11,1,12,17,2,19,10,1,11,38,4,42
Chandigarh,2006,Attempt To Commit Murder,0,0,0,4,0,4,2,0,2,2,0,2,8,0,8
Chandigarh,2006,C.H. Not Amounting To Murder,0,0,0,1,0,1,0,0,0,1,0,1,2,0,2
Chandigarh,2006,Rape,0,0,0,6,0,6,7,1,8,0,0,0,13,1,14
Chandigarh,2006,Kidnapping And Abduction,0,0,0,0,0,0,2,0,2,1,0,1,3,0,3
Chandigarh,2006,Dacoity,0,0,0,2,0,2,3,0,3,0,0,0,5,0,5
Chandigarh,2006,Prep. And Assembly For Dacoity,0,0,0,1,0,1,0,0,0,0,0,0,1,0,1
Chandigarh,2006,Robbery,0,0,0,1,0,1,2,0,2,2,0,2,5,0,5
Chandigarh,2006,Burglary,0,0,0,0,0,0,0,0,0,0,0,0,0,0,0
Chandigarh,2006,Thefts,0,0,0,1,0,1,2,0,2,1,0,1,4,0,4
Chandigarh,2006,Extortion,0,0,0,0,0,0,1,0,1,1,0,1,2,0,2
Chandigarh,2006,Riots,0,0,0,0,0,0,0,0,0,0,0,0,0,0,0
Chandigarh,2006,Arson,0,0,0,0,0,0,0,0,0,0,0,0,0,0,0
Chandigarh,2006,Criminal Breach Of Trust,0,0,0,0,0,0,3,0,3,1,0,1,4,0,4
Chandigarh,2006,Cheating,0,0,0,0,0,0,0,0,0,0,0,0,0,0,0
Chandigarh,2006,Counter Feiting,0,0,0,0,0,0,0,0,0,0,0,0,0,0,0
Chandigarh,2006,Dowry Deaths,0,0,0,0,0,0,2,0,2,0,0,0,2,0,2
Chandigarh,2006,Molestation,0,0,0,0,0,0,0,0,0,0,0,0,0,0,0
Chandigarh,2006,Eve-Teasing,0,0,0,0,0,0,0,0,0,0,0,0,0,0,0
Chandigarh,2006,Cruelty By Husband Or Relative Of Husband,0,0,0,0,0,0,0,0,0,0,0,0,0,0,0
Chandigarh,2006,Other Ipc Crimes,0,0,0,0,0,0,0,0,0,0,0,0,0,0,0
Chandigarh,2007,Murder,0,0,0,12,1,13,18,2,20,9,1,10,39,4,43
Chandigarh,2007,Attempt To Commit Murder,0,0,0,3,0,3,6,0,6,2,0,2,11,0,11
Chandigarh,2007,C.H. Not Amounting To Murder,0,0,0,1,0,1,3,0,3,2,0,2,6,0,6
Chandigarh,2007,Rape,0,0,0,4,0,4,11,0,11,1,0,1,16,0,16
Chandigarh,2007,Kidnapping And Abduction,0,0,0,1,0,1,2,0,2,2,0,2,5,0,5
Chandigarh,2007,Dacoity,0,0,0,1,0,1,1,0,1,1,0,1,3,0,3
Chandigarh,2007,Prep. And Assembly For Dacoity,0,0,0,0,0,0,4,0,4,1,0,1,5,0,5
Chandigarh,2007,Robbery,0,0,0,1,0,1,2,0,2,1,0,1,4,0,4
Chandigarh,2007,Burglary,0,0,0,0,0,0,0,0,0,0,0,0,0,0,0
Chandigarh,2007,Thefts,0,0,0,2,0,2,4,0,4,2,0,2,8,0,8
Chandigarh,2007,Extortion,0,0,0,0,0,0,0,0,0,0,0,0,0,0,0
Chandigarh,2007,Riots,0,0,0,0,0,0,0,0,0,0,0,0,0,0,0
Chandigarh,2007,Arson,0,0,0,0,0,0,0,0,0,0,0,0,0,0,0
Chandigarh,2007,Criminal Breach Of Trust,0,0,0,0,0,0,0,0,0,0,0,0,0,0,0
Chandigarh,2007,Cheating,0,0,0,0,0,0,0,0,0,0,0,0,0,0,0
Chandigarh,2007,Counter Feiting,0,0,0,0,0,0,0,0,0,0,0,0,0,0,0
Chandigarh,2007,Dowry Deaths,0,0,0,1,0,1,3,0,3,1,0,1,5,0,5
Chandigarh,2007,Molestation,0,0,0,0,0,0,0,0,0,0,0,0,0,0,0
Chandigarh,2007,Eve-Teasing,0,0,0,0,0,0,0,0,0,0,0,0,0,0,0
Chandigarh,2007,Cruelty By Husband Or Relative Of Husband,0,0,0,0,0,0,0,0,0,0,0,0,0,0,0
Chandigarh,2007,Other Ipc Crimes,0,0,0,0,0,0,0,0,0,0,0,0,0,0,0
Chandigarh,2008,Murder,0,0,0,16,1,17,30,2,32,15,0,15,61,3,64
Chandigarh,2008,Attempt To Commit Murder,0,0,0,4,0,4,6,0,6,2,0,2,12,0,12
Chandigarh,2008,C.H. Not Amounting To Murder,0,0,0,2,0,2,4,0,4,2,0,2,8,0,8
Chandigarh,2008,Rape,0,0,0,5,0,5,12,1,13,6,0,6,23,1,24
Chandigarh,2008,Kidnapping And Abduction,0,0,0,4,0,4,3,0,3,0,0,0,7,0,7
Chandigarh,2008,Dacoity,0,0,0,2,0,2,4,0,4,0,0,0,6,0,6
Chandigarh,2008,Prep. And Assembly For Dacoity,0,0,0,3,0,3,2,0,2,0,0,0,5,0,5
Chandigarh,2008,Robbery,0,0,0,1,0,1,1,0,1,0,0,0,2,0,2
Chandigarh,2008,Burglary,0,0,0,0,0,0,0,0,0,0,0,0,0,0,0
Chandigarh,2008,Thefts,0,0,0,3,1,4,1,0,1,1,0,1,5,1,6
Chandigarh,2008,Extortion,0,0,0,0,0,0,0,0,0,0,0,0,0,0,0
Chandigarh,2008,Riots,0,0,0,0,0,0,0,0,0,0,0,0,0,0,0
Chandigarh,2008,Arson,0,0,0,0,0,0,0,0,0,0,0,0,0,0,0
Chandigarh,2008,Criminal Breach Of Trust,0,0,0,0,0,0,0,0,0,0,0,0,0,0,0
Chandigarh,2008,Cheating,0,0,0,0,0,0,0,0,0,0,0,0,0,0,0
Chandigarh,2008,Counter Feiting,0,0,0,0,0,0,0,0,0,0,0,0,0,0,0
Chandigarh,2008,Dowry Deaths,0,0,0,1,0,1,0,0,0,1,0,1,2,0,2
Chandigarh,2008,Molestation,0,0,0,0,0,0,0,0,0,0,0,0,0,0,0
Chandigarh,2008,Eve-Teasing,0,0,0,0,0,0,0,0,0,0,0,0,0,0,0
Chandigarh,2008,Cruelty By Husband Or Relative Of Husband,0,0,0,0,0,0,0,0,0,0,0,0,0,0,0
Chandigarh,2008,Other Ipc Crimes,0,0,0,0,0,0,0,0,0,0,0,0,0,0,0
Chandigarh,2009,Murder,0,0,0,24,1,25,20,3,23,6,1,7,50,5,55
Chandigarh,2009,Attempt To Commit Murder,0,0,0,7,0,7,14,0,14,2,0,2,23,0,23
Chandigarh,2009,C.H. Not Amounting To Murder,0,0,0,6,0,6,9,1,10,1,0,1,16,1,17
Chandigarh,2009,Rape,0,0,0,5,0,5,11,0,11,1,0,1,17,0,17
Chandigarh,2009,Kidnapping And Abduction,0,0,0,4,0,4,7,1,8,2,0,2,13,1,14
Chandigarh,2009,Dacoity,0,0,0,4,0,4,9,0,9,1,0,1,14,0,14
Chandigarh,2009,Prep. And Assembly For Dacoity,0,0,0,2,0,2,6,0,6,0,0,0,8,0,8
Chandigarh,2009,Robbery,0,0,0,7,0,7,10,0,10,0,0,0,17,0,17
Chandigarh,2009,Burglary,0,0,0,0,0,0,0,0,0,0,0,0,0,0,0
Chandigarh,2009,Thefts,0,0,0,4,0,4,9,1,10,1,0,1,14,1,15
Chandigarh,2009,Extortion,0,0,0,0,0,0,0,0,0,0,0,0,0,0,0
Chandigarh,2009,Riots,0,0,0,0,0,0,0,0,0,0,0,0,0,0,0
Chandigarh,2009,Arson,0,0,0,0,0,0,0,0,0,0,0,0,0,0,0
Chandigarh,2009,Criminal Breach Of Trust,0,0,0,0,0,0,2,0,2,2,0,2,4,0,4
Chandigarh,2009,Cheating,0,0,0,0,0,0,1,0,1,1,0,1,2,0,2
Chandigarh,2009,Counter Feiting,0,0,0,0,0,0,0,0,0,0,0,0,0,0,0
Chandigarh,2009,Dowry Deaths,0,0,0,2,1,3,0,0,0,0,0,0,2,1,3
Chandigarh,2009,Molestation,0,0,0,0,0,0,0,0,0,0,0,0,0,0,0
Chandigarh,2009,Eve-Teasing,0,0,0,0,0,0,0,0,0,0,0,0,0,0,0
Chandigarh,2009,Cruelty By Husband Or Relative Of Husband,0,0,0,0,0,0,0,0,0,0,0,0,0,0,0
Chandigarh,2009,Other Ipc Crimes,0,0,0,0,0,0,0,0,0,0,0,0,0,0,0
Chandigarh,2010,Murder,0,0,0,28,1,29,24,4,28,5,2,7,57,7,64
Chandigarh,2010,Attempt To Commit Murder,0,0,0,6,0,6,10,0,10,1,0,1,17,0,17
Chandigarh,2010,C.H. Not Amounting To Murder,0,0,0,4,0,4,11,1,12,2,0,2,17,1,18
Chandigarh,2010,Rape,0,0,0,3,0,3,8,0,8,1,0,1,12,0,12
Chandigarh,2010,Kidnapping And Abduction,0,0,0,5,0,5,9,0,9,2,1,3,16,1,17
Chandigarh,2010,Dacoity,0,0,0,3,0,3,7,0,7,2,0,2,12,0,12
Chandigarh,2010,Prep. And Assembly For Dacoity,0,0,0,4,0,4,4,0,4,0,0,0,8,0,8
Chandigarh,2010,Robbery,0,0,0,5,0,5,10,0,10,0,0,0,15,0,15
Chandigarh,2010,Burglary,0,0,0,0,0,0,0,0,0,0,0,0,0,0,0
Chandigarh,2010,Thefts,0,0,0,6,0,6,8,1,9,4,0,4,18,1,19
Chandigarh,2010,Extortion,0,0,0,0,0,0,0,0,0,0,0,0,0,0,0
Chandigarh,2010,Riots,0,0,0,0,0,0,0,0,0,0,0,0,0,0,0
Chandigarh,2010,Arson,0,0,0,0,0,0,0,0,0,0,0,0,0,0,0
Chandigarh,2010,Criminal Breach Of Trust,0,0,0,0,0,0,4,0,4,3,0,3,7,0,7
Chandigarh,2010,Cheating,0,0,0,0,0,0,2,0,2,2,0,2,4,0,4
Chandigarh,2010,Counter Feiting,0,0,0,0,0,0,0,0,0,0,0,0,0,0,0
Chandigarh,2010,Dowry Deaths,0,0,0,3,0,3,1,0,1,1,0,1,5,0,5
Chandigarh,2010,Molestation,0,0,0,0,0,0,0,0,0,0,0,0,0,0,0
Chandigarh,2010,Eve-Teasing,0,0,0,0,0,0,0,0,0,0,0,0,0,0,0
Chandigarh,2010,Cruelty By Husband Or Relative Of Husband,0,0,0,0,0,0,0,0,0,0,0,0,0,0,0
Chandigarh,2010,Other Ipc Crimes,0,0,0,0,0,0,0,0,0,0,0,0,0,0,0
Chandigarh,2011,Murder,0,0,0,34,1,35,36,1,37,6,1,7,76,3,79
Chandigarh,2011,Attempt To Commit Murder,0,0,0,8,0,8,11,0,11,2,0,2,21,0,21
Chandigarh,2011,C.H. Not Amounting To Murder,0,0,0,6,0,6,6,1,7,1,0,1,13,1,14
Chandigarh,2011,Rape,0,0,0,9,0,9,7,0,7,3,0,3,19,0,19
Chandigarh,2011,Kidnapping And Abduction,0,0,0,4,0,4,4,0,4,0,0,0,8,0,8
Chandigarh,2011,Dacoity,0,0,0,3,0,3,4,0,4,0,0,0,7,0,7
Chandigarh,2011,Prep. And Assembly For Dacoity,0,0,0,2,0,2,3,0,3,0,0,0,5,0,5
Chandigarh,2011,Robbery,0,0,0,4,0,4,9,0,9,1,0,1,14,0,14
Chandigarh,2011,Burglary,0,0,0,0,0,0,7,1,8,1,0,1,8,1,9
Chandigarh,2011,Thefts,0,0,0,6,1,7,9,0,9,1,0,1,16,1,17
Chandigarh,2011,Extortion,0,0,0,0,0,0,0,0,0,0,0,0,0,0,0
Chandigarh,2011,Riots,0,0,0,0,0,0,0,0,0,0,0,0,0,0,0
Chandigarh,2011,Arson,0,0,0,0,0,0,0,0,0,0,0,0,0,0,0
Chandigarh,2011,Criminal Breach Of Trust,0,0,0,0,0,0,3,0,3,2,0,2,5,0,5
Chandigarh,2011,Cheating,0,0,0,0,0,0,0,0,0,0,0,0,0,0,0
Chandigarh,2011,Counter Feiting,0,0,0,0,0,0,0,0,0,0,0,0,0,0,0
Chandigarh,2011,Dowry Deaths,0,0,0,4,0,4,1,0,1,0,0,0,5,0,5
Chandigarh,2011,Molestation,0,0,0,0,0,0,0,0,0,0,0,0,0,0,0
Chandigarh,2011,Eve-Teasing,0,0,0,0,0,0,0,0,0,0,0,0,0,0,0
Chandigarh,2011,Cruelty By Husband Or Relative Of Husband,0,0,0,0,0,0,0,0,0,0,0,0,0,0,0
Chandigarh,2011,Other Ipc Crimes,0,0,0,0,0,0,0,0,0,0,0,0,0,0,0
Chandigarh,2012,Murder,0,0,0,26,2,28,19,3,22,4,0,4,49,5,54
Chandigarh,2012,Attempt To Commit Murder,0,0,0,13,0,13,14,0,14,2,0,2,29,0,29
Chandigarh,2012,C.H. Not Amounting To Murder,0,0,0,5,0,5,6,1,7,1,0,1,12,1,13
Chandigarh,2012,Rape,0,0,0,19,0,19,9,1,10,2,0,2,30,1,31
Chandigarh,2012,Kidnapping And Abduction,0,0,0,9,0,9,6,0,6,0,0,0,15,0,15
Chandigarh,2012,Dacoity,0,0,0,6,0,6,4,0,4,0,0,0,10,0,10
Chandigarh,2012,Prep. And Assembly For Dacoity,0,0,0,6,0,6,3,0,3,0,0,0,9,0,9
Chandigarh,2012,Robbery,0,0,0,2,0,2,1,0,1,0,0,0,3,0,3
Chandigarh,2012,Burglary,0,0,0,0,0,0,0,0,0,2,0,2,2,0,2
Chandigarh,2012,Thefts,0,0,0,12,1,13,8,1,9,4,1,5,24,3,27
Chandigarh,2012,Extortion,0,0,0,2,0,2,0,0,0,0,0,0,2,0,2
Chandigarh,2012,Riots,0,0,0,0,0,0,0,0,0,0,0,0,0,0,0
Chandigarh,2012,Arson,0,0,0,0,0,0,0,0,0,0,0,0,0,0,0
Chandigarh,2012,Criminal Breach Of Trust,0,0,0,3,0,3,1,1,2,0,0,0,4,1,5
Chandigarh,2012,Cheating,0,0,0,2,0,2,1,1,2,0,0,0,3,1,4
Chandigarh,2012,Counter Feiting,0,0,0,0,0,0,0,0,0,0,0,0,0,0,0
Chandigarh,2012,Dowry Deaths,0,0,0,1,0,1,2,0,2,0,0,0,3,0,3
Chandigarh,2012,Molestation,0,0,0,2,0,2,0,0,0,0,0,0,2,0,2
Chandigarh,2012,Eve-Teasing,0,0,0,0,0,0,0,0,0,0,0,0,0,0,0
Chandigarh,2012,Cruelty By Husband Or Relative Of Husband,0,0,0,0,0,0,0,0,0,0,0,0,0,0,0
Chandigarh,2012,Other Ipc Crimes,0,0,0,0,0,0,0,0,0,0,0,0,0,0,0
D & N Haveli,2001,Murder,0,0,0,0,0,0,0,0,0,0,0,0,0,0,0
D & N Haveli,2001,Murder,0,0,0,0,0,0,0,0,0,0,0,0,0,0,0
D & N Haveli,2001,Attempt To Commit Murder,0,0,0,0,0,0,0,0,0,0,0,0,0,0,0
D & N Haveli,2001,C.H. Not Amounting To Murder,0,0,0,0,0,0,0,0,0,0,0,0,0,0,0
D & N Haveli,2001,Rape,0,0,0,1,0,1,0,0,0,0,0,0,1,0,1
D & N Haveli,2001,Kidnapping And Abduction,0,0,0,0,0,0,0,0,0,0,0,0,0,0,0
D & N Haveli,2001,Dacoity,0,0,0,0,0,0,0,0,0,0,0,0,0,0,0
D & N Haveli,2001,Prep. And Assembly For Dacoity,0,0,0,0,0,0,0,0,0,0,0,0,0,0,0
D & N Haveli,2001,Robbery,0,0,0,0,0,0,0,0,0,0,0,0,0,0,0
D & N Haveli,2001,Burglary,0,0,0,0,0,0,0,0,0,0,0,0,0,0,0
D & N Haveli,2001,Thefts,0,0,0,3,0,3,1,0,1,0,0,0,4,0,4
D & N Haveli,2001,Extortion,0,0,0,0,0,0,0,0,0,0,0,0,0,0,0
D & N Haveli,2001,Riots,0,0,0,0,0,0,0,0,0,0,0,0,0,0,0
D & N Haveli,2001,Arson,0,0,0,0,0,0,0,0,0,0,0,0,0,0,0
D & N Haveli,2001,Criminal Breach Of Trust,0,0,0,0,0,0,0,0,0,0,0,0,0,0,0
D & N Haveli,2001,Cheating,0,0,0,0,0,0,0,0,0,0,0,0,0,0,0
D & N Haveli,2001,Counter Feiting,0,0,0,0,0,0,0,0,0,0,0,0,0,0,0
D & N Haveli,2001,Dowry Deaths,0,0,0,0,0,0,0,0,0,0,0,0,0,0,0
D & N Haveli,2001,Molestation,0,0,0,0,0,0,0,0,0,0,0,0,0,0,0
D & N Haveli,2001,Eve-Teasing,0,0,0,0,0,0,0,0,0,0,0,0,0,0,0
D & N Haveli,2001,Cruelty By Husband Or Relative Of Husband,0,0,0,0,0,0,0,0,0,0,0,0,0,0,0
D & N Haveli,2001,Other Ipc Crimes,0,0,0,2,0,2,1,0,1,0,0,0,3,0,3
D & N Haveli,2002,Murder,0,0,0,0,0,0,0,0,0,0,0,0,0,0,0
D & N Haveli,2002,Attempt To Commit Murder,0,0,0,0,0,0,0,0,0,0,0,0,0,0,0
D & N Haveli,2002,C.H. Not Amounting To Murder,0,0,0,0,0,0,0,0,0,0,0,0,0,0,0
D & N Haveli,2002,Rape,0,0,0,0,0,0,0,0,0,0,0,0,0,0,0
D & N Haveli,2002,Kidnapping And Abduction,0,0,0,0,0,0,0,0,0,0,0,0,0,0,0
D & N Haveli,2002,Dacoity,0,0,0,0,0,0,2,1,3,0,0,0,2,1,3
D & N Haveli,2002,Prep. And Assembly For Dacoity,0,0,0,0,0,0,0,0,0,0,0,0,0,0,0
D & N Haveli,2002,Robbery,0,0,0,0,0,0,0,0,0,0,0,0,0,0,0
D & N Haveli,2002,Burglary,0,0,0,0,0,0,2,0,2,0,0,0,2,0,2
D & N Haveli,2002,Thefts,0,0,0,0,0,0,0,0,0,0,0,0,0,0,0
D & N Haveli,2002,Extortion,0,0,0,0,0,0,0,0,0,0,0,0,0,0,0
D & N Haveli,2002,Riots,0,0,0,0,0,0,0,0,0,0,0,0,0,0,0
D & N Haveli,2002,Arson,0,0,0,0,0,0,0,0,0,0,0,0,0,0,0
D & N Haveli,2002,Criminal Breach Of Trust,0,0,0,0,0,0,0,0,0,0,0,0,0,0,0
D & N Haveli,2002,Cheating,0,0,0,0,0,0,0,0,0,0,0,0,0,0,0
D & N Haveli,2002,Counter Feiting,0,0,0,0,0,0,0,0,0,0,0,0,0,0,0
D & N Haveli,2002,Dowry Deaths,0,0,0,0,0,0,0,0,0,0,0,0,0,0,0
D & N Haveli,2002,Molestation,0,0,0,0,0,0,0,0,0,0,0,0,0,0,0
D & N Haveli,2002,Eve-Teasing,0,0,0,0,0,0,0,0,0,0,0,0,0,0,0
D & N Haveli,2002,Cruelty By Husband Or Relative Of Husband,0,0,0,0,0,0,0,0,0,0,0,0,0,0,0
D & N Haveli,2002,Other Ipc Crimes,0,0,0,0,0,0,0,0,0,0,0,0,0,0,0
D & N Haveli,2003,Murder,0,0,0,0,0,0,0,0,0,0,0,0,0,0,0
D & N Haveli,2003,Attempt To Commit Murder,0,0,0,0,0,0,0,0,0,0,0,0,0,0,0
D & N Haveli,2003,C.H. Not Amounting To Murder,0,0,0,0,0,0,0,0,0,0,0,0,0,0,0
D & N Haveli,2003,Rape,0,0,0,0,0,0,0,0,0,0,0,0,0,0,0
D & N Haveli,2003,Kidnapping And Abduction,0,0,0,0,0,0,0,0,0,0,0,0,0,0,0
D & N Haveli,2003,Dacoity,0,0,0,0,0,0,0,0,0,0,0,0,0,0,0
D & N Haveli,2003,Prep. And Assembly For Dacoity,0,0,0,0,0,0,0,0,0,0,0,0,0,0,0
D & N Haveli,2003,Robbery,0,0,0,0,0,0,0,0,0,0,0,0,0,0,0
D & N Haveli,2003,Burglary,0,0,0,0,0,0,0,0,0,0,0,0,0,0,0
D & N Haveli,2003,Thefts,0,0,0,0,0,0,0,0,0,0,0,0,0,0,0
D & N Haveli,2003,Extortion,0,0,0,0,0,0,0,0,0,0,0,0,0,0,0
D & N Haveli,2003,Riots,0,0,0,0,0,0,0,0,0,0,0,0,0,0,0
D & N Haveli,2003,Arson,0,0,0,0,0,0,0,0,0,0,0,0,0,0,0
D & N Haveli,2003,Criminal Breach Of Trust,0,0,0,0,0,0,0,0,0,0,0,0,0,0,0
D & N Haveli,2003,Cheating,0,0,0,0,0,0,0,0,0,0,0,0,0,0,0
D & N Haveli,2003,Counter Feiting,0,0,0,0,0,0,0,0,0,0,0,0,0,0,0
D & N Haveli,2003,Dowry Deaths,0,0,0,0,0,0,0,0,0,0,0,0,0,0,0
D & N Haveli,2003,Molestation,0,0,0,0,0,0,0,0,0,0,0,0,0,0,0
D & N Haveli,2003,Eve-Teasing,0,0,0,0,0,0,0,0,0,0,0,0,0,0,0
D & N Haveli,2003,Cruelty By Husband Or Relative Of Husband,0,0,0,0,0,0,0,0,0,0,0,0,0,0,0
D & N Haveli,2003,Other Ipc Crimes,0,0,0,0,0,0,0,0,0,0,0,0,0,0,0
D & N Haveli,2004,Murder,0,0,0,0,0,0,0,0,0,0,0,0,0,0,0
D & N Haveli,2004,Attempt To Commit Murder,0,0,0,0,0,0,0,0,0,0,0,0,0,0,0
D & N Haveli,2004,C.H. Not Amounting To Murder,0,0,0,0,0,0,0,0,0,0,0,0,0,0,0
D & N Haveli,2004,Rape,0,0,0,0,0,0,0,0,0,0,0,0,0,0,0
D & N Haveli,2004,Kidnapping And Abduction,0,0,0,0,0,0,0,0,0,0,0,0,0,0,0
D & N Haveli,2004,Dacoity,0,0,0,0,0,0,0,0,0,0,0,0,0,0,0
D & N Haveli,2004,Prep. And Assembly For Dacoity,0,0,0,0,0,0,0,0,0,0,0,0,0,0,0
D & N Haveli,2004,Robbery,0,0,0,0,0,0,0,0,0,0,0,0,0,0,0
D & N Haveli,2004,Burglary,0,0,0,0,0,0,0,0,0,0,0,0,0,0,0
D & N Haveli,2004,Thefts,0,0,0,0,0,0,0,0,0,0,0,0,0,0,0
D & N Haveli,2004,Extortion,0,0,0,0,0,0,0,0,0,0,0,0,0,0,0
D & N Haveli,2004,Riots,0,0,0,0,0,0,0,0,0,0,0,0,0,0,0
D & N Haveli,2004,Arson,0,0,0,0,0,0,0,0,0,0,0,0,0,0,0
D & N Haveli,2004,Criminal Breach Of Trust,0,0,0,0,0,0,0,0,0,0,0,0,0,0,0
D & N Haveli,2004,Cheating,0,0,0,0,0,0,0,0,0,0,0,0,0,0,0
D & N Haveli,2004,Counter Feiting,0,0,0,0,0,0,0,0,0,0,0,0,0,0,0
D & N Haveli,2004,Dowry Deaths,0,0,0,0,0,0,0,0,0,0,0,0,0,0,0
D & N Haveli,2004,Molestation,0,0,0,0,0,0,0,0,0,0,0,0,0,0,0
D & N Haveli,2004,Eve-Teasing,0,0,0,0,0,0,0,0,0,0,0,0,0,0,0
D & N Haveli,2004,Cruelty By Husband Or Relative Of Husband,0,0,0,0,0,0,0,0,0,0,0,0,0,0,0
D & N Haveli,2004,Other Ipc Crimes,0,0,0,0,0,0,0,0,0,0,0,0,0,0,0
D & N Haveli,2005,Murder,0,0,0,0,0,0,0,0,0,0,0,0,0,0,0
D & N Haveli,2005,Attempt To Commit Murder,0,0,0,0,0,0,0,0,0,0,0,0,0,0,0
D & N Haveli,2005,C.H. Not Amounting To Murder,0,0,0,0,0,0,0,0,0,0,0,0,0,0,0
D & N Haveli,2005,Rape,0,0,0,0,0,0,0,0,0,0,0,0,0,0,0
D & N Haveli,2005,Kidnapping And Abduction,0,0,0,0,0,0,0,0,0,0,0,0,0,0,0
D & N Haveli,2005,Dacoity,0,0,0,0,0,0,0,0,0,0,0,0,0,0,0
D & N Haveli,2005,Prep. And Assembly For Dacoity,0,0,0,0,0,0,0,0,0,0,0,0,0,0,0
D & N Haveli,2005,Robbery,0,0,0,0,0,0,0,0,0,0,0,0,0,0,0
D & N Haveli,2005,Burglary,0,0,0,0,0,0,0,0,0,0,0,0,0,0,0
D & N Haveli,2005,Thefts,0,0,0,0,0,0,0,0,0,0,0,0,0,0,0
D & N Haveli,2005,Extortion,0,0,0,0,0,0,0,0,0,0,0,0,0,0,0
D & N Haveli,2005,Riots,0,0,0,0,0,0,0,0,0,0,0,0,0,0,0
D & N Haveli,2005,Arson,0,0,0,0,0,0,0,0,0,0,0,0,0,0,0
D & N Haveli,2005,Criminal Breach Of Trust,0,0,0,0,0,0,0,0,0,0,0,0,0,0,0
D & N Haveli,2005,Cheating,0,0,0,0,0,0,0,0,0,0,0,0,0,0,0
D & N Haveli,2005,Counter Feiting,0,0,0,0,0,0,0,0,0,0,0,0,0,0,0
D & N Haveli,2005,Dowry Deaths,0,0,0,0,0,0,0,0,0,0,0,0,0,0,0
D & N Haveli,2005,Molestation,0,0,0,0,0,0,0,0,0,0,0,0,0,0,0
D & N Haveli,2005,Eve-Teasing,0,0,0,0,0,0,0,0,0,0,0,0,0,0,0
D & N Haveli,2005,Cruelty By Husband Or Relative Of Husband,0,0,0,0,0,0,0,0,0,0,0,0,0,0,0
D & N Haveli,2005,Other Ipc Crimes,0,0,0,0,0,0,0,0,0,0,0,0,0,0,0
D & N Haveli,2006,Murder,0,0,0,0,0,0,0,0,0,0,0,0,0,0,0
D & N Haveli,2006,Attempt To Commit Murder,0,0,0,0,0,0,0,0,0,0,0,0,0,0,0
D & N Haveli,2006,C.H. Not Amounting To Murder,0,0,0,0,0,0,0,0,0,0,0,0,0,0,0
D & N Haveli,2006,Rape,0,0,0,0,0,0,0,0,0,0,0,0,0,0,0
D & N Haveli,2006,Kidnapping And Abduction,0,0,0,0,0,0,0,0,0,0,0,0,0,0,0
D & N Haveli,2006,Dacoity,0,0,0,0,0,0,0,0,0,0,0,0,0,0,0
D & N Haveli,2006,Prep. And Assembly For Dacoity,0,0,0,0,0,0,0,0,0,0,0,0,0,0,0
D & N Haveli,2006,Robbery,0,0,0,0,0,0,0,0,0,0,0,0,0,0,0
D & N Haveli,2006,Burglary,0,0,0,0,0,0,0,0,0,0,0,0,0,0,0
D & N Haveli,2006,Thefts,0,0,0,0,0,0,0,0,0,0,0,0,0,0,0
D & N Haveli,2006,Extortion,0,0,0,0,0,0,0,0,0,0,0,0,0,0,0
D & N Haveli,2006,Riots,0,0,0,0,0,0,0,0,0,0,0,0,0,0,0
D & N Haveli,2006,Arson,0,0,0,0,0,0,0,0,0,0,0,0,0,0,0
D & N Haveli,2006,Criminal Breach Of Trust,0,0,0,0,0,0,0,0,0,0,0,0,0,0,0
D & N Haveli,2006,Cheating,0,0,0,0,0,0,0,0,0,0,0,0,0,0,0
D & N Haveli,2006,Counter Feiting,0,0,0,0,0,0,0,0,0,0,0,0,0,0,0
D & N Haveli,2006,Dowry Deaths,0,0,0,0,0,0,0,0,0,0,0,0,0,0,0
D & N Haveli,2006,Molestation,0,0,0,0,0,0,0,0,0,0,0,0,0,0,0
D & N Haveli,2006,Eve-Teasing,0,0,0,0,0,0,0,0,0,0,0,0,0,0,0
D & N Haveli,2006,Cruelty By Husband Or Relative Of Husband,0,0,0,0,0,0,0,0,0,0,0,0,0,0,0
D & N Haveli,2006,Other Ipc Crimes,0,0,0,0,0,0,0,0,0,0,0,0,0,0,0
D & N Haveli,2007,Murder,0,0,0,0,0,0,0,0,0,0,0,0,0,0,0
D & N Haveli,2007,Attempt To Commit Murder,0,0,0,0,0,0,0,0,0,0,0,0,0,0,0
D & N Haveli,2007,C.H. Not Amounting To Murder,0,0,0,0,0,0,0,0,0,0,0,0,0,0,0
D & N Haveli,2007,Rape,0,0,0,0,0,0,0,0,0,0,0,0,0,0,0
D & N Haveli,2007,Kidnapping And Abduction,0,0,0,0,0,0,0,0,0,0,0,0,0,0,0
D & N Haveli,2007,Dacoity,0,0,0,0,0,0,0,0,0,0,0,0,0,0,0
D & N Haveli,2007,Prep. And Assembly For Dacoity,0,0,0,0,0,0,0,0,0,0,0,0,0,0,0
D & N Haveli,2007,Robbery,0,0,0,0,0,0,0,0,0,0,0,0,0,0,0
D & N Haveli,2007,Burglary,0,0,0,0,0,0,0,0,0,0,0,0,0,0,0
D & N Haveli,2007,Thefts,0,0,0,0,0,0,0,0,0,0,0,0,0,0,0
D & N Haveli,2007,Extortion,0,0,0,0,0,0,0,0,0,0,0,0,0,0,0
D & N Haveli,2007,Riots,0,0,0,0,0,0,0,0,0,0,0,0,0,0,0
D & N Haveli,2007,Arson,0,0,0,0,0,0,0,0,0,0,0,0,0,0,0
D & N Haveli,2007,Criminal Breach Of Trust,0,0,0,0,0,0,0,0,0,0,0,0,0,0,0
D & N Haveli,2007,Cheating,0,0,0,0,0,0,0,0,0,0,0,0,0,0,0
D & N Haveli,2007,Counter Feiting,0,0,0,0,0,0,0,0,0,0,0,0,0,0,0
D & N Haveli,2007,Dowry Deaths,0,0,0,0,0,0,0,0,0,0,0,0,0,0,0
D & N Haveli,2007,Molestation,0,0,0,0,0,0,0,0,0,0,0,0,0,0,0
D & N Haveli,2007,Eve-Teasing,0,0,0,0,0,0,0,0,0,0,0,0,0,0,0
D & N Haveli,2007,Cruelty By Husband Or Relative Of Husband,0,0,0,0,0,0,0,0,0,0,0,0,0,0,0
D & N Haveli,2007,Other Ipc Crimes,0,0,0,0,0,0,0,0,0,0,0,0,0,0,0
D & N Haveli,2008,Murder,0,0,0,2,0,2,1,0,1,0,0,0,3,0,3
D & N Haveli,2008,Attempt To Commit Murder,0,0,0,1,0,1,0,0,0,0,0,0,1,0,1
D & N Haveli,2008,C.H. Not Amounting To Murder,0,0,0,0,0,0,0,0,0,0,0,0,0,0,0
D & N Haveli,2008,Rape,0,0,0,1,0,1,0,0,0,0,0,0,1,0,1
D & N Haveli,2008,Kidnapping And Abduction,0,0,0,1,0,1,0,0,0,0,0,0,1,0,1
D & N Haveli,2008,Dacoity,0,0,0,2,0,2,0,0,0,0,0,0,2,0,2
D & N Haveli,2008,Prep. And Assembly For Dacoity,0,0,0,0,0,0,0,0,0,0,0,0,0,0,0
D & N Haveli,2008,Robbery,0,0,0,0,0,0,0,0,0,0,0,0,0,0,0
D & N Haveli,2008,Burglary,0,0,0,0,0,0,0,0,0,0,0,0,0,0,0
D & N Haveli,2008,Thefts,0,0,0,1,0,1,0,0,0,0,0,0,1,0,1
D & N Haveli,2008,Extortion,0,0,0,0,0,0,0,0,0,0,0,0,0,0,0
D & N Haveli,2008,Riots,0,0,0,0,0,0,0,0,0,0,0,0,0,0,0
D & N Haveli,2008,Arson,0,0,0,0,0,0,0,0,0,0,0,0,0,0,0
D & N Haveli,2008,Criminal Breach Of Trust,0,0,0,0,0,0,0,0,0,0,0,0,0,0,0
D & N Haveli,2008,Cheating,0,0,0,0,0,0,0,0,0,0,0,0,0,0,0
D & N Haveli,2008,Counter Feiting,0,0,0,0,0,0,0,0,0,0,0,0,0,0,0
D & N Haveli,2008,Dowry Deaths,0,0,0,0,0,0,0,0,0,0,0,0,0,0,0
D & N Haveli,2008,Molestation,0,0,0,0,0,0,0,0,0,0,0,0,0,0,0
D & N Haveli,2008,Eve-Teasing,0,0,0,0,0,0,0,0,0,0,0,0,0,0,0
D & N Haveli,2008,Cruelty By Husband Or Relative Of Husband,0,0,0,0,0,0,0,0,0,0,0,0,0,0,0
D & N Haveli,2008,Other Ipc Crimes,0,0,0,0,0,0,0,0,0,0,0,0,0,0,0
D & N Haveli,2009,Murder,0,0,0,0,0,0,0,0,0,0,0,0,0,0,0
D & N Haveli,2009,Attempt To Commit Murder,0,0,0,0,0,0,0,0,0,0,0,0,0,0,0
D & N Haveli,2009,C.H. Not Amounting To Murder,0,0,0,1,0,1,0,0,0,0,0,0,1,0,1
D & N Haveli,2009,Rape,0,0,0,0,0,0,0,0,0,0,0,0,0,0,0
D & N Haveli,2009,Kidnapping And Abduction,0,0,0,0,0,0,0,0,0,0,0,0,0,0,0
D & N Haveli,2009,Dacoity,0,0,0,0,0,0,0,0,0,0,0,0,0,0,0
D & N Haveli,2009,Prep. And Assembly For Dacoity,0,0,0,0,0,0,0,0,0,0,0,0,0,0,0
D & N Haveli,2009,Robbery,0,0,0,0,0,0,0,0,0,0,0,0,0,0,0
D & N Haveli,2009,Burglary,0,0,0,0,0,0,0,0,0,0,0,0,0,0,0
D & N Haveli,2009,Thefts,0,0,0,0,0,0,0,0,0,0,0,0,0,0,0
D & N Haveli,2009,Extortion,0,0,0,0,0,0,0,0,0,0,0,0,0,0,0
D & N Haveli,2009,Riots,0,0,0,0,0,0,0,0,0,0,0,0,0,0,0
D & N Haveli,2009,Arson,0,0,0,0,0,0,0,0,0,0,0,0,0,0,0
D & N Haveli,2009,Criminal Breach Of Trust,0,0,0,0,0,0,0,0,0,0,0,0,0,0,0
D & N Haveli,2009,Cheating,0,0,0,0,0,0,0,0,0,0,0,0,0,0,0
D & N Haveli,2009,Counter Feiting,0,0,0,0,0,0,0,0,0,0,0,0,0,0,0
D & N Haveli,2009,Dowry Deaths,0,0,0,0,0,0,0,0,0,0,0,0,0,0,0
D & N Haveli,2009,Molestation,0,0,0,0,0,0,0,0,0,0,0,0,0,0,0
D & N Haveli,2009,Eve-Teasing,0,0,0,0,0,0,0,0,0,0,0,0,0,0,0
D & N Haveli,2009,Cruelty By Husband Or Relative Of Husband,0,0,0,0,0,0,0,0,0,0,0,0,0,0,0
D & N Haveli,2009,Other Ipc Crimes,0,0,0,0,0,0,0,0,0,0,0,0,0,0,0
D & N Haveli,2010,Murder,0,0,0,0,0,0,0,0,0,0,0,0,0,0,0
D & N Haveli,2010,Attempt To Commit Murder,0,0,0,0,0,0,0,0,0,0,0,0,0,0,0
D & N Haveli,2010,C.H. Not Amounting To Murder,0,0,0,0,0,0,0,0,0,0,0,0,0,0,0
D & N Haveli,2010,Rape,0,0,0,0,0,0,0,0,0,0,0,0,0,0,0
D & N Haveli,2010,Kidnapping And Abduction,0,0,0,0,0,0,0,0,0,0,0,0,0,0,0
D & N Haveli,2010,Dacoity,0,0,0,0,0,0,0,0,0,0,0,0,0,0,0
D & N Haveli,2010,Prep. And Assembly For Dacoity,0,0,0,0,0,0,0,0,0,0,0,0,0,0,0
D & N Haveli,2010,Robbery,0,0,0,0,0,0,0,0,0,0,0,0,0,0,0
D & N Haveli,2010,Burglary,0,0,0,0,0,0,0,0,0,0,0,0,0,0,0
D & N Haveli,2010,Thefts,0,0,0,0,0,0,0,0,0,0,0,0,0,0,0
D & N Haveli,2010,Extortion,0,0,0,0,0,0,0,0,0,0,0,0,0,0,0
D & N Haveli,2010,Riots,0,0,0,0,0,0,0,0,0,0,0,0,0,0,0
D & N Haveli,2010,Arson,0,0,0,0,0,0,0,0,0,0,0,0,0,0,0
D & N Haveli,2010,Criminal Breach Of Trust,0,0,0,0,0,0,0,0,0,0,0,0,0,0,0
D & N Haveli,2010,Cheating,0,0,0,0,0,0,0,0,0,0,0,0,0,0,0
D & N Haveli,2010,Counter Feiting,0,0,0,0,0,0,0,0,0,0,0,0,0,0,0
D & N Haveli,2010,Dowry Deaths,0,0,0,0,0,0,0,0,0,0,0,0,0,0,0
D & N Haveli,2010,Molestation,0,0,0,0,0,0,0,0,0,0,0,0,0,0,0
D & N Haveli,2010,Eve-Teasing,0,0,0,0,0,0,0,0,0,0,0,0,0,0,0
D & N Haveli,2010,Cruelty By Husband Or Relative Of Husband,0,0,0,0,0,0,0,0,0,0,0,0,0,0,0
D & N Haveli,2010,Other Ipc Crimes,0,0,0,0,0,0,0,0,0,0,0,0,0,0,0
D & N Haveli,2011,Murder,0,0,0,0,0,0,0,0,0,0,0,0,0,0,0
D & N Haveli,2011,Attempt To Commit Murder,0,0,0,0,0,0,0,0,0,0,0,0,0,0,0
D & N Haveli,2011,C.H. Not Amounting To Murder,0,0,0,0,0,0,0,0,0,0,0,0,0,0,0
D & N Haveli,2011,Rape,0,0,0,0,0,0,0,0,0,0,0,0,0,0,0
D & N Haveli,2011,Kidnapping And Abduction,0,0,0,0,0,0,0,0,0,0,0,0,0,0,0
D & N Haveli,2011,Dacoity,0,0,0,0,0,0,0,0,0,0,0,0,0,0,0
D & N Haveli,2011,Prep. And Assembly For Dacoity,0,0,0,0,0,0,0,0,0,0,0,0,0,0,0
D & N Haveli,2011,Robbery,0,0,0,0,0,0,0,0,0,0,0,0,0,0,0
D & N Haveli,2011,Burglary,0,0,0,0,0,0,0,0,0,0,0,0,0,0,0
D & N Haveli,2011,Thefts,0,0,0,0,0,0,0,0,0,0,0,0,0,0,0
D & N Haveli,2011,Extortion,0,0,0,0,0,0,0,0,0,0,0,0,0,0,0
D & N Haveli,2011,Riots,0,0,0,0,0,0,0,0,0,0,0,0,0,0,0
D & N Haveli,2011,Arson,0,0,0,0,0,0,0,0,0,0,0,0,0,0,0
D & N Haveli,2011,Criminal Breach Of Trust,0,0,0,0,0,0,0,0,0,0,0,0,0,0,0
D & N Haveli,2011,Cheating,0,0,0,0,0,0,0,0,0,0,0,0,0,0,0
D & N Haveli,2011,Counter Feiting,0,0,0,0,0,0,0,0,0,0,0,0,0,0,0
D & N Haveli,2011,Dowry Deaths,0,0,0,0,0,0,0,0,0,0,0,0,0,0,0
D & N Haveli,2011,Molestation,0,0,0,0,0,0,0,0,0,0,0,0,0,0,0
D & N Haveli,2011,Eve-Teasing,0,0,0,0,0,0,0,0,0,0,0,0,0,0,0
D & N Haveli,2011,Cruelty By Husband Or Relative Of Husband,0,0,0,0,0,0,0,0,0,0,0,0,0,0,0
D & N Haveli,2011,Other Ipc Crimes,0,0,0,0,0,0,0,0,0,0,0,0,0,0,0
D & N Haveli,2012,Murder,0,0,0,0,0,0,0,0,0,0,0,0,0,0,0
D & N Haveli,2012,Attempt To Commit Murder,0,0,0,0,0,0,0,0,0,0,0,0,0,0,0
D & N Haveli,2012,C.H. Not Amounting To Murder,0,0,0,0,0,0,0,0,0,0,0,0,0,0,0
D & N Haveli,2012,Rape,0,0,0,0,0,0,0,0,0,0,0,0,0,0,0
D & N Haveli,2012,Kidnapping And Abduction,0,0,0,0,0,0,0,0,0,0,0,0,0,0,0
D & N Haveli,2012,Dacoity,0,0,0,0,0,0,0,0,0,0,0,0,0,0,0
D & N Haveli,2012,Prep. And Assembly For Dacoity,0,0,0,0,0,0,0,0,0,0,0,0,0,0,0
D & N Haveli,2012,Robbery,0,0,0,0,0,0,0,0,0,0,0,0,0,0,0
D & N Haveli,2012,Burglary,0,0,0,0,0,0,0,0,0,0,0,0,0,0,0
D & N Haveli,2012,Thefts,0,0,0,0,0,0,0,0,0,0,0,0,0,0,0
D & N Haveli,2012,Extortion,0,0,0,0,0,0,0,0,0,0,0,0,0,0,0
D & N Haveli,2012,Riots,0,0,0,0,0,0,0,0,0,0,0,0,0,0,0
D & N Haveli,2012,Arson,0,0,0,0,0,0,0,0,0,0,0,0,0,0,0
D & N Haveli,2012,Criminal Breach Of Trust,0,0,0,0,0,0,0,0,0,0,0,0,0,0,0
D & N Haveli,2012,Cheating,0,0,0,0,0,0,0,0,0,0,0,0,0,0,0
D & N Haveli,2012,Counter Feiting,0,0,0,0,0,0,0,0,0,0,0,0,0,0,0
D & N Haveli,2012,Dowry Deaths,0,0,0,0,0,0,0,0,0,0,0,0,0,0,0
D & N Haveli,2012,Molestation,0,0,0,0,0,0,0,0,0,0,0,0,0,0,0
D & N Haveli,2012,Eve-Teasing,0,0,0,0,0,0,0,0,0,0,0,0,0,0,0
D & N Haveli,2012,Cruelty By Husband Or Relative Of Husband,0,0,0,0,0,0,0,0,0,0,0,0,0,0,0
D & N Haveli,2012,Other Ipc Crimes,0,0,0,0,0,0,0,0,0,0,0,0,0,0,0
Daman & Diu,2001,Murder,0,0,0,0,0,0,9,0,9,3,0,3,12,0,12
Daman & Diu,2001,Attempt To Commit Murder,0,0,0,0,0,0,0,0,0,0,0,0,0,0,0
Daman & Diu,2001,C.H. Not Amounting To Murder,0,0,0,0,0,0,0,0,0,0,0,0,0,0,0
Daman & Diu,2001,Rape,0,0,0,0,0,0,0,0,0,0,0,0,0,0,0
Daman & Diu,2001,Kidnapping And Abduction,0,0,0,0,0,0,0,0,0,0,0,0,0,0,0
Daman & Diu,2001,Dacoity,0,0,0,0,0,0,0,0,0,0,0,0,0,0,0
Daman & Diu,2001,Prep. And Assembly For Dacoity,0,0,0,0,0,0,0,0,0,0,0,0,0,0,0
Daman & Diu,2001,Robbery,0,0,0,8,0,8,0,0,0,0,0,0,8,0,8
Daman & Diu,2001,Burglary,0,0,0,0,0,0,0,0,0,0,0,0,0,0,0
Daman & Diu,2001,Thefts,0,0,0,0,0,0,3,0,3,0,0,0,3,0,3
Daman & Diu,2001,Extortion,0,0,0,0,0,0,0,0,0,0,0,0,0,0,0
Daman & Diu,2001,Riots,0,0,0,0,0,0,0,0,0,0,0,0,0,0,0
Daman & Diu,2001,Arson,0,0,0,0,0,0,0,0,0,0,0,0,0,0,0
Daman & Diu,2001,Criminal Breach Of Trust,0,0,0,0,0,0,0,0,0,0,0,0,0,0,0
Daman & Diu,2001,Cheating,0,0,0,0,0,0,0,0,0,0,0,0,0,0,0
Daman & Diu,2001,Counter Feiting,0,0,0,0,0,0,0,0,0,0,0,0,0,0,0
Daman & Diu,2001,Dowry Deaths,0,0,0,0,0,0,0,0,0,0,0,0,0,0,0
Daman & Diu,2001,Molestation,0,0,0,0,0,0,0,0,0,0,0,0,0,0,0
Daman & Diu,2001,Eve-Teasing,0,0,0,0,0,0,0,0,0,0,0,0,0,0,0
Daman & Diu,2001,Cruelty By Husband Or Relative Of Husband,0,0,0,0,0,0,0,0,0,0,0,0,0,0,0
Daman & Diu,2001,Other Ipc Crimes,0,0,0,0,0,0,0,0,0,0,0,0,0,0,0
Daman & Diu,2002,Murder,0,0,0,1,0,1,8,0,8,2,0,2,11,0,11
Daman & Diu,2002,Attempt To Commit Murder,0,0,0,0,0,0,0,0,0,0,0,0,0,0,0
Daman & Diu,2002,C.H. Not Amounting To Murder,0,0,0,0,0,0,1,0,1,0,0,0,1,0,1
Daman & Diu,2002,Rape,0,0,0,0,0,0,0,0,0,0,0,0,0,0,0
Daman & Diu,2002,Kidnapping And Abduction,0,0,0,0,0,0,0,0,0,0,0,0,0,0,0
Daman & Diu,2002,Dacoity,0,0,0,0,0,0,0,0,0,0,0,0,0,0,0
Daman & Diu,2002,Prep. And Assembly For Dacoity,0,0,0,0,0,0,0,0,0,0,0,0,0,0,0
Daman & Diu,2002,Robbery,0,0,0,0,0,0,0,0,0,0,0,0,0,0,0
Daman & Diu,2002,Burglary,0,0,0,0,0,0,0,0,0,0,0,0,0,0,0
Daman & Diu,2002,Thefts,0,0,0,0,0,0,1,0,1,0,0,0,1,0,1
Daman & Diu,2002,Extortion,0,0,0,0,0,0,0,0,0,0,0,0,0,0,0
Daman & Diu,2002,Riots,0,0,0,0,0,0,0,0,0,0,0,0,0,0,0
Daman & Diu,2002,Arson,0,0,0,0,0,0,0,0,0,0,0,0,0,0,0
Daman & Diu,2002,Criminal Breach Of Trust,0,0,0,0,0,0,0,0,0,0,0,0,0,0,0
Daman & Diu,2002,Cheating,0,0,0,0,0,0,0,0,0,0,0,0,0,0,0
Daman & Diu,2002,Counter Feiting,0,0,0,0,0,0,0,0,0,0,0,0,0,0,0
Daman & Diu,2002,Dowry Deaths,0,0,0,0,0,0,0,0,0,0,0,0,0,0,0
Daman & Diu,2002,Molestation,0,0,0,0,0,0,0,0,0,0,0,0,0,0,0
Daman & Diu,2002,Eve-Teasing,0,0,0,0,0,0,0,0,0,0,0,0,0,0,0
Daman & Diu,2002,Cruelty By Husband Or Relative Of Husband,0,0,0,0,0,0,0,0,0,0,0,0,0,0,0
Daman & Diu,2002,Other Ipc Crimes,0,0,0,0,0,0,0,0,0,0,0,0,0,0,0
Daman & Diu,2003,Murder,0,0,0,0,0,0,13,0,13,0,0,0,13,0,13
Daman & Diu,2003,Attempt To Commit Murder,0,0,0,0,0,0,0,0,0,0,0,0,0,0,0
Daman & Diu,2003,C.H. Not Amounting To Murder,0,0,0,0,0,0,0,0,0,0,0,0,0,0,0
Daman & Diu,2003,Rape,0,0,0,0,0,0,0,0,0,0,0,0,0,0,0
Daman & Diu,2003,Kidnapping And Abduction,0,0,0,0,0,0,0,0,0,0,0,0,0,0,0
Daman & Diu,2003,Dacoity,0,0,0,0,0,0,0,0,0,0,0,0,0,0,0
Daman & Diu,2003,Prep. And Assembly For Dacoity,0,0,0,0,0,0,0,0,0,0,0,0,0,0,0
Daman & Diu,2003,Robbery,0,0,0,0,0,0,0,0,0,0,0,0,0,0,0
Daman & Diu,2003,Burglary,0,0,0,0,0,0,0,0,0,0,0,0,0,0,0
Daman & Diu,2003,Thefts,0,0,0,0,0,0,0,0,0,0,0,0,0,0,0
Daman & Diu,2003,Extortion,0,0,0,0,0,0,0,0,0,0,0,0,0,0,0
Daman & Diu,2003,Riots,0,0,0,0,0,0,0,0,0,0,0,0,0,0,0
Daman & Diu,2003,Arson,0,0,0,0,0,0,0,0,0,0,0,0,0,0,0
Daman & Diu,2003,Criminal Breach Of Trust,0,0,0,0,0,0,0,0,0,0,0,0,0,0,0
Daman & Diu,2003,Cheating,0,0,0,0,0,0,0,0,0,0,0,0,0,0,0
Daman & Diu,2003,Counter Feiting,0,0,0,0,0,0,0,0,0,0,0,0,0,0,0
Daman & Diu,2003,Dowry Deaths,0,0,0,0,0,0,0,0,0,0,0,0,0,0,0
Daman & Diu,2003,Molestation,0,0,0,0,0,0,0,0,0,0,0,0,0,0,0
Daman & Diu,2003,Eve-Teasing,0,0,0,0,0,0,0,0,0,0,0,0,0,0,0
Daman & Diu,2003,Cruelty By Husband Or Relative Of Husband,0,0,0,0,0,0,0,0,0,0,0,0,0,0,0
Daman & Diu,2003,Other Ipc Crimes,0,0,0,0,0,0,0,0,0,0,0,0,0,0,0
Daman & Diu,2004,Murder,0,0,0,0,0,0,6,0,6,2,0,2,8,0,8
Daman & Diu,2004,Attempt To Commit Murder,0,0,0,0,0,0,0,0,0,0,0,0,0,0,0
Daman & Diu,2004,C.H. Not Amounting To Murder,0,0,0,0,0,0,0,0,0,0,0,0,0,0,0
Daman & Diu,2004,Rape,0,0,0,0,0,0,0,0,0,0,0,0,0,0,0
Daman & Diu,2004,Kidnapping And Abduction,0,0,0,0,0,0,0,0,0,0,0,0,0,0,0
Daman & Diu,2004,Dacoity,0,0,0,0,0,0,0,0,0,0,0,0,0,0,0
Daman & Diu,2004,Prep. And Assembly For Dacoity,0,0,0,0,0,0,0,0,0,0,0,0,0,0,0
Daman & Diu,2004,Robbery,0,0,0,0,0,0,0,0,0,0,0,0,0,0,0
Daman & Diu,2004,Burglary,0,0,0,0,0,0,0,0,0,0,0,0,0,0,0
Daman & Diu,2004,Thefts,0,0,0,0,0,0,0,0,0,0,0,0,0,0,0
Daman & Diu,2004,Extortion,0,0,0,0,0,0,0,0,0,0,0,0,0,0,0
Daman & Diu,2004,Riots,0,0,0,0,0,0,0,0,0,0,0,0,0,0,0
Daman & Diu,2004,Arson,0,0,0,0,0,0,0,0,0,0,0,0,0,0,0
Daman & Diu,2004,Criminal Breach Of Trust,0,0,0,0,0,0,0,0,0,0,0,0,0,0,0
Daman & Diu,2004,Cheating,0,0,0,0,0,0,0,0,0,0,0,0,0,0,0
Daman & Diu,2004,Counter Feiting,0,0,0,0,0,0,0,0,0,0,0,0,0,0,0
Daman & Diu,2004,Dowry Deaths,0,0,0,0,0,0,0,0,0,0,0,0,0,0,0
Daman & Diu,2004,Molestation,0,0,0,0,0,0,0,0,0,0,0,0,0,0,0
Daman & Diu,2004,Eve-Teasing,0,0,0,0,0,0,0,0,0,0,0,0,0,0,0
Daman & Diu,2004,Cruelty By Husband Or Relative Of Husband,0,0,0,0,0,0,0,0,0,0,0,0,0,0,0
Daman & Diu,2004,Other Ipc Crimes,0,0,0,0,0,0,0,0,0,0,0,0,0,0,0
Daman & Diu,2005,Murder,0,0,0,0,0,0,7,0,7,3,0,3,10,0,10
Daman & Diu,2005,Attempt To Commit Murder,0,0,0,1,0,1,0,0,0,0,0,0,1,0,1
Daman & Diu,2005,C.H. Not Amounting To Murder,0,0,0,0,0,0,0,0,0,0,0,0,0,0,0
Daman & Diu,2005,Rape,0,0,0,0,0,0,0,0,0,0,0,0,0,0,0
Daman & Diu,2005,Kidnapping And Abduction,0,0,0,0,0,0,0,0,0,0,0,0,0,0,0
Daman & Diu,2005,Dacoity,0,0,0,0,0,0,0,0,0,0,0,0,0,0,0
Daman & Diu,2005,Prep. And Assembly For Dacoity,0,0,0,0,0,0,0,0,0,0,0,0,0,0,0
Daman & Diu,2005,Robbery,0,0,0,0,0,0,0,0,0,0,0,0,0,0,0
Daman & Diu,2005,Burglary,0,0,0,0,0,0,0,0,0,0,0,0,0,0,0
Daman & Diu,2005,Thefts,0,0,0,0,0,0,0,0,0,0,0,0,0,0,0
Daman & Diu,2005,Extortion,0,0,0,0,0,0,0,0,0,0,0,0,0,0,0
Daman & Diu,2005,Riots,0,0,0,0,0,0,0,0,0,0,0,0,0,0,0
Daman & Diu,2005,Arson,0,0,0,0,0,0,0,0,0,0,0,0,0,0,0
Daman & Diu,2005,Criminal Breach Of Trust,0,0,0,0,0,0,0,0,0,0,0,0,0,0,0
Daman & Diu,2005,Cheating,0,0,0,0,0,0,0,0,0,0,0,0,0,0,0
Daman & Diu,2005,Counter Feiting,0,0,0,0,0,0,0,0,0,0,0,0,0,0,0
Daman & Diu,2005,Dowry Deaths,0,0,0,0,0,0,0,0,0,0,0,0,0,0,0
Daman & Diu,2005,Molestation,0,0,0,0,0,0,0,0,0,0,0,0,0,0,0
Daman & Diu,2005,Eve-Teasing,0,0,0,0,0,0,0,0,0,0,0,0,0,0,0
Daman & Diu,2005,Cruelty By Husband Or Relative Of Husband,0,0,0,0,0,0,0,0,0,0,0,0,0,0,0
Daman & Diu,2005,Other Ipc Crimes,0,0,0,0,0,0,0,0,0,0,0,0,0,0,0
Daman & Diu,2006,Murder,0,0,0,8,0,8,2,0,2,2,0,2,12,0,12
Daman & Diu,2006,Attempt To Commit Murder,0,0,0,0,0,0,0,0,0,0,0,0,0,0,0
Daman & Diu,2006,C.H. Not Amounting To Murder,0,0,0,0,0,0,0,0,0,0,0,0,0,0,0
Daman & Diu,2006,Rape,0,0,0,0,0,0,0,0,0,0,0,0,0,0,0
Daman & Diu,2006,Kidnapping And Abduction,0,0,0,0,0,0,0,0,0,0,0,0,0,0,0
Daman & Diu,2006,Dacoity,0,0,0,0,0,0,0,0,0,0,0,0,0,0,0
Daman & Diu,2006,Prep. And Assembly For Dacoity,0,0,0,0,0,0,0,0,0,0,0,0,0,0,0
Daman & Diu,2006,Robbery,0,0,0,0,0,0,0,0,0,0,0,0,0,0,0
Daman & Diu,2006,Burglary,0,0,0,0,0,0,0,0,0,0,0,0,0,0,0
Daman & Diu,2006,Thefts,0,0,0,0,0,0,0,0,0,0,0,0,0,0,0
Daman & Diu,2006,Extortion,0,0,0,0,0,0,0,0,0,0,0,0,0,0,0
Daman & Diu,2006,Riots,0,0,0,0,0,0,0,0,0,0,0,0,0,0,0
Daman & Diu,2006,Arson,0,0,0,0,0,0,0,0,0,0,0,0,0,0,0
Daman & Diu,2006,Criminal Breach Of Trust,0,0,0,0,0,0,0,0,0,0,0,0,0,0,0
Daman & Diu,2006,Cheating,0,0,0,0,0,0,0,0,0,0,0,0,0,0,0
Daman & Diu,2006,Counter Feiting,0,0,0,0,0,0,0,0,0,0,0,0,0,0,0
Daman & Diu,2006,Dowry Deaths,0,0,0,0,0,0,0,0,0,0,0,0,0,0,0
Daman & Diu,2006,Molestation,0,0,0,0,0,0,0,0,0,0,0,0,0,0,0
Daman & Diu,2006,Eve-Teasing,0,0,0,0,0,0,0,0,0,0,0,0,0,0,0
Daman & Diu,2006,Cruelty By Husband Or Relative Of Husband,0,0,0,0,0,0,0,0,0,0,0,0,0,0,0
Daman & Diu,2006,Other Ipc Crimes,0,0,0,0,0,0,0,0,0,0,0,0,0,0,0
Daman & Diu,2007,Murder,0,0,0,3,0,3,3,2,5,1,0,1,7,2,9
Daman & Diu,2007,Attempt To Commit Murder,0,0,0,0,0,0,1,0,1,0,0,0,1,0,1
Daman & Diu,2007,C.H. Not Amounting To Murder,0,0,0,0,0,0,0,0,0,0,0,0,0,0,0
Daman & Diu,2007,Rape,0,0,0,0,0,0,0,0,0,0,0,0,0,0,0
Daman & Diu,2007,Kidnapping And Abduction,0,0,0,0,0,0,0,0,0,0,0,0,0,0,0
Daman & Diu,2007,Dacoity,0,0,0,0,0,0,0,0,0,0,0,0,0,0,0
Daman & Diu,2007,Prep. And Assembly For Dacoity,0,0,0,0,0,0,0,0,0,0,0,0,0,0,0
Daman & Diu,2007,Robbery,0,0,0,0,0,0,0,0,0,0,0,0,0,0,0
Daman & Diu,2007,Burglary,0,0,0,0,0,0,0,0,0,0,0,0,0,0,0
Daman & Diu,2007,Thefts,0,0,0,0,0,0,0,0,0,0,0,0,0,0,0
Daman & Diu,2007,Extortion,0,0,0,0,0,0,0,0,0,0,0,0,0,0,0
Daman & Diu,2007,Riots,0,0,0,0,0,0,0,0,0,0,0,0,0,0,0
Daman & Diu,2007,Arson,0,0,0,0,0,0,0,0,0,0,0,0,0,0,0
Daman & Diu,2007,Criminal Breach Of Trust,0,0,0,0,0,0,0,0,0,0,0,0,0,0,0
Daman & Diu,2007,Cheating,0,0,0,0,0,0,0,0,0,0,0,0,0,0,0
Daman & Diu,2007,Counter Feiting,0,0,0,0,0,0,0,0,0,0,0,0,0,0,0
Daman & Diu,2007,Dowry Deaths,0,0,0,0,0,0,0,0,0,0,0,0,0,0,0
Daman & Diu,2007,Molestation,0,0,0,0,0,0,0,0,0,0,0,0,0,0,0
Daman & Diu,2007,Eve-Teasing,0,0,0,0,0,0,0,0,0,0,0,0,0,0,0
Daman & Diu,2007,Cruelty By Husband Or Relative Of Husband,0,0,0,0,0,0,0,0,0,0,0,0,0,0,0
Daman & Diu,2007,Other Ipc Crimes,0,0,0,0,0,0,0,0,0,0,0,0,0,0,0
Daman & Diu,2008,Murder,0,0,0,3,2,5,0,0,0,0,0,0,3,2,5
Daman & Diu,2008,Attempt To Commit Murder,0,0,0,0,0,0,0,0,0,0,0,0,0,0,0
Daman & Diu,2008,C.H. Not Amounting To Murder,0,0,0,1,0,1,0,0,0,0,0,0,1,0,1
Daman & Diu,2008,Rape,0,0,0,0,0,0,0,0,0,0,0,0,0,0,0
Daman & Diu,2008,Kidnapping And Abduction,0,0,0,0,0,0,0,0,0,0,0,0,0,0,0
Daman & Diu,2008,Dacoity,0,0,0,0,0,0,0,0,0,0,0,0,0,0,0
Daman & Diu,2008,Prep. And Assembly For Dacoity,0,0,0,0,0,0,0,0,0,0,0,0,0,0,0
Daman & Diu,2008,Robbery,0,0,0,2,0,2,4,0,4,3,0,3,9,0,9
Daman & Diu,2008,Burglary,0,0,0,1,0,1,0,0,0,0,0,0,1,0,1
Daman & Diu,2008,Thefts,0,0,0,0,0,0,0,0,0,0,0,0,0,0,0
Daman & Diu,2008,Extortion,0,0,0,0,0,0,0,0,0,0,0,0,0,0,0
Daman & Diu,2008,Riots,0,0,0,0,0,0,0,0,0,0,0,0,0,0,0
Daman & Diu,2008,Arson,0,0,0,0,0,0,0,0,0,0,0,0,0,0,0
Daman & Diu,2008,Criminal Breach Of Trust,0,0,0,0,0,0,0,0,0,0,0,0,0,0,0
Daman & Diu,2008,Cheating,0,0,0,0,0,0,0,0,0,0,0,0,0,0,0
Daman & Diu,2008,Counter Feiting,0,0,0,0,0,0,0,0,0,0,0,0,0,0,0
Daman & Diu,2008,Dowry Deaths,0,0,0,0,0,0,0,0,0,0,0,0,0,0,0
Daman & Diu,2008,Molestation,0,0,0,0,0,0,0,0,0,0,0,0,0,0,0
Daman & Diu,2008,Eve-Teasing,0,0,0,0,0,0,0,0,0,0,0,0,0,0,0
Daman & Diu,2008,Cruelty By Husband Or Relative Of Husband,0,0,0,0,0,0,0,0,0,0,0,0,0,0,0
Daman & Diu,2008,Other Ipc Crimes,0,0,0,0,0,0,0,0,0,0,0,0,0,0,0
Daman & Diu,2009,Murder,0,0,0,0,0,0,3,1,4,2,0,2,5,1,6
Daman & Diu,2009,Attempt To Commit Murder,0,0,0,0,0,0,0,0,0,0,0,0,0,0,0
Daman & Diu,2009,C.H. Not Amounting To Murder,0,0,0,0,0,0,1,0,1,0,0,0,1,0,1
Daman & Diu,2009,Rape,0,0,0,0,0,0,0,0,0,0,0,0,0,0,0
Daman & Diu,2009,Kidnapping And Abduction,0,0,0,0,0,0,0,0,0,0,0,0,0,0,0
Daman & Diu,2009,Dacoity,0,0,0,1,0,1,0,0,0,0,0,0,1,0,1
Daman & Diu,2009,Prep. And Assembly For Dacoity,0,0,0,0,0,0,0,0,0,0,0,0,0,0,0
Daman & Diu,2009,Robbery,0,0,0,0,0,0,0,0,0,0,0,0,0,0,0
Daman & Diu,2009,Burglary,0,0,0,1,0,1,0,0,0,0,0,0,1,0,1
Daman & Diu,2009,Thefts,0,0,0,5,0,5,0,0,0,0,0,0,5,0,5
Daman & Diu,2009,Extortion,0,0,0,0,0,0,0,0,0,0,0,0,0,0,0
Daman & Diu,2009,Riots,0,0,0,0,0,0,0,0,0,0,0,0,0,0,0
Daman & Diu,2009,Arson,0,0,0,0,0,0,0,0,0,0,0,0,0,0,0
Daman & Diu,2009,Criminal Breach Of Trust,0,0,0,0,0,0,0,0,0,0,0,0,0,0,0
Daman & Diu,2009,Cheating,0,0,0,0,0,0,0,0,0,0,0,0,0,0,0
Daman & Diu,2009,Counter Feiting,0,0,0,0,0,0,0,0,0,0,0,0,0,0,0
Daman & Diu,2009,Dowry Deaths,0,0,0,0,0,0,1,0,1,0,0,0,1,0,1
Daman & Diu,2009,Molestation,0,0,0,0,0,0,0,0,0,0,0,0,0,0,0
Daman & Diu,2009,Eve-Teasing,0,0,0,0,0,0,0,0,0,0,0,0,0,0,0
Daman & Diu,2009,Cruelty By Husband Or Relative Of Husband,0,0,0,0,0,0,0,0,0,0,0,0,0,0,0
Daman & Diu,2009,Other Ipc Crimes,0,0,0,0,0,0,0,0,0,0,0,0,0,0,0
Daman & Diu,2010,Murder,0,0,0,2,0,2,7,1,8,4,0,4,13,1,14
Daman & Diu,2010,Attempt To Commit Murder,0,0,0,0,0,0,0,0,0,0,0,0,0,0,0
Daman & Diu,2010,C.H. Not Amounting To Murder,0,0,0,0,0,0,0,0,0,0,0,0,0,0,0
Daman & Diu,2010,Rape,0,0,0,0,0,0,0,0,0,0,0,0,0,0,0
Daman & Diu,2010,Kidnapping And Abduction,0,0,0,0,0,0,0,0,0,0,0,0,0,0,0
Daman & Diu,2010,Dacoity,0,0,0,0,0,0,0,0,0,0,0,0,0,0,0
Daman & Diu,2010,Prep. And Assembly For Dacoity,0,0,0,0,0,0,0,0,0,0,0,0,0,0,0
Daman & Diu,2010,Robbery,0,0,0,0,0,0,0,0,0,0,0,0,0,0,0
Daman & Diu,2010,Burglary,0,0,0,0,0,0,0,0,0,0,0,0,0,0,0
Daman & Diu,2010,Thefts,0,0,0,0,0,0,0,0,0,0,0,0,0,0,0
Daman & Diu,2010,Extortion,0,0,0,0,0,0,0,0,0,0,0,0,0,0,0
Daman & Diu,2010,Riots,0,0,0,0,0,0,0,0,0,0,0,0,0,0,0
Daman & Diu,2010,Arson,0,0,0,0,0,0,0,0,0,0,0,0,0,0,0
Daman & Diu,2010,Criminal Breach Of Trust,0,0,0,0,0,0,0,0,0,0,0,0,0,0,0
Daman & Diu,2010,Cheating,0,0,0,0,0,0,0,0,0,0,0,0,0,0,0
Daman & Diu,2010,Counter Feiting,0,0,0,0,0,0,0,0,0,0,0,0,0,0,0
Daman & Diu,2010,Dowry Deaths,0,0,0,0,0,0,0,0,0,0,0,0,0,0,0
Daman & Diu,2010,Molestation,0,0,0,0,0,0,0,0,0,0,0,0,0,0,0
Daman & Diu,2010,Eve-Teasing,0,0,0,0,0,0,0,0,0,0,0,0,0,0,0
Daman & Diu,2010,Cruelty By Husband Or Relative Of Husband,0,0,0,0,0,0,0,0,0,0,0,0,0,0,0
Daman & Diu,2010,Other Ipc Crimes,0,0,0,0,0,0,0,0,0,0,0,0,0,0,0
Daman & Diu,2011,Murder,0,0,0,5,0,5,6,1,7,0,0,0,11,1,12
Daman & Diu,2011,Attempt To Commit Murder,0,0,0,0,0,0,0,0,0,0,0,0,0,0,0
Daman & Diu,2011,C.H. Not Amounting To Murder,0,0,0,0,0,0,0,0,0,0,0,0,0,0,0
Daman & Diu,2011,Rape,0,0,0,0,0,0,0,0,0,0,0,0,0,0,0
Daman & Diu,2011,Kidnapping And Abduction,0,0,0,0,0,0,0,0,0,0,0,0,0,0,0
Daman & Diu,2011,Dacoity,0,0,0,0,0,0,0,0,0,0,0,0,0,0,0
Daman & Diu,2011,Prep. And Assembly For Dacoity,0,0,0,0,0,0,0,0,0,0,0,0,0,0,0
Daman & Diu,2011,Robbery,0,0,0,0,0,0,0,0,0,0,0,0,0,0,0
Daman & Diu,2011,Burglary,0,0,0,0,0,0,0,0,0,0,0,0,0,0,0
Daman & Diu,2011,Thefts,0,0,0,0,0,0,0,0,0,0,0,0,0,0,0
Daman & Diu,2011,Extortion,0,0,0,0,0,0,0,0,0,0,0,0,0,0,0
Daman & Diu,2011,Riots,0,0,0,0,0,0,0,0,0,0,0,0,0,0,0
Daman & Diu,2011,Arson,0,0,0,0,0,0,0,0,0,0,0,0,0,0,0
Daman & Diu,2011,Criminal Breach Of Trust,0,0,0,0,0,0,0,0,0,0,0,0,0,0,0
Daman & Diu,2011,Cheating,0,0,0,0,0,0,0,0,0,0,0,0,0,0,0
Daman & Diu,2011,Counter Feiting,0,0,0,0,0,0,0,0,0,0,0,0,0,0,0
Daman & Diu,2011,Dowry Deaths,0,0,0,0,0,0,0,0,0,0,0,0,0,0,0
Daman & Diu,2011,Molestation,0,0,0,0,0,0,0,0,0,0,0,0,0,0,0
Daman & Diu,2011,Eve-Teasing,0,0,0,0,0,0,0,0,0,0,0,0,0,0,0
Daman & Diu,2011,Cruelty By Husband Or Relative Of Husband,0,0,0,0,0,0,0,0,0,0,0,0,0,0,0
Daman & Diu,2011,Other Ipc Crimes,0,0,0,0,0,0,0,0,0,0,0,0,0,0,0
Daman & Diu,2012,Murder,0,0,0,4,0,4,5,1,6,3,0,3,12,1,13
Daman & Diu,2012,Attempt To Commit Murder,0,0,0,0,0,0,0,0,0,0,0,0,0,0,0
Daman & Diu,2012,C.H. Not Amounting To Murder,0,0,0,0,0,0,0,0,0,0,0,0,0,0,0
Daman & Diu,2012,Rape,0,0,0,1,0,1,0,0,0,0,0,0,1,0,1
Daman & Diu,2012,Kidnapping And Abduction,0,0,0,0,0,0,0,0,0,0,0,0,0,0,0
Daman & Diu,2012,Dacoity,0,0,0,0,0,0,0,0,0,0,0,0,0,0,0
Daman & Diu,2012,Prep. And Assembly For Dacoity,0,0,0,0,0,0,0,0,0,0,0,0,0,0,0
Daman & Diu,2012,Robbery,0,0,0,0,0,0,0,0,0,0,0,0,0,0,0
Daman & Diu,2012,Burglary,0,0,0,0,0,0,0,0,0,0,0,0,0,0,0
Daman & Diu,2012,Thefts,0,0,0,0,0,0,0,0,0,0,0,0,0,0,0
Daman & Diu,2012,Extortion,0,0,0,0,0,0,0,0,0,0,0,0,0,0,0
Daman & Diu,2012,Riots,0,0,0,0,0,0,0,0,0,0,0,0,0,0,0
Daman & Diu,2012,Arson,0,0,0,0,0,0,0,0,0,0,0,0,0,0,0
Daman & Diu,2012,Criminal Breach Of Trust,0,0,0,0,0,0,0,0,0,0,0,0,0,0,0
Daman & Diu,2012,Cheating,0,0,0,0,0,0,0,0,0,0,0,0,0,0,0
Daman & Diu,2012,Counter Feiting,0,0,0,0,0,0,0,0,0,0,0,0,0,0,0
Daman & Diu,2012,Dowry Deaths,0,0,0,0,0,0,0,0,0,0,0,0,0,0,0
Daman & Diu,2012,Molestation,0,0,0,0,0,0,0,0,0,0,0,0,0,0,0
Daman & Diu,2012,Eve-Teasing,0,0,0,0,0,0,0,0,0,0,0,0,0,0,0
Daman & Diu,2012,Cruelty By Husband Or Relative Of Husband,0,0,0,0,0,0,0,0,0,0,0,0,0,0,0
Daman & Diu,2012,Other Ipc Crimes,0,0,0,0,0,0,0,0,0,0,0,0,0,0,0
Delhi,2001,Murder,12,0,12,402,17,419,335,23,358,84,9,93,833,49,882
Delhi,2001,Attempt To Commit Murder,2,0,2,48,0,48,36,0,36,19,0,19,105,0,105
Delhi,2001,C.H. Not Amounting To Murder,3,0,3,39,0,39,27,0,27,16,0,16,85,0,85
Delhi,2001,Rape,10,0,10,104,0,104,55,1,56,11,0,11,180,1,181
Delhi,2001,Kidnapping And Abduction,2,0,2,49,9,58,26,7,33,10,0,10,87,16,103
Delhi,2001,Dacoity,7,0,7,60,0,60,30,0,30,5,0,5,102,0,102
Delhi,2001,Prep. And Assembly For Dacoity,2,0,2,40,0,40,20,0,20,8,0,8,70,0,70
Delhi,2001,Robbery,5,0,5,26,0,26,5,0,5,3,0,3,39,0,39
Delhi,2001,Burglary,0,0,0,4,0,4,2,0,2,0,0,0,6,0,6
Delhi,2001,Thefts,6,0,6,48,0,48,30,0,30,10,0,10,94,0,94
Delhi,2001,Extortion,0,0,0,0,0,0,0,0,0,0,0,0,0,0,0
Delhi,2001,Riots,0,0,0,8,0,8,5,0,5,7,0,7,20,0,20
Delhi,2001,Arson,0,0,0,0,0,0,0,0,0,0,0,0,0,0,0
Delhi,2001,Criminal Breach Of Trust,0,0,0,3,0,3,3,0,3,0,0,0,6,0,6
Delhi,2001,Cheating,0,0,0,7,0,7,12,0,12,4,0,4,23,0,23
Delhi,2001,Counter Feiting,0,0,0,16,0,16,7,0,7,2,0,2,25,0,25
Delhi,2001,Dowry Deaths,0,0,0,20,0,20,7,0,7,2,0,2,29,0,29
Delhi,2001,Molestation,0,0,0,0,0,0,0,0,0,1,0,1,1,0,1
Delhi,2001,Eve-Teasing,0,0,0,0,0,0,0,0,0,0,0,0,0,0,0
Delhi,2001,Cruelty By Husband Or Relative Of Husband,0,0,0,5,0,5,6,0,6,0,0,0,11,0,11
Delhi,2001,Other Ipc Crimes,0,0,0,10,0,10,4,0,4,2,0,2,16,0,16
Delhi,2002,Murder,0,0,0,468,10,478,321,29,350,61,3,64,850,42,892
Delhi,2002,Attempt To Commit Murder,0,0,0,43,0,43,37,0,37,3,0,3,83,0,83
Delhi,2002,C.H. Not Amounting To Murder,0,0,0,26,0,26,23,0,23,1,0,1,50,0,50
Delhi,2002,Rape,0,0,0,146,4,150,57,8,65,4,1,5,207,13,220
Delhi,2002,Kidnapping And Abduction,0,0,0,60,2,62,39,3,42,5,0,5,104,5,109
Delhi,2002,Dacoity,0,0,0,129,0,129,84,0,84,5,0,5,218,0,218
Delhi,2002,Prep. And Assembly For Dacoity,0,0,0,5,0,5,1,0,1,0,0,0,6,0,6
Delhi,2002,Robbery,0,0,0,65,0,65,21,0,21,2,0,2,88,0,88
Delhi,2002,Burglary,0,0,0,2,0,2,0,0,0,0,0,0,2,0,2
Delhi,2002,Thefts,0,0,0,57,0,57,16,0,16,2,0,2,75,0,75
Delhi,2002,Extortion,0,0,0,0,0,0,0,0,0,0,0,0,0,0,0
Delhi,2002,Riots,0,0,0,0,0,0,0,0,0,0,0,0,0,0,0
Delhi,2002,Arson,0,0,0,0,0,0,0,0,0,0,0,0,0,0,0
Delhi,2002,Criminal Breach Of Trust,0,0,0,0,0,0,0,0,0,0,0,0,0,0,0
Delhi,2002,Cheating,0,0,0,10,0,10,10,2,12,4,0,4,24,2,26
Delhi,2002,Counter Feiting,0,0,0,1,0,1,1,0,1,0,0,0,2,0,2
Delhi,2002,Dowry Deaths,0,0,0,36,7,43,16,14,30,10,17,27,62,38,100
Delhi,2002,Molestation,0,0,0,0,0,0,0,0,0,0,0,0,0,0,0
Delhi,2002,Eve-Teasing,0,0,0,1,0,1,0,0,0,0,0,0,1,0,1
Delhi,2002,Cruelty By Husband Or Relative Of Husband,0,0,0,0,0,0,0,0,0,0,0,0,0,0,0
Delhi,2002,Other Ipc Crimes,0,0,0,17,0,17,12,0,12,0,0,0,29,0,29
Delhi,2003,Murder,0,0,0,0,0,0,0,0,0,0,0,0,0,0,0
Delhi,2003,Murder,0,0,0,492,14,506,342,14,356,57,7,64,891,35,926
Delhi,2003,Attempt To Commit Murder,0,0,0,52,0,52,27,0,27,1,0,1,80,0,80
Delhi,2003,C.H. Not Amounting To Murder,0,0,0,6,0,6,11,0,11,1,0,1,18,0,18
Delhi,2003,Rape,0,0,0,124,0,124,71,4,75,10,1,11,205,5,210
Delhi,2003,Kidnapping And Abduction,0,0,0,55,7,62,52,8,60,13,3,16,120,18,138
Delhi,2003,Dacoity,0,0,0,104,0,104,83,0,83,10,0,10,197,0,197
Delhi,2003,Prep. And Assembly For Dacoity,0,0,0,13,0,13,0,0,0,0,0,0,13,0,13
Delhi,2003,Robbery,0,0,0,46,0,46,13,0,13,1,0,1,60,0,60
Delhi,2003,Burglary,0,0,0,1,0,1,0,0,0,0,0,0,1,0,1
Delhi,2003,Thefts,0,0,0,49,2,51,24,1,25,5,0,5,78,3,81
Delhi,2003,Extortion,0,0,0,0,0,0,0,0,0,0,0,0,0,0,0
Delhi,2003,Riots,0,0,0,0,0,0,0,0,0,0,0,0,0,0,0
Delhi,2003,Arson,0,0,0,0,0,0,1,0,1,0,0,0,1,0,1
Delhi,2003,Criminal Breach Of Trust,0,0,0,0,0,0,0,0,0,0,0,0,0,0,0
Delhi,2003,Cheating,0,0,0,10,2,12,16,0,16,9,0,9,35,2,37
Delhi,2003,Counter Feiting,0,0,0,1,0,1,0,0,0,0,0,0,1,0,1
Delhi,2003,Dowry Deaths,0,0,0,28,13,41,37,18,55,11,13,24,76,44,120
Delhi,2003,Molestation,0,0,0,1,0,1,0,0,0,0,0,0,1,0,1
Delhi,2003,Eve-Teasing,0,0,0,2,0,2,0,0,0,0,0,0,2,0,2
Delhi,2003,Cruelty By Husband Or Relative Of Husband,0,0,0,0,0,0,0,0,0,0,0,0,0,0,0
Delhi,2003,Other Ipc Crimes,0,0,0,18,0,18,7,2,9,0,0,0,25,2,27
Delhi,2004,Murder,0,0,0,487,12,499,427,27,454,51,9,60,965,48,1013
Delhi,2004,Attempt To Commit Murder,0,0,0,65,0,65,52,0,52,9,0,9,126,0,126
Delhi,2004,C.H. Not Amounting To Murder,0,0,0,4,0,4,2,0,2,0,0,0,6,0,6
Delhi,2004,Rape,0,0,0,92,3,95,73,4,77,5,3,8,170,10,180
Delhi,2004,Kidnapping And Abduction,0,0,0,70,7,77,23,16,39,0,3,3,93,26,119
Delhi,2004,Dacoity,0,0,0,82,0,82,49,0,49,5,0,5,136,0,136
Delhi,2004,Prep. And Assembly For Dacoity,0,0,0,1,0,1,0,0,0,1,0,1,2,0,2
Delhi,2004,Robbery,0,0,0,58,0,58,35,0,35,4,0,4,97,0,97
Delhi,2004,Burglary,0,0,0,1,0,1,0,0,0,0,0,0,1,0,1
Delhi,2004,Thefts,0,0,0,96,0,96,26,0,26,7,0,7,129,0,129
Delhi,2004,Extortion,0,0,0,0,0,0,2,0,2,0,0,0,2,0,2
Delhi,2004,Riots,0,0,0,2,0,2,0,0,0,0,0,0,2,0,2
Delhi,2004,Arson,0,0,0,0,0,0,0,0,0,0,0,0,0,0,0
Delhi,2004,Criminal Breach Of Trust,0,0,0,2,0,2,1,0,1,3,0,3,6,0,6
Delhi,2004,Cheating,0,0,0,56,0,56,6,1,7,7,0,7,69,1,70
Delhi,2004,Counter Feiting,0,0,0,5,0,5,0,0,0,0,0,0,5,0,5
Delhi,2004,Dowry Deaths,0,0,0,50,2,52,26,12,38,14,13,27,90,27,117
Delhi,2004,Molestation,0,0,0,6,0,6,1,0,1,0,0,0,7,0,7
Delhi,2004,Eve-Teasing,0,0,0,2,0,2,1,0,1,1,0,1,4,0,4
Delhi,2004,Cruelty By Husband Or Relative Of Husband,0,0,0,0,0,0,1,0,1,0,0,0,1,0,1
Delhi,2004,Other Ipc Crimes,0,0,0,52,0,52,48,3,51,13,0,13,113,3,116
Delhi,2005,Murder,0,0,0,481,4,485,319,12,331,45,11,56,845,27,872
Delhi,2005,Attempt To Commit Murder,0,0,0,63,1,64,41,0,41,8,1,9,112,2,114
Delhi,2005,C.H. Not Amounting To Murder,0,0,0,11,0,11,8,0,8,0,0,0,19,0,19
Delhi,2005,Rape,0,0,0,126,2,128,71,4,75,11,2,13,208,8,216
Delhi,2005,Kidnapping And Abduction,0,0,0,50,1,51,44,11,55,1,2,3,95,14,109
Delhi,2005,Dacoity,0,0,0,141,0,141,49,0,49,5,0,5,195,0,195
Delhi,2005,Prep. And Assembly For Dacoity,0,0,0,13,0,13,3,0,3,1,0,1,17,0,17
Delhi,2005,Robbery,0,0,0,40,0,40,39,0,39,7,0,7,86,0,86
Delhi,2005,Burglary,0,0,0,1,0,1,1,0,1,0,0,0,2,0,2
Delhi,2005,Thefts,0,0,0,86,1,87,34,2,36,8,1,9,128,4,132
Delhi,2005,Extortion,0,0,0,0,0,0,4,0,4,0,0,0,4,0,4
Delhi,2005,Riots,0,0,0,0,0,0,0,0,0,0,0,0,0,0,0
Delhi,2005,Arson,0,0,0,0,0,0,0,0,0,0,0,0,0,0,0
Delhi,2005,Criminal Breach Of Trust,0,0,0,1,0,1,1,0,1,0,0,0,2,0,2
Delhi,2005,Cheating,0,0,0,6,0,6,8,1,9,0,0,0,14,1,15
Delhi,2005,Counter Feiting,0,0,0,0,0,0,5,0,5,2,0,2,7,0,7
Delhi,2005,Dowry Deaths,0,0,0,44,0,44,50,20,70,19,8,27,113,28,141
Delhi,2005,Molestation,0,0,0,0,0,0,3,0,3,4,0,4,7,0,7
Delhi,2005,Eve-Teasing,0,0,0,3,0,3,0,0,0,0,0,0,3,0,3
Delhi,2005,Cruelty By Husband Or Relative Of Husband,0,0,0,3,0,3,0,0,0,4,0,4,7,0,7
Delhi,2005,Other Ipc Crimes,0,0,0,67,0,67,70,1,71,1,0,1,138,1,139
Delhi,2006,Murder,0,0,0,349,5,354,297,15,312,50,6,56,696,26,722
Delhi,2006,Attempt To Commit Murder,0,0,0,59,0,59,65,3,68,8,0,8,132,3,135
Delhi,2006,C.H. Not Amounting To Murder,0,0,0,1,0,1,4,0,4,1,0,1,6,0,6
Delhi,2006,Rape,0,0,0,156,0,156,105,1,106,17,3,20,278,4,282
Delhi,2006,Kidnapping And Abduction,0,0,0,43,0,43,23,4,27,3,3,6,69,7,76
Delhi,2006,Dacoity,0,0,0,154,0,154,140,0,140,5,0,5,299,0,299
Delhi,2006,Prep. And Assembly For Dacoity,0,0,0,2,0,2,3,0,3,0,0,0,5,0,5
Delhi,2006,Robbery,0,0,0,45,0,45,17,0,17,3,0,3,65,0,65
Delhi,2006,Burglary,0,0,0,7,0,7,0,0,0,0,0,0,7,0,7
Delhi,2006,Thefts,0,0,0,107,0,107,95,0,95,2,0,2,204,0,204
Delhi,2006,Extortion,0,0,0,0,0,0,0,0,0,0,0,0,0,0,0
Delhi,2006,Riots,0,0,0,0,0,0,0,0,0,0,0,0,0,0,0
Delhi,2006,Arson,0,0,0,0,0,0,0,0,0,0,0,0,0,0,0
Delhi,2006,Criminal Breach Of Trust,0,0,0,1,0,1,0,0,0,0,0,0,1,0,1
Delhi,2006,Cheating,0,0,0,3,0,3,13,2,15,3,0,3,19,2,21
Delhi,2006,Counter Feiting,0,0,0,3,0,3,9,0,9,1,0,1,13,0,13
Delhi,2006,Dowry Deaths,0,0,0,27,0,27,41,14,55,13,5,18,81,19,100
Delhi,2006,Molestation,0,0,0,2,0,2,0,0,0,1,0,1,3,0,3
Delhi,2006,Eve-Teasing,0,0,0,0,0,0,0,0,0,0,0,0,0,0,0
Delhi,2006,Cruelty By Husband Or Relative Of Husband,0,0,0,0,0,0,0,0,0,0,0,0,0,0,0
Delhi,2006,Other Ipc Crimes,0,0,0,27,1,28,8,2,10,16,0,16,51,3,54
Delhi,2007,Murder,0,0,0,216,4,220,322,15,337,54,9,63,592,28,620
Delhi,2007,Attempt To Commit Murder,0,0,0,74,0,74,89,4,93,12,1,13,175,5,180
Delhi,2007,C.H. Not Amounting To Murder,0,0,0,5,0,5,1,0,1,6,0,6,12,0,12
Delhi,2007,Rape,0,0,0,136,0,136,102,1,103,28,2,30,266,3,269
Delhi,2007,Kidnapping And Abduction,0,0,0,64,0,64,36,4,40,2,2,4,102,6,108
Delhi,2007,Dacoity,0,0,0,141,0,141,115,0,115,5,0,5,261,0,261
Delhi,2007,Prep. And Assembly For Dacoity,0,0,0,19,0,19,5,0,5,0,0,0,24,0,24
Delhi,2007,Robbery,0,0,0,24,0,24,9,0,9,0,0,0,33,0,33
Delhi,2007,Burglary,0,0,0,10,0,10,2,0,2,0,0,0,12,0,12
Delhi,2007,Thefts,0,0,0,117,0,117,72,0,72,5,0,5,194,0,194
Delhi,2007,Extortion,0,0,0,9,0,9,0,0,0,0,0,0,9,0,9
Delhi,2007,Riots,0,0,0,0,0,0,0,0,0,0,0,0,0,0,0
Delhi,2007,Arson,0,0,0,0,0,0,0,0,0,0,0,0,0,0,0
Delhi,2007,Criminal Breach Of Trust,0,0,0,6,0,6,0,0,0,1,0,1,7,0,7
Delhi,2007,Cheating,0,0,0,12,0,12,24,1,25,6,0,6,42,1,43
Delhi,2007,Counter Feiting,0,0,0,6,0,6,11,0,11,4,0,4,21,0,21
Delhi,2007,Dowry Deaths,0,0,0,19,2,21,19,2,21,4,1,5,42,5,47
Delhi,2007,Molestation,0,0,0,2,0,2,0,0,0,0,0,0,2,0,2
Delhi,2007,Eve-Teasing,0,0,0,1,0,1,0,0,0,0,0,0,1,0,1
Delhi,2007,Cruelty By Husband Or Relative Of Husband,0,0,0,0,0,0,0,0,0,0,0,0,0,0,0
Delhi,2007,Other Ipc Crimes,0,0,0,13,0,13,12,0,12,12,0,12,37,0,37
Delhi,2008,Murder,0,0,0,234,3,237,271,18,289,53,7,60,558,28,586
Delhi,2008,Attempt To Commit Murder,0,0,0,53,1,54,51,0,51,11,1,12,115,2,117
Delhi,2008,C.H. Not Amounting To Murder,0,0,0,4,0,4,4,0,4,2,0,2,10,0,10
Delhi,2008,Rape,0,0,0,134,0,134,119,0,119,21,0,21,274,0,274
Delhi,2008,Kidnapping And Abduction,0,0,0,56,1,57,28,2,30,4,1,5,88,4,92
Delhi,2008,Dacoity,0,0,0,132,0,132,70,0,70,2,0,2,204,0,204
Delhi,2008,Prep. And Assembly For Dacoity,0,0,0,4,0,4,5,0,5,1,0,1,10,0,10
Delhi,2008,Robbery,0,0,0,52,0,52,18,0,18,0,0,0,70,0,70
Delhi,2008,Burglary,0,0,0,1,0,1,2,0,2,0,0,0,3,0,3
Delhi,2008,Thefts,0,0,0,70,0,70,58,0,58,2,0,2,130,0,130
Delhi,2008,Extortion,0,0,0,0,0,0,0,0,0,0,0,0,0,0,0
Delhi,2008,Riots,0,0,0,0,0,0,0,0,0,1,0,1,1,0,1
Delhi,2008,Arson,0,0,0,0,0,0,0,0,0,0,0,0,0,0,0
Delhi,2008,Criminal Breach Of Trust,0,0,0,6,0,6,0,0,0,0,0,0,6,0,6
Delhi,2008,Cheating,0,0,0,10,0,10,18,2,20,4,0,4,32,2,34
Delhi,2008,Counter Feiting,0,0,0,5,0,5,4,0,4,1,0,1,10,0,10
Delhi,2008,Dowry Deaths,0,0,0,17,0,17,20,2,22,9,4,13,46,6,52
Delhi,2008,Molestation,0,0,0,1,0,1,0,0,0,0,0,0,1,0,1
Delhi,2008,Eve-Teasing,0,0,0,3,0,3,0,0,0,0,0,0,3,0,3
Delhi,2008,Cruelty By Husband Or Relative Of Husband,0,0,0,0,0,0,0,0,0,0,0,0,0,0,0
Delhi,2008,Other Ipc Crimes,0,0,0,43,0,43,28,0,28,11,0,11,82,0,82
Delhi,2009,Murder,0,0,0,269,7,276,338,34,372,126,9,135,733,50,783
Delhi,2009,Attempt To Commit Murder,0,0,0,59,0,59,68,3,71,25,0,25,152,3,155
Delhi,2009,C.H. Not Amounting To Murder,0,0,0,4,0,4,6,0,6,0,0,0,10,0,10
Delhi,2009,Rape,0,0,0,140,0,140,140,3,143,28,0,28,308,3,311
Delhi,2009,Kidnapping And Abduction,0,0,0,49,2,51,33,5,38,4,1,5,86,8,94
Delhi,2009,Dacoity,0,0,0,103,0,103,72,0,72,6,0,6,181,0,181
Delhi,2009,Prep. And Assembly For Dacoity,0,0,0,13,0,13,13,0,13,0,0,0,26,0,26
Delhi,2009,Robbery,0,0,0,29,0,29,17,0,17,0,0,0,46,0,46
Delhi,2009,Burglary,0,0,0,4,0,4,4,0,4,0,0,0,8,0,8
Delhi,2009,Thefts,0,0,0,94,0,94,47,0,47,2,0,2,143,0,143
Delhi,2009,Extortion,0,0,0,0,0,0,0,0,0,0,0,0,0,0,0
Delhi,2009,Riots,0,0,0,0,0,0,0,0,0,0,0,0,0,0,0
Delhi,2009,Arson,0,0,0,0,0,0,0,0,0,0,0,0,0,0,0
Delhi,2009,Criminal Breach Of Trust,0,0,0,0,0,0,4,0,4,0,0,0,4,0,4
Delhi,2009,Cheating,0,0,0,5,0,5,12,0,12,4,1,5,21,1,22
Delhi,2009,Counter Feiting,0,0,0,5,0,5,3,1,4,1,0,1,9,1,10
Delhi,2009,Dowry Deaths,0,0,0,22,0,22,37,1,38,7,2,9,66,3,69
Delhi,2009,Molestation,0,0,0,0,0,0,0,0,0,0,0,0,0,0,0
Delhi,2009,Eve-Teasing,0,0,0,2,0,2,0,0,0,0,0,0,2,0,2
Delhi,2009,Cruelty By Husband Or Relative Of Husband,0,0,0,0,0,0,0,0,0,0,0,0,0,0,0
Delhi,2009,Other Ipc Crimes,0,0,0,17,0,17,22,0,22,1,0,1,40,0,40
Delhi,2010,Murder,0,0,0,356,7,363,419,32,451,111,9,120,886,48,934
Delhi,2010,Attempt To Commit Murder,0,0,0,66,0,66,55,3,58,27,0,27,148,3,151
Delhi,2010,C.H. Not Amounting To Murder,0,0,0,6,0,6,3,4,7,0,0,0,9,4,13
Delhi,2010,Rape,0,0,0,239,2,241,132,4,136,18,2,20,389,8,397
Delhi,2010,Kidnapping And Abduction,0,0,0,50,5,55,39,4,43,8,2,10,97,11,108
Delhi,2010,Dacoity,0,0,0,138,1,139,134,0,134,9,1,10,281,2,283
Delhi,2010,Prep. And Assembly For Dacoity,0,0,0,5,0,5,9,0,9,0,0,0,14,0,14
Delhi,2010,Robbery,0,0,0,27,0,27,12,0,12,0,0,0,39,0,39
Delhi,2010,Burglary,0,0,0,2,0,2,0,0,0,0,0,0,2,0,2
Delhi,2010,Thefts,0,0,0,77,0,77,51,0,51,2,0,2,130,0,130
Delhi,2010,Extortion,0,0,0,0,0,0,2,0,2,0,0,0,2,0,2
Delhi,2010,Riots,0,0,0,1,0,1,2,0,2,0,0,0,3,0,3
Delhi,2010,Arson,0,0,0,3,0,3,0,0,0,0,0,0,3,0,3
Delhi,2010,Criminal Breach Of Trust,0,0,0,0,0,0,0,0,0,0,0,0,0,0,0
Delhi,2010,Cheating,0,0,0,9,0,9,12,0,12,11,0,11,32,0,32
Delhi,2010,Counter Feiting,0,0,0,10,0,10,5,0,5,1,0,1,16,0,16
Delhi,2010,Dowry Deaths,0,0,0,25,0,25,35,3,38,10,6,16,70,9,79
Delhi,2010,Molestation,0,0,0,3,0,3,3,0,3,1,0,1,7,0,7
Delhi,2010,Eve-Teasing,0,0,0,0,0,0,0,0,0,0,0,0,0,0,0
Delhi,2010,Cruelty By Husband Or Relative Of Husband,0,0,0,0,0,0,0,0,0,0,0,0,0,0,0
Delhi,2010,Other Ipc Crimes,0,0,0,67,1,68,66,2,68,1,0,1,134,3,137
Delhi,2011,Murder,0,0,0,439,8,447,510,37,547,118,9,127,1067,54,1121
Delhi,2011,Attempt To Commit Murder,0,0,0,143,0,143,98,1,99,31,0,31,272,1,273
Delhi,2011,C.H. Not Amounting To Murder,0,0,0,9,1,10,0,2,2,1,3,4,10,6,16
Delhi,2011,Rape,0,0,0,224,2,226,179,1,180,23,0,23,426,3,429
Delhi,2011,Kidnapping And Abduction,0,0,0,54,2,56,41,4,45,8,6,14,103,12,115
Delhi,2011,Dacoity,0,0,0,165,0,165,143,0,143,13,0,13,321,0,321
Delhi,2011,Prep. And Assembly For Dacoity,0,0,0,9,0,9,3,0,3,0,0,0,12,0,12
Delhi,2011,Robbery,0,0,0,53,0,53,17,0,17,3,0,3,73,0,73
Delhi,2011,Burglary,0,0,0,4,0,4,0,0,0,0,0,0,4,0,4
Delhi,2011,Thefts,0,0,0,56,1,57,63,1,64,16,0,16,135,2,137
Delhi,2011,Extortion,0,0,0,1,0,1,6,0,6,0,0,0,7,0,7
Delhi,2011,Riots,0,0,0,3,0,3,2,0,2,0,0,0,5,0,5
Delhi,2011,Arson,0,0,0,1,0,1,1,0,1,0,0,0,2,0,2
Delhi,2011,Criminal Breach Of Trust,0,0,0,4,0,4,0,0,0,0,0,0,4,0,4
Delhi,2011,Cheating,0,0,0,13,0,13,15,1,16,17,0,17,45,1,46
Delhi,2011,Counter Feiting,0,0,0,4,0,4,3,0,3,0,0,0,7,0,7
Delhi,2011,Dowry Deaths,0,0,0,45,0,45,41,4,45,11,12,23,97,16,113
Delhi,2011,Molestation,0,0,0,0,0,0,0,0,0,0,0,0,0,0,0
Delhi,2011,Eve-Teasing,0,0,0,0,0,0,0,0,0,0,0,0,0,0,0
Delhi,2011,Cruelty By Husband Or Relative Of Husband,0,0,0,0,0,0,0,0,0,0,0,0,0,0,0
Delhi,2011,Other Ipc Crimes,0,0,0,8,3,11,1,2,3,3,1,4,12,6,18
Delhi,2012,Murder,0,0,0,424,12,436,508,37,545,127,12,139,1059,61,1120
Delhi,2012,Attempt To Commit Murder,0,0,0,125,0,125,119,2,121,36,0,36,280,2,282
Delhi,2012,C.H. Not Amounting To Murder,0,0,0,9,3,12,2,3,5,1,1,2,12,7,19
Delhi,2012,Rape,0,0,0,226,0,226,167,3,170,24,4,28,417,7,424
Delhi,2012,Kidnapping And Abduction,0,0,0,62,1,63,47,2,49,12,4,16,121,7,128
Delhi,2012,Dacoity,0,0,0,135,0,135,135,0,135,10,0,10,280,0,280
Delhi,2012,Prep. And Assembly For Dacoity,0,0,0,7,0,7,5,0,5,0,0,0,12,0,12
Delhi,2012,Robbery,0,0,0,67,0,67,35,0,35,5,0,5,107,0,107
Delhi,2012,Burglary,0,0,0,5,0,5,2,0,2,0,0,0,7,0,7
Delhi,2012,Thefts,0,0,0,66,1,67,77,2,79,16,0,16,159,3,162
Delhi,2012,Extortion,0,0,0,0,0,0,1,0,1,0,0,0,1,0,1
Delhi,2012,Riots,0,0,0,2,0,2,2,0,2,0,0,0,4,0,4
Delhi,2012,Arson,0,0,0,0,0,0,0,0,0,0,0,0,0,0,0
Delhi,2012,Criminal Breach Of Trust,0,0,0,2,0,2,0,0,0,0,0,0,2,0,2
Delhi,2012,Cheating,0,0,0,13,0,13,18,0,18,16,0,16,47,0,47
Delhi,2012,Counter Feiting,0,0,0,3,0,3,6,0,6,1,0,1,10,0,10
Delhi,2012,Dowry Deaths,0,0,0,37,1,38,40,3,43,10,10,20,87,14,101
Delhi,2012,Molestation,0,0,0,0,0,0,0,0,0,0,0,0,0,0,0
Delhi,2012,Eve-Teasing,0,0,0,0,0,0,0,0,0,0,0,0,0,0,0
Delhi,2012,Cruelty By Husband Or Relative Of Husband,0,0,0,0,0,0,0,0,0,0,0,0,0,0,0
Delhi,2012,Other Ipc Crimes,0,0,0,4,2,6,1,2,3,6,1,7,11,5,16
Lakshadweep,2001,Murder,0,0,0,0,0,0,0,0,0,0,0,0,0,0,0
Lakshadweep,2001,Attempt To Commit Murder,0,0,0,0,0,0,0,0,0,0,0,0,0,0,0
Lakshadweep,2001,C.H. Not Amounting To Murder,0,0,0,0,0,0,0,0,0,0,0,0,0,0,0
Lakshadweep,2001,Rape,0,0,0,0,0,0,0,0,0,0,0,0,0,0,0
Lakshadweep,2001,Kidnapping And Abduction,0,0,0,0,0,0,0,0,0,0,0,0,0,0,0
Lakshadweep,2001,Dacoity,0,0,0,0,0,0,0,0,0,0,0,0,0,0,0
Lakshadweep,2001,Prep. And Assembly For Dacoity,0,0,0,0,0,0,0,0,0,0,0,0,0,0,0
Lakshadweep,2001,Robbery,0,0,0,0,0,0,0,0,0,0,0,0,0,0,0
Lakshadweep,2001,Burglary,0,0,0,0,0,0,0,0,0,0,0,0,0,0,0
Lakshadweep,2001,Thefts,0,0,0,0,0,0,0,0,0,0,0,0,0,0,0
Lakshadweep,2001,Extortion,0,0,0,0,0,0,0,0,0,0,0,0,0,0,0
Lakshadweep,2001,Riots,0,0,0,0,0,0,0,0,0,0,0,0,0,0,0
Lakshadweep,2001,Arson,0,0,0,0,0,0,0,0,0,0,0,0,0,0,0
Lakshadweep,2001,Criminal Breach Of Trust,0,0,0,0,0,0,0,0,0,0,0,0,0,0,0
Lakshadweep,2001,Cheating,0,0,0,0,0,0,0,0,0,0,0,0,0,0,0
Lakshadweep,2001,Counter Feiting,0,0,0,0,0,0,0,0,0,0,0,0,0,0,0
Lakshadweep,2001,Dowry Deaths,0,0,0,0,0,0,0,0,0,0,0,0,0,0,0
Lakshadweep,2001,Molestation,0,0,0,0,0,0,0,0,0,0,0,0,0,0,0
Lakshadweep,2001,Eve-Teasing,0,0,0,0,0,0,0,0,0,0,0,0,0,0,0
Lakshadweep,2001,Cruelty By Husband Or Relative Of Husband,0,0,0,0,0,0,0,0,0,0,0,0,0,0,0
Lakshadweep,2001,Other Ipc Crimes,0,0,0,0,0,0,0,0,0,0,0,0,0,0,0
Lakshadweep,2002,Murder,0,0,0,0,0,0,0,0,0,0,0,0,0,0,0
Lakshadweep,2002,Attempt To Commit Murder,0,0,0,0,0,0,0,0,0,0,0,0,0,0,0
Lakshadweep,2002,C.H. Not Amounting To Murder,0,0,0,0,0,0,0,0,0,0,0,0,0,0,0
Lakshadweep,2002,Rape,0,0,0,0,0,0,0,0,0,0,0,0,0,0,0
Lakshadweep,2002,Kidnapping And Abduction,0,0,0,0,0,0,0,0,0,0,0,0,0,0,0
Lakshadweep,2002,Dacoity,0,0,0,0,0,0,0,0,0,0,0,0,0,0,0
Lakshadweep,2002,Prep. And Assembly For Dacoity,0,0,0,0,0,0,0,0,0,0,0,0,0,0,0
Lakshadweep,2002,Robbery,0,0,0,0,0,0,0,0,0,0,0,0,0,0,0
Lakshadweep,2002,Burglary,0,0,0,0,0,0,0,0,0,0,0,0,0,0,0
Lakshadweep,2002,Thefts,0,0,0,0,0,0,0,0,0,0,0,0,0,0,0
Lakshadweep,2002,Extortion,0,0,0,0,0,0,0,0,0,0,0,0,0,0,0
Lakshadweep,2002,Riots,0,0,0,0,0,0,0,0,0,0,0,0,0,0,0
Lakshadweep,2002,Arson,0,0,0,0,0,0,0,0,0,0,0,0,0,0,0
Lakshadweep,2002,Criminal Breach Of Trust,0,0,0,0,0,0,0,0,0,0,0,0,0,0,0
Lakshadweep,2002,Cheating,0,0,0,0,0,0,0,0,0,0,0,0,0,0,0
Lakshadweep,2002,Counter Feiting,0,0,0,0,0,0,0,0,0,0,0,0,0,0,0
Lakshadweep,2002,Dowry Deaths,0,0,0,0,0,0,0,0,0,0,0,0,0,0,0
Lakshadweep,2002,Molestation,0,0,0,0,0,0,0,0,0,0,0,0,0,0,0
Lakshadweep,2002,Eve-Teasing,0,0,0,0,0,0,0,0,0,0,0,0,0,0,0
Lakshadweep,2002,Cruelty By Husband Or Relative Of Husband,0,0,0,0,0,0,0,0,0,0,0,0,0,0,0
Lakshadweep,2002,Other Ipc Crimes,0,0,0,0,0,0,2,0,2,0,0,0,2,0,2
Lakshadweep,2003,Murder,0,0,0,0,0,0,0,0,0,0,0,0,0,0,0
Lakshadweep,2003,Attempt To Commit Murder,0,0,0,0,0,0,0,0,0,0,0,0,0,0,0
Lakshadweep,2003,C.H. Not Amounting To Murder,0,0,0,0,0,0,0,0,0,0,0,0,0,0,0
Lakshadweep,2003,Rape,0,0,0,0,0,0,0,0,0,0,0,0,0,0,0
Lakshadweep,2003,Kidnapping And Abduction,0,0,0,0,0,0,0,0,0,0,0,0,0,0,0
Lakshadweep,2003,Dacoity,0,0,0,0,0,0,0,0,0,0,0,0,0,0,0
Lakshadweep,2003,Prep. And Assembly For Dacoity,0,0,0,0,0,0,0,0,0,0,0,0,0,0,0
Lakshadweep,2003,Robbery,0,0,0,0,0,0,0,0,0,0,0,0,0,0,0
Lakshadweep,2003,Burglary,0,0,0,0,0,0,0,0,0,0,0,0,0,0,0
Lakshadweep,2003,Thefts,0,0,0,0,0,0,0,0,0,0,0,0,0,0,0
Lakshadweep,2003,Extortion,0,0,0,0,0,0,0,0,0,0,0,0,0,0,0
Lakshadweep,2003,Riots,0,0,0,0,0,0,0,0,0,0,0,0,0,0,0
Lakshadweep,2003,Arson,0,0,0,0,0,0,0,0,0,0,0,0,0,0,0
Lakshadweep,2003,Criminal Breach Of Trust,0,0,0,0,0,0,0,0,0,0,0,0,0,0,0
Lakshadweep,2003,Cheating,0,0,0,0,0,0,0,0,0,0,0,0,0,0,0
Lakshadweep,2003,Counter Feiting,0,0,0,0,0,0,0,0,0,0,0,0,0,0,0
Lakshadweep,2003,Dowry Deaths,0,0,0,0,0,0,0,0,0,0,0,0,0,0,0
Lakshadweep,2003,Molestation,0,0,0,0,0,0,0,0,0,0,0,0,0,0,0
Lakshadweep,2003,Eve-Teasing,0,0,0,0,0,0,0,0,0,0,0,0,0,0,0
Lakshadweep,2003,Cruelty By Husband Or Relative Of Husband,0,0,0,0,0,0,0,0,0,0,0,0,0,0,0
Lakshadweep,2003,Other Ipc Crimes,0,0,0,0,0,0,0,0,0,0,0,0,0,0,0
Lakshadweep,2004,Murder,0,0,0,0,0,0,0,0,0,0,0,0,0,0,0
Lakshadweep,2004,Attempt To Commit Murder,0,0,0,0,0,0,0,0,0,0,0,0,0,0,0
Lakshadweep,2004,C.H. Not Amounting To Murder,0,0,0,0,0,0,0,0,0,0,0,0,0,0,0
Lakshadweep,2004,Rape,0,0,0,0,0,0,0,0,0,0,0,0,0,0,0
Lakshadweep,2004,Kidnapping And Abduction,0,0,0,0,0,0,0,0,0,0,0,0,0,0,0
Lakshadweep,2004,Dacoity,0,0,0,0,0,0,0,0,0,0,0,0,0,0,0
Lakshadweep,2004,Prep. And Assembly For Dacoity,0,0,0,0,0,0,0,0,0,0,0,0,0,0,0
Lakshadweep,2004,Robbery,0,0,0,0,0,0,0,0,0,0,0,0,0,0,0
Lakshadweep,2004,Burglary,0,0,0,0,0,0,0,0,0,0,0,0,0,0,0
Lakshadweep,2004,Thefts,0,0,0,0,0,0,0,0,0,0,0,0,0,0,0
Lakshadweep,2004,Extortion,0,0,0,0,0,0,0,0,0,0,0,0,0,0,0
Lakshadweep,2004,Riots,0,0,0,0,0,0,0,0,0,0,0,0,0,0,0
Lakshadweep,2004,Arson,0,0,0,0,0,0,0,0,0,0,0,0,0,0,0
Lakshadweep,2004,Criminal Breach Of Trust,0,0,0,0,0,0,0,0,0,0,0,0,0,0,0
Lakshadweep,2004,Cheating,0,0,0,0,0,0,0,0,0,0,0,0,0,0,0
Lakshadweep,2004,Counter Feiting,0,0,0,0,0,0,0,0,0,0,0,0,0,0,0
Lakshadweep,2004,Dowry Deaths,0,0,0,0,0,0,0,0,0,0,0,0,0,0,0
Lakshadweep,2004,Molestation,0,0,0,0,0,0,0,0,0,0,0,0,0,0,0
Lakshadweep,2004,Eve-Teasing,0,0,0,0,0,0,0,0,0,0,0,0,0,0,0
Lakshadweep,2004,Cruelty By Husband Or Relative Of Husband,0,0,0,0,0,0,0,0,0,0,0,0,0,0,0
Lakshadweep,2004,Other Ipc Crimes,0,0,0,0,0,0,0,0,0,0,0,0,0,0,0
Lakshadweep,2005,Murder,0,0,0,0,0,0,0,0,0,0,0,0,0,0,0
Lakshadweep,2005,Attempt To Commit Murder,0,0,0,0,0,0,0,0,0,0,0,0,0,0,0
Lakshadweep,2005,C.H. Not Amounting To Murder,0,0,0,0,0,0,0,0,0,0,0,0,0,0,0
Lakshadweep,2005,Rape,0,0,0,0,0,0,0,0,0,0,0,0,0,0,0
Lakshadweep,2005,Kidnapping And Abduction,0,0,0,0,0,0,0,0,0,0,0,0,0,0,0
Lakshadweep,2005,Dacoity,0,0,0,0,0,0,0,0,0,0,0,0,0,0,0
Lakshadweep,2005,Prep. And Assembly For Dacoity,0,0,0,0,0,0,0,0,0,0,0,0,0,0,0
Lakshadweep,2005,Robbery,0,0,0,0,0,0,0,0,0,0,0,0,0,0,0
Lakshadweep,2005,Burglary,0,0,0,0,0,0,0,0,0,0,0,0,0,0,0
Lakshadweep,2005,Thefts,0,0,0,0,0,0,0,0,0,0,0,0,0,0,0
Lakshadweep,2005,Extortion,0,0,0,0,0,0,0,0,0,0,0,0,0,0,0
Lakshadweep,2005,Riots,0,0,0,0,0,0,0,0,0,0,0,0,0,0,0
Lakshadweep,2005,Arson,0,0,0,0,0,0,0,0,0,0,0,0,0,0,0
Lakshadweep,2005,Criminal Breach Of Trust,0,0,0,0,0,0,0,0,0,0,0,0,0,0,0
Lakshadweep,2005,Cheating,0,0,0,0,0,0,0,0,0,0,0,0,0,0,0
Lakshadweep,2005,Counter Feiting,0,0,0,0,0,0,0,0,0,0,0,0,0,0,0
Lakshadweep,2005,Dowry Deaths,0,0,0,0,0,0,0,0,0,0,0,0,0,0,0
Lakshadweep,2005,Molestation,0,0,0,0,0,0,0,0,0,0,0,0,0,0,0
Lakshadweep,2005,Eve-Teasing,0,0,0,0,0,0,0,0,0,0,0,0,0,0,0
Lakshadweep,2005,Cruelty By Husband Or Relative Of Husband,0,0,0,0,0,0,0,0,0,0,0,0,0,0,0
Lakshadweep,2005,Other Ipc Crimes,0,0,0,0,0,0,0,0,0,0,0,0,0,0,0
Lakshadweep,2006,Murder,0,0,0,0,0,0,0,0,0,0,0,0,0,0,0
Lakshadweep,2006,Attempt To Commit Murder,0,0,0,0,0,0,0,0,0,0,0,0,0,0,0
Lakshadweep,2006,C.H. Not Amounting To Murder,0,0,0,0,0,0,0,0,0,0,0,0,0,0,0
Lakshadweep,2006,Rape,0,0,0,0,0,0,0,0,0,0,0,0,0,0,0
Lakshadweep,2006,Kidnapping And Abduction,0,0,0,0,0,0,0,0,0,0,0,0,0,0,0
Lakshadweep,2006,Dacoity,0,0,0,0,0,0,0,0,0,0,0,0,0,0,0
Lakshadweep,2006,Prep. And Assembly For Dacoity,0,0,0,0,0,0,0,0,0,0,0,0,0,0,0
Lakshadweep,2006,Robbery,0,0,0,0,0,0,0,0,0,0,0,0,0,0,0
Lakshadweep,2006,Burglary,0,0,0,0,0,0,0,0,0,0,0,0,0,0,0
Lakshadweep,2006,Thefts,0,0,0,0,0,0,0,0,0,0,0,0,0,0,0
Lakshadweep,2006,Extortion,0,0,0,0,0,0,0,0,0,0,0,0,0,0,0
Lakshadweep,2006,Riots,0,0,0,0,0,0,0,0,0,0,0,0,0,0,0
Lakshadweep,2006,Arson,0,0,0,0,0,0,0,0,0,0,0,0,0,0,0
Lakshadweep,2006,Criminal Breach Of Trust,0,0,0,0,0,0,0,0,0,0,0,0,0,0,0
Lakshadweep,2006,Cheating,0,0,0,0,0,0,0,0,0,0,0,0,0,0,0
Lakshadweep,2006,Counter Feiting,0,0,0,0,0,0,0,0,0,0,0,0,0,0,0
Lakshadweep,2006,Dowry Deaths,0,0,0,0,0,0,0,0,0,0,0,0,0,0,0
Lakshadweep,2006,Molestation,0,0,0,0,0,0,0,0,0,0,0,0,0,0,0
Lakshadweep,2006,Eve-Teasing,0,0,0,0,0,0,0,0,0,0,0,0,0,0,0
Lakshadweep,2006,Cruelty By Husband Or Relative Of Husband,0,0,0,0,0,0,0,0,0,0,0,0,0,0,0
Lakshadweep,2006,Other Ipc Crimes,0,0,0,0,0,0,0,0,0,0,0,0,0,0,0
Lakshadweep,2007,Murder,0,0,0,0,0,0,1,0,1,0,0,0,1,0,1
Lakshadweep,2007,Attempt To Commit Murder,0,0,0,0,0,0,0,0,0,0,0,0,0,0,0
Lakshadweep,2007,C.H. Not Amounting To Murder,0,0,0,0,0,0,0,0,0,0,0,0,0,0,0
Lakshadweep,2007,Rape,0,0,0,2,0,2,0,0,0,0,0,0,2,0,2
Lakshadweep,2007,Kidnapping And Abduction,0,0,0,0,0,0,0,0,0,0,0,0,0,0,0
Lakshadweep,2007,Dacoity,0,0,0,0,0,0,0,0,0,0,0,0,0,0,0
Lakshadweep,2007,Prep. And Assembly For Dacoity,0,0,0,0,0,0,0,0,0,0,0,0,0,0,0
Lakshadweep,2007,Robbery,0,0,0,0,0,0,0,0,0,0,0,0,0,0,0
Lakshadweep,2007,Burglary,0,0,0,0,0,0,0,0,0,0,0,0,0,0,0
Lakshadweep,2007,Thefts,0,0,0,0,0,0,0,0,0,0,0,0,0,0,0
Lakshadweep,2007,Extortion,0,0,0,0,0,0,0,0,0,0,0,0,0,0,0
Lakshadweep,2007,Riots,0,0,0,0,0,0,0,0,0,0,0,0,0,0,0
Lakshadweep,2007,Arson,0,0,0,0,0,0,0,0,0,0,0,0,0,0,0
Lakshadweep,2007,Criminal Breach Of Trust,0,0,0,0,0,0,0,0,0,0,0,0,0,0,0
Lakshadweep,2007,Cheating,0,0,0,0,0,0,0,0,0,0,0,0,0,0,0
Lakshadweep,2007,Counter Feiting,0,0,0,0,0,0,0,0,0,0,0,0,0,0,0
Lakshadweep,2007,Dowry Deaths,0,0,0,0,0,0,0,0,0,0,0,0,0,0,0
Lakshadweep,2007,Molestation,0,0,0,0,0,0,0,0,0,0,0,0,0,0,0
Lakshadweep,2007,Eve-Teasing,0,0,0,0,0,0,0,0,0,0,0,0,0,0,0
Lakshadweep,2007,Cruelty By Husband Or Relative Of Husband,0,0,0,0,0,0,0,0,0,0,0,0,0,0,0
Lakshadweep,2007,Other Ipc Crimes,0,0,0,0,0,0,0,0,0,0,0,0,0,0,0
Lakshadweep,2008,Murder,0,0,0,0,0,0,0,0,0,0,0,0,0,0,0
Lakshadweep,2008,Attempt To Commit Murder,0,0,0,0,0,0,0,0,0,0,0,0,0,0,0
Lakshadweep,2008,C.H. Not Amounting To Murder,0,0,0,0,0,0,0,0,0,0,0,0,0,0,0
Lakshadweep,2008,Rape,0,0,0,0,0,0,0,0,0,0,0,0,0,0,0
Lakshadweep,2008,Kidnapping And Abduction,0,0,0,0,0,0,0,0,0,0,0,0,0,0,0
Lakshadweep,2008,Dacoity,0,0,0,0,0,0,0,0,0,0,0,0,0,0,0
Lakshadweep,2008,Prep. And Assembly For Dacoity,0,0,0,0,0,0,0,0,0,0,0,0,0,0,0
Lakshadweep,2008,Robbery,0,0,0,0,0,0,0,0,0,0,0,0,0,0,0
Lakshadweep,2008,Burglary,0,0,0,0,0,0,0,0,0,0,0,0,0,0,0
Lakshadweep,2008,Thefts,0,0,0,0,0,0,0,0,0,0,0,0,0,0,0
Lakshadweep,2008,Extortion,0,0,0,0,0,0,0,0,0,0,0,0,0,0,0
Lakshadweep,2008,Riots,0,0,0,0,0,0,0,0,0,0,0,0,0,0,0
Lakshadweep,2008,Arson,0,0,0,0,0,0,0,0,0,0,0,0,0,0,0
Lakshadweep,2008,Criminal Breach Of Trust,0,0,0,0,0,0,0,0,0,0,0,0,0,0,0
Lakshadweep,2008,Cheating,0,0,0,0,0,0,0,0,0,0,0,0,0,0,0
Lakshadweep,2008,Counter Feiting,0,0,0,0,0,0,0,0,0,0,0,0,0,0,0
Lakshadweep,2008,Dowry Deaths,0,0,0,0,0,0,0,0,0,0,0,0,0,0,0
Lakshadweep,2008,Molestation,0,0,0,0,0,0,0,0,0,0,0,0,0,0,0
Lakshadweep,2008,Eve-Teasing,0,0,0,0,0,0,0,0,0,0,0,0,0,0,0
Lakshadweep,2008,Cruelty By Husband Or Relative Of Husband,0,0,0,0,0,0,0,0,0,0,0,0,0,0,0
Lakshadweep,2008,Other Ipc Crimes,0,0,0,0,0,0,0,0,0,0,0,0,0,0,0
Lakshadweep,2009,Murder,0,0,0,0,0,0,0,0,0,0,0,0,0,0,0
Lakshadweep,2009,Attempt To Commit Murder,0,0,0,0,0,0,1,0,1,0,0,0,1,0,1
Lakshadweep,2009,C.H. Not Amounting To Murder,0,0,0,0,0,0,0,0,0,0,0,0,0,0,0
Lakshadweep,2009,Rape,0,0,0,0,0,0,0,0,0,0,0,0,0,0,0
Lakshadweep,2009,Kidnapping And Abduction,0,0,0,0,0,0,0,0,0,0,0,0,0,0,0
Lakshadweep,2009,Dacoity,0,0,0,0,0,0,0,0,0,0,0,0,0,0,0
Lakshadweep,2009,Prep. And Assembly For Dacoity,0,0,0,0,0,0,0,0,0,0,0,0,0,0,0
Lakshadweep,2009,Robbery,0,0,0,0,0,0,0,0,0,0,0,0,0,0,0
Lakshadweep,2009,Burglary,0,0,0,0,0,0,0,0,0,0,0,0,0,0,0
Lakshadweep,2009,Thefts,0,0,0,0,0,0,0,0,0,0,0,0,0,0,0
Lakshadweep,2009,Extortion,0,0,0,0,0,0,0,0,0,0,0,0,0,0,0
Lakshadweep,2009,Riots,0,0,0,0,0,0,0,0,0,0,0,0,0,0,0
Lakshadweep,2009,Arson,0,0,0,0,0,0,0,0,0,0,0,0,0,0,0
Lakshadweep,2009,Criminal Breach Of Trust,0,0,0,0,0,0,0,0,0,0,0,0,0,0,0
Lakshadweep,2009,Cheating,0,0,0,0,0,0,0,0,0,0,0,0,0,0,0
Lakshadweep,2009,Counter Feiting,0,0,0,0,0,0,0,0,0,0,0,0,0,0,0
Lakshadweep,2009,Dowry Deaths,0,0,0,0,0,0,0,0,0,0,0,0,0,0,0
Lakshadweep,2009,Molestation,0,0,0,0,0,0,0,0,0,0,0,0,0,0,0
Lakshadweep,2009,Eve-Teasing,0,0,0,0,0,0,0,0,0,0,0,0,0,0,0
Lakshadweep,2009,Cruelty By Husband Or Relative Of Husband,0,0,0,0,0,0,0,0,0,0,0,0,0,0,0
Lakshadweep,2009,Other Ipc Crimes,0,0,0,0,0,0,0,0,0,0,0,0,0,0,0
Lakshadweep,2010,Murder,0,0,0,0,0,0,0,0,0,0,0,0,0,0,0
Lakshadweep,2010,Attempt To Commit Murder,0,0,0,0,0,0,0,0,0,0,0,0,0,0,0
Lakshadweep,2010,C.H. Not Amounting To Murder,0,0,0,0,0,0,0,0,0,0,0,0,0,0,0
Lakshadweep,2010,Rape,0,0,0,0,0,0,0,0,0,0,0,0,0,0,0
Lakshadweep,2010,Kidnapping And Abduction,0,0,0,0,0,0,0,0,0,0,0,0,0,0,0
Lakshadweep,2010,Dacoity,0,0,0,0,0,0,0,0,0,0,0,0,0,0,0
Lakshadweep,2010,Prep. And Assembly For Dacoity,0,0,0,0,0,0,0,0,0,0,0,0,0,0,0
Lakshadweep,2010,Robbery,0,0,0,0,0,0,0,0,0,0,0,0,0,0,0
Lakshadweep,2010,Burglary,0,0,0,0,0,0,0,0,0,0,0,0,0,0,0
Lakshadweep,2010,Thefts,0,0,0,0,0,0,0,0,0,0,0,0,0,0,0
Lakshadweep,2010,Extortion,0,0,0,0,0,0,0,0,0,0,0,0,0,0,0
Lakshadweep,2010,Riots,0,0,0,0,0,0,0,0,0,0,0,0,0,0,0
Lakshadweep,2010,Arson,0,0,0,0,0,0,0,0,0,0,0,0,0,0,0
Lakshadweep,2010,Criminal Breach Of Trust,0,0,0,0,0,0,0,0,0,0,0,0,0,0,0
Lakshadweep,2010,Cheating,0,0,0,0,0,0,0,0,0,0,0,0,0,0,0
Lakshadweep,2010,Counter Feiting,0,0,0,0,0,0,0,0,0,0,0,0,0,0,0
Lakshadweep,2010,Dowry Deaths,0,0,0,0,0,0,0,0,0,0,0,0,0,0,0
Lakshadweep,2010,Molestation,0,0,0,0,0,0,0,0,0,0,0,0,0,0,0
Lakshadweep,2010,Eve-Teasing,0,0,0,0,0,0,0,0,0,0,0,0,0,0,0
Lakshadweep,2010,Cruelty By Husband Or Relative Of Husband,0,0,0,0,0,0,0,0,0,0,0,0,0,0,0
Lakshadweep,2010,Other Ipc Crimes,0,0,0,0,0,0,0,0,0,0,0,0,0,0,0
Lakshadweep,2011,Murder,0,0,0,0,0,0,0,0,0,0,0,0,0,0,0
Lakshadweep,2011,Attempt To Commit Murder,0,0,0,0,0,0,0,0,0,0,0,0,0,0,0
Lakshadweep,2011,C.H. Not Amounting To Murder,0,0,0,0,0,0,0,0,0,0,0,0,0,0,0
Lakshadweep,2011,Rape,0,0,0,0,0,0,0,0,0,0,0,0,0,0,0
Lakshadweep,2011,Kidnapping And Abduction,0,0,0,0,0,0,0,0,0,0,0,0,0,0,0
Lakshadweep,2011,Dacoity,0,0,0,0,0,0,0,0,0,0,0,0,0,0,0
Lakshadweep,2011,Prep. And Assembly For Dacoity,0,0,0,0,0,0,0,0,0,0,0,0,0,0,0
Lakshadweep,2011,Robbery,0,0,0,0,0,0,0,0,0,0,0,0,0,0,0
Lakshadweep,2011,Burglary,0,0,0,0,0,0,0,0,0,0,0,0,0,0,0
Lakshadweep,2011,Thefts,0,0,0,0,0,0,0,0,0,0,0,0,0,0,0
Lakshadweep,2011,Extortion,0,0,0,0,0,0,0,0,0,0,0,0,0,0,0
Lakshadweep,2011,Riots,0,0,0,0,0,0,0,0,0,0,0,0,0,0,0
Lakshadweep,2011,Arson,0,0,0,0,0,0,0,0,0,0,0,0,0,0,0
Lakshadweep,2011,Criminal Breach Of Trust,0,0,0,0,0,0,0,0,0,0,0,0,0,0,0
Lakshadweep,2011,Cheating,0,0,0,0,0,0,0,0,0,0,0,0,0,0,0
Lakshadweep,2011,Counter Feiting,0,0,0,0,0,0,0,0,0,0,0,0,0,0,0
Lakshadweep,2011,Dowry Deaths,0,0,0,0,0,0,0,0,0,0,0,0,0,0,0
Lakshadweep,2011,Molestation,0,0,0,0,0,0,0,0,0,0,0,0,0,0,0
Lakshadweep,2011,Eve-Teasing,0,0,0,0,0,0,0,0,0,0,0,0,0,0,0
Lakshadweep,2011,Cruelty By Husband Or Relative Of Husband,0,0,0,0,0,0,0,0,0,0,0,0,0,0,0
Lakshadweep,2011,Other Ipc Crimes,0,0,0,0,0,0,0,0,0,0,0,0,0,0,0
Lakshadweep,2012,Murder,0,0,0,0,0,0,0,0,0,0,0,0,0,0,0
Lakshadweep,2012,Attempt To Commit Murder,0,0,0,0,0,0,0,0,0,0,0,0,0,0,0
Lakshadweep,2012,C.H. Not Amounting To Murder,0,0,0,0,0,0,0,0,0,0,0,0,0,0,0
Lakshadweep,2012,Rape,0,0,0,0,0,0,0,0,0,0,0,0,0,0,0
Lakshadweep,2012,Kidnapping And Abduction,0,0,0,0,0,0,0,0,0,0,0,0,0,0,0
Lakshadweep,2012,Dacoity,0,0,0,0,0,0,0,0,0,0,0,0,0,0,0
Lakshadweep,2012,Prep. And Assembly For Dacoity,0,0,0,0,0,0,0,0,0,0,0,0,0,0,0
Lakshadweep,2012,Robbery,0,0,0,0,0,0,0,0,0,0,0,0,0,0,0
Lakshadweep,2012,Burglary,0,0,0,0,0,0,0,0,0,0,0,0,0,0,0
Lakshadweep,2012,Thefts,0,0,0,0,0,0,0,0,0,0,0,0,0,0,0
Lakshadweep,2012,Extortion,0,0,0,0,0,0,0,0,0,0,0,0,0,0,0
Lakshadweep,2012,Riots,0,0,0,0,0,0,0,0,0,0,0,0,0,0,0
Lakshadweep,2012,Arson,0,0,0,0,0,0,0,0,0,0,0,0,0,0,0
Lakshadweep,2012,Criminal Breach Of Trust,0,0,0,0,0,0,0,0,0,0,0,0,0,0,0
Lakshadweep,2012,Cheating,0,0,0,0,0,0,0,0,0,0,0,0,0,0,0
Lakshadweep,2012,Counter Feiting,0,0,0,0,0,0,0,0,0,0,0,0,0,0,0
Lakshadweep,2012,Dowry Deaths,0,0,0,0,0,0,0,0,0,0,0,0,0,0,0
Lakshadweep,2012,Molestation,0,0,0,0,0,0,0,0,0,0,0,0,0,0,0
Lakshadweep,2012,Eve-Teasing,0,0,0,0,0,0,0,0,0,0,0,0,0,0,0
Lakshadweep,2012,Cruelty By Husband Or Relative Of Husband,0,0,0,0,0,0,0,0,0,0,0,0,0,0,0
Lakshadweep,2012,Other Ipc Crimes,0,0,0,0,0,0,0,0,0,0,0,0,0,0,0
Pondicherry,2001,Murder,0,0,0,28,0,28,32,0,32,12,0,12,72,0,72
Pondicherry,2001,Attempt To Commit Murder,0,0,0,4,0,4,0,0,0,0,0,0,4,0,4
Pondicherry,2001,C.H. Not Amounting To Murder,0,0,0,0,0,0,0,0,0,0,0,0,0,0,0
Pondicherry,2001,Rape,0,0,0,0,0,0,0,0,0,0,0,0,0,0,0
Pondicherry,2001,Kidnapping And Abduction,0,0,0,0,0,0,1,0,1,0,0,0,1,0,1
Pondicherry,2001,Dacoity,0,0,0,0,0,0,0,0,0,0,0,0,0,0,0
Pondicherry,2001,Prep. And Assembly For Dacoity,0,0,0,0,0,0,0,0,0,0,0,0,0,0,0
Pondicherry,2001,Robbery,0,0,0,2,0,2,0,0,0,0,0,0,2,0,2
Pondicherry,2001,Burglary,0,0,0,0,0,0,0,0,0,0,0,0,0,0,0
Pondicherry,2001,Thefts,0,0,0,8,0,8,16,0,16,0,0,0,24,0,24
Pondicherry,2001,Extortion,0,0,0,0,0,0,0,0,0,0,0,0,0,0,0
Pondicherry,2001,Riots,0,0,0,0,0,0,0,0,0,0,0,0,0,0,0
Pondicherry,2001,Arson,0,0,0,0,0,0,0,0,0,0,0,0,0,0,0
Pondicherry,2001,Criminal Breach Of Trust,0,0,0,0,0,0,0,0,0,0,0,0,0,0,0
Pondicherry,2001,Cheating,0,0,0,0,0,0,1,0,1,0,0,0,1,0,1
Pondicherry,2001,Counter Feiting,0,0,0,0,0,0,0,0,0,0,0,0,0,0,0
Pondicherry,2001,Dowry Deaths,0,0,0,0,0,0,0,0,0,0,0,0,0,0,0
Pondicherry,2001,Molestation,0,0,0,0,0,0,0,0,0,0,0,0,0,0,0
Pondicherry,2001,Eve-Teasing,0,0,0,0,0,0,0,0,0,0,0,0,0,0,0
Pondicherry,2001,Cruelty By Husband Or Relative Of Husband,0,0,0,0,0,0,0,0,0,0,0,0,0,0,0
Pondicherry,2001,Other Ipc Crimes,0,0,0,1,0,1,0,0,0,0,0,0,1,0,1
Pondicherry,2002,Murder,0,0,0,33,0,33,48,0,48,4,0,4,85,0,85
Pondicherry,2002,Attempt To Commit Murder,0,0,0,5,0,5,0,0,0,0,0,0,5,0,5
Pondicherry,2002,C.H. Not Amounting To Murder,0,0,0,1,0,1,2,0,2,0,0,0,3,0,3
Pondicherry,2002,Rape,0,0,0,0,0,0,0,0,0,0,0,0,0,0,0
Pondicherry,2002,Kidnapping And Abduction,0,0,0,1,0,1,0,0,0,0,0,0,1,0,1
Pondicherry,2002,Dacoity,0,0,0,0,0,0,0,0,0,0,0,0,0,0,0
Pondicherry,2002,Prep. And Assembly For Dacoity,0,0,0,0,0,0,0,0,0,0,0,0,0,0,0
Pondicherry,2002,Robbery,0,0,0,0,0,0,0,0,0,0,0,0,0,0,0
Pondicherry,2002,Burglary,0,0,0,4,0,4,0,0,0,0,0,0,4,0,4
Pondicherry,2002,Thefts,0,0,0,8,0,8,13,0,13,2,0,2,23,0,23
Pondicherry,2002,Extortion,0,0,0,0,0,0,0,0,0,0,0,0,0,0,0
Pondicherry,2002,Riots,0,0,0,0,0,0,0,0,0,0,0,0,0,0,0
Pondicherry,2002,Arson,0,0,0,0,0,0,0,0,0,0,0,0,0,0,0
Pondicherry,2002,Criminal Breach Of Trust,0,0,0,0,0,0,0,0,0,0,0,0,0,0,0
Pondicherry,2002,Cheating,0,0,0,0,0,0,8,0,8,0,0,0,8,0,8
Pondicherry,2002,Counter Feiting,0,0,0,0,0,0,0,0,0,0,0,0,0,0,0
Pondicherry,2002,Dowry Deaths,0,0,0,0,0,0,0,0,0,0,0,0,0,0,0
Pondicherry,2002,Molestation,0,0,0,0,0,0,0,0,0,0,0,0,0,0,0
Pondicherry,2002,Eve-Teasing,0,0,0,0,0,0,0,0,0,0,0,0,0,0,0
Pondicherry,2002,Cruelty By Husband Or Relative Of Husband,0,0,0,0,0,0,0,0,0,0,0,0,0,0,0
Pondicherry,2002,Other Ipc Crimes,0,0,0,0,0,0,0,0,0,0,0,0,0,0,0
Pondicherry,2003,Murder,0,0,0,58,0,58,35,1,36,4,0,4,97,1,98
Pondicherry,2003,Attempt To Commit Murder,0,0,0,0,0,0,5,0,5,0,0,0,5,0,5
Pondicherry,2003,C.H. Not Amounting To Murder,0,0,0,0,0,0,0,0,0,0,0,0,0,0,0
Pondicherry,2003,Rape,0,0,0,0,0,0,0,0,0,0,0,0,0,0,0
Pondicherry,2003,Kidnapping And Abduction,0,0,0,0,0,0,3,0,3,0,0,0,3,0,3
Pondicherry,2003,Dacoity,0,0,0,0,0,0,0,0,0,0,0,0,0,0,0
Pondicherry,2003,Prep. And Assembly For Dacoity,0,0,0,0,0,0,0,0,0,0,0,0,0,0,0
Pondicherry,2003,Robbery,0,0,0,0,0,0,1,0,1,0,0,0,1,0,1
Pondicherry,2003,Burglary,0,0,0,0,0,0,7,0,7,4,0,4,11,0,11
Pondicherry,2003,Thefts,0,0,0,9,0,9,0,0,0,8,0,8,17,0,17
Pondicherry,2003,Extortion,0,0,0,0,0,0,0,0,0,0,0,0,0,0,0
Pondicherry,2003,Riots,0,0,0,0,0,0,0,0,0,0,0,0,0,0,0
Pondicherry,2003,Arson,0,0,0,0,0,0,0,0,0,0,0,0,0,0,0
Pondicherry,2003,Criminal Breach Of Trust,0,0,0,0,0,0,0,0,0,0,0,0,0,0,0
Pondicherry,2003,Cheating,0,0,0,0,0,0,2,0,2,0,0,0,2,0,2
Pondicherry,2003,Counter Feiting,0,0,0,0,0,0,0,0,0,0,0,0,0,0,0
Pondicherry,2003,Dowry Deaths,0,0,0,0,0,0,0,0,0,0,1,1,0,1,1
Pondicherry,2003,Molestation,0,0,0,0,0,0,0,0,0,0,0,0,0,0,0
Pondicherry,2003,Eve-Teasing,0,0,0,0,0,0,0,0,0,0,0,0,0,0,0
Pondicherry,2003,Cruelty By Husband Or Relative Of Husband,0,0,0,0,0,0,0,0,0,0,0,0,0,0,0
Pondicherry,2003,Other Ipc Crimes,0,0,0,0,0,0,0,0,0,0,0,0,0,0,0
Pondicherry,2004,Murder,0,0,0,18,0,18,37,0,37,11,0,11,66,0,66
Pondicherry,2004,Attempt To Commit Murder,0,0,0,2,0,2,0,0,0,0,0,0,2,0,2
Pondicherry,2004,C.H. Not Amounting To Murder,0,0,0,2,0,2,2,0,2,0,0,0,4,0,4
Pondicherry,2004,Rape,0,0,0,0,0,0,1,0,1,0,0,0,1,0,1
Pondicherry,2004,Kidnapping And Abduction,0,0,0,0,0,0,1,1,2,1,0,1,2,1,3
Pondicherry,2004,Dacoity,0,0,0,0,0,0,0,0,0,0,0,0,0,0,0
Pondicherry,2004,Prep. And Assembly For Dacoity,0,0,0,0,0,0,0,0,0,0,0,0,0,0,0
Pondicherry,2004,Robbery,0,0,0,0,0,0,0,0,0,0,0,0,0,0,0
Pondicherry,2004,Burglary,0,0,0,0,0,0,0,0,0,0,0,0,0,0,0
Pondicherry,2004,Thefts,0,0,0,4,0,4,2,0,2,0,0,0,6,0,6
Pondicherry,2004,Extortion,0,0,0,0,0,0,0,0,0,0,0,0,0,0,0
Pondicherry,2004,Riots,0,0,0,0,0,0,1,0,1,0,0,0,1,0,1
Pondicherry,2004,Arson,0,0,0,0,0,0,0,0,0,0,0,0,0,0,0
Pondicherry,2004,Criminal Breach Of Trust,0,0,0,4,0,4,3,0,3,0,0,0,7,0,7
Pondicherry,2004,Cheating,0,0,0,0,0,0,3,0,3,0,0,0,3,0,3
Pondicherry,2004,Counter Feiting,0,0,0,0,0,0,0,0,0,0,0,0,0,0,0
Pondicherry,2004,Dowry Deaths,0,0,0,0,0,0,4,0,4,0,0,0,4,0,4
Pondicherry,2004,Molestation,0,0,0,0,0,0,0,0,0,0,0,0,0,0,0
Pondicherry,2004,Eve-Teasing,0,0,0,0,0,0,0,0,0,0,0,0,0,0,0
Pondicherry,2004,Cruelty By Husband Or Relative Of Husband,0,0,0,0,0,0,1,0,1,0,1,1,1,1,2
Pondicherry,2004,Other Ipc Crimes,0,0,0,2,0,2,6,0,6,0,0,0,8,0,8
Pondicherry,2005,Murder,0,0,0,27,1,28,35,0,35,3,0,3,65,1,66
Pondicherry,2005,Attempt To Commit Murder,0,0,0,7,0,7,0,0,0,3,0,3,10,0,10
Pondicherry,2005,C.H. Not Amounting To Murder,0,0,0,3,0,3,3,0,3,0,1,1,6,1,7
Pondicherry,2005,Rape,0,0,0,0,0,0,0,0,0,0,0,0,0,0,0
Pondicherry,2005,Kidnapping And Abduction,0,0,0,2,0,2,2,1,3,0,0,0,4,1,5
Pondicherry,2005,Dacoity,0,0,0,0,0,0,1,0,1,0,0,0,1,0,1
Pondicherry,2005,Prep. And Assembly For Dacoity,0,0,0,0,0,0,0,0,0,0,0,0,0,0,0
Pondicherry,2005,Robbery,0,0,0,3,0,3,4,0,4,0,0,0,7,0,7
Pondicherry,2005,Burglary,0,0,0,0,0,0,6,0,6,4,0,4,10,0,10
Pondicherry,2005,Thefts,0,0,0,3,2,5,0,0,0,3,0,3,6,2,8
Pondicherry,2005,Extortion,0,0,0,0,0,0,0,0,0,0,0,0,0,0,0
Pondicherry,2005,Riots,0,0,0,0,0,0,0,0,0,0,0,0,0,0,0
Pondicherry,2005,Arson,0,0,0,0,0,0,0,0,0,0,0,0,0,0,0
Pondicherry,2005,Criminal Breach Of Trust,0,0,0,0,0,0,0,0,0,0,0,0,0,0,0
Pondicherry,2005,Cheating,0,0,0,0,0,0,0,0,0,0,0,0,0,0,0
Pondicherry,2005,Counter Feiting,0,0,0,0,0,0,0,0,0,0,0,0,0,0,0
Pondicherry,2005,Dowry Deaths,0,0,0,0,0,0,2,0,2,0,0,0,2,0,2
Pondicherry,2005,Molestation,0,0,0,0,0,0,0,0,0,0,0,0,0,0,0
Pondicherry,2005,Eve-Teasing,0,0,0,0,0,0,0,0,0,0,0,0,0,0,0
Pondicherry,2005,Cruelty By Husband Or Relative Of Husband,0,0,0,0,0,0,0,0,0,0,0,0,0,0,0
Pondicherry,2005,Other Ipc Crimes,0,0,0,0,0,0,0,0,0,0,0,0,0,0,0
Pondicherry,2006,Murder,0,0,0,33,1,34,32,0,32,6,0,6,71,1,72
Pondicherry,2006,Attempt To Commit Murder,0,0,0,7,0,7,0,0,0,0,0,0,7,0,7
Pondicherry,2006,C.H. Not Amounting To Murder,0,0,0,0,0,0,0,0,0,0,0,0,0,0,0
Pondicherry,2006,Rape,0,0,0,0,0,0,1,0,1,0,0,0,1,0,1
Pondicherry,2006,Kidnapping And Abduction,0,0,0,0,0,0,0,1,1,0,0,0,0,1,1
Pondicherry,2006,Dacoity,0,0,0,0,0,0,0,0,0,0,0,0,0,0,0
Pondicherry,2006,Prep. And Assembly For Dacoity,0,0,0,0,0,0,0,0,0,0,0,0,0,0,0
Pondicherry,2006,Robbery,0,0,0,4,0,4,2,0,2,0,0,0,6,0,6
Pondicherry,2006,Burglary,0,0,0,8,0,8,3,0,3,0,0,0,11,0,11
Pondicherry,2006,Thefts,0,0,0,5,0,5,3,0,3,0,0,0,8,0,8
Pondicherry,2006,Extortion,0,0,0,0,0,0,0,0,0,0,0,0,0,0,0
Pondicherry,2006,Riots,0,0,0,0,0,0,0,0,0,0,0,0,0,0,0
Pondicherry,2006,Arson,0,0,0,0,0,0,0,0,0,0,0,0,0,0,0
Pondicherry,2006,Criminal Breach Of Trust,0,0,0,0,0,0,0,0,0,0,0,0,0,0,0
Pondicherry,2006,Cheating,0,0,0,0,0,0,0,0,0,0,0,0,0,0,0
Pondicherry,2006,Counter Feiting,0,0,0,0,0,0,0,0,0,0,0,0,0,0,0
Pondicherry,2006,Dowry Deaths,0,0,0,0,0,0,0,0,0,0,1,1,0,1,1
Pondicherry,2006,Molestation,0,0,0,0,0,0,0,0,0,0,0,0,0,0,0
Pondicherry,2006,Eve-Teasing,0,0,0,0,0,0,0,0,0,0,0,0,0,0,0
Pondicherry,2006,Cruelty By Husband Or Relative Of Husband,0,0,0,0,0,0,0,0,0,0,0,0,0,0,0
Pondicherry,2006,Other Ipc Crimes,0,0,0,0,0,0,0,0,0,0,0,0,0,0,0
Pondicherry,2007,Murder,0,0,0,30,1,31,33,0,33,7,0,7,70,1,71
Pondicherry,2007,Attempt To Commit Murder,0,0,0,6,0,6,1,0,1,0,0,0,7,0,7
Pondicherry,2007,C.H. Not Amounting To Murder,0,0,0,0,0,0,1,0,1,1,0,1,2,0,2
Pondicherry,2007,Rape,0,0,0,1,0,1,2,0,2,0,0,0,3,0,3
Pondicherry,2007,Kidnapping And Abduction,0,0,0,3,0,3,0,0,0,0,0,0,3,0,3
Pondicherry,2007,Dacoity,0,0,0,0,0,0,0,0,0,0,0,0,0,0,0
Pondicherry,2007,Prep. And Assembly For Dacoity,0,0,0,0,0,0,0,0,0,0,0,0,0,0,0
Pondicherry,2007,Robbery,0,0,0,4,0,4,2,0,2,0,0,0,6,0,6
Pondicherry,2007,Burglary,0,0,0,2,0,2,2,0,2,0,0,0,4,0,4
Pondicherry,2007,Thefts,0,0,0,12,1,13,0,0,0,2,0,2,14,1,15
Pondicherry,2007,Extortion,0,0,0,0,0,0,0,0,0,0,0,0,0,0,0
Pondicherry,2007,Riots,0,0,0,0,0,0,0,0,0,0,0,0,0,0,0
Pondicherry,2007,Arson,0,0,0,0,0,0,0,0,0,0,0,0,0,0,0
Pondicherry,2007,Criminal Breach Of Trust,0,0,0,0,0,0,0,0,0,0,0,0,0,0,0
Pondicherry,2007,Cheating,0,0,0,0,0,0,0,0,0,0,0,0,0,0,0
Pondicherry,2007,Counter Feiting,0,0,0,0,0,0,0,0,0,0,0,0,0,0,0
Pondicherry,2007,Dowry Deaths,0,0,0,0,0,0,0,0,0,0,0,0,0,0,0
Pondicherry,2007,Molestation,0,0,0,0,0,0,0,0,0,0,0,0,0,0,0
Pondicherry,2007,Eve-Teasing,0,0,0,0,0,0,0,0,0,0,0,0,0,0,0
Pondicherry,2007,Cruelty By Husband Or Relative Of Husband,0,0,0,0,0,0,0,0,0,0,0,0,0,0,0
Pondicherry,2007,Other Ipc Crimes,0,0,0,0,0,0,0,0,0,0,0,0,0,0,0
Pondicherry,2008,Murder,0,0,0,36,1,37,30,0,30,3,0,3,69,1,70
Pondicherry,2008,Attempt To Commit Murder,0,0,0,6,0,6,0,0,0,0,0,0,6,0,6
Pondicherry,2008,C.H. Not Amounting To Murder,0,0,0,2,0,2,0,0,0,0,0,0,2,0,2
Pondicherry,2008,Rape,0,0,0,1,0,1,0,0,0,0,0,0,1,0,1
Pondicherry,2008,Kidnapping And Abduction,0,0,0,2,0,2,1,0,1,0,0,0,3,0,3
Pondicherry,2008,Dacoity,0,0,0,0,0,0,0,0,0,0,0,0,0,0,0
Pondicherry,2008,Prep. And Assembly For Dacoity,0,0,0,0,0,0,0,0,0,0,0,0,0,0,0
Pondicherry,2008,Robbery,0,0,0,0,0,0,1,0,1,0,0,0,1,0,1
Pondicherry,2008,Burglary,0,0,0,0,0,0,0,0,0,0,0,0,0,0,0
Pondicherry,2008,Thefts,0,0,0,7,0,7,0,0,0,0,0,0,7,0,7
Pondicherry,2008,Extortion,0,0,0,0,0,0,0,0,0,0,0,0,0,0,0
Pondicherry,2008,Riots,0,0,0,0,0,0,0,0,0,0,0,0,0,0,0
Pondicherry,2008,Arson,0,0,0,0,0,0,0,0,0,0,0,0,0,0,0
Pondicherry,2008,Criminal Breach Of Trust,0,0,0,0,0,0,0,0,0,0,0,0,0,0,0
Pondicherry,2008,Cheating,0,0,0,1,0,1,0,0,0,0,0,0,1,0,1
Pondicherry,2008,Counter Feiting,0,0,0,0,0,0,0,0,0,0,0,0,0,0,0
Pondicherry,2008,Dowry Deaths,0,0,0,2,0,2,0,0,0,0,0,0,2,0,2
Pondicherry,2008,Molestation,0,0,0,0,0,0,0,0,0,0,0,0,0,0,0
Pondicherry,2008,Eve-Teasing,0,0,0,0,0,0,0,0,0,0,0,0,0,0,0
Pondicherry,2008,Cruelty By Husband Or Relative Of Husband,0,0,0,0,0,0,0,0,0,0,0,0,0,0,0
Pondicherry,2008,Other Ipc Crimes,0,0,0,3,0,3,0,0,0,0,0,0,3,0,3
Pondicherry,2009,Murder,0,0,0,18,0,18,61,1,62,8,0,8,87,1,88
Pondicherry,2009,Attempt To Commit Murder,0,0,0,1,0,1,0,0,0,0,0,0,1,0,1
Pondicherry,2009,C.H. Not Amounting To Murder,0,0,0,1,0,1,2,0,2,2,0,2,5,0,5
Pondicherry,2009,Rape,0,0,0,1,0,1,4,0,4,1,0,1,6,0,6
Pondicherry,2009,Kidnapping And Abduction,0,0,0,6,0,6,0,0,0,0,0,0,6,0,6
Pondicherry,2009,Dacoity,0,0,0,0,0,0,0,0,0,0,0,0,0,0,0
Pondicherry,2009,Prep. And Assembly For Dacoity,0,0,0,0,0,0,0,0,0,0,0,0,0,0,0
Pondicherry,2009,Robbery,0,0,0,0,0,0,1,1,2,0,0,0,1,1,2
Pondicherry,2009,Burglary,0,0,0,0,0,0,0,0,0,0,0,0,0,0,0
Pondicherry,2009,Thefts,0,0,0,5,0,5,1,0,1,1,0,1,7,0,7
Pondicherry,2009,Extortion,0,0,0,0,0,0,0,0,0,0,0,0,0,0,0
Pondicherry,2009,Riots,0,0,0,0,0,0,0,0,0,0,0,0,0,0,0
Pondicherry,2009,Arson,0,0,0,0,0,0,0,0,0,0,0,0,0,0,0
Pondicherry,2009,Criminal Breach Of Trust,0,0,0,0,0,0,0,0,0,0,0,0,0,0,0
Pondicherry,2009,Cheating,0,0,0,0,0,0,0,0,0,0,0,0,0,0,0
Pondicherry,2009,Counter Feiting,0,0,0,0,0,0,0,0,0,0,0,0,0,0,0
Pondicherry,2009,Dowry Deaths,0,0,0,0,0,0,0,0,0,0,0,0,0,0,0
Pondicherry,2009,Molestation,0,0,0,0,0,0,0,0,0,0,0,0,0,0,0
Pondicherry,2009,Eve-Teasing,0,0,0,0,0,0,0,0,0,0,0,0,0,0,0
Pondicherry,2009,Cruelty By Husband Or Relative Of Husband,0,0,0,0,0,0,0,0,0,0,0,0,0,0,0
Pondicherry,2009,Other Ipc Crimes,0,0,0,0,0,0,3,0,3,0,0,0,3,0,3
Pondicherry,2010,Murder,0,0,0,20,0,20,51,1,52,4,1,5,75,2,77
Pondicherry,2010,Attempt To Commit Murder,0,0,0,4,0,4,11,0,11,4,0,4,19,0,19
Pondicherry,2010,C.H. Not Amounting To Murder,0,0,0,2,0,2,3,0,3,1,0,1,6,0,6
Pondicherry,2010,Rape,0,0,0,0,0,0,5,0,5,1,0,1,6,0,6
Pondicherry,2010,Kidnapping And Abduction,0,0,0,1,0,1,0,0,0,1,0,1,2,0,2
Pondicherry,2010,Dacoity,0,0,0,0,0,0,0,0,0,0,0,0,0,0,0
Pondicherry,2010,Prep. And Assembly For Dacoity,0,0,0,0,0,0,0,0,0,0,0,0,0,0,0
Pondicherry,2010,Robbery,0,0,0,0,0,0,0,0,0,0,0,0,0,0,0
Pondicherry,2010,Burglary,0,0,0,0,0,0,0,0,0,0,0,0,0,0,0
Pondicherry,2010,Thefts,0,0,0,9,0,9,3,0,3,0,0,0,12,0,12
Pondicherry,2010,Extortion,0,0,0,2,0,2,0,0,0,0,0,0,2,0,2
Pondicherry,2010,Riots,0,0,0,0,0,0,0,0,0,0,0,0,0,0,0
Pondicherry,2010,Arson,0,0,0,0,0,0,0,0,0,0,0,0,0,0,0
Pondicherry,2010,Criminal Breach Of Trust,0,0,0,0,0,0,0,0,0,0,0,0,0,0,0
Pondicherry,2010,Cheating,0,0,0,0,0,0,0,0,0,0,0,0,0,0,0
Pondicherry,2010,Counter Feiting,0,0,0,0,0,0,0,0,0,0,0,0,0,0,0
Pondicherry,2010,Dowry Deaths,0,0,0,0,0,0,0,0,0,0,0,0,0,0,0
Pondicherry,2010,Molestation,0,0,0,0,0,0,1,0,1,0,0,0,1,0,1
Pondicherry,2010,Eve-Teasing,0,0,0,0,0,0,0,0,0,0,0,0,0,0,0
Pondicherry,2010,Cruelty By Husband Or Relative Of Husband,0,0,0,0,0,0,0,0,0,0,0,0,0,0,0
Pondicherry,2010,Other Ipc Crimes,0,0,0,0,0,0,3,0,3,1,0,1,4,0,4
Pondicherry,2011,Murder,0,0,0,16,0,16,66,1,67,11,1,12,93,2,95
Pondicherry,2011,Attempt To Commit Murder,0,0,0,2,0,2,0,1,1,0,0,0,2,1,3
Pondicherry,2011,C.H. Not Amounting To Murder,0,0,0,0,0,0,2,0,2,2,0,2,4,0,4
Pondicherry,2011,Rape,0,0,0,1,0,1,3,0,3,1,0,1,5,0,5
Pondicherry,2011,Kidnapping And Abduction,0,0,0,0,0,0,0,0,0,0,0,0,0,0,0
Pondicherry,2011,Dacoity,0,0,0,0,0,0,0,0,0,0,0,0,0,0,0
Pondicherry,2011,Prep. And Assembly For Dacoity,0,0,0,0,0,0,0,0,0,0,0,0,0,0,0
Pondicherry,2011,Robbery,0,0,0,0,0,0,2,0,2,1,0,1,3,0,3
Pondicherry,2011,Burglary,0,0,0,0,0,0,0,0,0,0,0,0,0,0,0
Pondicherry,2011,Thefts,0,0,0,3,0,3,12,0,12,2,0,2,17,0,17
Pondicherry,2011,Extortion,0,0,0,0,0,0,0,0,0,0,0,0,0,0,0
Pondicherry,2011,Riots,0,0,0,0,0,0,0,0,0,0,0,0,0,0,0
Pondicherry,2011,Arson,0,0,0,0,0,0,0,0,0,0,0,0,0,0,0
Pondicherry,2011,Criminal Breach Of Trust,0,0,0,0,0,0,0,0,0,0,0,0,0,0,0
Pondicherry,2011,Cheating,0,0,0,0,0,0,0,0,0,0,0,0,0,0,0
Pondicherry,2011,Counter Feiting,0,0,0,0,0,0,0,0,0,0,0,0,0,0,0
Pondicherry,2011,Dowry Deaths,0,0,0,0,0,0,0,0,0,0,0,0,0,0,0
Pondicherry,2011,Molestation,0,0,0,0,0,0,1,0,1,0,0,0,1,0,1
Pondicherry,2011,Eve-Teasing,0,0,0,0,0,0,0,0,0,0,0,0,0,0,0
Pondicherry,2011,Cruelty By Husband Or Relative Of Husband,0,0,0,0,0,0,0,0,0,0,0,0,0,0,0
Pondicherry,2011,Other Ipc Crimes,0,0,0,0,0,0,0,0,0,1,0,1,1,0,1
Pondicherry,2012,Murder,0,0,0,6,0,6,54,1,55,9,1,10,69,2,71
Pondicherry,2012,Attempt To Commit Murder,0,0,0,0,0,0,0,0,0,0,0,0,0,0,0
Pondicherry,2012,C.H. Not Amounting To Murder,0,0,0,3,0,3,3,0,3,0,0,0,6,0,6
Pondicherry,2012,Rape,0,0,0,0,0,0,4,0,4,0,0,0,4,0,4
Pondicherry,2012,Kidnapping And Abduction,0,0,0,0,0,0,4,0,4,0,0,0,4,0,4
Pondicherry,2012,Dacoity,0,0,0,0,0,0,0,0,0,0,0,0,0,0,0
Pondicherry,2012,Prep. And Assembly For Dacoity,0,0,0,0,0,0,0,0,0,0,0,0,0,0,0
Pondicherry,2012,Robbery,0,0,0,0,0,0,0,0,0,0,0,0,0,0,0
Pondicherry,2012,Burglary,0,0,0,3,0,3,3,0,3,0,0,0,6,0,6
Pondicherry,2012,Thefts,0,0,0,0,0,0,0,0,0,0,0,0,0,0,0
Pondicherry,2012,Extortion,0,0,0,0,0,0,0,0,0,0,0,0,0,0,0
Pondicherry,2012,Riots,0,0,0,0,0,0,0,0,0,0,0,0,0,0,0
Pondicherry,2012,Arson,0,0,0,0,0,0,0,0,0,0,0,0,0,0,0
Pondicherry,2012,Criminal Breach Of Trust,0,0,0,0,0,0,0,0,0,0,0,0,0,0,0
Pondicherry,2012,Cheating,0,0,0,0,0,0,0,0,0,0,0,0,0,0,0
Pondicherry,2012,Counter Feiting,0,0,0,0,0,0,1,0,1,0,0,0,1,0,1
Pondicherry,2012,Dowry Deaths,0,0,0,0,0,0,0,0,0,0,0,0,0,0,0
Pondicherry,2012,Molestation,0,0,0,0,0,0,0,0,0,0,0,0,0,0,0
Pondicherry,2012,Eve-Teasing,0,0,0,0,0,0,0,0,0,0,0,0,0,0,0
Pondicherry,2012,Cruelty By Husband Or Relative Of Husband,0,0,0,0,0,0,0,0,0,0,0,0,0,0,0
Pondicherry,2012,Other Ipc Crimes,0,0,0,0,0,0,8,0,8,9,0,9,17,0,17
Andhra Pradesh,2013,Murder,0,0,0,822,32,854,1612,121,1733,177,41,218,2611,194,2805
Andhra Pradesh,2013,Attempt To Commit Murder,0,0,0,28,1,29,74,7,81,13,1,14,115,9,124
Andhra Pradesh,2013,C.H. Not Amounting To Murder,0,0,0,16,0,16,22,0,22,10,0,10,48,0,48
Andhra Pradesh,2013,Rape,0,0,0,72,0,72,51,1,52,8,0,8,131,1,132
Andhra Pradesh,2013,Kidnapping And Abduction,0,0,0,22,0,22,22,2,24,2,0,2,46,2,48
Andhra Pradesh,2013,Dacoity,0,0,0,39,1,40,48,2,50,3,0,3,90,3,93
Andhra Pradesh,2013,Prep. And Assembly For Dacoity,0,0,0,3,0,3,0,0,0,0,0,0,3,0,3
Andhra Pradesh,2013,Robbery,0,0,0,32,0,32,23,2,25,3,0,3,58,2,60
Andhra Pradesh,2013,Burglary,0,0,0,21,0,21,13,0,13,5,0,5,39,0,39
Andhra Pradesh,2013,Thefts,0,0,0,248,0,248,106,1,107,5,1,6,359,2,361
Andhra Pradesh,2013,Extortion,0,0,0,9,0,9,5,0,5,0,0,0,14,0,14
Andhra Pradesh,2013,Riots,0,0,0,1,0,1,3,0,3,0,0,0,4,0,4
Andhra Pradesh,2013,Arson,0,0,0,0,0,0,5,0,5,3,0,3,8,0,8
Andhra Pradesh,2013,Criminal Breach Of Trust,0,0,0,0,0,0,0,0,0,0,0,0,0,0,0
Andhra Pradesh,2013,Cheating,0,0,0,9,1,10,9,1,10,0,1,1,18,3,21
Andhra Pradesh,2013,Counter Feiting,0,0,0,0,0,0,0,0,0,3,0,3,3,0,3
Andhra Pradesh,2013,Dowry Deaths,0,0,0,36,1,37,93,15,108,15,14,29,144,30,174
Andhra Pradesh,2013,Molestation,0,0,0,9,0,9,11,0,11,1,0,1,21,0,21
Andhra Pradesh,2013,Eve-Teasing,0,0,0,0,0,0,0,0,0,0,0,0,0,0,0
Andhra Pradesh,2013,Cruelty By Husband Or Relative Of Husband,0,0,0,9,0,9,14,0,14,1,0,1,24,0,24
Andhra Pradesh,2013,Other Ipc Crimes,0,0,0,133,1,134,97,3,100,25,0,25,255,4,259
Arunachal Pradesh,2013,Murder,0,0,0,0,0,0,1,0,1,0,0,0,1,0,1
Arunachal Pradesh,2013,Attempt To Commit Murder,0,0,0,0,0,0,0,0,0,0,0,0,0,0,0
Arunachal Pradesh,2013,C.H. Not Amounting To Murder,0,0,0,0,0,0,2,1,3,0,0,0,2,1,3
Arunachal Pradesh,2013,Rape,0,0,0,1,0,1,2,0,2,2,0,2,5,0,5
Arunachal Pradesh,2013,Kidnapping And Abduction,0,0,0,0,0,0,0,0,0,0,0,0,0,0,0
Arunachal Pradesh,2013,Dacoity,0,0,0,0,0,0,0,0,0,0,0,0,0,0,0
Arunachal Pradesh,2013,Prep. And Assembly For Dacoity,0,0,0,0,0,0,0,0,0,0,0,0,0,0,0
Arunachal Pradesh,2013,Robbery,0,0,0,0,0,0,0,0,0,0,0,0,0,0,0
Arunachal Pradesh,2013,Burglary,0,0,0,0,0,0,0,0,0,0,0,0,0,0,0
Arunachal Pradesh,2013,Thefts,0,0,0,0,0,0,0,0,0,0,0,0,0,0,0
Arunachal Pradesh,2013,Extortion,0,0,0,0,0,0,1,0,1,0,0,0,1,0,1
Arunachal Pradesh,2013,Riots,0,0,0,0,0,0,0,0,0,0,0,0,0,0,0
Arunachal Pradesh,2013,Arson,0,0,0,0,0,0,0,0,0,0,0,0,0,0,0
Arunachal Pradesh,2013,Criminal Breach Of Trust,0,0,0,0,0,0,0,0,0,0,0,0,0,0,0
Arunachal Pradesh,2013,Cheating,0,0,0,0,0,0,1,0,1,0,0,0,1,0,1
Arunachal Pradesh,2013,Counter Feiting,0,0,0,0,0,0,0,0,0,0,0,0,0,0,0
Arunachal Pradesh,2013,Dowry Deaths,0,0,0,0,0,0,0,0,0,0,0,0,0,0,0
Arunachal Pradesh,2013,Molestation,0,0,0,0,0,0,0,0,0,0,0,0,0,0,0
Arunachal Pradesh,2013,Eve-Teasing,0,0,0,0,0,0,0,0,0,0,0,0,0,0,0
Arunachal Pradesh,2013,Cruelty By Husband Or Relative Of Husband,0,0,0,0,0,0,0,0,0,0,0,0,0,0,0
Arunachal Pradesh,2013,Other Ipc Crimes,0,0,0,0,0,0,0,0,0,0,0,0,0,0,0
Assam,2013,Murder,0,0,0,394,10,404,1022,40,1062,280,12,292,1696,62,1758
Assam,2013,Attempt To Commit Murder,0,0,0,40,0,40,257,8,265,57,3,60,354,11,365
Assam,2013,C.H. Not Amounting To Murder,0,0,0,31,1,32,92,9,101,27,0,27,150,10,160
Assam,2013,Rape,0,0,0,60,0,60,173,3,176,19,0,19,252,3,255
Assam,2013,Kidnapping And Abduction,0,0,0,20,1,21,38,0,38,2,2,4,60,3,63
Assam,2013,Dacoity,0,0,0,19,0,19,32,0,32,5,1,6,56,1,57
Assam,2013,Prep. And Assembly For Dacoity,0,0,0,1,0,1,0,0,0,2,0,2,3,0,3
Assam,2013,Robbery,0,0,0,10,0,10,16,1,17,0,0,0,26,1,27
Assam,2013,Burglary,0,0,0,2,0,2,10,0,10,0,0,0,12,0,12
Assam,2013,Thefts,0,0,0,25,0,25,70,1,71,12,1,13,107,2,109
Assam,2013,Extortion,0,0,0,2,0,2,6,0,6,2,0,2,10,0,10
Assam,2013,Riots,0,0,0,7,0,7,4,0,4,0,0,0,11,0,11
Assam,2013,Arson,0,0,0,5,0,5,11,0,11,2,0,2,18,0,18
Assam,2013,Criminal Breach Of Trust,0,0,0,1,0,1,1,0,1,0,0,0,2,0,2
Assam,2013,Cheating,0,0,0,1,0,1,1,0,1,0,0,0,2,0,2
Assam,2013,Counter Feiting,0,0,0,8,0,8,3,0,3,0,0,0,11,0,11
Assam,2013,Dowry Deaths,0,0,0,2,0,2,20,0,20,2,0,2,24,0,24
Assam,2013,Molestation,0,0,0,0,0,0,2,0,2,0,0,0,2,0,2
Assam,2013,Eve-Teasing,0,0,0,0,0,0,0,0,0,0,0,0,0,0,0
Assam,2013,Cruelty By Husband Or Relative Of Husband,0,0,0,4,0,4,16,0,16,1,0,1,21,0,21
Assam,2013,Other Ipc Crimes,0,0,0,12,0,12,22,3,25,3,0,3,37,3,40
Bihar,2013,Murder,0,0,0,489,5,494,1186,31,1217,604,15,619,2279,51,2330
Bihar,2013,Attempt To Commit Murder,0,0,0,76,2,78,197,7,204,62,3,65,335,12,347
Bihar,2013,C.H. Not Amounting To Murder,0,0,0,13,1,14,44,4,48,16,3,19,73,8,81
Bihar,2013,Rape,0,0,0,60,0,60,54,0,54,9,0,9,123,0,123
Bihar,2013,Kidnapping And Abduction,0,0,0,63,2,65,102,2,104,49,2,51,214,6,220
Bihar,2013,Dacoity,0,0,0,40,1,41,76,0,76,24,0,24,140,1,141
Bihar,2013,Prep. And Assembly For Dacoity,0,0,0,16,0,16,11,0,11,8,1,9,35,1,36
Bihar,2013,Robbery,0,0,0,35,0,35,35,0,35,10,0,10,80,0,80
Bihar,2013,Burglary,0,0,0,3,0,3,9,0,9,2,0,2,14,0,14
Bihar,2013,Thefts,0,0,0,65,0,65,67,0,67,27,0,27,159,0,159
Bihar,2013,Extortion,0,0,0,12,0,12,14,0,14,1,0,1,27,0,27
Bihar,2013,Riots,0,0,0,3,0,3,0,0,0,0,0,0,3,0,3
Bihar,2013,Arson,0,0,0,2,0,2,7,0,7,3,0,3,12,0,12
Bihar,2013,Criminal Breach Of Trust,0,0,0,3,0,3,6,0,6,0,0,0,9,0,9
Bihar,2013,Cheating,0,0,0,6,0,6,12,0,12,3,0,3,21,0,21
Bihar,2013,Counter Feiting,0,0,0,3,0,3,8,0,8,0,0,0,11,0,11
Bihar,2013,Dowry Deaths,0,0,0,50,4,54,129,15,144,73,11,84,252,30,282
Bihar,2013,Molestation,0,0,0,0,0,0,4,0,4,0,0,0,4,0,4
Bihar,2013,Eve-Teasing,0,0,0,0,0,0,0,0,0,0,0,0,0,0,0
Bihar,2013,Cruelty By Husband Or Relative Of Husband,0,0,0,6,1,7,15,0,15,1,0,1,22,1,23
Bihar,2013,Other Ipc Crimes,0,0,0,4,0,4,3,1,4,3,1,4,10,2,12
Chhatisgarh,2013,Murder,0,0,0,1250,67,1317,2032,114,2146,740,30,770,4022,211,4233
Chhatisgarh,2013,Attempt To Commit Murder,0,0,0,137,5,142,125,1,126,38,2,40,300,8,308
Chhatisgarh,2013,C.H. Not Amounting To Murder,0,0,0,73,1,74,73,3,76,23,4,27,169,8,177
Chhatisgarh,2013,Rape,0,0,0,300,1,301,229,0,229,52,0,52,581,1,582
Chhatisgarh,2013,Kidnapping And Abduction,0,0,0,27,4,31,22,2,24,8,0,8,57,6,63
Chhatisgarh,2013,Dacoity,0,0,0,71,0,71,52,0,52,6,0,6,129,0,129
Chhatisgarh,2013,Prep. And Assembly For Dacoity,0,0,0,3,0,3,1,0,1,0,0,0,4,0,4
Chhatisgarh,2013,Robbery,0,0,0,54,0,54,38,0,38,4,0,4,96,0,96
Chhatisgarh,2013,Burglary,0,0,0,22,0,22,16,0,16,0,0,0,38,0,38
Chhatisgarh,2013,Thefts,0,0,0,51,1,52,29,0,29,2,0,2,82,1,83
Chhatisgarh,2013,Extortion,0,0,0,2,0,2,1,0,1,0,0,0,3,0,3
Chhatisgarh,2013,Riots,0,0,0,0,0,0,0,0,0,0,0,0,0,0,0
Chhatisgarh,2013,Arson,0,0,0,6,0,6,2,0,2,2,0,2,10,0,10
Chhatisgarh,2013,Criminal Breach Of Trust,0,0,0,0,0,0,0,0,0,0,0,0,0,0,0
Chhatisgarh,2013,Cheating,0,0,0,13,0,13,19,0,19,9,0,9,41,0,41
Chhatisgarh,2013,Counter Feiting,0,0,0,14,1,15,9,0,9,2,0,2,25,1,26
Chhatisgarh,2013,Dowry Deaths,0,0,0,83,5,88,31,19,50,20,11,31,134,35,169
Chhatisgarh,2013,Molestation,0,0,0,15,0,15,10,0,10,2,0,2,27,0,27
Chhatisgarh,2013,Eve-Teasing,0,0,0,1,0,1,0,0,0,0,0,0,1,0,1
Chhatisgarh,2013,Cruelty By Husband Or Relative Of Husband,0,0,0,2,0,2,6,1,7,0,0,0,8,1,9
Chhatisgarh,2013,Other Ipc Crimes,0,0,0,64,0,64,38,3,41,5,3,8,107,6,113
Goa,2013,Murder,0,0,0,0,0,0,39,2,41,6,0,6,45,2,47
Goa,2013,Attempt To Commit Murder,0,0,0,0,0,0,5,0,5,0,0,0,5,0,5
Goa,2013,C.H. Not Amounting To Murder,0,0,0,0,0,0,4,0,4,0,0,0,4,0,4
Goa,2013,Rape,0,0,0,0,0,0,15,0,15,2,0,2,17,0,17
Goa,2013,Kidnapping And Abduction,0,0,0,0,0,0,6,1,7,0,0,0,6,1,7
Goa,2013,Dacoity,0,0,0,0,0,0,2,0,2,0,0,0,2,0,2
Goa,2013,Prep. And Assembly For Dacoity,0,0,0,0,0,0,0,0,0,0,0,0,0,0,0
Goa,2013,Robbery,0,0,0,0,0,0,6,0,6,0,0,0,6,0,6
Goa,2013,Burglary,0,0,0,0,0,0,0,0,0,0,0,0,0,0,0
Goa,2013,Thefts,0,0,0,0,0,0,4,1,5,0,0,0,4,1,5
Goa,2013,Extortion,0,0,0,0,0,0,0,0,0,0,0,0,0,0,0
Goa,2013,Riots,0,0,0,0,0,0,0,0,0,0,0,0,0,0,0
Goa,2013,Arson,0,0,0,0,0,0,0,0,0,0,0,0,0,0,0
Goa,2013,Criminal Breach Of Trust,0,0,0,0,0,0,0,0,0,0,0,0,0,0,0
Goa,2013,Cheating,0,0,0,0,0,0,2,0,2,0,0,0,2,0,2
Goa,2013,Counter Feiting,0,0,0,0,0,0,1,0,1,0,0,0,1,0,1
Goa,2013,Dowry Deaths,0,0,0,0,0,0,0,0,0,0,0,0,0,0,0
Goa,2013,Molestation,0,0,0,0,0,0,0,0,0,0,0,0,0,0,0
Goa,2013,Eve-Teasing,0,0,0,0,0,0,0,0,0,0,0,0,0,0,0
Goa,2013,Cruelty By Husband Or Relative Of Husband,0,0,0,0,0,0,0,0,0,0,0,0,0,0,0
Goa,2013,Other Ipc Crimes,0,0,0,0,0,0,8,3,11,0,0,0,8,3,11
Gujarat,2013,Murder,0,0,0,445,18,463,1009,75,1084,285,24,309,1739,117,1856
Gujarat,2013,Attempt To Commit Murder,0,0,0,38,0,38,52,2,54,19,0,19,109,2,111
Gujarat,2013,C.H. Not Amounting To Murder,0,0,0,115,4,119,117,5,122,63,5,68,295,14,309
Gujarat,2013,Rape,0,0,0,180,1,181,124,1,125,9,1,10,313,3,316
Gujarat,2013,Kidnapping And Abduction,0,0,0,43,2,45,20,3,23,9,2,11,72,7,79
Gujarat,2013,Dacoity,0,0,0,35,1,36,32,0,32,9,0,9,76,1,77
Gujarat,2013,Prep. And Assembly For Dacoity,0,0,0,15,0,15,8,0,8,2,0,2,25,0,25
Gujarat,2013,Robbery,0,0,0,25,1,26,20,0,20,9,0,9,54,1,55
Gujarat,2013,Burglary,0,0,0,14,0,14,8,0,8,2,0,2,24,0,24
Gujarat,2013,Thefts,0,0,0,29,0,29,18,0,18,7,0,7,54,0,54
Gujarat,2013,Extortion,0,0,0,0,0,0,0,0,0,0,0,0,0,0,0
Gujarat,2013,Riots,0,0,0,0,0,0,0,0,0,0,0,0,0,0,0
Gujarat,2013,Arson,0,0,0,3,1,4,4,1,5,1,1,2,8,3,11
Gujarat,2013,Criminal Breach Of Trust,0,0,0,9,0,9,7,0,7,6,0,6,22,0,22
Gujarat,2013,Cheating,0,0,0,2,0,2,1,0,1,0,0,0,3,0,3
Gujarat,2013,Counter Feiting,0,0,0,12,1,13,12,0,12,7,0,7,31,1,32
Gujarat,2013,Dowry Deaths,0,0,0,18,1,19,11,1,12,4,1,5,33,3,36
Gujarat,2013,Molestation,0,0,0,1,0,1,3,0,3,0,0,0,4,0,4
Gujarat,2013,Eve-Teasing,0,0,0,0,0,0,0,0,0,0,0,0,0,0,0
Gujarat,2013,Cruelty By Husband Or Relative Of Husband,0,0,0,31,2,33,19,1,20,10,1,11,60,4,64
Gujarat,2013,Other Ipc Crimes,0,0,0,87,1,88,75,0,75,41,2,43,203,3,206
Haryana,2013,Murder,0,0,0,1198,56,1254,1353,87,1440,427,48,475,2978,191,3169
Haryana,2013,Attempt To Commit Murder,0,0,0,216,4,220,151,1,152,48,3,51,415,8,423
Haryana,2013,C.H. Not Amounting To Murder,0,0,0,47,1,48,45,1,46,19,1,20,111,3,114
Haryana,2013,Rape,0,0,0,467,1,468,255,4,259,77,1,78,799,6,805
Haryana,2013,Kidnapping And Abduction,0,0,0,103,6,109,70,8,78,7,2,9,180,16,196
Haryana,2013,Dacoity,0,0,0,255,0,255,174,1,175,10,0,10,439,1,440
Haryana,2013,Prep. And Assembly For Dacoity,0,0,0,26,0,26,19,0,19,0,0,0,45,0,45
Haryana,2013,Robbery,0,0,0,98,0,98,56,0,56,2,0,2,156,0,156
Haryana,2013,Burglary,0,0,0,27,0,27,36,0,36,10,0,10,73,0,73
Haryana,2013,Thefts,0,0,0,48,0,48,17,1,18,1,0,1,66,1,67
Haryana,2013,Extortion,0,0,0,3,0,3,4,0,4,0,0,0,7,0,7
Haryana,2013,Riots,0,0,0,1,0,1,1,0,1,0,0,0,2,0,2
Haryana,2013,Arson,0,0,0,0,0,0,5,0,5,0,0,0,5,0,5
Haryana,2013,Criminal Breach Of Trust,0,0,0,0,0,0,6,1,7,3,1,4,9,2,11
Haryana,2013,Cheating,0,0,0,2,0,2,25,0,25,5,0,5,32,0,32
Haryana,2013,Counter Feiting,0,0,0,0,0,0,12,1,13,1,0,1,13,1,14
Haryana,2013,Dowry Deaths,0,0,0,128,8,136,160,50,210,77,33,110,365,91,456
Haryana,2013,Molestation,0,0,0,19,0,19,8,0,8,1,0,1,28,0,28
Haryana,2013,Eve-Teasing,0,0,0,0,0,0,0,0,0,0,0,0,0,0,0
Haryana,2013,Cruelty By Husband Or Relative Of Husband,0,0,0,16,0,16,18,1,19,3,0,3,37,1,38
Haryana,2013,Other Ipc Crimes,0,0,0,69,3,72,129,3,132,28,0,28,226,6,232
Himachal Pradesh,2013,Murder,0,0,0,77,1,78,189,17,206,95,6,101,361,24,385
Himachal Pradesh,2013,Attempt To Commit Murder,0,0,0,9,0,9,13,0,13,4,1,5,26,1,27
Himachal Pradesh,2013,C.H. Not Amounting To Murder,0,0,0,14,0,14,15,0,15,7,0,7,36,0,36
Himachal Pradesh,2013,Rape,0,0,0,65,0,65,68,0,68,13,0,13,146,0,146
Himachal Pradesh,2013,Kidnapping And Abduction,0,0,0,2,0,2,0,0,0,0,0,0,2,0,2
Himachal Pradesh,2013,Dacoity,0,0,0,14,0,14,7,0,7,0,0,0,21,0,21
Himachal Pradesh,2013,Prep. And Assembly For Dacoity,0,0,0,0,0,0,0,0,0,0,0,0,0,0,0
Himachal Pradesh,2013,Robbery,0,0,0,2,0,2,0,0,0,0,0,0,2,0,2
Himachal Pradesh,2013,Burglary,0,0,0,2,0,2,6,0,6,1,0,1,9,0,9
Himachal Pradesh,2013,Thefts,0,0,0,16,1,17,6,0,6,0,0,0,22,1,23
Himachal Pradesh,2013,Extortion,0,0,0,0,0,0,0,0,0,0,0,0,0,0,0
Himachal Pradesh,2013,Riots,0,0,0,0,0,0,0,0,0,0,0,0,0,0,0
Himachal Pradesh,2013,Arson,0,0,0,0,0,0,0,0,0,0,0,0,0,0,0
Himachal Pradesh,2013,Criminal Breach Of Trust,0,0,0,0,0,0,2,0,2,0,0,0,2,0,2
Himachal Pradesh,2013,Cheating,0,0,0,0,0,0,0,0,0,0,0,0,0,0,0
Himachal Pradesh,2013,Counter Feiting,0,0,0,0,0,0,0,0,0,0,0,0,0,0,0
Himachal Pradesh,2013,Dowry Deaths,0,0,0,1,0,1,2,0,2,0,0,0,3,0,3
Himachal Pradesh,2013,Molestation,0,0,0,1,0,1,1,0,1,0,0,0,2,0,2
Himachal Pradesh,2013,Eve-Teasing,0,0,0,0,0,0,0,0,0,0,0,0,0,0,0
Himachal Pradesh,2013,Cruelty By Husband Or Relative Of Husband,0,0,0,1,0,1,9,1,10,3,1,4,13,2,15
Himachal Pradesh,2013,Other Ipc Crimes,0,0,0,13,3,16,38,1,39,12,0,12,63,4,67
Jammu And Kashmir,2013,Murder,0,0,0,22,0,22,114,3,117,35,7,42,171,10,181
Jammu And Kashmir,2013,Attempt To Commit Murder,0,0,0,1,0,1,0,0,0,1,0,1,2,0,2
Jammu And Kashmir,2013,C.H. Not Amounting To Murder,0,0,0,3,0,3,8,0,8,0,0,0,11,0,11
Jammu And Kashmir,2013,Rape,0,0,0,15,0,15,40,0,40,4,0,4,59,0,59
Jammu And Kashmir,2013,Kidnapping And Abduction,0,0,0,0,0,0,2,0,2,0,0,0,2,0,2
Jammu And Kashmir,2013,Dacoity,0,0,0,0,0,0,0,0,0,0,0,0,0,0,0
Jammu And Kashmir,2013,Prep. And Assembly For Dacoity,0,0,0,0,0,0,0,0,0,0,0,0,0,0,0
Jammu And Kashmir,2013,Robbery,0,0,0,1,0,1,0,0,0,0,0,0,1,0,1
Jammu And Kashmir,2013,Burglary,0,0,0,4,0,4,4,0,4,0,0,0,8,0,8
Jammu And Kashmir,2013,Thefts,0,0,0,2,0,2,2,0,2,0,0,0,4,0,4
Jammu And Kashmir,2013,Extortion,0,0,0,0,0,0,0,0,0,0,0,0,0,0,0
Jammu And Kashmir,2013,Riots,0,0,0,0,0,0,0,0,0,0,0,0,0,0,0
Jammu And Kashmir,2013,Arson,0,0,0,0,0,0,0,0,0,0,0,0,0,0,0
Jammu And Kashmir,2013,Criminal Breach Of Trust,0,0,0,0,0,0,0,0,0,0,0,0,0,0,0
Jammu And Kashmir,2013,Cheating,0,0,0,0,0,0,1,0,1,0,0,0,1,0,1
Jammu And Kashmir,2013,Counter Feiting,0,0,0,0,0,0,0,0,0,0,0,0,0,0,0
Jammu And Kashmir,2013,Dowry Deaths,0,0,0,0,0,0,0,0,0,0,0,0,0,0,0
Jammu And Kashmir,2013,Molestation,0,0,0,0,0,0,1,0,1,0,0,0,1,0,1
Jammu And Kashmir,2013,Eve-Teasing,0,0,0,0,0,0,0,0,0,0,0,0,0,0,0
Jammu And Kashmir,2013,Cruelty By Husband Or Relative Of Husband,0,0,0,1,0,1,2,0,2,1,0,1,4,0,4
Jammu And Kashmir,2013,Other Ipc Crimes,0,0,0,1,0,1,3,0,3,0,0,0,4,0,4
Jharkhand,2013,Murder,0,0,0,608,12,620,1398,46,1444,321,18,339,2327,76,2403
Jharkhand,2013,Attempt To Commit Murder,0,0,0,36,0,36,67,2,69,62,0,62,165,2,167
Jharkhand,2013,C.H. Not Amounting To Murder,0,0,0,7,0,7,19,1,20,5,0,5,31,1,32
Jharkhand,2013,Rape,0,0,0,82,0,82,101,1,102,14,0,14,197,1,198
Jharkhand,2013,Kidnapping And Abduction,0,0,0,27,1,28,58,0,58,24,0,24,109,1,110
Jharkhand,2013,Dacoity,0,0,0,55,0,55,78,0,78,14,0,14,147,0,147
Jharkhand,2013,Prep. And Assembly For Dacoity,0,0,0,7,0,7,8,0,8,0,0,0,15,0,15
Jharkhand,2013,Robbery,0,0,0,19,0,19,46,0,46,19,0,19,84,0,84
Jharkhand,2013,Burglary,0,0,0,5,0,5,3,0,3,1,0,1,9,0,9
Jharkhand,2013,Thefts,0,0,0,47,0,47,83,1,84,14,0,14,144,1,145
Jharkhand,2013,Extortion,0,0,0,11,0,11,25,0,25,0,0,0,36,0,36
Jharkhand,2013,Riots,0,0,0,0,0,0,1,0,1,0,0,0,1,0,1
Jharkhand,2013,Arson,0,0,0,0,0,0,0,0,0,0,0,0,0,0,0
Jharkhand,2013,Criminal Breach Of Trust,0,0,0,1,0,1,10,0,10,0,0,0,11,0,11
Jharkhand,2013,Cheating,0,0,0,6,0,6,33,0,33,0,0,0,39,0,39
Jharkhand,2013,Counter Feiting,0,0,0,0,0,0,0,1,1,0,0,0,0,1,1
Jharkhand,2013,Dowry Deaths,0,0,0,65,13,78,135,38,173,90,11,101,290,62,352
Jharkhand,2013,Molestation,0,0,0,0,0,0,2,0,2,0,0,0,2,0,2
Jharkhand,2013,Eve-Teasing,0,0,0,1,0,1,0,0,0,0,0,0,1,0,1
Jharkhand,2013,Cruelty By Husband Or Relative Of Husband,0,0,0,15,2,17,41,2,43,17,2,19,73,6,79
Jharkhand,2013,Other Ipc Crimes,0,0,0,1,0,1,3,0,3,0,0,0,4,0,4
Karnataka,2013,Murder,0,0,0,1249,84,1333,1476,68,1544,109,5,114,2834,157,2991
Karnataka,2013,Attempt To Commit Murder,0,0,0,119,2,121,103,0,103,3,0,3,225,2,227
Karnataka,2013,C.H. Not Amounting To Murder,0,0,0,9,0,9,47,0,47,1,0,1,57,0,57
Karnataka,2013,Rape,0,0,0,79,0,79,48,0,48,0,0,0,127,0,127
Karnataka,2013,Kidnapping And Abduction,0,0,0,43,0,43,21,0,21,0,0,0,64,0,64
Karnataka,2013,Dacoity,0,0,0,37,0,37,67,0,67,0,0,0,104,0,104
Karnataka,2013,Prep. And Assembly For Dacoity,0,0,0,6,0,6,11,0,11,0,0,0,17,0,17
Karnataka,2013,Robbery,0,0,0,66,0,66,29,0,29,1,0,1,96,0,96
Karnataka,2013,Burglary,0,0,0,37,0,37,43,0,43,1,0,1,81,0,81
Karnataka,2013,Thefts,0,0,0,109,3,112,47,19,66,4,0,4,160,22,182
Karnataka,2013,Extortion,0,0,0,3,0,3,5,0,5,0,0,0,8,0,8
Karnataka,2013,Riots,0,0,0,13,0,13,9,0,9,2,0,2,24,0,24
Karnataka,2013,Arson,0,0,0,2,0,2,2,0,2,0,0,0,4,0,4
Karnataka,2013,Criminal Breach Of Trust,0,0,0,4,0,4,6,0,6,0,0,0,10,0,10
Karnataka,2013,Cheating,0,0,0,31,1,32,49,4,53,3,0,3,83,5,88
Karnataka,2013,Counter Feiting,0,0,0,0,0,0,0,0,0,0,0,0,0,0,0
Karnataka,2013,Dowry Deaths,0,0,0,31,1,32,76,3,79,6,2,8,113,6,119
Karnataka,2013,Molestation,0,0,0,1,0,1,7,0,7,1,0,1,9,0,9
Karnataka,2013,Eve-Teasing,0,0,0,3,0,3,2,0,2,0,0,0,5,0,5
Karnataka,2013,Cruelty By Husband Or Relative Of Husband,0,0,0,7,0,7,16,2,18,1,1,2,24,3,27
Karnataka,2013,Other Ipc Crimes,0,0,0,0,1,1,1,1,2,1,0,1,2,2,4
Kerala,2013,Murder,0,0,0,225,4,229,504,24,528,527,5,532,1256,33,1289
Kerala,2013,Attempt To Commit Murder,0,0,0,60,0,60,82,0,82,36,0,36,178,0,178
Kerala,2013,C.H. Not Amounting To Murder,0,0,0,12,3,15,45,0,45,0,0,0,57,3,60
Kerala,2013,Rape,0,0,0,6,0,6,4,0,4,2,0,2,12,0,12
Kerala,2013,Kidnapping And Abduction,0,0,0,0,0,0,6,0,6,0,0,0,6,0,6
Kerala,2013,Dacoity,0,0,0,12,0,12,20,0,20,2,0,2,34,0,34
Kerala,2013,Prep. And Assembly For Dacoity,0,0,0,12,0,12,24,0,24,2,0,2,38,0,38
Kerala,2013,Robbery,0,0,0,47,4,51,52,0,52,17,0,17,116,4,120
Kerala,2013,Burglary,0,0,0,35,0,35,40,0,40,5,0,5,80,0,80
Kerala,2013,Thefts,0,0,0,72,1,73,82,0,82,43,0,43,197,1,198
Kerala,2013,Extortion,0,0,0,0,0,0,0,0,0,0,0,0,0,0,0
Kerala,2013,Riots,0,0,0,22,0,22,12,0,12,4,0,4,38,0,38
Kerala,2013,Arson,0,0,0,0,0,0,4,0,4,0,0,0,4,0,4
Kerala,2013,Criminal Breach Of Trust,0,0,0,10,0,10,23,0,23,15,0,15,48,0,48
Kerala,2013,Cheating,0,0,0,8,0,8,18,0,18,4,0,4,30,0,30
Kerala,2013,Counter Feiting,0,0,0,0,0,0,4,0,4,2,0,2,6,0,6
Kerala,2013,Dowry Deaths,0,0,0,3,0,3,15,0,15,0,0,0,18,0,18
Kerala,2013,Molestation,0,0,0,12,0,12,6,0,6,0,0,0,18,0,18
Kerala,2013,Eve-Teasing,0,0,0,7,0,7,1,0,1,0,0,0,8,0,8
Kerala,2013,Cruelty By Husband Or Relative Of Husband,0,0,0,4,0,4,16,0,16,2,0,2,22,0,22
Kerala,2013,Other Ipc Crimes,0,0,0,28,0,28,38,0,38,16,0,16,82,0,82
Madhya Pradesh,2013,Murder,0,0,0,3691,59,3750,5076,194,5270,1253,42,1295,10020,295,10315
Madhya Pradesh,2013,Attempt To Commit Murder,0,0,0,249,5,254,309,18,327,74,0,74,632,23,655
Madhya Pradesh,2013,C.H. Not Amounting To Murder,0,0,0,150,9,159,250,19,269,55,3,58,455,31,486
Madhya Pradesh,2013,Rape,0,0,0,642,4,646,439,8,447,64,0,64,1145,12,1157
Madhya Pradesh,2013,Kidnapping And Abduction,0,0,0,144,7,151,146,9,155,41,1,42,331,17,348
Madhya Pradesh,2013,Dacoity,0,0,0,117,0,117,106,3,109,20,0,20,243,3,246
Madhya Pradesh,2013,Prep. And Assembly For Dacoity,0,0,0,24,0,24,25,0,25,5,0,5,54,0,54
Madhya Pradesh,2013,Robbery,0,0,0,150,0,150,99,0,99,13,0,13,262,0,262
Madhya Pradesh,2013,Burglary,0,0,0,40,0,40,39,2,41,5,0,5,84,2,86
Madhya Pradesh,2013,Thefts,0,0,0,110,0,110,115,2,117,7,0,7,232,2,234
Madhya Pradesh,2013,Extortion,0,0,0,15,0,15,17,0,17,0,0,0,32,0,32
Madhya Pradesh,2013,Riots,0,0,0,9,0,9,15,0,15,3,0,3,27,0,27
Madhya Pradesh,2013,Arson,0,0,0,25,0,25,16,0,16,8,0,8,49,0,49
Madhya Pradesh,2013,Criminal Breach Of Trust,0,0,0,11,0,11,29,0,29,9,0,9,49,0,49
Madhya Pradesh,2013,Cheating,0,0,0,23,2,25,38,1,39,19,0,19,80,3,83
Madhya Pradesh,2013,Counter Feiting,0,0,0,10,0,10,16,0,16,3,0,3,29,0,29
Madhya Pradesh,2013,Dowry Deaths,0,0,0,112,23,135,128,26,154,64,15,79,304,64,368
Madhya Pradesh,2013,Molestation,0,0,0,39,0,39,32,0,32,9,0,9,80,0,80
Madhya Pradesh,2013,Eve-Teasing,0,0,0,2,0,2,24,0,24,2,0,2,28,0,28
Madhya Pradesh,2013,Cruelty By Husband Or Relative Of Husband,0,0,0,26,1,27,20,2,22,10,0,10,56,3,59
Madhya Pradesh,2013,Other Ipc Crimes,0,0,0,429,3,432,318,16,334,80,1,81,827,20,847
Maharashtra,2013,Murder,3,0,3,941,16,957,2755,95,2850,1174,40,1214,4873,151,5024
Maharashtra,2013,Attempt To Commit Murder,0,0,0,127,3,130,45,13,58,34,5,39,206,21,227
Maharashtra,2013,C.H. Not Amounting To Murder,0,0,0,55,3,58,53,4,57,16,4,20,124,11,135
Maharashtra,2013,Rape,3,0,3,58,0,58,118,0,118,26,0,26,205,0,205
Maharashtra,2013,Kidnapping And Abduction,0,0,0,73,3,76,55,2,57,22,1,23,150,6,156
Maharashtra,2013,Dacoity,0,0,0,52,0,52,59,0,59,7,0,7,118,0,118
Maharashtra,2013,Prep. And Assembly For Dacoity,0,0,0,90,8,98,62,7,69,7,0,7,159,15,174
Maharashtra,2013,Robbery,4,0,4,79,18,97,70,16,86,5,0,5,158,34,192
Maharashtra,2013,Burglary,0,0,0,41,0,41,54,1,55,11,0,11,106,1,107
Maharashtra,2013,Thefts,12,0,12,69,25,94,54,14,68,13,0,13,148,39,187
Maharashtra,2013,Extortion,0,0,0,3,0,3,3,0,3,0,0,0,6,0,6
Maharashtra,2013,Riots,0,0,0,7,0,7,4,0,4,0,0,0,11,0,11
Maharashtra,2013,Arson,0,0,0,24,30,54,27,15,42,0,0,0,51,45,96
Maharashtra,2013,Criminal Breach Of Trust,0,0,0,1,0,1,7,0,7,0,0,0,8,0,8
Maharashtra,2013,Cheating,0,0,0,61,10,71,34,10,44,1,0,1,96,20,116
Maharashtra,2013,Counter Feiting,0,0,0,1,0,1,16,1,17,2,1,3,19,2,21
Maharashtra,2013,Dowry Deaths,0,0,0,8,1,9,34,3,37,12,0,12,54,4,58
Maharashtra,2013,Molestation,0,0,0,7,0,7,14,0,14,1,3,4,22,3,25
Maharashtra,2013,Eve-Teasing,0,0,0,1,0,1,3,0,3,0,0,0,4,0,4
Maharashtra,2013,Cruelty By Husband Or Relative Of Husband,0,0,0,5,0,5,33,11,44,17,4,21,55,15,70
Maharashtra,2013,Other Ipc Crimes,5,0,5,157,2,159,170,1,171,40,0,40,372,3,375
Manipur,2013,Murder,0,0,0,7,0,7,6,1,7,9,0,9,22,1,23
Manipur,2013,Attempt To Commit Murder,0,0,0,0,0,0,1,0,1,0,0,0,1,0,1
Manipur,2013,C.H. Not Amounting To Murder,0,0,0,1,0,1,0,1,1,0,0,0,1,1,2
Manipur,2013,Rape,0,0,0,3,0,3,3,0,3,0,0,0,6,0,6
Manipur,2013,Kidnapping And Abduction,0,0,0,0,0,0,0,0,0,0,0,0,0,0,0
Manipur,2013,Dacoity,0,0,0,0,0,0,0,0,0,0,0,0,0,0,0
Manipur,2013,Prep. And Assembly For Dacoity,0,0,0,0,0,0,0,0,0,0,0,0,0,0,0
Manipur,2013,Robbery,0,0,0,0,0,0,0,0,0,0,0,0,0,0,0
Manipur,2013,Burglary,0,0,0,0,0,0,0,0,0,0,0,0,0,0,0
Manipur,2013,Thefts,0,0,0,0,0,0,0,0,0,0,0,0,0,0,0
Manipur,2013,Extortion,0,0,0,0,0,0,0,0,0,0,0,0,0,0,0
Manipur,2013,Riots,0,0,0,0,0,0,0,0,0,0,0,0,0,0,0
Manipur,2013,Arson,0,0,0,0,0,0,0,0,0,0,0,0,0,0,0
Manipur,2013,Criminal Breach Of Trust,0,0,0,0,0,0,0,0,0,0,0,0,0,0,0
Manipur,2013,Cheating,0,0,0,0,0,0,0,0,0,0,0,0,0,0,0
Manipur,2013,Counter Feiting,0,0,0,0,0,0,0,0,0,0,0,0,0,0,0
Manipur,2013,Dowry Deaths,0,0,0,0,0,0,0,0,0,0,0,0,0,0,0
Manipur,2013,Molestation,0,0,0,0,0,0,0,0,0,0,0,0,0,0,0
Manipur,2013,Eve-Teasing,0,0,0,0,0,0,0,0,0,0,0,0,0,0,0
Manipur,2013,Cruelty By Husband Or Relative Of Husband,0,0,0,0,0,0,0,0,0,0,0,0,0,0,0
Manipur,2013,Other Ipc Crimes,0,0,0,1,0,1,1,0,1,0,0,0,2,0,2
Meghalaya,2013,Murder,0,0,0,1,0,1,8,0,8,3,0,3,12,0,12
Meghalaya,2013,Attempt To Commit Murder,0,0,0,1,0,1,0,0,0,0,0,0,1,0,1
Meghalaya,2013,C.H. Not Amounting To Murder,0,0,0,0,0,0,2,0,2,0,0,0,2,0,2
Meghalaya,2013,Rape,0,0,0,21,0,21,6,0,6,1,0,1,28,0,28
Meghalaya,2013,Kidnapping And Abduction,0,0,0,1,0,1,2,0,2,0,0,0,3,0,3
Meghalaya,2013,Dacoity,0,0,0,2,0,2,0,0,0,0,0,0,2,0,2
Meghalaya,2013,Prep. And Assembly For Dacoity,0,0,0,0,0,0,0,0,0,0,0,0,0,0,0
Meghalaya,2013,Robbery,0,0,0,3,0,3,0,0,0,0,0,0,3,0,3
Meghalaya,2013,Burglary,0,0,0,1,0,1,1,0,1,0,0,0,2,0,2
Meghalaya,2013,Thefts,0,0,0,1,0,1,1,0,1,0,0,0,2,0,2
Meghalaya,2013,Extortion,0,0,0,0,0,0,0,0,0,0,0,0,0,0,0
Meghalaya,2013,Riots,0,0,0,0,0,0,0,0,0,0,0,0,0,0,0
Meghalaya,2013,Arson,0,0,0,0,0,0,0,0,0,0,0,0,0,0,0
Meghalaya,2013,Criminal Breach Of Trust,0,0,0,0,0,0,0,0,0,0,0,0,0,0,0
Meghalaya,2013,Cheating,0,0,0,0,0,0,0,0,0,0,0,0,0,0,0
Meghalaya,2013,Counter Feiting,0,0,0,0,0,0,1,0,1,0,0,0,1,0,1
Meghalaya,2013,Dowry Deaths,0,0,0,0,0,0,0,0,0,0,0,0,0,0,0
Meghalaya,2013,Molestation,0,0,0,0,0,0,0,0,0,0,0,0,0,0,0
Meghalaya,2013,Eve-Teasing,0,0,0,0,0,0,0,0,0,0,0,0,0,0,0
Meghalaya,2013,Cruelty By Husband Or Relative Of Husband,0,0,0,0,0,0,0,0,0,0,0,0,0,0,0
Meghalaya,2013,Other Ipc Crimes,0,0,0,0,0,0,2,0,2,0,0,0,2,0,2
Mizoram,2013,Murder,0,0,0,24,0,24,29,0,29,9,0,9,62,0,62
Mizoram,2013,Attempt To Commit Murder,0,0,0,3,0,3,1,0,1,0,0,0,4,0,4
Mizoram,2013,C.H. Not Amounting To Murder,0,0,0,3,0,3,3,0,3,0,0,0,6,0,6
Mizoram,2013,Rape,0,0,0,30,0,30,52,0,52,13,0,13,95,0,95
Mizoram,2013,Kidnapping And Abduction,0,0,0,2,0,2,0,0,0,0,0,0,2,0,2
Mizoram,2013,Dacoity,0,0,0,0,0,0,0,0,0,0,0,0,0,0,0
Mizoram,2013,Prep. And Assembly For Dacoity,0,0,0,0,0,0,0,0,0,0,0,0,0,0,0
Mizoram,2013,Robbery,0,0,0,0,0,0,0,0,0,0,0,0,0,0,0
Mizoram,2013,Burglary,NA,0,0,15,0,15,9,0,9,0,0,0,24,0,24
Mizoram,2013,Thefts,0,0,0,55,0,55,50,0,50,2,0,2,107,0,107
Mizoram,2013,Extortion,0,0,0,0,0,0,0,0,0,0,0,0,0,0,0
Mizoram,2013,Riots,0,0,0,0,0,0,0,0,0,0,0,0,0,0,0
Mizoram,2013,Arson,0,0,0,0,0,0,0,0,0,0,0,0,0,0,0
Mizoram,2013,Criminal Breach Of Trust,0,0,0,1,0,1,0,0,0,0,0,0,1,0,1
Mizoram,2013,Cheating,0,0,0,1,0,1,2,0,2,0,0,0,3,0,3
Mizoram,2013,Counter Feiting,0,0,0,0,0,0,1,0,1,0,0,0,1,0,1
Mizoram,2013,Dowry Deaths,0,0,0,0,0,0,0,0,0,0,0,0,0,0,0
Mizoram,2013,Molestation,0,0,0,2,0,2,3,0,3,0,0,0,5,0,5
Mizoram,2013,Eve-Teasing,0,0,0,0,0,0,1,0,1,0,0,0,1,0,1
Mizoram,2013,Cruelty By Husband Or Relative Of Husband,0,0,0,0,0,0,0,0,0,0,0,0,0,0,0
Mizoram,2013,Other Ipc Crimes,0,0,0,8,0,8,19,0,19,1,0,1,28,0,28
Nagaland,2013,Murder,0,0,0,11,0,11,27,2,29,5,0,5,43,2,45
Nagaland,2013,Attempt To Commit Murder,0,0,0,1,0,1,0,0,0,0,0,0,1,0,1
Nagaland,2013,C.H. Not Amounting To Murder,0,0,0,0,0,0,0,0,0,0,0,0,0,0,0
Nagaland,2013,Rape,0,0,0,8,0,8,6,0,6,0,0,0,14,0,14
Nagaland,2013,Kidnapping And Abduction,0,0,0,5,0,5,2,0,2,0,0,0,7,0,7
Nagaland,2013,Dacoity,0,0,0,0,0,0,0,0,0,0,0,0,0,0,0
Nagaland,2013,Prep. And Assembly For Dacoity,0,0,0,0,0,0,0,0,0,0,0,0,0,0,0
Nagaland,2013,Robbery,0,0,0,6,0,6,2,0,2,0,0,0,8,0,8
Nagaland,2013,Burglary,0,0,0,4,0,4,0,0,0,0,0,0,4,0,4
Nagaland,2013,Thefts,0,0,0,9,0,9,0,0,0,0,0,0,9,0,9
Nagaland,2013,Extortion,0,0,0,1,0,1,0,0,0,0,0,0,1,0,1
Nagaland,2013,Riots,0,0,0,0,0,0,0,0,0,0,0,0,0,0,0
Nagaland,2013,Arson,0,0,0,0,0,0,0,0,0,0,0,0,0,0,0
Nagaland,2013,Criminal Breach Of Trust,0,0,0,0,0,0,0,0,0,0,0,0,0,0,0
Nagaland,2013,Cheating,0,0,0,0,0,0,0,0,0,0,0,0,0,0,0
Nagaland,2013,Counter Feiting,0,0,0,0,0,0,0,0,0,0,0,0,0,0,0
Nagaland,2013,Dowry Deaths,0,0,0,0,0,0,0,0,0,0,0,0,0,0,0
Nagaland,2013,Molestation,0,0,0,1,0,1,0,0,0,0,0,0,1,0,1
Nagaland,2013,Eve-Teasing,0,0,0,0,0,0,0,0,0,0,0,0,0,0,0
Nagaland,2013,Cruelty By Husband Or Relative Of Husband,0,0,0,0,0,0,0,0,0,0,0,0,0,0,0
Nagaland,2013,Other Ipc Crimes,0,0,0,1,0,1,0,0,0,0,0,0,1,0,1
Orissa,2013,Murder,0,0,0,631,7,638,849,7,856,410,19,429,1890,33,1923
Orissa,2013,Attempt To Commit Murder,0,0,0,134,3,137,150,42,192,77,5,82,361,50,411
Orissa,2013,C.H. Not Amounting To Murder,0,0,0,94,2,96,45,5,50,23,3,26,162,10,172
Orissa,2013,Rape,0,0,0,136,0,136,45,0,45,10,0,10,191,0,191
Orissa,2013,Kidnapping And Abduction,0,0,0,12,0,12,12,0,12,8,0,8,32,0,32
Orissa,2013,Dacoity,0,0,0,104,0,104,47,0,47,5,0,5,156,0,156
Orissa,2013,Prep. And Assembly For Dacoity,0,0,0,0,0,0,0,0,0,0,0,0,0,0,0
Orissa,2013,Robbery,0,0,0,34,0,34,18,0,18,0,0,0,52,0,52
Orissa,2013,Burglary,0,0,0,46,0,46,21,0,21,7,0,7,74,0,74
Orissa,2013,Thefts,0,0,0,80,0,80,40,0,40,10,0,10,130,0,130
Orissa,2013,Extortion,0,0,0,0,0,0,0,0,0,0,0,0,0,0,0
Orissa,2013,Riots,0,0,0,0,0,0,0,0,0,0,0,0,0,0,0
Orissa,2013,Arson,0,0,0,8,0,8,1,0,1,2,0,2,11,0,11
Orissa,2013,Criminal Breach Of Trust,0,0,0,9,0,9,10,0,10,3,0,3,22,0,22
Orissa,2013,Cheating,0,0,0,10,0,10,3,0,3,2,0,2,15,0,15
Orissa,2013,Counter Feiting,0,0,0,0,0,0,0,0,0,0,0,0,0,0,0
Orissa,2013,Dowry Deaths,0,0,0,3,0,3,20,3,23,5,0,5,28,3,31
Orissa,2013,Molestation,0,0,0,5,0,5,5,0,5,3,0,3,13,0,13
Orissa,2013,Eve-Teasing,0,0,0,0,0,0,0,0,0,0,0,0,0,0,0
Orissa,2013,Cruelty By Husband Or Relative Of Husband,0,0,0,24,2,26,10,2,12,8,0,8,42,4,46
Orissa,2013,Other Ipc Crimes,0,0,0,20,0,20,33,0,33,8,0,8,61,0,61
Punjab,2013,Murder,0,0,0,585,29,614,921,28,949,495,29,524,2001,86,2087
Punjab,2013,Attempt To Commit Murder,0,0,0,221,19,240,387,5,392,104,5,109,712,29,741
Punjab,2013,C.H. Not Amounting To Murder,0,0,0,76,13,89,91,7,98,42,6,48,209,26,235
Punjab,2013,Rape,0,0,0,113,8,121,195,9,204,72,4,76,380,21,401
Punjab,2013,Kidnapping And Abduction,0,0,0,93,1,94,88,5,93,36,7,43,217,13,230
Punjab,2013,Dacoity,0,0,0,47,0,47,93,2,95,9,1,10,149,3,152
Punjab,2013,Prep. And Assembly For Dacoity,0,0,0,38,0,38,39,1,40,5,1,6,82,2,84
Punjab,2013,Robbery,0,0,0,62,1,63,69,1,70,21,2,23,152,4,156
Punjab,2013,Burglary,0,0,0,70,0,70,29,0,29,14,0,14,113,0,113
Punjab,2013,Thefts,0,0,0,140,27,167,187,4,191,55,0,55,382,31,413
Punjab,2013,Extortion,0,0,0,12,0,12,22,0,22,6,0,6,40,0,40
Punjab,2013,Riots,0,0,0,30,1,31,21,1,22,3,0,3,54,2,56
Punjab,2013,Arson,0,0,0,6,0,6,15,0,15,7,0,7,28,0,28
Punjab,2013,Criminal Breach Of Trust,0,0,0,26,0,26,35,0,35,16,0,16,77,0,77
Punjab,2013,Cheating,0,0,0,26,11,37,107,3,110,38,0,38,171,14,185
Punjab,2013,Counter Feiting,0,0,0,24,0,24,37,1,38,9,1,10,70,2,72
Punjab,2013,Dowry Deaths,0,0,0,155,37,192,183,21,204,57,5,62,395,63,458
Punjab,2013,Molestation,0,0,0,33,0,33,17,0,17,4,0,4,54,0,54
Punjab,2013,Eve-Teasing,0,0,0,8,0,8,6,0,6,3,0,3,17,0,17
Punjab,2013,Cruelty By Husband Or Relative Of Husband,0,0,0,63,7,70,81,6,87,26,0,26,170,13,183
Punjab,2013,Other Ipc Crimes,0,0,0,28,1,29,49,3,52,20,3,23,97,7,104
Rajasthan,2013,Murder,0,0,0,845,21,866,1679,107,1786,584,45,629,3108,173,3281
Rajasthan,2013,Attempt To Commit Murder,0,0,0,109,0,109,131,0,131,40,0,40,280,0,280
Rajasthan,2013,C.H. Not Amounting To Murder,0,0,0,46,0,46,87,0,87,34,0,34,167,0,167
Rajasthan,2013,Rape,0,0,0,198,0,198,184,9,193,43,4,47,425,13,438
Rajasthan,2013,Kidnapping And Abduction,0,0,0,66,0,66,62,0,62,19,1,20,147,1,148
Rajasthan,2013,Dacoity,0,0,0,56,0,56,42,0,42,12,0,12,110,0,110
Rajasthan,2013,Prep. And Assembly For Dacoity,0,0,0,52,0,52,21,0,21,8,0,8,81,0,81
Rajasthan,2013,Robbery,0,0,0,33,0,33,65,0,65,8,0,8,106,0,106
Rajasthan,2013,Burglary,0,0,0,33,0,33,22,0,22,5,0,5,60,0,60
Rajasthan,2013,Thefts,0,0,0,67,2,69,105,0,105,15,0,15,187,2,189
Rajasthan,2013,Extortion,0,0,0,8,0,8,7,0,7,0,0,0,15,0,15
Rajasthan,2013,Riots,0,0,0,9,0,9,7,0,7,0,0,0,16,0,16
Rajasthan,2013,Arson,0,0,0,15,0,15,5,0,5,1,0,1,21,0,21
Rajasthan,2013,Criminal Breach Of Trust,0,0,0,1,0,1,0,0,0,0,0,0,1,0,1
Rajasthan,2013,Cheating,0,0,0,34,0,34,27,0,27,5,0,5,66,0,66
Rajasthan,2013,Counter Feiting,0,0,0,7,0,7,4,0,4,0,0,0,11,0,11
Rajasthan,2013,Dowry Deaths,0,0,0,59,0,59,68,15,83,40,5,45,167,20,187
Rajasthan,2013,Molestation,0,0,0,3,0,3,13,0,13,1,0,1,17,0,17
Rajasthan,2013,Eve-Teasing,0,0,0,0,0,0,0,0,0,0,0,0,0,0,0
Rajasthan,2013,Cruelty By Husband Or Relative Of Husband,0,0,0,6,0,6,16,0,16,0,2,2,22,2,24
Rajasthan,2013,Other Ipc Crimes,0,0,0,41,0,41,34,0,34,26,0,26,101,0,101
Sikkim,2013,Murder,0,0,0,1,1,2,29,0,29,5,0,5,35,1,36
Sikkim,2013,Attempt To Commit Murder,0,0,0,0,0,0,0,0,0,0,0,0,0,0,0
Sikkim,2013,C.H. Not Amounting To Murder,0,0,0,0,0,0,5,0,5,1,0,1,6,0,6
Sikkim,2013,Rape,0,0,0,5,0,5,20,0,20,0,0,0,25,0,25
Sikkim,2013,Kidnapping And Abduction,0,0,0,0,0,0,1,0,1,0,0,0,1,0,1
Sikkim,2013,Dacoity,0,0,0,0,0,0,0,0,0,0,0,0,0,0,0
Sikkim,2013,Prep. And Assembly For Dacoity,0,0,0,0,0,0,0,0,0,0,0,0,0,0,0
Sikkim,2013,Robbery,0,0,0,0,0,0,0,0,0,0,0,0,0,0,0
Sikkim,2013,Burglary,0,0,0,4,0,4,2,0,2,0,0,0,6,0,6
Sikkim,2013,Thefts,0,0,0,1,0,1,8,0,8,0,0,0,9,0,9
Sikkim,2013,Extortion,0,0,0,0,0,0,0,0,0,0,0,0,0,0,0
Sikkim,2013,Riots,0,0,0,0,0,0,0,0,0,0,0,0,0,0,0
Sikkim,2013,Arson,0,0,0,0,0,0,0,0,0,0,0,0,0,0,0
Sikkim,2013,Criminal Breach Of Trust,0,0,0,0,0,0,0,0,0,0,0,0,0,0,0
Sikkim,2013,Cheating,0,0,0,0,0,0,2,0,2,0,0,0,2,0,2
Sikkim,2013,Counter Feiting,0,0,0,0,0,0,0,0,0,0,0,0,0,0,0
Sikkim,2013,Dowry Deaths,0,0,0,0,0,0,0,0,0,0,0,0,0,0,0
Sikkim,2013,Molestation,0,0,0,0,0,0,6,0,6,0,0,0,6,0,6
Sikkim,2013,Eve-Teasing,0,0,0,0,0,0,0,0,0,0,0,0,0,0,0
Sikkim,2013,Cruelty By Husband Or Relative Of Husband,0,0,0,0,0,0,2,0,2,0,0,0,2,0,2
Sikkim,2013,Other Ipc Crimes,0,0,0,0,0,0,0,0,0,0,0,0,0,0,0
Tamilnadu,2013,Murder,0,0,0,698,21,719,1552,91,1643,348,28,376,2598,140,2738
Tamilnadu,2013,Attempt To Commit Murder,0,0,0,74,3,77,287,3,290,62,0,62,423,6,429
Tamilnadu,2013,C.H. Not Amounting To Murder,0,0,0,3,0,3,14,1,15,16,3,19,33,4,37
Tamilnadu,2013,Rape,0,0,0,25,0,25,64,0,64,10,0,10,99,0,99
Tamilnadu,2013,Kidnapping And Abduction,0,0,0,51,0,51,136,2,138,32,0,32,219,2,221
Tamilnadu,2013,Dacoity,0,0,0,27,0,27,100,1,101,20,0,20,147,1,148
Tamilnadu,2013,Prep. And Assembly For Dacoity,0,0,0,2,0,2,0,0,0,4,0,4,6,0,6
Tamilnadu,2013,Robbery,0,0,0,83,0,83,81,1,82,31,0,31,195,1,196
Tamilnadu,2013,Burglary,0,0,0,9,0,9,51,0,51,25,0,25,85,0,85
Tamilnadu,2013,Thefts,0,0,0,63,0,63,127,0,127,44,0,44,234,0,234
Tamilnadu,2013,Extortion,0,0,0,0,0,0,2,0,2,8,0,8,10,0,10
Tamilnadu,2013,Riots,0,0,0,0,0,0,0,0,0,0,0,0,0,0,0
Tamilnadu,2013,Arson,0,0,0,0,0,0,0,0,0,0,0,0,0,0,0
Tamilnadu,2013,Criminal Breach Of Trust,0,0,0,0,0,0,9,0,9,0,0,0,9,0,9
Tamilnadu,2013,Cheating,0,0,0,20,0,20,7,0,7,11,0,11,38,0,38
Tamilnadu,2013,Counter Feiting,0,0,0,3,0,3,9,0,9,0,0,0,12,0,12
Tamilnadu,2013,Dowry Deaths,0,0,0,4,0,4,28,1,29,2,0,2,34,1,35
Tamilnadu,2013,Molestation,0,0,0,0,0,0,0,0,0,0,0,0,0,0,0
Tamilnadu,2013,Eve-Teasing,0,0,0,8,0,8,5,0,5,0,0,0,13,0,13
Tamilnadu,2013,Cruelty By Husband Or Relative Of Husband,0,0,0,5,0,5,75,0,75,8,0,8,88,0,88
Tamilnadu,2013,Other Ipc Crimes,0,0,0,2,0,2,0,1,1,2,0,2,4,1,5
Tripura,2013,Murder,0,0,0,40,1,41,149,5,154,43,1,44,232,7,239
Tripura,2013,Attempt To Commit Murder,0,0,0,1,0,1,2,0,2,2,0,2,5,0,5
Tripura,2013,C.H. Not Amounting To Murder,0,0,0,11,0,11,6,1,7,4,0,4,21,1,22
Tripura,2013,Rape,0,0,0,37,1,38,56,0,56,3,0,3,96,1,97
Tripura,2013,Kidnapping And Abduction,0,0,0,7,0,7,5,0,5,1,1,2,13,1,14
Tripura,2013,Dacoity,0,0,0,0,0,0,0,0,0,0,0,0,0,0,0
Tripura,2013,Prep. And Assembly For Dacoity,0,0,0,0,0,0,0,0,0,0,0,0,0,0,0
Tripura,2013,Robbery,0,0,0,0,0,0,2,0,2,0,0,0,2,0,2
Tripura,2013,Burglary,0,0,0,2,0,2,0,0,0,0,0,0,2,0,2
Tripura,2013,Thefts,0,0,0,13,0,13,10,0,10,1,0,1,24,0,24
Tripura,2013,Extortion,0,0,0,0,0,0,0,0,0,0,0,0,0,0,0
Tripura,2013,Riots,0,0,0,2,0,2,5,0,5,0,0,0,7,0,7
Tripura,2013,Arson,0,0,0,0,0,0,0,0,0,0,0,0,0,0,0
Tripura,2013,Criminal Breach Of Trust,0,0,0,0,0,0,0,0,0,0,0,0,0,0,0
Tripura,2013,Cheating,0,0,0,2,0,2,1,0,1,0,0,0,3,0,3
Tripura,2013,Counter Feiting,0,0,0,5,0,5,3,0,3,0,2,2,8,2,10
Tripura,2013,Dowry Deaths,0,0,0,8,0,8,18,0,18,3,2,5,29,2,31
Tripura,2013,Molestation,0,0,0,0,0,0,0,0,0,3,0,3,3,0,3
Tripura,2013,Eve-Teasing,0,0,0,0,0,0,0,0,0,0,0,0,0,0,0
Tripura,2013,Cruelty By Husband Or Relative Of Husband,0,0,0,5,0,5,8,0,8,0,0,0,13,0,13
Tripura,2013,Other Ipc Crimes,0,0,0,6,0,6,18,0,18,2,0,2,26,0,26
Uttar Pradesh,2013,Murder,0,0,0,1910,81,1991,7364,170,7534,4592,94,4686,13866,345,14211
Uttar Pradesh,2013,Attempt To Commit Murder,0,0,0,400,2,402,606,10,616,293,22,315,1299,34,1333
Uttar Pradesh,2013,C.H. Not Amounting To Murder,0,0,0,284,12,296,454,30,484,239,12,251,977,54,1031
Uttar Pradesh,2013,Rape,0,0,0,686,2,688,685,5,690,235,8,243,1606,15,1621
Uttar Pradesh,2013,Kidnapping And Abduction,0,0,0,213,6,219,364,16,380,105,6,111,682,28,710
Uttar Pradesh,2013,Dacoity,0,0,0,93,0,93,175,0,175,81,0,81,349,0,349
Uttar Pradesh,2013,Prep. And Assembly For Dacoity,0,0,0,28,0,28,33,0,33,14,0,14,75,0,75
Uttar Pradesh,2013,Robbery,0,0,0,110,0,110,160,1,161,51,0,51,321,1,322
Uttar Pradesh,2013,Burglary,0,0,0,23,0,23,42,0,42,18,0,18,83,0,83
Uttar Pradesh,2013,Thefts,0,0,0,257,1,258,202,3,205,57,0,57,516,4,520
Uttar Pradesh,2013,Extortion,0,0,0,14,0,14,11,0,11,1,0,1,26,0,26
Uttar Pradesh,2013,Riots,0,0,0,5,0,5,11,0,11,1,0,1,17,0,17
Uttar Pradesh,2013,Arson,0,0,0,3,0,3,6,0,6,3,0,3,12,0,12
Uttar Pradesh,2013,Criminal Breach Of Trust,0,0,0,4,0,4,33,0,33,18,0,18,55,0,55
Uttar Pradesh,2013,Cheating,0,0,0,17,1,18,21,0,21,8,0,8,46,1,47
Uttar Pradesh,2013,Counter Feiting,0,0,0,23,0,23,38,0,38,10,0,10,71,0,71
Uttar Pradesh,2013,Dowry Deaths,0,0,0,513,73,586,842,157,999,364,178,542,1719,408,2127
Uttar Pradesh,2013,Molestation,0,0,0,36,0,36,21,0,21,16,0,16,73,0,73
Uttar Pradesh,2013,Eve-Teasing,0,0,0,0,0,0,0,0,0,0,0,0,0,0,0
Uttar Pradesh,2013,Cruelty By Husband Or Relative Of Husband,0,0,0,48,0,48,45,11,56,20,3,23,113,14,127
Uttar Pradesh,2013,Other Ipc Crimes,0,0,0,123,1,124,171,9,180,61,4,65,355,14,369
Uttaranchal,2013,Murder,0,0,0,205,2,207,376,16,392,130,4,134,711,22,733
Uttaranchal,2013,Attempt To Commit Murder,0,0,0,68,0,68,89,2,91,42,0,42,199,2,201
Uttaranchal,2013,C.H. Not Amounting To Murder,0,0,0,33,0,33,30,3,33,32,0,32,95,3,98
Uttaranchal,2013,Rape,0,0,0,57,0,57,36,0,36,10,0,10,103,0,103
Uttaranchal,2013,Kidnapping And Abduction,0,0,0,4,0,4,23,1,24,12,0,12,39,1,40
Uttaranchal,2013,Dacoity,0,0,0,9,0,9,24,0,24,16,0,16,49,0,49
Uttaranchal,2013,Prep. And Assembly For Dacoity,0,0,0,2,0,2,0,0,0,0,0,0,2,0,2
Uttaranchal,2013,Robbery,0,0,0,0,0,0,23,0,23,7,0,7,30,0,30
Uttaranchal,2013,Burglary,0,0,0,12,0,12,11,0,11,3,0,3,26,0,26
Uttaranchal,2013,Thefts,0,0,0,52,0,52,42,4,46,28,0,28,122,4,126
Uttaranchal,2013,Extortion,0,0,0,0,0,0,0,0,0,0,0,0,0,0,0
Uttaranchal,2013,Riots,0,0,0,0,0,0,0,0,0,0,0,0,0,0,0
Uttaranchal,2013,Arson,0,0,0,2,0,2,0,0,0,0,0,0,2,0,2
Uttaranchal,2013,Criminal Breach Of Trust,0,0,0,0,0,0,1,0,1,4,0,4,5,0,5
Uttaranchal,2013,Cheating,0,0,0,0,0,0,20,0,20,7,0,7,27,0,27
Uttaranchal,2013,Counter Feiting,0,0,0,3,0,3,2,0,2,0,0,0,5,0,5
Uttaranchal,2013,Dowry Deaths,0,0,0,30,9,39,21,7,28,26,7,33,77,23,100
Uttaranchal,2013,Molestation,0,0,0,2,0,2,7,0,7,0,0,0,9,0,9
Uttaranchal,2013,Eve-Teasing,0,0,0,0,0,0,0,0,0,0,0,0,0,0,0
Uttaranchal,2013,Cruelty By Husband Or Relative Of Husband,0,0,0,24,5,29,3,0,3,0,0,0,27,5,32
Uttaranchal,2013,Other Ipc Crimes,0,0,0,3,0,3,0,0,0,0,0,0,3,0,3
West Bengal,2013,Murder,0,0,0,471,46,517,1509,67,1576,558,41,599,2538,154,2692
West Bengal,2013,Attempt To Commit Murder,0,0,0,54,0,54,65,1,66,21,4,25,140,5,145
West Bengal,2013,C.H. Not Amounting To Murder,0,0,0,52,1,53,92,3,95,43,1,44,187,5,192
West Bengal,2013,Rape,0,0,0,164,0,164,188,0,188,55,0,55,407,0,407
West Bengal,2013,Kidnapping And Abduction,0,0,0,77,8,85,89,9,98,26,4,30,192,21,213
West Bengal,2013,Dacoity,0,0,0,63,1,64,99,0,99,28,0,28,190,1,191
West Bengal,2013,Prep. And Assembly For Dacoity,0,0,0,16,0,16,30,0,30,11,0,11,57,0,57
West Bengal,2013,Robbery,0,0,0,18,0,18,23,0,23,9,0,9,50,0,50
West Bengal,2013,Burglary,0,0,0,4,0,4,6,0,6,0,0,0,10,0,10
West Bengal,2013,Thefts,0,0,0,29,0,29,10,0,10,9,0,9,48,0,48
West Bengal,2013,Extortion,0,0,0,1,0,1,2,0,2,1,0,1,4,0,4
West Bengal,2013,Riots,0,0,0,9,0,9,9,0,9,9,0,9,27,0,27
West Bengal,2013,Arson,0,0,0,0,0,0,1,0,1,1,0,1,2,0,2
West Bengal,2013,Criminal Breach Of Trust,0,0,0,0,0,0,1,0,1,0,0,0,1,0,1
West Bengal,2013,Cheating,0,0,0,0,0,0,1,0,1,3,0,3,4,0,4
West Bengal,2013,Counter Feiting,0,0,0,9,0,9,19,0,19,1,0,1,29,0,29
West Bengal,2013,Dowry Deaths,0,0,0,39,5,44,62,13,75,50,21,71,151,39,190
West Bengal,2013,Molestation,0,0,0,0,0,0,3,0,3,1,0,1,4,0,4
West Bengal,2013,Eve-Teasing,0,0,0,0,0,0,0,0,0,0,0,0,0,0,0
West Bengal,2013,Cruelty By Husband Or Relative Of Husband,0,0,0,24,3,27,28,13,41,25,12,37,77,28,105
West Bengal,2013,Other Ipc Crimes,0,0,0,4,0,4,6,0,6,7,0,7,17,0,17
Andaman And Nicobar Islands,2013,Murder,0,0,0,7,0,7,22,0,22,9,0,9,38,0,38
Andaman And Nicobar Islands,2013,Attempt To Commit Murder,0,0,0,0,0,0,2,0,2,0,0,0,2,0,2
Andaman And Nicobar Islands,2013,C.H. Not Amounting To Murder,0,0,0,0,0,0,3,0,3,0,0,0,3,0,3
Andaman And Nicobar Islands,2013,Rape,0,0,0,2,0,2,3,0,3,1,0,1,6,0,6
Andaman And Nicobar Islands,2013,Kidnapping And Abduction,0,0,0,0,0,0,0,0,0,0,0,0,0,0,0
Andaman And Nicobar Islands,2013,Dacoity,0,0,0,0,0,0,0,0,0,0,0,0,0,0,0
Andaman And Nicobar Islands,2013,Prep. And Assembly For Dacoity,0,0,0,0,0,0,0,0,0,0,0,0,0,0,0
Andaman And Nicobar Islands,2013,Robbery,0,0,0,0,0,0,0,0,0,0,0,0,0,0,0
Andaman And Nicobar Islands,2013,Burglary,0,0,0,0,0,0,0,0,0,0,0,0,0,0,0
Andaman And Nicobar Islands,2013,Thefts,0,0,0,1,0,1,0,1,1,0,0,0,1,1,2
Andaman And Nicobar Islands,2013,Extortion,0,0,0,0,0,0,0,0,0,0,0,0,0,0,0
Andaman And Nicobar Islands,2013,Riots,0,0,0,0,0,0,0,0,0,0,0,0,0,0,0
Andaman And Nicobar Islands,2013,Arson,0,0,0,0,0,0,0,0,0,0,0,0,0,0,0
Andaman And Nicobar Islands,2013,Criminal Breach Of Trust,0,0,0,0,0,0,0,0,0,0,0,0,0,0,0
Andaman And Nicobar Islands,2013,Cheating,0,0,0,0,0,0,0,0,0,0,0,0,0,0,0
Andaman And Nicobar Islands,2013,Counter Feiting,0,0,0,0,0,0,0,0,0,0,0,0,0,0,0
Andaman And Nicobar Islands,2013,Dowry Deaths,0,0,0,0,0,0,0,0,0,0,0,0,0,0,0
Andaman And Nicobar Islands,2013,Molestation,0,0,0,0,0,0,0,0,0,0,0,0,0,0,0
Andaman And Nicobar Islands,2013,Eve-Teasing,0,0,0,0,0,0,0,0,0,0,0,0,0,0,0
Andaman And Nicobar Islands,2013,Cruelty By Husband Or Relative Of Husband,0,0,0,0,0,0,0,0,0,0,0,0,0,0,0
Andaman And Nicobar Islands,2013,Other Ipc Crimes,0,0,0,1,0,1,5,0,5,1,0,1,7,0,7
Chandigarh,2013,Murder,0,0,0,28,2,30,21,4,25,8,1,9,57,7,64
Chandigarh,2013,Attempt To Commit Murder,0,0,0,6,0,6,6,0,6,4,0,4,16,0,16
Chandigarh,2013,C.H. Not Amounting To Murder,0,0,0,4,0,4,5,1,6,2,0,2,11,1,12
Chandigarh,2013,Rape,0,0,0,22,0,22,14,1,15,4,0,4,40,1,41
Chandigarh,2013,Kidnapping And Abduction,0,0,0,6,0,6,5,0,5,3,0,3,14,0,14
Chandigarh,2013,Dacoity,0,0,0,3,0,3,2,0,2,2,0,2,7,0,7
Chandigarh,2013,Prep. And Assembly For Dacoity,0,0,0,4,0,4,4,0,4,0,0,0,8,0,8
Chandigarh,2013,Robbery,0,0,0,1,0,1,2,0,2,4,0,4,7,0,7
Chandigarh,2013,Burglary,0,0,0,0,0,0,0,0,0,3,0,3,3,0,3
Chandigarh,2013,Thefts,0,0,0,6,1,7,7,1,8,6,0,6,19,2,21
Chandigarh,2013,Extortion,0,0,0,1,0,1,0,0,0,0,0,0,1,0,1
Chandigarh,2013,Riots,0,0,0,0,0,0,0,0,0,0,0,0,0,0,0
Chandigarh,2013,Arson,0,0,0,0,0,0,0,0,0,0,0,0,0,0,0
Chandigarh,2013,Criminal Breach Of Trust,0,0,0,4,0,4,2,0,2,0,0,0,6,0,6
Chandigarh,2013,Cheating,0,0,0,2,0,2,3,0,3,0,0,0,5,0,5
Chandigarh,2013,Counter Feiting,0,0,0,0,0,0,0,0,0,0,0,0,0,0,0
Chandigarh,2013,Dowry Deaths,0,0,0,2,0,2,2,0,2,0,0,0,4,0,4
Chandigarh,2013,Molestation,0,0,0,0,0,0,0,0,0,0,0,0,0,0,0
Chandigarh,2013,Eve-Teasing,0,0,0,0,0,0,0,0,0,0,0,0,0,0,0
Chandigarh,2013,Cruelty By Husband Or Relative Of Husband,0,0,0,0,0,0,3,0,3,0,0,0,3,0,3
Chandigarh,2013,Other Ipc Crimes,0,0,0,0,0,0,0,0,0,0,0,0,0,0,0
Dadra And Nagar Haveli,2013,Murder,0,0,0,0,0,0,0,0,0,0,0,0,0,0,0
Dadra And Nagar Haveli,2013,Attempt To Commit Murder,0,0,0,0,0,0,0,0,0,0,0,0,0,0,0
Dadra And Nagar Haveli,2013,C.H. Not Amounting To Murder,0,0,0,0,0,0,0,0,0,0,0,0,0,0,0
Dadra And Nagar Haveli,2013,Rape,0,0,0,0,0,0,0,0,0,0,0,0,0,0,0
Dadra And Nagar Haveli,2013,Kidnapping And Abduction,0,0,0,0,0,0,0,0,0,0,0,0,0,0,0
Dadra And Nagar Haveli,2013,Dacoity,0,0,0,0,0,0,0,0,0,0,0,0,0,0,0
Dadra And Nagar Haveli,2013,Prep. And Assembly For Dacoity,0,0,0,0,0,0,0,0,0,0,0,0,0,0,0
Dadra And Nagar Haveli,2013,Robbery,0,0,0,0,0,0,0,0,0,0,0,0,0,0,0
Dadra And Nagar Haveli,2013,Burglary,0,0,0,0,0,0,0,0,0,0,0,0,0,0,0
Dadra And Nagar Haveli,2013,Thefts,0,0,0,0,0,0,0,0,0,0,0,0,0,0,0
Dadra And Nagar Haveli,2013,Extortion,0,0,0,0,0,0,0,0,0,0,0,0,0,0,0
Dadra And Nagar Haveli,2013,Riots,0,0,0,0,0,0,0,0,0,0,0,0,0,0,0
Dadra And Nagar Haveli,2013,Arson,0,0,0,0,0,0,0,0,0,0,0,0,0,0,0
Dadra And Nagar Haveli,2013,Criminal Breach Of Trust,0,0,0,0,0,0,0,0,0,0,0,0,0,0,0
Dadra And Nagar Haveli,2013,Cheating,0,0,0,0,0,0,0,0,0,0,0,0,0,0,0
Dadra And Nagar Haveli,2013,Counter Feiting,0,0,0,0,0,0,0,0,0,0,0,0,0,0,0
Dadra And Nagar Haveli,2013,Dowry Deaths,0,0,0,0,0,0,0,0,0,0,0,0,0,0,0
Dadra And Nagar Haveli,2013,Molestation,0,0,0,0,0,0,0,0,0,0,0,0,0,0,0
Dadra And Nagar Haveli,2013,Eve-Teasing,0,0,0,0,0,0,0,0,0,0,0,0,0,0,0
Dadra And Nagar Haveli,2013,Cruelty By Husband Or Relative Of Husband,0,0,0,0,0,0,0,0,0,0,0,0,0,0,0
Dadra And Nagar Haveli,2013,Other Ipc Crimes,0,0,0,0,0,0,0,0,0,0,0,0,0,0,0
Daman And Diu,2013,Murder,0,0,0,2,0,2,6,1,7,4,0,4,12,1,13
Daman And Diu,2013,Attempt To Commit Murder,0,0,0,1,0,1,0,0,0,0,0,0,1,0,1
Daman And Diu,2013,C.H. Not Amounting To Murder,0,0,0,0,0,0,0,0,0,0,0,0,0,0,0
Daman And Diu,2013,Rape,0,0,0,1,0,1,1,0,1,0,0,0,2,0,2
Daman And Diu,2013,Kidnapping And Abduction,0,0,0,0,0,0,0,0,0,0,0,0,0,0,0
Daman And Diu,2013,Dacoity,0,0,0,0,0,0,0,0,0,0,0,0,0,0,0
Daman And Diu,2013,Prep. And Assembly For Dacoity,0,0,0,0,0,0,0,0,0,0,0,0,0,0,0
Daman And Diu,2013,Robbery,0,0,0,0,0,0,0,0,0,0,0,0,0,0,0
Daman And Diu,2013,Burglary,0,0,0,2,0,2,0,0,0,0,0,0,2,0,2
Daman And Diu,2013,Thefts,0,0,0,0,0,0,0,0,0,0,0,0,0,0,0
Daman And Diu,2013,Extortion,0,0,0,0,0,0,0,0,0,0,0,0,0,0,0
Daman And Diu,2013,Riots,0,0,0,0,0,0,0,0,0,0,0,0,0,0,0
Daman And Diu,2013,Arson,0,0,0,0,0,0,0,0,0,0,0,0,0,0,0
Daman And Diu,2013,Criminal Breach Of Trust,0,0,0,0,0,0,0,0,0,0,0,0,0,0,0
Daman And Diu,2013,Cheating,0,0,0,0,0,0,0,0,0,0,0,0,0,0,0
Daman And Diu,2013,Counter Feiting,0,0,0,0,0,0,0,0,0,0,0,0,0,0,0
Daman And Diu,2013,Dowry Deaths,0,0,0,0,0,0,0,0,0,0,0,0,0,0,0
Daman And Diu,2013,Molestation,0,0,0,0,0,0,0,0,0,0,0,0,0,0,0
Daman And Diu,2013,Eve-Teasing,0,0,0,0,0,0,0,0,0,0,0,0,0,0,0
Daman And Diu,2013,Cruelty By Husband Or Relative Of Husband,0,0,0,0,0,0,0,0,0,0,0,0,0,0,0
Daman And Diu,2013,Other Ipc Crimes,0,0,0,0,0,0,0,0,0,0,0,0,0,0,0
Delhi,2013,Murder,0,0,0,406,10,416,528,33,561,153,19,172,1087,62,1149
Delhi,2013,Attempt To Commit Murder,0,0,0,112,0,112,120,2,122,38,1,39,270,3,273
Delhi,2013,C.H. Not Amounting To Murder,0,0,0,6,0,6,2,1,3,1,1,2,9,2,11
Delhi,2013,Rape,0,0,0,218,0,218,213,4,217,35,2,37,466,6,472
Delhi,2013,Kidnapping And Abduction,0,0,0,58,6,64,52,7,59,9,3,12,119,16,135
Delhi,2013,Dacoity,0,0,0,124,0,124,162,0,162,8,0,8,294,0,294
Delhi,2013,Prep. And Assembly For Dacoity,0,0,0,5,0,5,6,0,6,0,0,0,11,0,11
Delhi,2013,Robbery,0,0,0,66,0,66,44,0,44,1,0,1,111,0,111
Delhi,2013,Burglary,0,0,0,6,0,6,0,0,0,1,0,1,7,0,7
Delhi,2013,Thefts,0,0,0,65,0,65,115,1,116,10,0,10,190,1,191
Delhi,2013,Extortion,0,0,0,0,0,0,1,0,1,0,0,0,1,0,1
Delhi,2013,Riots,0,0,0,1,0,1,1,0,1,0,0,0,2,0,2
Delhi,2013,Arson,0,0,0,0,0,0,0,0,0,0,0,0,0,0,0
Delhi,2013,Criminal Breach Of Trust,0,0,0,1,0,1,1,0,1,0,0,0,2,0,2
Delhi,2013,Cheating,0,0,0,12,0,12,32,0,32,33,0,33,77,0,77
Delhi,2013,Counter Feiting,0,0,0,3,0,3,8,3,11,1,0,1,12,3,15
Delhi,2013,Dowry Deaths,0,0,0,26,0,26,43,1,44,8,7,15,77,8,85
Delhi,2013,Molestation,0,0,0,4,0,4,2,0,2,6,0,6,12,0,12
Delhi,2013,Eve-Teasing,0,0,0,3,0,3,0,0,0,0,0,0,3,0,3
Delhi,2013,Cruelty By Husband Or Relative Of Husband,0,0,0,0,0,0,0,0,0,0,0,0,0,0,0
Delhi,2013,Other Ipc Crimes,0,0,0,30,0,30,18,3,21,31,2,33,79,5,84
Lakshadweep,2013,Murder,0,0,0,0,0,0,0,0,0,0,0,0,0,0,0
Lakshadweep,2013,Attempt To Commit Murder,0,0,0,0,0,0,0,0,0,0,0,0,0,0,0
Lakshadweep,2013,C.H. Not Amounting To Murder,0,0,0,0,0,0,0,0,0,0,0,0,0,0,0
Lakshadweep,2013,Rape,0,0,0,0,0,0,0,0,0,0,0,0,0,0,0
Lakshadweep,2013,Kidnapping And Abduction,0,0,0,0,0,0,0,0,0,0,0,0,0,0,0
Lakshadweep,2013,Dacoity,0,0,0,0,0,0,0,0,0,0,0,0,0,0,0
Lakshadweep,2013,Prep. And Assembly For Dacoity,0,0,0,0,0,0,0,0,0,0,0,0,0,0,0
Lakshadweep,2013,Robbery,0,0,0,0,0,0,0,0,0,0,0,0,0,0,0
Lakshadweep,2013,Burglary,0,0,0,0,0,0,0,0,0,0,0,0,0,0,0
Lakshadweep,2013,Thefts,0,0,0,0,0,0,0,0,0,0,0,0,0,0,0
Lakshadweep,2013,Extortion,0,0,0,0,0,0,0,0,0,0,0,0,0,0,0
Lakshadweep,2013,Riots,0,0,0,0,0,0,0,0,0,0,0,0,0,0,0
Lakshadweep,2013,Arson,0,0,0,0,0,0,0,0,0,0,0,0,0,0,0
Lakshadweep,2013,Criminal Breach Of Trust,0,0,0,0,0,0,0,0,0,0,0,0,0,0,0
Lakshadweep,2013,Cheating,0,0,0,0,0,0,0,0,0,0,0,0,0,0,0
Lakshadweep,2013,Counter Feiting,0,0,0,0,0,0,0,0,0,0,0,0,0,0,0
Lakshadweep,2013,Dowry Deaths,0,0,0,0,0,0,0,0,0,0,0,0,0,0,0
Lakshadweep,2013,Molestation,0,0,0,0,0,0,0,0,0,0,0,0,0,0,0
Lakshadweep,2013,Eve-Teasing,0,0,0,0,0,0,0,0,0,0,0,0,0,0,0
Lakshadweep,2013,Cruelty By Husband Or Relative Of Husband,0,0,0,0,0,0,0,0,0,0,0,0,0,0,0
Lakshadweep,2013,Other Ipc Crimes,0,0,0,0,0,0,0,0,0,0,0,0,0,0,0
Pondicherry,2013,Murder,0,0,0,7,0,7,46,1,47,11,1,12,64,2,66
Pondicherry,2013,Attempt To Commit Murder,0,0,0,0,0,0,0,0,0,0,0,0,0,0,0
Pondicherry,2013,C.H. Not Amounting To Murder,0,0,0,1,0,1,1,0,1,0,0,0,2,0,2
Pondicherry,2013,Rape,0,0,0,0,0,0,2,0,2,1,0,1,3,0,3
Pondicherry,2013,Kidnapping And Abduction,0,0,0,1,0,1,2,0,2,1,0,1,4,0,4
Pondicherry,2013,Dacoity,0,0,0,0,0,0,0,0,0,0,0,0,0,0,0
Pondicherry,2013,Prep. And Assembly For Dacoity,0,0,0,0,0,0,0,0,0,0,0,0,0,0,0
Pondicherry,2013,Robbery,0,0,0,0,0,0,0,0,0,0,0,0,0,0,0
Pondicherry,2013,Burglary,0,0,0,0,0,0,2,0,2,0,0,0,2,0,2
Pondicherry,2013,Thefts,0,0,0,0,0,0,0,0,0,0,0,0,0,0,0
Pondicherry,2013,Extortion,0,0,0,0,0,0,0,0,0,0,0,0,0,0,0
Pondicherry,2013,Riots,0,0,0,0,0,0,0,0,0,0,0,0,0,0,0
Pondicherry,2013,Arson,0,0,0,0,0,0,0,0,0,0,0,0,0,0,0
Pondicherry,2013,Criminal Breach Of Trust,0,0,0,0,0,0,0,0,0,0,0,0,0,0,0
Pondicherry,2013,Cheating,0,0,0,0,0,0,0,0,0,0,0,0,0,0,0
Pondicherry,2013,Counter Feiting,0,0,0,0,0,0,1,0,1,0,0,0,1,0,1
Pondicherry,2013,Dowry Deaths,0,0,0,0,0,0,0,0,0,1,0,1,1,0,1
Pondicherry,2013,Molestation,0,0,0,0,0,0,0,0,0,0,0,0,0,0,0
Pondicherry,2013,Eve-Teasing,0,0,0,0,0,0,0,0,0,0,0,0,0,0,0
Pondicherry,2013,Cruelty By Husband Or Relative Of Husband,0,0,0,0,0,0,0,0,0,0,0,0,0,0,0
Pondicherry,2013,Other Ipc Crimes,0,0,0,2,0,2,6,0,6,0,0,0,8,0,8
