State_UT_name,Year,Jail_Type,Male Convicts,Female_Convicts,Total_Convicts,Male_Under_trial,Female_Under_trial,Total_Under_trial,Male_Detenues,Female_Detenues,Total_Detenues,Male_Others,Female_Others,Total_Others,Total_Male,Total_Female,Grand_Total
Andhra Pradesh,2001,Central Jail,3372,3,3375,2718,114,2832,4,0,4,22,0,22,6116,117,6233
Andhra Pradesh,2001,District Jail,294,1,295,2379,136,2515,0,0,0,0,0,0,2673,137,2810
Andhra Pradesh,2001,Sub_Jail,188,10,198,3263,151,3414,0,0,0,0,0,0,3451,161,3612
Andhra Pradesh,2001,Women Jail,0,88,88,0,81,81,0,1,1,0,0,0,0,170,170
Andhra Pradesh,2001,Borstal School,17,0,17,0,0,0,0,0,0,0,0,0,17,0,17
Andhra Pradesh,2001,Open Jail,248,0,248,0,0,0,0,0,0,0,0,0,248,0,248
Andhra Pradesh,2001,Special Jail,0,0,0,0,0,0,0,0,0,0,0,0,0,0,0
Andhra Pradesh,2001,Others,0,0,0,0,0,0,0,0,0,0,0,0,0,0,0
Andhra Pradesh,2001,Total,4119,102,4221,8360,482,8842,4,1,5,22,0,22,12505,585,13090
Andhra Pradesh,2002,Central Jail,4111,4,4115,3173,157,3330,2,0,2,0,0,0,7286,161,7447
Andhra Pradesh,2002,District Jail,250,3,253,1908,108,2016,0,0,0,0,0,0,2158,111,2269
Andhra Pradesh,2002,Sub_Jail,114,1,115,2911,200,3111,0,0,0,0,0,0,3025,201,3226
Andhra Pradesh,2002,Women Jail,0,143,143,0,92,92,0,0,0,0,0,0,0,235,235
Andhra Pradesh,2002,Borstal School,28,0,28,0,0,0,0,0,0,0,0,0,28,0,28
Andhra Pradesh,2002,Open Jail,218,0,218,0,0,0,0,0,0,0,0,0,218,0,218
Andhra Pradesh,2002,Special Jail,0,0,0,0,0,0,0,0,0,0,0,0,0,0,0
Andhra Pradesh,2002,Others,0,0,0,0,0,0,0,0,0,0,0,0,0,0,0
Andhra Pradesh,2002,Total,4721,151,4872,7992,557,8549,2,0,2,0,0,0,12715,708,13423
Andhra Pradesh,2003,Central Jail,4305,11,4316,3280,202,3482,18,0,18,0,0,0,7603,213,7816
Andhra Pradesh,2003,District Jail,269,0,269,1927,165,2092,0,0,0,0,0,0,2196,165,2361
Andhra Pradesh,2003,Sub_Jail,125,0,125,3171,22,3193,0,0,0,0,0,0,3296,22,3318
Andhra Pradesh,2003,Women Jail,0,161,161,0,152,152,0,0,0,0,0,0,0,313,313
Andhra Pradesh,2003,Borstal School,22,0,22,0,0,0,0,0,0,0,0,0,22,0,22
Andhra Pradesh,2003,Open Jail,254,0,254,0,0,0,0,0,0,0,0,0,254,0,254
Andhra Pradesh,2003,Special Jail,0,0,0,0,0,0,0,0,0,0,0,0,0,0,0
Andhra Pradesh,2003,Others,0,0,0,0,0,0,0,0,0,0,0,0,0,0,0
Andhra Pradesh,2003,Total,4975,172,5147,8378,541,8919,18,0,18,0,0,0,13371,713,14084
Andhra Pradesh,2004,Central Jail,3949,15,3964,3401,194,3595,27,0,27,0,0,0,7377,209,7586
Andhra Pradesh,2004,District Jail,224,6,230,2063,174,2237,2,0,2,0,0,0,2289,180,2469
Andhra Pradesh,2004,Sub_Jail,105,2,107,3035,40,3075,0,0,0,0,0,0,3140,42,3182
Andhra Pradesh,2004,Women Jail,0,174,174,0,171,171,0,9,9,0,0,0,0,354,354
Andhra Pradesh,2004,Borstal School,6,0,6,0,0,0,0,0,0,0,0,0,6,0,6
Andhra Pradesh,2004,Open Jail,284,0,284,0,0,0,0,0,0,0,0,0,284,0,284
Andhra Pradesh,2004,Special Jail,0,0,0,0,0,0,0,0,0,0,0,0,0,0,0
Andhra Pradesh,2004,Others,0,0,0,0,0,0,0,0,0,0,0,0,0,0,0
Andhra Pradesh,2004,Total,4568,197,4765,8499,579,9078,29,9,38,0,0,0,13096,785,13881
Andhra Pradesh,2005,Central Jail,4152,9,4161,3897,132,4029,10,0,10,0,0,0,8059,141,8200
Andhra Pradesh,2005,District Jail,219,4,223,1871,218,2089,0,0,0,0,0,0,2090,222,2312
Andhra Pradesh,2005,Sub_Jail,145,1,146,3138,50,3188,0,0,0,0,0,0,3283,51,3334
Andhra Pradesh,2005,Women Jail,0,184,184,0,286,286,0,0,0,0,0,0,0,470,470
Andhra Pradesh,2005,Borstal School,7,0,7,0,0,0,0,0,0,0,0,0,7,0,7
Andhra Pradesh,2005,Open Jail,290,0,290,0,0,0,0,0,0,0,0,0,290,0,290
Andhra Pradesh,2005,Special Jail,0,0,0,0,0,0,0,0,0,0,0,0,0,0,0
Andhra Pradesh,2005,Others,0,0,0,0,0,0,0,0,0,0,0,0,0,0,0
Andhra Pradesh,2005,Total,4813,198,5011,8906,686,9592,10,0,10,0,0,0,13729,884,14613
Andhra Pradesh,2006,Central Jail,4271,8,4279,3674,150,3824,17,0,17,34,0,34,7996,158,8154
Andhra Pradesh,2006,District Jail,368,6,374,2203,233,2436,0,0,0,0,0,0,2571,239,2810
Andhra Pradesh,2006,Sub_Jail,92,1,93,3568,75,3643,0,0,0,0,0,0,3660,76,3736
Andhra Pradesh,2006,Women Jail,0,192,192,0,179,179,0,1,1,0,0,0,0,372,372
Andhra Pradesh,2006,Borstal School,14,0,14,0,0,0,0,0,0,0,0,0,14,0,14
Andhra Pradesh,2006,Open Jail,335,0,335,0,0,0,0,0,0,0,0,0,335,0,335
Andhra Pradesh,2006,Special Jail,0,0,0,0,0,0,0,0,0,0,0,0,0,0,0
Andhra Pradesh,2006,Others,0,0,0,0,0,0,0,0,0,0,0,0,0,0,0
Andhra Pradesh,2006,Total,5080,207,5287,9445,637,10082,17,1,18,34,0,34,14576,845,15421
Andhra Pradesh,2007,Central Jail,4582,30,4612,3469,117,3586,21,0,21,20,0,20,8092,147,8239
Andhra Pradesh,2007,District Jail,291,7,298,2081,195,2276,0,0,0,0,0,0,2372,202,2574
Andhra Pradesh,2007,Sub_Jail,107,0,107,3260,155,3415,0,0,0,0,0,0,3367,155,3522
Andhra Pradesh,2007,Women Jail,0,195,195,0,168,168,0,0,0,0,0,0,0,363,363
Andhra Pradesh,2007,Borstal School,13,0,13,0,0,0,0,0,0,0,0,0,13,0,13
Andhra Pradesh,2007,Open Jail,334,0,334,0,0,0,0,0,0,0,0,0,334,0,334
Andhra Pradesh,2007,Special Jail,0,0,0,0,0,0,0,0,0,0,0,0,0,0,0
Andhra Pradesh,2007,Others,0,0,0,0,0,0,0,0,0,0,0,0,0,0,0
Andhra Pradesh,2007,Total,5327,232,5559,8810,635,9445,21,0,21,20,0,20,14178,867,15045
Andhra Pradesh,2008,Central Jail,4436,31,4467,3148,87,3235,21,0,21,12,0,12,7617,118,7735
Andhra Pradesh,2008,District Jail,286,5,291,1956,179,2135,0,0,0,0,0,0,2242,184,2426
Andhra Pradesh,2008,Sub_Jail,86,0,86,2914,240,3154,0,0,0,0,0,0,3000,240,3240
Andhra Pradesh,2008,Women Jail,0,187,187,0,145,145,0,0,0,0,0,0,0,332,332
Andhra Pradesh,2008,Borstal School,7,0,7,0,0,0,0,0,0,0,0,0,7,0,7
Andhra Pradesh,2008,Open Jail,340,0,340,0,0,0,0,0,0,0,0,0,340,0,340
Andhra Pradesh,2008,Special Jail,0,0,0,0,0,0,0,0,0,0,0,0,0,0,0
Andhra Pradesh,2008,Others,0,0,0,0,0,0,0,0,0,0,0,0,0,0,0
Andhra Pradesh,2008,Total,5155,223,5378,8018,651,8669,21,0,21,12,0,12,13206,874,14080
Andhra Pradesh,2009,Central Jail,3704,99,3803,2713,77,2790,38,0,38,15,0,15,6470,176,6646
Andhra Pradesh,2009,District Jail,241,1,242,1915,159,2074,0,0,0,0,0,0,2156,160,2316
Andhra Pradesh,2009,Sub_Jail,77,1,78,3012,212,3224,0,0,0,0,0,0,3089,213,3302
Andhra Pradesh,2009,Women Jail,0,96,96,0,129,129,0,2,2,0,0,0,0,227,227
Andhra Pradesh,2009,Borstal School,12,0,12,0,0,0,0,0,0,0,0,0,12,0,12
Andhra Pradesh,2009,Open Jail,305,0,305,0,0,0,0,0,0,0,0,0,305,0,305
Andhra Pradesh,2009,Special Jail,0,0,0,0,0,0,0,0,0,0,0,0,0,0,0
Andhra Pradesh,2009,Others,0,0,0,0,0,0,0,0,0,0,0,0,0,0,0
Andhra Pradesh,2009,Total,4339,197,4536,7640,577,8217,38,2,40,15,0,15,12032,776,12808
Andhra Pradesh,2010,Central Jail,3938,71,4009,2823,67,2890,28,0,28,13,0,13,6802,138,6940
Andhra Pradesh,2010,District Jail,195,1,196,1594,161,1755,0,0,0,0,0,0,1789,162,1951
Andhra Pradesh,2010,Sub_Jail,83,2,85,2686,189,2875,0,0,0,0,0,0,2769,191,2960
Andhra Pradesh,2010,Women Jail,0,157,157,0,129,129,0,2,2,0,0,0,0,288,288
Andhra Pradesh,2010,Borstal School,13,0,13,0,0,0,0,0,0,0,0,0,13,0,13
Andhra Pradesh,2010,Open Jail,338,0,338,0,0,0,0,0,0,0,0,0,338,0,338
Andhra Pradesh,2010,Special Jail,0,0,0,0,0,0,0,0,0,0,0,0,0,0,0
Andhra Pradesh,2010,Others,0,0,0,0,0,0,0,0,0,0,0,0,0,0,0
Andhra Pradesh,2010,Total,4567,231,4798,7103,546,7649,28,2,30,13,0,13,11711,779,12490
Andhra Pradesh,2011,Central Jail,3774,92,3866,3140,54,3194,13,0,13,17,0,17,6944,146,7090
Andhra Pradesh,2011,District Jail,270,3,273,2005,174,2179,0,0,0,0,0,0,2275,177,2452
Andhra Pradesh,2011,Sub_Jail,48,1,49,2819,209,3028,0,0,0,0,0,0,2867,210,3077
Andhra Pradesh,2011,Women Jail,0,165,165,0,143,143,0,1,1,0,0,0,0,309,309
Andhra Pradesh,2011,Borstal School,6,0,6,0,0,0,0,0,0,0,0,0,6,0,6
Andhra Pradesh,2011,Open Jail,279,0,279,0,0,0,0,0,0,0,0,0,279,0,279
Andhra Pradesh,2011,Special Jail,0,0,0,0,0,0,0,0,0,0,0,0,0,0,0
Andhra Pradesh,2011,Others,0,0,0,0,0,0,0,0,0,0,0,0,0,0,0
Andhra Pradesh,2011,Total,4377,261,4638,7964,580,8544,13,1,14,17,0,17,12371,842,13213
Andhra Pradesh,2012,Central Jail,3810,115,3925,2903,97,3000,3,0,3,7,1,8,6723,213,6936
Andhra Pradesh,2012,District Jail,251,1,252,1904,164,2068,0,0,0,0,0,0,2155,165,2320
Andhra Pradesh,2012,Sub_Jail,48,1,49,3107,233,3340,0,0,0,0,0,0,3155,234,3389
Andhra Pradesh,2012,Women Jail,0,168,168,0,143,143,0,1,1,0,0,0,0,312,312
Andhra Pradesh,2012,Borstal School,5,0,5,0,0,0,0,0,0,0,0,0,5,0,5
Andhra Pradesh,2012,Open Jail,323,0,323,0,0,0,0,0,0,0,0,0,323,0,323
Andhra Pradesh,2012,Special Jail,0,0,0,0,0,0,0,0,0,0,0,0,0,0,0
Andhra Pradesh,2012,Others,0,0,0,0,0,0,0,0,0,0,0,0,0,0,0
Andhra Pradesh,2012,Total,4437,285,4722,7914,637,8551,3,1,4,7,1,8,12361,924,13285
Arunachal Pradesh,2009,Central Jail,0,0,0,0,0,0,0,0,0,0,0,0,0,0,0
Arunachal Pradesh,2009,District Jail,2,0,2,56,4,60,0,0,0,0,0,0,58,4,62
Arunachal Pradesh,2009,Sub_Jail,0,0,0,0,0,0,0,0,0,0,0,0,0,0,0
Arunachal Pradesh,2009,Women Jail,0,0,0,0,0,0,0,0,0,0,0,0,0,0,0
Arunachal Pradesh,2009,Borstal School,0,0,0,0,0,0,0,0,0,0,0,0,0,0,0
Arunachal Pradesh,2009,Open Jail,0,0,0,0,0,0,0,0,0,0,0,0,0,0,0
Arunachal Pradesh,2009,Special Jail,0,0,0,0,0,0,0,0,0,0,0,0,0,0,0
Arunachal Pradesh,2009,Others,0,0,0,0,0,0,0,0,0,0,0,0,0,0,0
Arunachal Pradesh,2009,Total,2,0,2,56,4,60,0,0,0,0,0,0,58,4,62
Arunachal Pradesh,2010,Central Jail,0,0,0,0,0,0,0,0,0,0,0,0,0,0,0
Arunachal Pradesh,2010,District Jail,5,0,5,48,4,52,0,0,0,0,0,0,53,4,57
Arunachal Pradesh,2010,Sub_Jail,0,0,0,0,0,0,0,0,0,0,0,0,0,0,0
Arunachal Pradesh,2010,Women Jail,0,0,0,0,0,0,0,0,0,0,0,0,0,0,0
Arunachal Pradesh,2010,Borstal School,0,0,0,0,0,0,0,0,0,0,0,0,0,0,0
Arunachal Pradesh,2010,Open Jail,0,0,0,0,0,0,0,0,0,0,0,0,0,0,0
Arunachal Pradesh,2010,Special Jail,0,0,0,0,0,0,0,0,0,0,0,0,0,0,0
Arunachal Pradesh,2010,Others,0,0,0,0,0,0,0,0,0,0,0,0,0,0,0
Arunachal Pradesh,2010,Total,5,0,5,48,4,52,0,0,0,0,0,0,53,4,57
Arunachal Pradesh,2011,Central Jail,0,0,0,0,0,0,0,0,0,0,0,0,0,0,0
Arunachal Pradesh,2011,District Jail,6,0,6,44,5,49,0,0,0,0,0,0,50,5,55
Arunachal Pradesh,2011,Sub_Jail,0,0,0,0,0,0,0,0,0,0,0,0,0,0,0
Arunachal Pradesh,2011,Women Jail,0,0,0,0,0,0,0,0,0,0,0,0,0,0,0
Arunachal Pradesh,2011,Borstal School,0,0,0,0,0,0,0,0,0,0,0,0,0,0,0
Arunachal Pradesh,2011,Open Jail,0,0,0,0,0,0,0,0,0,0,0,0,0,0,0
Arunachal Pradesh,2011,Special Jail,0,0,0,0,0,0,0,0,0,0,0,0,0,0,0
Arunachal Pradesh,2011,Others,0,0,0,0,0,0,0,0,0,0,0,0,0,0,0
Arunachal Pradesh,2011,Total,6,0,6,44,5,49,0,0,0,0,0,0,50,5,55
Arunachal Pradesh,2012,Central Jail,0,0,0,0,0,0,0,0,0,0,0,0,0,0,0
Arunachal Pradesh,2012,District Jail,4,0,4,63,4,67,0,0,0,0,0,0,67,4,71
Arunachal Pradesh,2012,Sub_Jail,0,0,0,0,0,0,0,0,0,0,0,0,0,0,0
Arunachal Pradesh,2012,Women Jail,0,0,0,0,0,0,0,0,0,0,0,0,0,0,0
Arunachal Pradesh,2012,Borstal School,0,0,0,0,0,0,0,0,0,0,0,0,0,0,0
Arunachal Pradesh,2012,Open Jail,0,0,0,0,0,0,0,0,0,0,0,0,0,0,0
Arunachal Pradesh,2012,Special Jail,0,0,0,0,0,0,0,0,0,0,0,0,0,0,0
Arunachal Pradesh,2012,Others,0,0,0,0,0,0,0,0,0,0,0,0,0,0,0
Arunachal Pradesh,2012,Total,4,0,4,63,4,67,0,0,0,0,0,0,67,4,71
Assam,2001,Central Jail,0,0,0,0,0,0,0,0,0,0,0,0,0,0,0
Assam,2001,District Jail,2282,45,2327,3779,114,3893,14,0,14,1,0,1,6076,159,6235
Assam,2001,Sub_Jail,0,0,0,0,0,0,0,0,0,0,0,0,0,0,0
Assam,2001,Women Jail,0,0,0,0,0,0,0,0,0,0,0,0,0,0,0
Assam,2001,Borstal School,0,0,0,0,0,0,0,0,0,0,0,0,0,0,0
Assam,2001,Open Jail,36,0,36,0,0,0,0,0,0,0,0,0,36,0,36
Assam,2001,Special Jail,36,2,38,126,13,139,2,0,2,0,0,0,164,15,179
Assam,2001,Others,2,0,2,33,0,33,0,0,0,0,0,0,35,0,35
Assam,2001,Total,2356,47,2403,3938,127,4065,16,0,16,1,0,1,6311,174,6485
Assam,2002,Central Jail,1493,25,1518,1916,68,1984,7,0,7,0,0,0,3416,93,3509
Assam,2002,District Jail,994,25,1019,2016,43,2059,10,0,10,0,0,0,3020,68,3088
Assam,2002,Sub_Jail,0,0,0,34,0,34,0,0,0,0,0,0,34,0,34
Assam,2002,Women Jail,0,0,0,0,0,0,0,0,0,0,0,0,0,0,0
Assam,2002,Borstal School,0,0,0,0,0,0,0,0,0,0,0,0,0,0,0
Assam,2002,Open Jail,43,0,43,0,0,0,0,0,0,0,0,0,43,0,43
Assam,2002,Special Jail,146,4,150,240,2,242,1,0,1,0,0,0,387,6,393
Assam,2002,Others,0,0,0,0,0,0,0,0,0,0,0,0,0,0,0
Assam,2002,Total,2676,54,2730,4206,113,4319,18,0,18,0,0,0,6900,167,7067
Assam,2003,Central Jail,1490,39,1529,2111,58,2169,18,0,18,0,0,0,3619,97,3716
Assam,2003,District Jail,1261,32,1293,2056,76,2132,10,2,12,1,0,1,3328,110,3438
Assam,2003,Sub_Jail,1,0,1,22,0,22,0,0,0,0,0,0,23,0,23
Assam,2003,Women Jail,0,0,0,0,0,0,0,0,0,0,0,0,0,0,0
Assam,2003,Borstal School,0,0,0,0,0,0,0,0,0,0,0,0,0,0,0
Assam,2003,Open Jail,43,0,43,0,0,0,0,0,0,0,0,0,43,0,43
Assam,2003,Special Jail,213,1,214,197,3,200,1,0,1,2,0,2,413,4,417
Assam,2003,Others,0,0,0,0,0,0,0,0,0,0,0,0,0,0,0
Assam,2003,Total,3008,72,3080,4386,137,4523,29,2,31,3,0,3,7426,211,7637
Assam,2004,Central Jail,1603,42,1645,1989,43,2032,90,22,112,4,0,4,3686,107,3793
Assam,2004,District Jail,1338,35,1373,1914,82,1996,105,13,118,1,0,1,3358,130,3488
Assam,2004,Sub_Jail,2,0,2,27,0,27,0,0,0,0,0,0,29,0,29
Assam,2004,Women Jail,0,0,0,0,0,0,0,0,0,0,0,0,0,0,0
Assam,2004,Borstal School,0,0,0,0,0,0,0,0,0,0,0,0,0,0,0
Assam,2004,Open Jail,34,0,34,0,0,0,0,0,0,0,0,0,34,0,34
Assam,2004,Special Jail,214,0,214,234,9,243,20,5,25,2,0,2,470,14,484
Assam,2004,Others,0,0,0,0,0,0,0,0,0,0,0,0,0,0,0
Assam,2004,Total,3191,77,3268,4164,134,4298,215,40,255,7,0,7,7577,251,7828
Assam,2005,Central Jail,1675,35,1710,2376,61,2437,19,3,22,0,0,0,4070,99,4169
Assam,2005,District Jail,1499,40,1539,2309,68,2377,7,0,7,4,0,4,3819,108,3927
Assam,2005,Sub_Jail,4,0,4,28,0,28,0,0,0,0,0,0,32,0,32
Assam,2005,Women Jail,0,0,0,0,0,0,0,0,0,0,0,0,0,0,0
Assam,2005,Borstal School,0,0,0,0,0,0,0,0,0,0,0,0,0,0,0
Assam,2005,Open Jail,28,0,28,0,0,0,0,0,0,0,0,0,28,0,28
Assam,2005,Special Jail,191,3,194,154,4,158,5,0,5,0,0,0,350,7,357
Assam,2005,Others,0,0,0,0,0,0,0,0,0,0,0,0,0,0,0
Assam,2005,Total,3397,78,3475,4867,133,5000,31,3,34,4,0,4,8299,214,8513
Assam,2006,Central Jail,1629,38,1667,2236,62,2298,19,0,19,0,0,0,3884,100,3984
Assam,2006,District Jail,1653,45,1698,2341,95,2436,7,0,7,2,0,2,4003,140,4143
Assam,2006,Sub_Jail,2,0,2,56,1,57,0,0,0,0,0,0,58,1,59
Assam,2006,Women Jail,0,0,0,0,0,0,0,0,0,0,0,0,0,0,0
Assam,2006,Borstal School,0,0,0,0,0,0,0,0,0,0,0,0,0,0,0
Assam,2006,Open Jail,43,0,43,0,0,0,0,0,0,0,0,0,43,0,43
Assam,2006,Special Jail,138,1,139,168,1,169,1,0,1,0,0,0,307,2,309
Assam,2006,Others,0,0,0,0,0,0,0,0,0,0,0,0,0,0,0
Assam,2006,Total,3465,84,3549,4801,159,4960,27,0,27,2,0,2,8295,243,8538
Assam,2007,Central Jail,1588,41,1629,2335,57,2392,19,4,23,0,0,0,3942,102,4044
Assam,2007,District Jail,1724,53,1777,2459,84,2543,6,1,7,0,0,0,4189,138,4327
Assam,2007,Sub_Jail,6,0,6,49,0,49,1,0,1,0,0,0,56,0,56
Assam,2007,Women Jail,0,0,0,0,0,0,0,0,0,0,0,0,0,0,0
Assam,2007,Borstal School,0,0,0,0,0,0,0,0,0,0,0,0,0,0,0
Assam,2007,Open Jail,38,0,38,0,0,0,0,0,0,0,0,0,38,0,38
Assam,2007,Special Jail,124,6,130,101,5,106,4,0,4,0,0,0,229,11,240
Assam,2007,Others,0,0,0,0,0,0,0,0,0,0,0,0,0,0,0
Assam,2007,Total,3480,100,3580,4944,146,5090,30,5,35,0,0,0,8454,251,8705
Assam,2008,Central Jail,1539,42,1581,2300,84,2384,8,0,8,0,0,0,3847,126,3973
Assam,2008,District Jail,1717,54,1771,2575,123,2698,1,0,1,0,0,0,4293,177,4470
Assam,2008,Sub_Jail,5,0,5,59,1,60,0,0,0,0,0,0,64,1,65
Assam,2008,Women Jail,0,0,0,0,0,0,0,0,0,0,0,0,0,0,0
Assam,2008,Borstal School,0,0,0,0,0,0,0,0,0,0,0,0,0,0,0
Assam,2008,Open Jail,43,0,43,0,0,0,0,0,0,0,0,0,43,0,43
Assam,2008,Special Jail,92,2,94,89,7,96,1,0,1,0,0,0,182,9,191
Assam,2008,Others,0,0,0,0,0,0,0,0,0,0,0,0,0,0,0
Assam,2008,Total,3396,98,3494,5023,215,5238,10,0,10,0,0,0,8429,313,8742
Assam,2009,Central Jail,1350,35,1385,1644,67,1711,7,0,7,0,0,0,3001,102,3103
Assam,2009,District Jail,1784,57,1841,2778,123,2901,0,2,2,0,0,0,4562,182,4744
Assam,2009,Sub_Jail,2,0,2,45,0,45,0,0,0,0,0,0,47,0,47
Assam,2009,Women Jail,0,0,0,0,0,0,0,0,0,0,0,0,0,0,0
Assam,2009,Borstal School,0,0,0,0,0,0,0,0,0,0,0,0,0,0,0
Assam,2009,Open Jail,35,0,35,0,0,0,0,0,0,0,0,0,35,0,35
Assam,2009,Special Jail,64,0,64,152,15,167,0,0,0,0,0,0,216,15,231
Assam,2009,Others,0,0,0,0,0,0,0,0,0,0,0,0,0,0,0
Assam,2009,Total,3235,92,3327,4619,205,4824,7,2,9,0,0,0,7861,299,8160
Assam,2010,Central Jail,1258,37,1295,1700,67,1767,3,0,3,0,0,0,2961,104,3065
Assam,2010,District Jail,1812,61,1873,2545,108,2653,0,0,0,0,0,0,4357,169,4526
Assam,2010,Sub_Jail,2,0,2,54,0,54,0,0,0,0,0,0,56,0,56
Assam,2010,Women Jail,0,0,0,0,0,0,0,0,0,0,0,0,0,0,0
Assam,2010,Borstal School,0,0,0,0,0,0,0,0,0,0,0,0,0,0,0
Assam,2010,Open Jail,28,0,28,0,0,0,0,0,0,0,0,0,28,0,28
Assam,2010,Special Jail,66,0,66,181,0,181,0,0,0,0,0,0,247,0,247
Assam,2010,Others,0,0,0,0,0,0,0,0,0,0,0,0,0,0,0
Assam,2010,Total,3166,98,3264,4480,175,4655,3,0,3,0,0,0,7649,273,7922
Assam,2011,Central Jail,1271,35,1306,1905,87,1992,0,0,0,0,0,0,3176,122,3298
Assam,2011,District Jail,1683,55,1738,2756,119,2875,0,0,0,0,0,0,4439,174,4613
Assam,2011,Sub_Jail,3,0,3,72,1,73,0,0,0,0,0,0,75,1,76
Assam,2011,Women Jail,0,0,0,0,0,0,0,0,0,0,0,0,0,0,0
Assam,2011,Borstal School,0,0,0,0,0,0,0,0,0,0,0,0,0,0,0
Assam,2011,Open Jail,23,0,23,0,0,0,0,0,0,0,0,0,23,0,23
Assam,2011,Special Jail,66,1,67,126,0,126,0,0,0,0,0,0,192,1,193
Assam,2011,Others,0,0,0,0,0,0,0,0,0,0,0,0,0,0,0
Assam,2011,Total,3046,91,3137,4859,207,5066,0,0,0,0,0,0,7905,298,8203
Assam,2012,Central Jail,1203,37,1240,1819,70,1889,1,0,1,0,0,0,3023,107,3130
Assam,2012,District Jail,1760,71,1831,2886,106,2992,2,0,2,0,0,0,4648,177,4825
Assam,2012,Sub_Jail,1,0,1,76,0,76,0,0,0,0,0,0,77,0,77
Assam,2012,Women Jail,0,0,0,0,0,0,0,0,0,0,0,0,0,0,0
Assam,2012,Borstal School,0,0,0,0,0,0,0,0,0,0,0,0,0,0,0
Assam,2012,Open Jail,31,0,31,0,0,0,0,0,0,0,0,0,31,0,31
Assam,2012,Special Jail,67,0,67,134,7,141,0,0,0,0,0,0,201,7,208
Assam,2012,Others,0,0,0,0,0,0,0,0,0,0,0,0,0,0,0
Assam,2012,Total,3062,108,3170,4915,183,5098,3,0,3,0,0,0,7980,291,8271
Bihar,2001,Central Jail,3712,21,3733,6084,63,6147,4,0,4,4,0,4,9804,84,9888
Bihar,2001,District Jail,1072,9,1081,17139,546,17685,8,0,8,30,0,30,18249,555,18804
Bihar,2001,Sub_Jail,203,2,205,6777,156,6933,0,0,0,3,0,3,6983,158,7141
Bihar,2001,Women Jail,0,46,46,0,28,28,0,0,0,0,0,0,0,74,74
Bihar,2001,Borstal School,0,0,0,0,0,0,0,0,0,0,0,0,0,0,0
Bihar,2001,Open Jail,0,0,0,0,0,0,0,0,0,0,0,0,0,0,0
Bihar,2001,Special Jail,0,0,0,0,0,0,0,0,0,0,0,0,0,0,0
Bihar,2001,Others,0,0,0,0,0,0,0,0,0,0,0,0,0,0,0
Bihar,2001,Total,4987,78,5065,30000,793,30793,12,0,12,37,0,37,35036,871,35907
Bihar,2002,Central Jail,3799,19,3818,6924,108,7032,5,0,5,36,0,36,10764,127,10891
Bihar,2002,District Jail,1005,16,1021,17249,629,17878,15,0,15,63,0,63,18332,645,18977
Bihar,2002,Sub_Jail,155,1,156,6986,173,7159,13,0,13,3,0,3,7157,174,7331
Bihar,2002,Women Jail,0,69,69,0,32,32,0,0,0,0,0,0,0,101,101
Bihar,2002,Borstal School,0,0,0,0,0,0,0,0,0,0,0,0,0,0,0
Bihar,2002,Open Jail,0,0,0,0,0,0,0,0,0,0,0,0,0,0,0
Bihar,2002,Special Jail,0,0,0,0,0,0,0,0,0,0,0,0,0,0,0
Bihar,2002,Others,0,0,0,0,0,0,0,0,0,0,0,0,0,0,0
Bihar,2002,Total,4959,105,5064,31159,942,32101,33,0,33,102,0,102,36253,1047,37300
Bihar,2003,Central Jail,3712,18,3730,6721,93,6814,1,0,1,24,0,24,10458,111,10569
Bihar,2003,District Jail,1065,25,1090,17880,619,18499,21,0,21,61,0,61,19027,644,19671
Bihar,2003,Sub_Jail,197,2,199,6588,186,6774,0,0,0,4,0,4,6789,188,6977
Bihar,2003,Women Jail,0,59,59,0,47,47,0,0,0,0,0,0,0,106,106
Bihar,2003,Borstal School,0,0,0,0,0,0,0,0,0,0,0,0,0,0,0
Bihar,2003,Open Jail,0,0,0,0,0,0,0,0,0,0,0,0,0,0,0
Bihar,2003,Special Jail,0,0,0,0,0,0,0,0,0,0,0,0,0,0,0
Bihar,2003,Others,0,0,0,0,0,0,0,0,0,0,0,0,0,0,0
Bihar,2003,Total,4974,104,5078,31189,945,32134,22,0,22,89,0,89,36274,1049,37323
Bihar,2004,Central Jail,3959,35,3994,6441,174,6615,24,0,24,40,0,40,10464,209,10673
Bihar,2004,District Jail,1107,21,1128,14426,397,14823,36,0,36,70,0,70,15639,418,16057
Bihar,2004,Sub_Jail,324,5,329,5765,146,5911,5,0,5,3,0,3,6097,151,6248
Bihar,2004,Women Jail,0,69,69,0,26,26,0,0,0,0,0,0,0,95,95
Bihar,2004,Borstal School,0,0,0,0,0,0,0,0,0,0,0,0,0,0,0
Bihar,2004,Open Jail,0,0,0,0,0,0,0,0,0,0,0,0,0,0,0
Bihar,2004,Special Jail,0,0,0,0,0,0,0,0,0,0,0,0,0,0,0
Bihar,2004,Others,0,0,0,0,0,0,0,0,0,0,0,0,0,0,0
Bihar,2004,Total,5390,130,5520,26632,743,27375,65,0,65,113,0,113,32200,873,33073
Bihar,2005,Central Jail,3978,30,4008,8870,254,9124,0,0,0,29,0,29,12877,284,13161
Bihar,2005,District Jail,1174,27,1201,21242,677,21919,0,0,0,136,0,136,22552,704,23256
Bihar,2005,Sub_Jail,333,10,343,8709,227,8936,0,0,0,25,0,25,9067,237,9304
Bihar,2005,Women Jail,0,57,57,0,40,40,0,0,0,0,0,0,0,97,97
Bihar,2005,Borstal School,0,0,0,0,0,0,0,0,0,0,0,0,0,0,0
Bihar,2005,Open Jail,0,0,0,0,0,0,0,0,0,0,0,0,0,0,0
Bihar,2005,Special Jail,0,0,0,0,0,0,0,0,0,0,0,0,0,0,0
Bihar,2005,Others,0,0,0,0,0,0,0,0,0,0,0,0,0,0,0
Bihar,2005,Total,5485,124,5609,38821,1198,40019,0,0,0,190,0,190,44496,1322,45818
Bihar,2006,Central Jail,4418,50,4468,8087,222,8309,0,0,0,38,0,38,12543,272,12815
Bihar,2006,District Jail,1577,26,1603,19942,731,20673,0,0,0,94,0,94,21613,757,22370
Bihar,2006,Sub_Jail,621,10,631,8077,291,8368,0,0,0,9,0,9,8707,301,9008
Bihar,2006,Women Jail,0,63,63,0,25,25,0,0,0,0,0,0,0,88,88
Bihar,2006,Borstal School,0,0,0,0,0,0,0,0,0,0,0,0,0,0,0
Bihar,2006,Open Jail,0,0,0,0,0,0,0,0,0,0,0,0,0,0,0
Bihar,2006,Special Jail,0,0,0,0,0,0,0,0,0,0,0,0,0,0,0
Bihar,2006,Others,0,0,0,0,0,0,0,0,0,0,0,0,0,0,0
Bihar,2006,Total,6616,149,6765,36106,1269,37375,0,0,0,141,0,141,42863,1418,44281
Bihar,2007,Central Jail,4172,29,4201,6775,225,7000,12,0,12,3,0,3,10962,254,11216
Bihar,2007,District Jail,1764,31,1795,21540,782,22322,11,0,11,25,0,25,23340,813,24153
Bihar,2007,Sub_Jail,194,0,194,3845,117,3962,1,0,1,4,0,4,4044,117,4161
Bihar,2007,Women Jail,0,76,76,0,32,32,0,0,0,0,0,0,0,108,108
Bihar,2007,Borstal School,0,0,0,0,0,0,0,0,0,0,0,0,0,0,0
Bihar,2007,Open Jail,0,0,0,0,0,0,0,0,0,0,0,0,0,0,0
Bihar,2007,Special Jail,0,0,0,0,0,0,0,0,0,0,0,0,0,0,0
Bihar,2007,Others,0,0,0,0,0,0,0,0,0,0,0,0,0,0,0
Bihar,2007,Total,6130,136,6266,32160,1156,33316,24,0,24,32,0,32,38346,1292,39638
Bihar,2008,Central Jail,4108,28,4136,6879,229,7108,14,0,14,15,0,15,11016,257,11273
Bihar,2008,District Jail,1602,34,1636,20210,732,20942,10,0,10,22,0,22,21844,766,22610
Bihar,2008,Sub_Jail,158,1,159,3460,110,3570,0,0,0,2,0,2,3620,111,3731
Bihar,2008,Women Jail,0,68,68,0,27,27,0,0,0,0,0,0,0,95,95
Bihar,2008,Borstal School,0,0,0,0,0,0,0,0,0,0,0,0,0,0,0
Bihar,2008,Open Jail,0,0,0,0,0,0,0,0,0,0,0,0,0,0,0
Bihar,2008,Special Jail,0,0,0,0,0,0,0,0,0,0,0,0,0,0,0
Bihar,2008,Others,0,0,0,0,0,0,0,0,0,0,0,0,0,0,0
Bihar,2008,Total,5868,131,5999,30549,1098,31647,24,0,24,39,0,39,36480,1229,37709
Bihar,2009,Central Jail,3646,22,3668,6262,185,6447,6,0,6,2,0,2,9916,207,10123
Bihar,2009,District Jail,1658,23,1681,18011,605,18616,4,0,4,4,1,5,19677,629,20306
Bihar,2009,Sub_Jail,119,1,120,2973,96,3069,0,0,0,0,0,0,3092,97,3189
Bihar,2009,Women Jail,0,62,62,0,31,31,0,0,0,0,0,0,0,93,93
Bihar,2009,Borstal School,0,0,0,0,0,0,0,0,0,0,0,0,0,0,0
Bihar,2009,Open Jail,0,0,0,0,0,0,0,0,0,0,0,0,0,0,0
Bihar,2009,Special Jail,0,0,0,0,0,0,0,0,0,0,0,0,0,0,0
Bihar,2009,Others,0,0,0,0,0,0,0,0,0,0,0,0,0,0,0
Bihar,2009,Total,5423,108,5531,27246,917,28163,10,0,10,6,1,7,32685,1026,33711
Bihar,2010,Central Jail,3402,30,3432,7003,207,7210,10,0,10,3,0,3,10418,237,10655
Bihar,2010,District Jail,1610,41,1651,13961,477,14438,22,0,22,12,0,12,15605,518,16123
Bihar,2010,Sub_Jail,154,2,156,2625,64,2689,2,0,2,4,0,4,2785,66,2851
Bihar,2010,Women Jail,0,46,46,0,25,25,0,0,0,0,0,0,0,71,71
Bihar,2010,Borstal School,0,0,0,0,0,0,0,0,0,0,0,0,0,0,0
Bihar,2010,Open Jail,0,0,0,0,0,0,0,0,0,0,0,0,0,0,0
Bihar,2010,Special Jail,0,0,0,0,0,0,0,0,0,0,0,0,0,0,0
Bihar,2010,Others,0,0,0,0,0,0,0,0,0,0,0,0,0,0,0
Bihar,2010,Total,5166,119,5285,23589,773,24362,34,0,34,19,0,19,28808,892,29700
Bihar,2011,Central Jail,2359,26,2385,6183,201,6384,5,0,5,3,0,3,8550,227,8777
Bihar,2011,District Jail,1336,25,1361,13671,484,14155,3,0,3,8,0,8,15018,509,15527
Bihar,2011,Sub_Jail,91,1,92,2526,88,2614,0,0,0,2,0,2,2619,89,2708
Bihar,2011,Women Jail,0,34,34,0,22,22,0,0,0,0,0,0,0,56,56
Bihar,2011,Borstal School,0,0,0,0,0,0,0,0,0,0,0,0,0,0,0
Bihar,2011,Open Jail,0,0,0,0,0,0,0,0,0,0,0,0,0,0,0
Bihar,2011,Special Jail,722,0,722,242,0,242,0,0,0,0,0,0,964,0,964
Bihar,2011,Others,0,0,0,0,0,0,0,0,0,0,0,0,0,0,0
Bihar,2011,Total,4508,86,4594,22622,795,23417,8,0,8,13,0,13,27151,881,28032
Bihar,2012,Central Jail,2044,37,2081,6616,224,6840,8,0,8,0,0,0,8668,261,8929
Bihar,2012,District Jail,1208,30,1238,13623,474,14097,32,0,32,13,0,13,14876,504,15380
Bihar,2012,Sub_Jail,111,0,111,2925,97,3022,0,0,0,0,0,0,3036,97,3133
Bihar,2012,Women Jail,0,35,35,0,31,31,0,0,0,0,0,0,0,66,66
Bihar,2012,Borstal School,0,0,0,0,0,0,0,0,0,0,0,0,0,0,0
Bihar,2012,Open Jail,102,0,102,0,0,0,0,0,0,0,0,0,102,0,102
Bihar,2012,Special Jail,541,0,541,399,0,399,0,0,0,0,0,0,940,0,940
Bihar,2012,Others,0,0,0,0,0,0,0,0,0,0,0,0,0,0,0
Bihar,2012,Total,4006,102,4108,23563,826,24389,40,0,40,13,0,13,27622,928,28550
Chhattisgarh,2012,Central Jail,5533,240,5773,3837,380,4217,0,0,0,13,0,13,9383,620,10003
Chhattisgarh,2012,District Jail,161,4,165,2783,75,2858,0,0,0,4,0,4,2948,79,3027
Chhattisgarh,2012,Sub_Jail,26,0,26,1724,0,1724,0,0,0,0,0,0,1750,0,1750
Chhattisgarh,2012,Women Jail,0,0,0,0,0,0,0,0,0,0,0,0,0,0,0
Chhattisgarh,2012,Borstal School,0,0,0,0,0,0,0,0,0,0,0,0,0,0,0
Chhattisgarh,2012,Open Jail,0,0,0,0,0,0,0,0,0,0,0,0,0,0,0
Chhattisgarh,2012,Special Jail,0,0,0,0,0,0,0,0,0,0,0,0,0,0,0
Chhattisgarh,2012,Others,0,0,0,0,0,0,0,0,0,0,0,0,0,0,0
Chhattisgarh,2012,Total,5720,244,5964,8344,455,8799,0,0,0,17,0,17,14081,699,14780
Chhattisgarh,2001,Central Jail,4207,185,4392,2043,146,2189,4,0,4,1,1,2,6255,332,6587
Chhattisgarh,2001,District Jail,146,0,146,937,58,995,0,0,0,3,0,3,1086,58,1144
Chhattisgarh,2001,Sub_Jail,166,0,166,1737,0,1737,0,0,0,4,0,4,1907,0,1907
Chhattisgarh,2001,Women Jail,0,0,0,0,0,0,0,0,0,0,0,0,0,0,0
Chhattisgarh,2001,Borstal School,0,0,0,0,0,0,0,0,0,0,0,0,0,0,0
Chhattisgarh,2001,Open Jail,29,0,29,0,0,0,0,0,0,0,0,0,29,0,29
Chhattisgarh,2001,Special Jail,0,0,0,0,0,0,0,0,0,0,0,0,0,0,0
Chhattisgarh,2001,Others,0,0,0,0,0,0,0,0,0,0,0,0,0,0,0
Chhattisgarh,2001,Total,4548,185,4733,4717,204,4921,4,0,4,8,1,9,9277,390,9667
Chhattisgarh,2002,Central Jail,4434,200,4634,1864,162,2026,1,0,1,1,0,1,6300,362,6662
Chhattisgarh,2002,District Jail,254,2,256,1253,63,1316,0,0,0,5,0,5,1512,65,1577
Chhattisgarh,2002,Sub_Jail,125,0,125,1619,0,1619,0,0,0,2,0,2,1746,0,1746
Chhattisgarh,2002,Women Jail,0,0,0,0,0,0,0,0,0,0,0,0,0,0,0
Chhattisgarh,2002,Borstal School,0,0,0,0,0,0,0,0,0,0,0,0,0,0,0
Chhattisgarh,2002,Open Jail,21,0,21,0,0,0,0,0,0,0,0,0,21,0,21
Chhattisgarh,2002,Special Jail,0,0,0,0,0,0,0,0,0,0,0,0,0,0,0
Chhattisgarh,2002,Others,0,0,0,0,0,0,0,0,0,0,0,0,0,0,0
Chhattisgarh,2002,Total,4834,202,5036,4736,225,4961,1,0,1,8,0,8,9579,427,10006
Chhattisgarh,2003,Central Jail,4142,194,4336,1634,115,1749,3,0,3,1,0,1,5780,309,6089
Chhattisgarh,2003,District Jail,267,5,272,1045,45,1090,0,0,0,2,0,2,1314,50,1364
Chhattisgarh,2003,Sub_Jail,112,0,112,1289,0,1289,0,0,0,7,0,7,1408,0,1408
Chhattisgarh,2003,Women Jail,0,0,0,0,0,0,0,0,0,0,0,0,0,0,0
Chhattisgarh,2003,Borstal School,0,0,0,0,0,0,0,0,0,0,0,0,0,0,0
Chhattisgarh,2003,Open Jail,0,0,0,0,0,0,0,0,0,0,0,0,0,0,0
Chhattisgarh,2003,Special Jail,0,0,0,0,0,0,0,0,0,0,0,0,0,0,0
Chhattisgarh,2003,Others,0,0,0,0,0,0,0,0,0,0,0,0,0,0,0
Chhattisgarh,2003,Total,4521,199,4720,3968,160,4128,3,0,3,10,0,10,8502,359,8861
Chhattisgarh,2004,Central Jail,3969,202,4171,1417,133,1550,0,0,0,1,0,1,5387,335,5722
Chhattisgarh,2004,District Jail,237,3,240,1099,61,1160,0,0,0,2,0,2,1338,64,1402
Chhattisgarh,2004,Sub_Jail,114,0,114,1627,0,1627,0,0,0,8,0,8,1749,0,1749
Chhattisgarh,2004,Women Jail,0,0,0,0,0,0,0,0,0,0,0,0,0,0,0
Chhattisgarh,2004,Borstal School,0,0,0,0,0,0,0,0,0,0,0,0,0,0,0
Chhattisgarh,2004,Open Jail,0,0,0,0,0,0,0,0,0,0,0,0,0,0,0
Chhattisgarh,2004,Special Jail,0,0,0,0,0,0,0,0,0,0,0,0,0,0,0
Chhattisgarh,2004,Others,0,0,0,0,0,0,0,0,0,0,0,0,0,0,0
Chhattisgarh,2004,Total,4320,205,4525,4143,194,4337,0,0,0,11,0,11,8474,399,8873
Chhattisgarh,2005,Central Jail,3826,187,4013,2187,173,2360,2,0,2,4,0,4,6019,360,6379
Chhattisgarh,2005,District Jail,206,4,210,1411,59,1470,0,0,0,3,0,3,1620,63,1683
Chhattisgarh,2005,Sub_Jail,76,0,76,1679,0,1679,0,0,0,4,0,4,1759,0,1759
Chhattisgarh,2005,Women Jail,0,0,0,0,0,0,0,0,0,0,0,0,0,0,0
Chhattisgarh,2005,Borstal School,0,0,0,0,0,0,0,0,0,0,0,0,0,0,0
Chhattisgarh,2005,Open Jail,0,0,0,0,0,0,0,0,0,0,0,0,0,0,0
Chhattisgarh,2005,Special Jail,0,0,0,0,0,0,0,0,0,0,0,0,0,0,0
Chhattisgarh,2005,Others,0,0,0,0,0,0,0,0,0,0,0,0,0,0,0
Chhattisgarh,2005,Total,4108,191,4299,5277,232,5509,2,0,2,11,0,11,9398,423,9821
Chhattisgarh,2006,Central Jail,3817,186,4003,2271,210,2481,1,0,1,2,0,2,6091,396,6487
Chhattisgarh,2006,District Jail,164,1,165,1490,74,1564,0,0,0,3,0,3,1657,75,1732
Chhattisgarh,2006,Sub_Jail,106,0,106,2028,0,2028,0,0,0,6,0,6,2140,0,2140
Chhattisgarh,2006,Women Jail,0,0,0,0,0,0,0,0,0,0,0,0,0,0,0
Chhattisgarh,2006,Borstal School,0,0,0,0,0,0,0,0,0,0,0,0,0,0,0
Chhattisgarh,2006,Open Jail,0,0,0,0,0,0,0,0,0,0,0,0,0,0,0
Chhattisgarh,2006,Special Jail,0,0,0,0,0,0,0,0,0,0,0,0,0,0,0
Chhattisgarh,2006,Others,0,0,0,0,0,0,0,0,0,0,0,0,0,0,0
Chhattisgarh,2006,Total,4087,187,4274,5789,284,6073,1,0,1,11,0,11,9888,471,10359
Chhattisgarh,2007,Central Jail,4139,207,4346,2998,231,3229,0,0,0,14,0,14,7151,438,7589
Chhattisgarh,2007,District Jail,117,1,118,1551,22,1573,0,0,0,8,0,8,1676,23,1699
Chhattisgarh,2007,Sub_Jail,61,0,61,1097,0,1097,0,0,0,5,0,5,1163,0,1163
Chhattisgarh,2007,Women Jail,0,0,0,0,0,0,0,0,0,0,0,0,0,0,0
Chhattisgarh,2007,Borstal School,0,0,0,0,0,0,0,0,0,0,0,0,0,0,0
Chhattisgarh,2007,Open Jail,0,0,0,0,0,0,0,0,0,0,0,0,0,0,0
Chhattisgarh,2007,Special Jail,0,0,0,0,0,0,0,0,0,0,0,0,0,0,0
Chhattisgarh,2007,Others,0,0,0,0,0,0,0,0,0,0,0,0,0,0,0
Chhattisgarh,2007,Total,4317,208,4525,5646,253,5899,0,0,0,27,0,27,9990,461,10451
Chhattisgarh,2008,Central Jail,4364,192,4556,3261,272,3533,0,0,0,3,0,3,7628,464,8092
Chhattisgarh,2008,District Jail,149,2,151,1681,30,1711,0,0,0,1,0,1,1831,32,1863
Chhattisgarh,2008,Sub_Jail,60,0,60,1213,0,1213,0,0,0,2,0,2,1275,0,1275
Chhattisgarh,2008,Women Jail,0,0,0,0,0,0,0,0,0,0,0,0,0,0,0
Chhattisgarh,2008,Borstal School,0,0,0,0,0,0,0,0,0,0,0,0,0,0,0
Chhattisgarh,2008,Open Jail,0,0,0,0,0,0,0,0,0,0,0,0,0,0,0
Chhattisgarh,2008,Special Jail,0,0,0,0,0,0,0,0,0,0,0,0,0,0,0
Chhattisgarh,2008,Others,0,0,0,0,0,0,0,0,0,0,0,0,0,0,0
Chhattisgarh,2008,Total,4573,194,4767,6155,302,6457,0,0,0,6,0,6,10734,496,11230
Chhattisgarh,2009,Central Jail,4461,217,4678,3579,305,3884,0,0,0,13,0,13,8053,522,8575
Chhattisgarh,2009,District Jail,128,0,128,2014,54,2068,0,0,0,1,0,1,2143,54,2197
Chhattisgarh,2009,Sub_Jail,51,0,51,1317,0,1317,0,0,0,2,0,2,1370,0,1370
Chhattisgarh,2009,Women Jail,0,0,0,0,0,0,0,0,0,0,0,0,0,0,0
Chhattisgarh,2009,Borstal School,0,0,0,0,0,0,0,0,0,0,0,0,0,0,0
Chhattisgarh,2009,Open Jail,0,0,0,0,0,0,0,0,0,0,0,0,0,0,0
Chhattisgarh,2009,Special Jail,0,0,0,0,0,0,0,0,0,0,0,0,0,0,0
Chhattisgarh,2009,Others,0,0,0,0,0,0,0,0,0,0,0,0,0,0,0
Chhattisgarh,2009,Total,4640,217,4857,6910,359,7269,0,0,0,16,0,16,11566,576,12142
Chhattisgarh,2010,Central Jail,4790,207,4997,3888,331,4219,1,0,1,10,0,10,8689,538,9227
Chhattisgarh,2010,District Jail,148,2,150,2364,44,2408,0,0,0,6,0,6,2518,46,2564
Chhattisgarh,2010,Sub_Jail,49,0,49,1072,0,1072,0,0,0,3,0,3,1124,0,1124
Chhattisgarh,2010,Women Jail,0,0,0,0,0,0,0,0,0,0,0,0,0,0,0
Chhattisgarh,2010,Borstal School,0,0,0,0,0,0,0,0,0,0,0,0,0,0,0
Chhattisgarh,2010,Open Jail,0,0,0,0,0,0,0,0,0,0,0,0,0,0,0
Chhattisgarh,2010,Special Jail,0,0,0,0,0,0,0,0,0,0,0,0,0,0,0
Chhattisgarh,2010,Others,0,0,0,0,0,0,0,0,0,0,0,0,0,0,0
Chhattisgarh,2010,Total,4987,209,5196,7324,375,7699,1,0,1,19,0,19,12331,584,12915
Chhattisgarh,2011,Central Jail,5220,242,5462,4050,344,4394,0,0,0,10,0,10,9280,586,9866
Chhattisgarh,2011,District Jail,126,0,126,2695,48,2743,0,0,0,2,0,2,2823,48,2871
Chhattisgarh,2011,Sub_Jail,42,0,42,1138,0,1138,0,0,0,1,0,1,1181,0,1181
Chhattisgarh,2011,Women Jail,0,0,0,0,0,0,0,0,0,0,0,0,0,0,0
Chhattisgarh,2011,Borstal School,0,0,0,0,0,0,0,0,0,0,0,0,0,0,0
Chhattisgarh,2011,Open Jail,0,0,0,0,0,0,0,0,0,0,0,0,0,0,0
Chhattisgarh,2011,Special Jail,0,0,0,0,0,0,0,0,0,0,0,0,0,0,0
Chhattisgarh,2011,Others,0,0,0,0,0,0,0,0,0,0,0,0,0,0,0
Chhattisgarh,2011,Total,5388,242,5630,7883,392,8275,0,0,0,13,0,13,13284,634,13918
Goa,2001,Central Jail,124,4,128,30,7,37,0,0,0,0,0,0,154,11,165
Goa,2001,District Jail,0,0,0,0,0,0,0,0,0,0,0,0,0,0,0
Goa,2001,Sub_Jail,30,0,30,152,0,152,0,0,0,0,0,0,182,0,182
Goa,2001,Women Jail,0,0,0,0,0,0,0,0,0,0,0,0,0,0,0
Goa,2001,Borstal School,0,0,0,0,0,0,0,0,0,0,0,0,0,0,0
Goa,2001,Open Jail,0,0,0,0,0,0,0,0,0,0,0,0,0,0,0
Goa,2001,Special Jail,0,0,0,0,0,0,0,0,0,0,0,0,0,0,0
Goa,2001,Others,0,0,0,105,0,105,0,0,0,0,0,0,105,0,105
Goa,2001,Total,154,4,158,287,7,294,0,0,0,0,0,0,441,11,452
Goa,2002,Central Jail,136,4,140,17,5,22,0,0,0,0,0,0,153,9,162
Goa,2002,District Jail,0,0,0,0,0,0,0,0,0,0,0,0,0,0,0
Goa,2002,Sub_Jail,9,0,9,76,0,76,0,0,0,0,0,0,85,0,85
Goa,2002,Women Jail,0,0,0,0,0,0,0,0,0,0,0,0,0,0,0
Goa,2002,Borstal School,0,0,0,0,0,0,0,0,0,0,0,0,0,0,0
Goa,2002,Open Jail,0,0,0,0,0,0,0,0,0,0,0,0,0,0,0
Goa,2002,Special Jail,0,0,0,0,0,0,0,0,0,0,0,0,0,0,0
Goa,2002,Others,0,0,0,105,0,105,0,0,0,0,0,0,105,0,105
Goa,2002,Total,145,4,149,198,5,203,0,0,0,0,0,0,343,9,352
Goa,2003,Central Jail,124,3,127,28,9,37,1,0,1,0,0,0,153,12,165
Goa,2003,District Jail,0,0,0,0,0,0,0,0,0,0,0,0,0,0,0
Goa,2003,Sub_Jail,16,0,16,84,0,84,0,0,0,0,0,0,100,0,100
Goa,2003,Women Jail,0,0,0,0,0,0,0,0,0,0,0,0,0,0,0
Goa,2003,Borstal School,0,0,0,0,0,0,0,0,0,0,0,0,0,0,0
Goa,2003,Open Jail,0,0,0,0,0,0,0,0,0,0,0,0,0,0,0
Goa,2003,Special Jail,0,0,0,0,0,0,0,0,0,0,0,0,0,0,0
Goa,2003,Others,0,0,0,267,0,267,0,0,0,0,0,0,267,0,267
Goa,2003,Total,140,3,143,379,9,388,1,0,1,0,0,0,520,12,532
Goa,2004,Central Jail,130,2,132,36,9,45,0,0,0,0,0,0,166,11,177
Goa,2004,District Jail,0,0,0,0,0,0,0,0,0,0,0,0,0,0,0
Goa,2004,Sub_Jail,18,0,18,108,0,108,0,0,0,0,0,0,126,0,126
Goa,2004,Women Jail,0,0,0,0,0,0,0,0,0,0,0,0,0,0,0
Goa,2004,Borstal School,0,0,0,0,0,0,0,0,0,0,0,0,0,0,0
Goa,2004,Open Jail,0,0,0,0,0,0,0,0,0,0,0,0,0,0,0
Goa,2004,Special Jail,0,0,0,0,0,0,0,0,0,0,0,0,0,0,0
Goa,2004,Others,0,0,0,124,0,124,0,0,0,0,0,0,124,0,124
Goa,2004,Total,148,2,150,268,9,277,0,0,0,0,0,0,416,11,427
Goa,2005,Central Jail,125,3,128,0,17,17,0,0,0,0,0,0,125,20,145
Goa,2005,District Jail,0,0,0,0,0,0,0,0,0,0,0,0,0,0,0
Goa,2005,Sub_Jail,10,0,10,97,0,97,0,0,0,0,0,0,107,0,107
Goa,2005,Women Jail,0,0,0,0,0,0,0,0,0,0,0,0,0,0,0
Goa,2005,Borstal School,0,0,0,0,0,0,0,0,0,0,0,0,0,0,0
Goa,2005,Open Jail,0,0,0,0,0,0,0,0,0,0,0,0,0,0,0
Goa,2005,Special Jail,0,0,0,0,0,0,0,0,0,0,0,0,0,0,0
Goa,2005,Others,0,0,0,132,0,132,0,0,0,0,0,0,132,0,132
Goa,2005,Total,135,3,138,229,17,246,0,0,0,0,0,0,364,20,384
Goa,2006,Central Jail,122,2,124,0,18,18,0,0,0,0,0,0,122,20,142
Goa,2006,District Jail,0,0,0,0,0,0,0,0,0,0,0,0,0,0,0
Goa,2006,Sub_Jail,20,0,20,101,0,101,0,0,0,0,0,0,121,0,121
Goa,2006,Women Jail,0,0,0,0,0,0,0,0,0,0,0,0,0,0,0
Goa,2006,Borstal School,0,0,0,0,0,0,0,0,0,0,0,0,0,0,0
Goa,2006,Open Jail,0,0,0,0,0,0,0,0,0,0,0,0,0,0,0
Goa,2006,Special Jail,0,0,0,0,0,0,0,0,0,0,0,0,0,0,0
Goa,2006,Others,0,0,0,117,0,117,0,0,0,0,0,0,117,0,117
Goa,2006,Total,142,2,144,218,18,236,0,0,0,0,0,0,360,20,380
Goa,2007,Central Jail,122,2,124,0,18,18,0,0,0,0,0,0,122,20,142
Goa,2007,District Jail,0,0,0,0,0,0,0,0,0,0,0,0,0,0,0
Goa,2007,Sub_Jail,23,0,23,76,0,76,0,0,0,0,0,0,99,0,99
Goa,2007,Women Jail,0,0,0,0,0,0,0,0,0,0,0,0,0,0,0
Goa,2007,Borstal School,0,0,0,0,0,0,0,0,0,0,0,0,0,0,0
Goa,2007,Open Jail,0,0,0,0,0,0,0,0,0,0,0,0,0,0,0
Goa,2007,Special Jail,0,0,0,0,0,0,0,0,0,0,0,0,0,0,0
Goa,2007,Others,0,0,0,125,0,125,0,0,0,0,0,0,125,0,125
Goa,2007,Total,145,2,147,201,18,219,0,0,0,0,0,0,346,20,366
Goa,2008,Central Jail,118,9,127,0,16,16,0,0,0,0,0,0,118,25,143
Goa,2008,District Jail,0,0,0,0,0,0,0,0,0,0,0,0,0,0,0
Goa,2008,Sub_Jail,23,0,23,112,0,112,0,0,0,0,0,0,135,0,135
Goa,2008,Women Jail,0,0,0,0,0,0,0,0,0,0,0,0,0,0,0
Goa,2008,Borstal School,0,0,0,0,0,0,0,0,0,0,0,0,0,0,0
Goa,2008,Open Jail,0,0,0,0,0,0,0,0,0,0,0,0,0,0,0
Goa,2008,Special Jail,0,0,0,0,0,0,0,0,0,0,0,0,0,0,0
Goa,2008,Others,0,0,0,125,0,125,0,0,0,0,0,0,125,0,125
Goa,2008,Total,141,9,150,237,16,253,0,0,0,0,0,0,378,25,403
Goa,2009,Central Jail,125,7,132,0,24,24,0,0,0,0,0,0,125,31,156
Goa,2009,District Jail,0,0,0,0,0,0,0,0,0,0,0,0,0,0,0
Goa,2009,Sub_Jail,56,0,56,98,0,98,0,0,0,0,0,0,154,0,154
Goa,2009,Women Jail,0,0,0,0,0,0,0,0,0,0,0,0,0,0,0
Goa,2009,Borstal School,0,0,0,0,0,0,0,0,0,0,0,0,0,0,0
Goa,2009,Open Jail,0,0,0,0,0,0,0,0,0,0,0,0,0,0,0
Goa,2009,Special Jail,0,0,0,0,0,0,0,0,0,0,0,0,0,0,0
Goa,2009,Others,0,0,0,122,0,122,0,0,0,0,0,0,122,0,122
Goa,2009,Total,181,7,188,220,24,244,0,0,0,0,0,0,401,31,432
Goa,2010,Central Jail,136,8,144,0,27,27,0,0,0,0,0,0,136,35,171
Goa,2010,District Jail,0,0,0,0,0,0,0,0,0,0,0,0,0,0,0
Goa,2010,Sub_Jail,33,0,33,187,0,187,0,0,0,0,0,0,220,0,220
Goa,2010,Women Jail,0,0,0,0,0,0,0,0,0,0,0,0,0,0,0
Goa,2010,Borstal School,0,0,0,0,0,0,0,0,0,0,0,0,0,0,0
Goa,2010,Open Jail,0,0,0,0,0,0,0,0,0,0,0,0,0,0,0
Goa,2010,Special Jail,0,0,0,0,0,0,0,0,0,0,0,0,0,0,0
Goa,2010,Others,0,0,0,65,0,65,0,0,0,0,0,0,65,0,65
Goa,2010,Total,169,8,177,252,27,279,0,0,0,0,0,0,421,35,456
Goa,2011,Central Jail,118,0,118,3,0,3,0,0,0,0,0,0,121,0,121
Goa,2011,District Jail,0,0,0,0,0,0,0,0,0,0,0,0,0,0,0
Goa,2011,Sub_Jail,20,6,26,254,28,282,0,0,0,0,0,0,274,34,308
Goa,2011,Women Jail,0,0,0,0,0,0,0,0,0,0,0,0,0,0,0
Goa,2011,Borstal School,0,0,0,0,0,0,0,0,0,0,0,0,0,0,0
Goa,2011,Open Jail,0,0,0,0,0,0,0,0,0,0,0,0,0,0,0
Goa,2011,Special Jail,0,0,0,0,0,0,0,0,0,0,0,0,0,0,0
Goa,2011,Others,0,0,0,60,0,60,0,0,0,0,0,0,60,0,60
Goa,2011,Total,138,6,144,317,28,345,0,0,0,0,0,0,455,34,489
Goa,2012,Central Jail,112,0,112,3,0,3,0,0,0,0,0,0,115,0,115
Goa,2012,District Jail,0,0,0,0,0,0,0,0,0,0,0,0,0,0,0
Goa,2012,Sub_Jail,20,4,24,247,24,271,0,0,0,0,0,0,267,28,295
Goa,2012,Women Jail,0,0,0,0,0,0,0,0,0,0,0,0,0,0,0
Goa,2012,Borstal School,0,0,0,0,0,0,0,0,0,0,0,0,0,0,0
Goa,2012,Open Jail,0,0,0,0,0,0,0,0,0,0,0,0,0,0,0
Goa,2012,Special Jail,0,0,0,0,0,0,0,0,0,0,0,0,0,0,0
Goa,2012,Others,0,0,0,62,0,62,0,0,0,0,0,0,62,0,62
Goa,2012,Total,132,4,136,312,24,336,0,0,0,0,0,0,444,28,472
Gujarat,2001,Central Jail,2313,58,2371,1355,32,1387,107,30,137,0,0,0,3775,120,3895
Gujarat,2001,District Jail,385,0,385,2350,66,2416,213,0,213,0,0,0,2948,66,3014
Gujarat,2001,Sub_Jail,68,0,68,1641,40,1681,20,0,20,0,0,0,1729,40,1769
Gujarat,2001,Women Jail,0,0,0,0,0,0,0,0,0,0,0,0,0,0,0
Gujarat,2001,Borstal School,0,0,0,0,0,0,0,0,0,0,0,0,0,0,0
Gujarat,2001,Open Jail,82,0,82,0,0,0,0,0,0,0,0,0,82,0,82
Gujarat,2001,Special Jail,10,0,10,72,1,73,80,0,80,0,0,0,162,1,163
Gujarat,2001,Others,0,0,0,0,0,0,0,0,0,0,0,0,0,0,0
Gujarat,2001,Total,2858,58,2916,5418,139,5557,420,30,450,0,0,0,8696,227,8923
Gujarat,2002,Central Jail,2585,92,2677,1589,46,1635,61,45,106,0,0,0,4235,183,4418
Gujarat,2002,District Jail,413,0,413,2653,84,2737,374,0,374,0,0,0,3440,84,3524
Gujarat,2002,Sub_Jail,100,0,100,1876,56,1932,18,0,18,0,0,0,1994,56,2050
Gujarat,2002,Women Jail,0,0,0,0,0,0,0,0,0,0,0,0,0,0,0
Gujarat,2002,Borstal School,0,0,0,0,0,0,0,0,0,0,0,0,0,0,0
Gujarat,2002,Open Jail,86,0,86,0,0,0,0,0,0,0,0,0,86,0,86
Gujarat,2002,Special Jail,10,0,10,64,1,65,94,0,94,0,0,0,168,1,169
Gujarat,2002,Others,0,0,0,0,0,0,0,0,0,0,0,0,0,0,0
Gujarat,2002,Total,3194,92,3286,6182,187,6369,547,45,592,0,0,0,9923,324,10247
Gujarat,2003,Central Jail,2720,109,2829,1801,76,1877,66,52,118,0,0,0,4587,237,4824
Gujarat,2003,District Jail,399,7,406,2526,103,2629,202,0,202,0,0,0,3127,110,3237
Gujarat,2003,Sub_Jail,115,1,116,1729,53,1782,18,0,18,0,0,0,1862,54,1916
Gujarat,2003,Women Jail,0,0,0,0,0,0,0,0,0,0,0,0,0,0,0
Gujarat,2003,Borstal School,0,0,0,0,0,0,0,0,0,0,0,0,0,0,0
Gujarat,2003,Open Jail,66,0,66,0,0,0,0,0,0,0,0,0,66,0,66
Gujarat,2003,Special Jail,11,0,11,131,2,133,39,0,39,0,0,0,181,2,183
Gujarat,2003,Others,0,0,0,0,0,0,0,0,0,0,0,0,0,0,0
Gujarat,2003,Total,3311,117,3428,6187,234,6421,325,52,377,0,0,0,9823,403,10226
Gujarat,2004,Central Jail,3083,133,3216,2151,72,2223,70,56,126,0,0,0,5304,261,5565
Gujarat,2004,District Jail,415,8,423,2821,124,2945,263,0,263,0,0,0,3499,132,3631
Gujarat,2004,Sub_Jail,136,1,137,1771,93,1864,23,0,23,0,0,0,1930,94,2024
Gujarat,2004,Women Jail,0,0,0,0,0,0,0,0,0,0,0,0,0,0,0
Gujarat,2004,Borstal School,0,0,0,0,0,0,0,0,0,0,0,0,0,0,0
Gujarat,2004,Open Jail,93,0,93,0,0,0,0,0,0,0,0,0,93,0,93
Gujarat,2004,Special Jail,12,0,12,162,8,170,75,0,75,0,0,0,249,8,257
Gujarat,2004,Others,0,0,0,0,0,0,0,0,0,0,0,0,0,0,0
Gujarat,2004,Total,3739,142,3881,6905,297,7202,431,56,487,0,0,0,11075,495,11570
Gujarat,2005,Central Jail,3574,138,3712,2097,65,2162,70,16,86,0,0,0,5741,219,5960
Gujarat,2005,District Jail,519,7,526,2450,107,2557,171,1,172,0,0,0,3140,115,3255
Gujarat,2005,Sub_Jail,118,2,120,1494,60,1554,29,0,29,0,0,0,1641,62,1703
Gujarat,2005,Women Jail,0,0,0,0,0,0,0,0,0,0,0,0,0,0,0
Gujarat,2005,Borstal School,0,0,0,0,0,0,0,0,0,0,0,0,0,0,0
Gujarat,2005,Open Jail,77,0,77,0,0,0,0,0,0,0,0,0,77,0,77
Gujarat,2005,Special Jail,10,0,10,164,14,178,33,0,33,0,0,0,207,14,221
Gujarat,2005,Others,0,0,0,0,0,0,0,0,0,0,0,0,0,0,0
Gujarat,2005,Total,4298,147,4445,6205,246,6451,303,17,320,0,0,0,10806,410,11216
Gujarat,2006,Central Jail,4027,155,4182,2007,67,2074,36,48,84,0,0,0,6070,270,6340
Gujarat,2006,District Jail,613,5,618,2451,131,2582,216,1,217,0,0,0,3280,137,3417
Gujarat,2006,Sub_Jail,143,0,143,1501,81,1582,40,0,40,0,0,0,1684,81,1765
Gujarat,2006,Women Jail,0,0,0,0,0,0,0,0,0,0,0,0,0,0,0
Gujarat,2006,Borstal School,0,0,0,0,0,0,0,0,0,0,0,0,0,0,0
Gujarat,2006,Open Jail,75,0,75,0,0,0,0,0,0,0,0,0,75,0,75
Gujarat,2006,Special Jail,10,0,10,139,10,149,37,0,37,0,0,0,186,10,196
Gujarat,2006,Others,0,0,0,0,0,0,0,0,0,0,0,0,0,0,0
Gujarat,2006,Total,4868,160,5028,6098,289,6387,329,49,378,0,0,0,11295,498,11793
Gujarat,2007,Central Jail,4097,165,4262,1687,74,1761,38,107,145,0,0,0,5822,346,6168
Gujarat,2007,District Jail,582,19,601,2561,162,2723,410,51,461,0,0,0,3553,232,3785
Gujarat,2007,Sub_Jail,106,8,114,1187,49,1236,201,17,218,0,0,0,1494,74,1568
Gujarat,2007,Women Jail,0,0,0,0,0,0,0,0,0,0,0,0,0,0,0
Gujarat,2007,Borstal School,0,0,0,0,0,0,0,0,0,0,0,0,0,0,0
Gujarat,2007,Open Jail,68,0,68,0,0,0,0,0,0,0,0,0,68,0,68
Gujarat,2007,Special Jail,23,1,24,154,12,166,63,0,63,0,0,0,240,13,253
Gujarat,2007,Others,0,0,0,0,0,0,0,0,0,0,0,0,0,0,0
Gujarat,2007,Total,4876,193,5069,5589,297,5886,712,175,887,0,0,0,11177,665,11842
Gujarat,2008,Central Jail,3985,189,4174,1882,83,1965,6,36,42,0,0,0,5873,308,6181
Gujarat,2008,District Jail,557,13,570,3087,136,3223,195,9,204,0,0,0,3839,158,3997
Gujarat,2008,Sub_Jail,96,5,101,1536,68,1604,105,1,106,0,0,0,1737,74,1811
Gujarat,2008,Women Jail,0,0,0,0,0,0,0,0,0,0,0,0,0,0,0
Gujarat,2008,Borstal School,0,0,0,0,0,0,0,0,0,0,0,0,0,0,0
Gujarat,2008,Open Jail,62,0,62,0,0,0,0,0,0,0,0,0,62,0,62
Gujarat,2008,Special Jail,19,1,20,175,4,179,29,0,29,0,0,0,223,5,228
Gujarat,2008,Others,0,0,0,0,0,0,0,0,0,0,0,0,0,0,0
Gujarat,2008,Total,4719,208,4927,6680,291,6971,335,46,381,0,0,0,11734,545,12279
Gujarat,2009,Central Jail,3402,169,3571,2044,109,2153,7,38,45,0,0,0,5453,316,5769
Gujarat,2009,District Jail,590,11,601,3031,149,3180,129,16,145,0,0,0,3750,176,3926
Gujarat,2009,Sub_Jail,92,4,96,1414,64,1478,121,5,126,0,0,0,1627,73,1700
Gujarat,2009,Women Jail,0,0,0,0,0,0,0,0,0,0,0,0,0,0,0
Gujarat,2009,Borstal School,0,0,0,0,0,0,0,0,0,0,0,0,0,0,0
Gujarat,2009,Open Jail,69,0,69,0,0,0,0,0,0,0,0,0,69,0,69
Gujarat,2009,Special Jail,43,0,43,376,19,395,40,0,40,0,0,0,459,19,478
Gujarat,2009,Others,0,0,0,0,0,0,0,0,0,0,0,0,0,0,0
Gujarat,2009,Total,4196,184,4380,6865,341,7206,297,59,356,0,0,0,11358,584,11942
Gujarat,2010,Central Jail,3365,186,3551,2101,91,2192,12,27,39,0,0,0,5478,304,5782
Gujarat,2010,District Jail,626,5,631,2663,157,2820,96,7,103,0,0,0,3385,169,3554
Gujarat,2010,Sub_Jail,73,0,73,1384,72,1456,61,0,61,0,0,0,1518,72,1590
Gujarat,2010,Women Jail,0,0,0,0,0,0,0,0,0,0,0,0,0,0,0
Gujarat,2010,Borstal School,0,0,0,0,0,0,0,0,0,0,0,0,0,0,0
Gujarat,2010,Open Jail,74,0,74,0,0,0,0,0,0,0,0,0,74,0,74
Gujarat,2010,Special Jail,45,0,45,411,31,442,41,0,41,0,0,0,497,31,528
Gujarat,2010,Others,0,0,0,0,0,0,0,0,0,0,0,0,0,0,0
Gujarat,2010,Total,4183,191,4374,6559,351,6910,210,34,244,0,0,0,10952,576,11528
Gujarat,2011,Central Jail,3436,173,3609,1874,60,1934,26,11,37,0,0,0,5336,244,5580
Gujarat,2011,District Jail,681,3,684,2765,148,2913,169,28,197,0,0,0,3615,179,3794
Gujarat,2011,Sub_Jail,94,0,94,1266,94,1360,102,4,106,0,0,0,1462,98,1560
Gujarat,2011,Women Jail,0,0,0,0,0,0,0,0,0,0,0,0,0,0,0
Gujarat,2011,Borstal School,0,0,0,0,0,0,0,0,0,0,0,0,0,0,0
Gujarat,2011,Open Jail,74,0,74,0,0,0,0,0,0,0,0,0,74,0,74
Gujarat,2011,Special Jail,43,0,43,463,26,489,58,3,61,0,0,0,564,29,593
Gujarat,2011,Others,0,0,0,0,0,0,0,0,0,0,0,0,0,0,0
Gujarat,2011,Total,4328,176,4504,6368,328,6696,355,46,401,0,0,0,11051,550,11601
Gujarat,2012,Central Jail,3775,94,3869,3046,118,3164,284,23,307,0,0,0,7105,235,7340
Gujarat,2012,District Jail,254,6,260,1737,85,1822,105,14,119,0,0,0,2096,105,2201
Gujarat,2012,Sub_Jail,112,0,112,1087,83,1170,25,0,25,0,0,0,1224,83,1307
Gujarat,2012,Women Jail,0,84,84,0,14,14,0,11,11,0,0,0,0,109,109
Gujarat,2012,Borstal School,0,0,0,0,0,0,0,0,0,0,0,0,0,0,0
Gujarat,2012,Open Jail,72,0,72,0,0,0,0,0,0,0,0,0,72,0,72
Gujarat,2012,Special Jail,56,0,56,416,27,443,54,3,57,0,0,0,526,30,556
Gujarat,2012,Others,0,0,0,0,0,0,0,0,0,0,0,0,0,0,0
Gujarat,2012,Total,4269,184,4453,6286,327,6613,468,51,519,0,0,0,11023,562,11585
Haryana,2001,Central Jail,1221,8,1229,2407,59,2466,0,0,0,22,0,22,3650,67,3717
Haryana,2001,District Jail,1731,3,1734,4963,185,5148,0,0,0,21,0,21,6715,188,6903
Haryana,2001,Sub_Jail,7,0,7,426,0,426,0,0,0,1,0,1,434,0,434
Haryana,2001,Women Jail,0,0,0,0,0,0,0,0,0,0,0,0,0,0,0
Haryana,2001,Borstal School,25,97,122,93,79,172,0,0,0,0,0,0,118,176,294
Haryana,2001,Open Jail,0,0,0,0,0,0,0,0,0,0,0,0,0,0,0
Haryana,2001,Special Jail,0,0,0,0,0,0,0,0,0,0,0,0,0,0,0
Haryana,2001,Others,0,0,0,0,0,0,0,0,0,0,0,0,0,0,0
Haryana,2001,Total,2984,108,3092,7889,323,8212,0,0,0,44,0,44,10917,431,11348
Haryana,2002,Central Jail,1382,17,1399,2200,82,2282,0,0,0,7,0,7,3589,99,3688
Haryana,2002,District Jail,2093,5,2098,4688,173,4861,0,0,0,0,0,0,6781,178,6959
Haryana,2002,Sub_Jail,5,0,5,435,0,435,0,0,0,1,0,1,441,0,441
Haryana,2002,Women Jail,0,0,0,0,0,0,0,0,0,0,0,0,0,0,0
Haryana,2002,Borstal School,23,108,131,73,66,139,0,0,0,0,0,0,96,174,270
Haryana,2002,Open Jail,0,0,0,0,0,0,0,0,0,0,0,0,0,0,0
Haryana,2002,Special Jail,0,0,0,0,0,0,0,0,0,0,0,0,0,0,0
Haryana,2002,Others,0,0,0,0,0,0,0,0,0,0,0,0,0,0,0
Haryana,2002,Total,3503,130,3633,7396,321,7717,0,0,0,8,0,8,10907,451,11358
Haryana,2003,Central Jail,1564,32,1596,1979,88,2067,0,0,0,76,0,76,3619,120,3739
Haryana,2003,District Jail,2696,32,2728,4837,190,5027,0,0,0,63,0,63,7596,222,7818
Haryana,2003,Sub_Jail,0,0,0,294,0,294,0,0,0,13,0,13,307,0,307
Haryana,2003,Women Jail,0,0,0,0,0,0,0,0,0,0,0,0,0,0,0
Haryana,2003,Borstal School,16,103,119,57,59,116,0,0,0,0,0,0,73,162,235
Haryana,2003,Open Jail,0,0,0,0,0,0,0,0,0,0,0,0,0,0,0
Haryana,2003,Special Jail,0,0,0,0,0,0,0,0,0,0,0,0,0,0,0
Haryana,2003,Others,0,0,0,0,0,0,0,0,0,0,0,0,0,0,0
Haryana,2003,Total,4276,167,4443,7167,337,7504,0,0,0,152,0,152,11595,504,12099
Haryana,2004,Central Jail,1540,29,1569,1947,67,2014,0,0,0,3,0,3,3490,96,3586
Haryana,2004,District Jail,2858,65,2923,4776,193,4969,0,0,0,10,0,10,7644,258,7902
Haryana,2004,Sub_Jail,0,0,0,316,0,316,0,0,0,0,0,0,316,0,316
Haryana,2004,Women Jail,0,0,0,0,0,0,0,0,0,0,0,0,0,0,0
Haryana,2004,Borstal School,13,96,109,51,46,97,0,0,0,0,0,0,64,142,206
Haryana,2004,Open Jail,0,0,0,0,0,0,0,0,0,0,0,0,0,0,0
Haryana,2004,Special Jail,0,0,0,0,0,0,0,0,0,0,0,0,0,0,0
Haryana,2004,Others,0,0,0,0,0,0,0,0,0,0,0,0,0,0,0
Haryana,2004,Total,4411,190,4601,7090,306,7396,0,0,0,13,0,13,11514,496,12010
Haryana,2005,Central Jail,1249,24,1273,1484,43,1527,0,0,0,17,1,18,2750,68,2818
Haryana,2005,District Jail,3346,104,3450,5546,207,5753,0,0,0,16,0,16,8908,311,9219
Haryana,2005,Sub_Jail,0,0,0,300,0,300,0,0,0,3,0,3,303,0,303
Haryana,2005,Women Jail,0,0,0,0,0,0,0,0,0,0,0,0,0,0,0
Haryana,2005,Borstal School,10,60,70,61,76,137,0,0,0,0,0,0,71,136,207
Haryana,2005,Open Jail,0,0,0,0,0,0,0,0,0,0,0,0,0,0,0
Haryana,2005,Special Jail,0,0,0,0,0,0,0,0,0,0,0,0,0,0,0
Haryana,2005,Others,0,0,0,0,0,0,0,0,0,0,0,0,0,0,0
Haryana,2005,Total,4605,188,4793,7391,326,7717,0,0,0,36,1,37,12032,515,12547
Haryana,2006,Central Jail,1166,28,1194,1411,34,1445,0,0,0,3,0,3,2580,62,2642
Haryana,2006,District Jail,3616,104,3720,5618,231,5849,0,0,0,8,0,8,9242,335,9577
Haryana,2006,Sub_Jail,0,0,0,253,0,253,0,0,0,2,0,2,255,0,255
Haryana,2006,Women Jail,0,0,0,0,0,0,0,0,0,0,0,0,0,0,0
Haryana,2006,Borstal School,6,68,74,71,68,139,0,0,0,0,0,0,77,136,213
Haryana,2006,Open Jail,0,0,0,0,0,0,0,0,0,0,0,0,0,0,0
Haryana,2006,Special Jail,0,0,0,0,0,0,0,0,0,0,0,0,0,0,0
Haryana,2006,Others,0,0,0,0,0,0,0,0,0,0,0,0,0,0,0
Haryana,2006,Total,4788,200,4988,7353,333,7686,0,0,0,13,0,13,12154,533,12687
Haryana,2007,Central Jail,1134,25,1159,1507,28,1535,0,0,0,0,0,0,2641,53,2694
Haryana,2007,District Jail,3632,108,3740,5978,281,6259,0,0,0,0,0,0,9610,389,9999
Haryana,2007,Sub_Jail,0,0,0,224,0,224,0,0,0,0,0,0,224,0,224
Haryana,2007,Women Jail,0,0,0,0,0,0,0,0,0,0,0,0,0,0,0
Haryana,2007,Borstal School,9,68,77,48,51,99,0,0,0,0,0,0,57,119,176
Haryana,2007,Open Jail,0,0,0,0,0,0,0,0,0,0,0,0,0,0,0
Haryana,2007,Special Jail,0,0,0,0,0,0,0,0,0,0,0,0,0,0,0
Haryana,2007,Others,0,0,0,0,0,0,0,0,0,0,0,0,0,0,0
Haryana,2007,Total,4775,201,4976,7757,360,8117,0,0,0,0,0,0,12532,561,13093
Haryana,2008,Central Jail,1327,34,1361,1503,58,1561,0,0,0,0,0,0,2830,92,2922
Haryana,2008,District Jail,3792,140,3932,6448,275,6723,0,0,0,0,0,0,10240,415,10655
Haryana,2008,Sub_Jail,0,0,0,251,0,251,0,0,0,0,0,0,251,0,251
Haryana,2008,Women Jail,0,0,0,0,0,0,0,0,0,0,0,0,0,0,0
Haryana,2008,Borstal School,13,81,94,58,69,127,0,0,0,0,0,0,71,150,221
Haryana,2008,Open Jail,0,0,0,0,0,0,0,0,0,0,0,0,0,0,0
Haryana,2008,Special Jail,0,0,0,0,0,0,0,0,0,0,0,0,0,0,0
Haryana,2008,Others,0,0,0,0,0,0,0,0,0,0,0,0,0,0,0
Haryana,2008,Total,5132,255,5387,8260,402,8662,0,0,0,0,0,0,13392,657,14049
Haryana,2009,Central Jail,1198,7,1205,1350,34,1384,0,0,0,0,0,0,2548,41,2589
Haryana,2009,District Jail,4318,143,4461,6162,258,6420,0,0,0,0,0,0,10480,401,10881
Haryana,2009,Sub_Jail,0,0,0,111,0,111,0,0,0,4,0,4,115,0,115
Haryana,2009,Women Jail,0,0,0,0,0,0,0,0,0,0,0,0,0,0,0
Haryana,2009,Borstal School,12,114,126,64,62,126,0,0,0,0,0,0,76,176,252
Haryana,2009,Open Jail,0,0,0,0,0,0,0,0,0,0,0,0,0,0,0
Haryana,2009,Special Jail,0,0,0,0,0,0,0,0,0,0,0,0,0,0,0
Haryana,2009,Others,0,0,0,0,0,0,0,0,0,0,0,0,0,0,0
Haryana,2009,Total,5528,264,5792,7687,354,8041,0,0,0,4,0,4,13219,618,13837
Haryana,2010,Central Jail,1224,21,1245,1417,34,1451,0,0,0,0,0,0,2641,55,2696
Haryana,2010,District Jail,4733,138,4871,6183,230,6413,0,0,0,0,0,0,10916,368,11284
Haryana,2010,Sub_Jail,0,0,0,0,0,0,0,0,0,0,0,0,0,0,0
Haryana,2010,Women Jail,0,0,0,0,0,0,0,0,0,0,0,0,0,0,0
Haryana,2010,Borstal School,9,86,95,58,86,144,0,0,0,0,0,0,67,172,239
Haryana,2010,Open Jail,0,0,0,0,0,0,0,0,0,0,0,0,0,0,0
Haryana,2010,Special Jail,0,0,0,0,0,0,0,0,0,0,0,0,0,0,0
Haryana,2010,Others,0,0,0,0,0,0,0,0,0,0,0,0,0,0,0
Haryana,2010,Total,5966,245,6211,7658,350,8008,0,0,0,0,0,0,13624,595,14219
Haryana,2011,Central Jail,1098,23,1121,1456,34,1490,0,0,0,0,0,0,2554,57,2611
Haryana,2011,District Jail,5142,180,5322,6592,272,6864,0,0,0,1,0,1,11735,452,12187
Haryana,2011,Sub_Jail,0,0,0,0,0,0,0,0,0,0,0,0,0,0,0
Haryana,2011,Women Jail,0,0,0,0,0,0,0,0,0,0,0,0,0,0,0
Haryana,2011,Borstal School,4,82,86,70,79,149,0,0,0,0,0,0,74,161,235
Haryana,2011,Open Jail,0,0,0,0,0,0,0,0,0,0,0,0,0,0,0
Haryana,2011,Special Jail,0,0,0,0,0,0,0,0,0,0,0,0,0,0,0
Haryana,2011,Others,0,0,0,0,0,0,0,0,0,0,0,0,0,0,0
Haryana,2011,Total,6244,285,6529,8118,385,8503,0,0,0,1,0,1,14363,670,15033
Haryana,2012,Central Jail,1193,22,1215,1686,71,1757,0,0,0,0,0,0,2879,93,2972
Haryana,2012,District Jail,5209,180,5389,7999,287,8286,0,0,0,0,0,0,13208,467,13675
Haryana,2012,Sub_Jail,0,0,0,0,0,0,0,0,0,0,0,0,0,0,0
Haryana,2012,Women Jail,0,0,0,0,0,0,0,0,0,0,0,0,0,0,0
Haryana,2012,Borstal School,9,88,97,106,102,208,0,0,0,0,0,0,115,190,305
Haryana,2012,Open Jail,0,0,0,0,0,0,0,0,0,0,0,0,0,0,0
Haryana,2012,Special Jail,0,0,0,0,0,0,0,0,0,0,0,0,0,0,0
Haryana,2012,Others,0,0,0,0,0,0,0,0,0,0,0,0,0,0,0
Haryana,2012,Total,6411,290,6701,9791,460,10251,0,0,0,0,0,0,16202,750,16952
Himachal Pradesh,2001,Central Jail,283,11,294,104,2,106,0,0,0,0,0,0,387,13,400
Himachal Pradesh,2001,District Jail,29,0,29,127,5,132,0,0,0,0,0,0,156,5,161
Himachal Pradesh,2001,Sub_Jail,24,0,24,266,8,274,0,0,0,0,0,0,290,8,298
Himachal Pradesh,2001,Women Jail,0,0,0,0,0,0,0,0,0,0,0,0,0,0,0
Himachal Pradesh,2001,Borstal School,7,0,7,0,0,0,0,0,0,0,0,0,7,0,7
Himachal Pradesh,2001,Open Jail,41,0,41,0,0,0,0,0,0,0,0,0,41,0,41
Himachal Pradesh,2001,Special Jail,0,0,0,0,0,0,0,0,0,0,0,0,0,0,0
Himachal Pradesh,2001,Others,0,0,0,0,0,0,0,0,0,0,0,0,0,0,0
Himachal Pradesh,2001,Total,384,11,395,497,15,512,0,0,0,0,0,0,881,26,907
Himachal Pradesh,2002,Central Jail,333,6,339,66,2,68,0,0,0,0,0,0,399,8,407
Himachal Pradesh,2002,District Jail,22,1,23,126,1,127,0,0,0,0,0,0,148,2,150
Himachal Pradesh,2002,Sub_Jail,11,0,11,266,17,283,0,0,0,0,0,0,277,17,294
Himachal Pradesh,2002,Women Jail,0,0,0,0,0,0,0,0,0,0,0,0,0,0,0
Himachal Pradesh,2002,Borstal School,13,0,13,0,0,0,0,0,0,0,0,0,13,0,13
Himachal Pradesh,2002,Open Jail,33,0,33,0,0,0,0,0,0,0,0,0,33,0,33
Himachal Pradesh,2002,Special Jail,0,0,0,0,0,0,0,0,0,0,0,0,0,0,0
Himachal Pradesh,2002,Others,0,0,0,0,0,0,0,0,0,0,0,0,0,0,0
Himachal Pradesh,2002,Total,412,7,419,458,20,478,0,0,0,0,0,0,870,27,897
Himachal Pradesh,2003,Central Jail,380,10,390,69,0,69,0,0,0,0,0,0,449,10,459
Himachal Pradesh,2003,District Jail,36,1,37,159,5,164,0,0,0,0,0,0,195,6,201
Himachal Pradesh,2003,Sub_Jail,14,1,15,255,14,269,0,0,0,0,0,0,269,15,284
Himachal Pradesh,2003,Women Jail,0,0,0,0,0,0,0,0,0,0,0,0,0,0,0
Himachal Pradesh,2003,Borstal School,4,0,4,0,0,0,0,0,0,0,0,0,4,0,4
Himachal Pradesh,2003,Open Jail,30,0,30,0,0,0,0,0,0,0,0,0,30,0,30
Himachal Pradesh,2003,Special Jail,0,0,0,0,0,0,0,0,0,0,0,0,0,0,0
Himachal Pradesh,2003,Others,0,0,0,0,0,0,0,0,0,0,0,0,0,0,0
Himachal Pradesh,2003,Total,464,12,476,483,19,502,0,0,0,0,0,0,947,31,978
Himachal Pradesh,2004,Central Jail,426,16,442,111,1,112,0,0,0,0,0,0,537,17,554
Himachal Pradesh,2004,District Jail,65,1,66,125,5,130,0,0,0,0,0,0,190,6,196
Himachal Pradesh,2004,Sub_Jail,8,0,8,232,13,245,0,0,0,0,0,0,240,13,253
Himachal Pradesh,2004,Women Jail,0,0,0,0,0,0,0,0,0,0,0,0,0,0,0
Himachal Pradesh,2004,Borstal School,5,0,5,0,0,0,0,0,0,0,0,0,5,0,5
Himachal Pradesh,2004,Open Jail,36,0,36,0,0,0,0,0,0,0,0,0,36,0,36
Himachal Pradesh,2004,Special Jail,0,0,0,0,0,0,0,0,0,0,0,0,0,0,0
Himachal Pradesh,2004,Others,0,0,0,0,0,0,0,0,0,0,0,0,0,0,0
Himachal Pradesh,2004,Total,540,17,557,468,19,487,0,0,0,0,0,0,1008,36,1044
Himachal Pradesh,2005,Central Jail,450,14,464,126,1,127,0,0,0,0,0,0,576,15,591
Himachal Pradesh,2005,District Jail,89,2,91,125,9,134,0,0,0,0,0,0,214,11,225
Himachal Pradesh,2005,Sub_Jail,21,2,23,269,6,275,0,0,0,0,0,0,290,8,298
Himachal Pradesh,2005,Women Jail,0,0,0,0,0,0,0,0,0,0,0,0,0,0,0
Himachal Pradesh,2005,Borstal School,20,0,20,0,0,0,0,0,0,0,0,0,20,0,20
Himachal Pradesh,2005,Open Jail,34,0,34,0,0,0,0,0,0,0,0,0,34,0,34
Himachal Pradesh,2005,Special Jail,0,0,0,0,0,0,0,0,0,0,0,0,0,0,0
Himachal Pradesh,2005,Others,0,0,0,0,0,0,0,0,0,0,0,0,0,0,0
Himachal Pradesh,2005,Total,614,18,632,520,16,536,0,0,0,0,0,0,1134,34,1168
Himachal Pradesh,2006,Central Jail,543,17,560,161,2,163,0,0,0,0,0,0,704,19,723
Himachal Pradesh,2006,District Jail,122,6,128,135,8,143,0,0,0,0,0,0,257,14,271
Himachal Pradesh,2006,Sub_Jail,20,1,21,255,11,266,0,0,0,0,0,0,275,12,287
Himachal Pradesh,2006,Women Jail,0,0,0,0,0,0,0,0,0,0,0,0,0,0,0
Himachal Pradesh,2006,Borstal School,17,0,17,0,0,0,0,0,0,0,0,0,17,0,17
Himachal Pradesh,2006,Open Jail,38,0,38,0,0,0,0,0,0,0,0,0,38,0,38
Himachal Pradesh,2006,Special Jail,0,0,0,0,0,0,0,0,0,0,0,0,0,0,0
Himachal Pradesh,2006,Others,0,0,0,0,0,0,0,0,0,0,0,0,0,0,0
Himachal Pradesh,2006,Total,740,24,764,551,21,572,0,0,0,0,0,0,1291,45,1336
Himachal Pradesh,2007,Central Jail,608,26,634,142,5,147,0,0,0,0,0,0,750,31,781
Himachal Pradesh,2007,District Jail,150,8,158,129,8,137,0,0,0,0,0,0,279,16,295
Himachal Pradesh,2007,Sub_Jail,18,3,21,265,11,276,0,0,0,0,0,0,283,14,297
Himachal Pradesh,2007,Women Jail,0,0,0,0,0,0,0,0,0,0,0,0,0,0,0
Himachal Pradesh,2007,Borstal School,13,0,13,0,0,0,0,0,0,0,0,0,13,0,13
Himachal Pradesh,2007,Open Jail,49,0,49,0,0,0,0,0,0,0,0,0,49,0,49
Himachal Pradesh,2007,Special Jail,0,0,0,0,0,0,0,0,0,0,0,0,0,0,0
Himachal Pradesh,2007,Others,0,0,0,0,0,0,0,0,0,0,0,0,0,0,0
Himachal Pradesh,2007,Total,838,37,875,536,24,560,0,0,0,0,0,0,1374,61,1435
Himachal Pradesh,2008,Central Jail,592,22,614,98,6,104,0,0,0,0,0,0,690,28,718
Himachal Pradesh,2008,District Jail,179,6,185,129,11,140,0,0,0,0,0,0,308,17,325
Himachal Pradesh,2008,Sub_Jail,27,4,31,325,9,334,0,0,0,0,0,0,352,13,365
Himachal Pradesh,2008,Women Jail,0,0,0,0,0,0,0,0,0,0,0,0,0,0,0
Himachal Pradesh,2008,Borstal School,10,0,10,0,0,0,0,0,0,0,0,0,10,0,10
Himachal Pradesh,2008,Open Jail,50,0,50,0,0,0,0,0,0,0,0,0,50,0,50
Himachal Pradesh,2008,Special Jail,0,0,0,0,0,0,0,0,0,0,0,0,0,0,0
Himachal Pradesh,2008,Others,0,0,0,0,0,0,0,0,0,0,0,0,0,0,0
Himachal Pradesh,2008,Total,858,32,890,552,26,578,0,0,0,0,0,0,1410,58,1468
Himachal Pradesh,2009,Central Jail,555,25,580,143,3,146,0,0,0,0,0,0,698,28,726
Himachal Pradesh,2009,District Jail,163,7,170,184,6,190,0,0,0,0,0,0,347,13,360
Himachal Pradesh,2009,Sub_Jail,24,3,27,368,8,376,0,0,0,0,0,0,392,11,403
Himachal Pradesh,2009,Women Jail,0,0,0,0,0,0,0,0,0,0,0,0,0,0,0
Himachal Pradesh,2009,Borstal School,10,0,10,0,0,0,0,0,0,0,0,0,10,0,10
Himachal Pradesh,2009,Open Jail,55,0,55,0,0,0,0,0,0,0,0,0,55,0,55
Himachal Pradesh,2009,Special Jail,0,0,0,0,0,0,0,0,0,0,0,0,0,0,0
Himachal Pradesh,2009,Others,0,0,0,0,0,0,0,0,0,0,0,0,0,0,0
Himachal Pradesh,2009,Total,807,35,842,695,17,712,0,0,0,0,0,0,1502,52,1554
Himachal Pradesh,2010,Central Jail,644,22,666,163,5,168,0,0,0,0,0,0,807,27,834
Himachal Pradesh,2010,District Jail,202,4,206,124,6,130,0,0,0,0,0,0,326,10,336
Himachal Pradesh,2010,Sub_Jail,27,1,28,313,12,325,0,0,0,0,0,0,340,13,353
Himachal Pradesh,2010,Women Jail,0,0,0,0,0,0,0,0,0,0,0,0,0,0,0
Himachal Pradesh,2010,Borstal School,9,0,9,0,0,0,0,0,0,0,0,0,9,0,9
Himachal Pradesh,2010,Open Jail,53,0,53,0,0,0,0,0,0,0,0,0,53,0,53
Himachal Pradesh,2010,Special Jail,0,0,0,0,0,0,0,0,0,0,0,0,0,0,0
Himachal Pradesh,2010,Others,0,0,0,0,0,0,0,0,0,0,0,0,0,0,0
Himachal Pradesh,2010,Total,935,27,962,600,23,623,0,0,0,0,0,0,1535,50,1585
Himachal Pradesh,2011,Central Jail,556,16,572,170,5,175,0,0,0,0,0,0,726,21,747
Himachal Pradesh,2011,District Jail,196,5,201,107,12,119,0,0,0,0,0,0,303,17,320
Himachal Pradesh,2011,Sub_Jail,94,8,102,355,16,371,0,0,0,0,0,0,449,24,473
Himachal Pradesh,2011,Women Jail,0,0,0,0,0,0,0,0,0,0,0,0,0,0,0
Himachal Pradesh,2011,Borstal School,4,0,4,0,0,0,0,0,0,0,0,0,4,0,4
Himachal Pradesh,2011,Open Jail,63,0,63,0,0,0,0,0,0,0,0,0,63,0,63
Himachal Pradesh,2011,Special Jail,0,0,0,0,0,0,0,0,0,0,0,0,0,0,0
Himachal Pradesh,2011,Others,0,0,0,0,0,0,0,0,0,0,0,0,0,0,0
Himachal Pradesh,2011,Total,913,29,942,632,33,665,0,0,0,0,0,0,1545,62,1607
Himachal Pradesh,2012,Central Jail,565,20,585,152,4,156,0,0,0,0,0,0,717,24,741
Himachal Pradesh,2012,District Jail,181,6,187,147,11,158,0,0,0,0,0,0,328,17,345
Himachal Pradesh,2012,Sub_Jail,96,10,106,428,22,450,0,0,0,0,0,0,524,32,556
Himachal Pradesh,2012,Women Jail,0,0,0,0,0,0,0,0,0,0,0,0,0,0,0
Himachal Pradesh,2012,Borstal School,3,0,3,0,0,0,0,0,0,0,0,0,3,0,3
Himachal Pradesh,2012,Open Jail,71,0,71,0,0,0,0,0,0,0,0,0,71,0,71
Himachal Pradesh,2012,Special Jail,0,0,0,0,0,0,0,0,0,0,0,0,0,0,0
Himachal Pradesh,2012,Others,0,0,0,0,0,0,0,0,0,0,0,0,0,0,0
Himachal Pradesh,2012,Total,916,36,952,727,37,764,0,0,0,0,0,0,1643,73,1716
Jammu & Kashmir,2001,Central Jail,29,0,29,332,6,338,177,0,177,1,0,1,539,6,545
Jammu & Kashmir,2001,District Jail,82,5,87,672,27,699,220,2,222,2,0,2,976,34,1010
Jammu & Kashmir,2001,Sub_Jail,7,0,7,68,0,68,17,0,17,0,0,0,92,0,92
Jammu & Kashmir,2001,Women Jail,0,0,0,0,0,0,0,0,0,0,0,0,0,0,0
Jammu & Kashmir,2001,Borstal School,0,0,0,0,0,0,0,0,0,0,0,0,0,0,0
Jammu & Kashmir,2001,Open Jail,0,0,0,0,0,0,0,0,0,0,0,0,0,0,0
Jammu & Kashmir,2001,Special Jail,0,0,0,0,0,0,0,0,0,0,0,0,0,0,0
Jammu & Kashmir,2001,Others,0,0,0,0,0,0,0,0,0,0,0,0,0,0,0
Jammu & Kashmir,2001,Total,118,5,123,1072,33,1105,414,2,416,3,0,3,1607,40,1647
Jammu & Kashmir,2002,Central Jail,40,0,40,386,12,398,262,0,262,1,0,1,689,12,701
Jammu & Kashmir,2002,District Jail,80,3,83,727,34,761,171,1,172,0,0,0,978,38,1016
Jammu & Kashmir,2002,Sub_Jail,6,0,6,70,0,70,10,0,10,0,0,0,86,0,86
Jammu & Kashmir,2002,Women Jail,0,0,0,0,0,0,0,0,0,0,0,0,0,0,0
Jammu & Kashmir,2002,Borstal School,0,0,0,0,0,0,0,0,0,0,0,0,0,0,0
Jammu & Kashmir,2002,Open Jail,0,0,0,0,0,0,0,0,0,0,0,0,0,0,0
Jammu & Kashmir,2002,Special Jail,0,0,0,0,0,0,0,0,0,0,0,0,0,0,0
Jammu & Kashmir,2002,Others,0,0,0,0,0,0,0,0,0,0,0,0,0,0,0
Jammu & Kashmir,2002,Total,126,3,129,1183,46,1229,443,1,444,1,0,1,1753,50,1803
Jammu & Kashmir,2003,Central Jail,49,0,49,360,11,371,254,0,254,0,0,0,663,11,674
Jammu & Kashmir,2003,District Jail,113,1,114,843,53,896,134,0,134,0,0,0,1090,54,1144
Jammu & Kashmir,2003,Sub_Jail,5,0,5,63,0,63,9,0,9,0,0,0,77,0,77
Jammu & Kashmir,2003,Women Jail,0,0,0,0,0,0,0,0,0,0,0,0,0,0,0
Jammu & Kashmir,2003,Borstal School,0,0,0,0,0,0,0,0,0,0,0,0,0,0,0
Jammu & Kashmir,2003,Open Jail,0,0,0,0,0,0,0,0,0,0,0,0,0,0,0
Jammu & Kashmir,2003,Special Jail,0,0,0,0,0,0,0,0,0,0,0,0,0,0,0
Jammu & Kashmir,2003,Others,0,0,0,0,0,0,0,0,0,0,0,0,0,0,0
Jammu & Kashmir,2003,Total,167,1,168,1266,64,1330,397,0,397,0,0,0,1830,65,1895
Jammu & Kashmir,2004,Central Jail,72,0,72,458,8,466,273,1,274,0,0,0,803,9,812
Jammu & Kashmir,2004,District Jail,113,5,118,811,45,856,175,1,176,1,0,1,1100,51,1151
Jammu & Kashmir,2004,Sub_Jail,10,0,10,65,0,65,1,0,1,0,0,0,76,0,76
Jammu & Kashmir,2004,Women Jail,0,0,0,0,0,0,0,0,0,0,0,0,0,0,0
Jammu & Kashmir,2004,Borstal School,0,0,0,0,0,0,0,0,0,0,0,0,0,0,0
Jammu & Kashmir,2004,Open Jail,0,0,0,0,0,0,0,0,0,0,0,0,0,0,0
Jammu & Kashmir,2004,Special Jail,0,0,0,0,0,0,0,0,0,0,0,0,0,0,0
Jammu & Kashmir,2004,Others,0,0,0,0,0,0,0,0,0,0,0,0,0,0,0
Jammu & Kashmir,2004,Total,195,5,200,1334,53,1387,449,2,451,1,0,1,1979,60,2039
Jammu & Kashmir,2005,Central Jail,87,1,88,516,11,527,255,2,257,0,0,0,858,14,872
Jammu & Kashmir,2005,District Jail,117,9,126,893,46,939,116,2,118,0,0,0,1126,57,1183
Jammu & Kashmir,2005,Sub_Jail,7,0,7,73,0,73,2,0,2,0,0,0,82,0,82
Jammu & Kashmir,2005,Women Jail,0,0,0,0,0,0,0,0,0,0,0,0,0,0,0
Jammu & Kashmir,2005,Borstal School,0,0,0,0,0,0,0,0,0,0,0,0,0,0,0
Jammu & Kashmir,2005,Open Jail,0,0,0,0,0,0,0,0,0,0,0,0,0,0,0
Jammu & Kashmir,2005,Special Jail,0,0,0,0,0,0,0,0,0,0,0,0,0,0,0
Jammu & Kashmir,2005,Others,0,0,0,0,0,0,0,0,0,0,0,0,0,0,0
Jammu & Kashmir,2005,Total,211,10,221,1482,57,1539,373,4,377,0,0,0,2066,71,2137
Jammu & Kashmir,2006,Central Jail,82,0,82,508,13,521,228,0,228,0,0,0,818,13,831
Jammu & Kashmir,2006,District Jail,165,9,174,1004,36,1040,139,1,140,3,0,3,1311,46,1357
Jammu & Kashmir,2006,Sub_Jail,8,0,8,73,0,73,1,0,1,0,0,0,82,0,82
Jammu & Kashmir,2006,Women Jail,0,0,0,0,0,0,0,0,0,0,0,0,0,0,0
Jammu & Kashmir,2006,Borstal School,0,0,0,0,0,0,0,0,0,0,0,0,0,0,0
Jammu & Kashmir,2006,Open Jail,0,0,0,0,0,0,0,0,0,0,0,0,0,0,0
Jammu & Kashmir,2006,Special Jail,0,0,0,0,0,0,0,0,0,0,0,0,0,0,0
Jammu & Kashmir,2006,Others,0,0,0,0,0,0,0,0,0,0,0,0,0,0,0
Jammu & Kashmir,2006,Total,255,9,264,1585,49,1634,368,1,369,3,0,3,2211,59,2270
Jammu & Kashmir,2007,Central Jail,92,0,92,517,8,525,153,2,155,0,0,0,762,10,772
Jammu & Kashmir,2007,District Jail,174,7,181,1062,64,1126,118,1,119,0,0,0,1354,72,1426
Jammu & Kashmir,2007,Sub_Jail,19,0,19,81,0,81,1,0,1,0,0,0,101,0,101
Jammu & Kashmir,2007,Women Jail,0,0,0,0,0,0,0,0,0,0,0,0,0,0,0
Jammu & Kashmir,2007,Borstal School,0,0,0,0,0,0,0,0,0,0,0,0,0,0,0
Jammu & Kashmir,2007,Open Jail,0,0,0,0,0,0,0,0,0,0,0,0,0,0,0
Jammu & Kashmir,2007,Special Jail,0,0,0,0,0,0,0,0,0,0,0,0,0,0,0
Jammu & Kashmir,2007,Others,0,0,0,0,0,0,0,0,0,0,0,0,0,0,0
Jammu & Kashmir,2007,Total,285,7,292,1660,72,1732,272,3,275,0,0,0,2217,82,2299
Jammu & Kashmir,2008,Central Jail,110,0,110,464,8,472,144,1,145,0,0,0,718,9,727
Jammu & Kashmir,2008,District Jail,209,9,218,1077,67,1144,120,0,120,0,0,0,1406,76,1482
Jammu & Kashmir,2008,Sub_Jail,10,0,10,90,0,90,1,0,1,0,0,0,101,0,101
Jammu & Kashmir,2008,Women Jail,0,0,0,0,0,0,0,0,0,0,0,0,0,0,0
Jammu & Kashmir,2008,Borstal School,0,0,0,0,0,0,0,0,0,0,0,0,0,0,0
Jammu & Kashmir,2008,Open Jail,0,0,0,0,0,0,0,0,0,0,0,0,0,0,0
Jammu & Kashmir,2008,Special Jail,0,0,0,0,0,0,0,0,0,0,0,0,0,0,0
Jammu & Kashmir,2008,Others,0,0,0,0,0,0,0,0,0,0,0,0,0,0,0
Jammu & Kashmir,2008,Total,329,9,338,1631,75,1706,265,1,266,0,0,0,2225,85,2310
Jammu & Kashmir,2009,Central Jail,162,0,162,531,18,549,139,1,140,1,0,1,833,19,852
Jammu & Kashmir,2009,District Jail,180,12,192,1052,67,1119,38,0,38,0,0,0,1270,79,1349
Jammu & Kashmir,2009,Sub_Jail,4,0,4,153,0,153,4,0,4,0,0,0,161,0,161
Jammu & Kashmir,2009,Women Jail,0,0,0,0,0,0,0,0,0,0,0,0,0,0,0
Jammu & Kashmir,2009,Borstal School,0,0,0,0,0,0,0,0,0,0,0,0,0,0,0
Jammu & Kashmir,2009,Open Jail,0,0,0,0,0,0,0,0,0,0,0,0,0,0,0
Jammu & Kashmir,2009,Special Jail,0,0,0,0,0,0,0,0,0,0,0,0,0,0,0
Jammu & Kashmir,2009,Others,0,0,0,0,0,0,0,0,0,0,0,0,0,0,0
Jammu & Kashmir,2009,Total,346,12,358,1736,85,1821,181,1,182,1,0,1,2264,98,2362
Jammu & Kashmir,2010,Central Jail,152,0,152,584,11,595,269,13,282,1,0,1,1006,24,1030
Jammu & Kashmir,2010,District Jail,99,7,106,1137,73,1210,111,2,113,1,0,1,1348,82,1430
Jammu & Kashmir,2010,Sub_Jail,1,0,1,102,0,102,14,0,14,0,0,0,117,0,117
Jammu & Kashmir,2010,Women Jail,0,0,0,0,0,0,0,0,0,0,0,0,0,0,0
Jammu & Kashmir,2010,Borstal School,0,0,0,0,0,0,0,0,0,0,0,0,0,0,0
Jammu & Kashmir,2010,Open Jail,0,0,0,0,0,0,0,0,0,0,0,0,0,0,0
Jammu & Kashmir,2010,Special Jail,0,0,0,0,0,0,0,0,0,0,0,0,0,0,0
Jammu & Kashmir,2010,Others,0,0,0,0,0,0,0,0,0,0,0,0,0,0,0
Jammu & Kashmir,2010,Total,252,7,259,1823,84,1907,394,15,409,2,0,2,2471,106,2577
Jammu & Kashmir,2011,Central Jail,194,2,196,693,20,713,161,5,166,9,0,9,1057,27,1084
Jammu & Kashmir,2011,District Jail,97,8,105,1169,68,1237,70,0,70,1,0,1,1337,76,1413
Jammu & Kashmir,2011,Sub_Jail,0,0,0,163,0,163,3,0,3,0,0,0,166,0,166
Jammu & Kashmir,2011,Women Jail,0,0,0,0,0,0,0,0,0,0,0,0,0,0,0
Jammu & Kashmir,2011,Borstal School,0,0,0,0,0,0,0,0,0,0,0,0,0,0,0
Jammu & Kashmir,2011,Open Jail,0,0,0,0,0,0,0,0,0,0,0,0,0,0,0
Jammu & Kashmir,2011,Special Jail,0,0,0,0,0,0,0,0,0,0,0,0,0,0,0
Jammu & Kashmir,2011,Others,0,0,0,0,0,0,0,0,0,0,0,0,0,0,0
Jammu & Kashmir,2011,Total,291,10,301,2025,88,2113,234,5,239,10,0,10,2560,103,2663
Jammu & Kashmir,2012,Central Jail,220,5,225,613,2,615,86,0,86,0,0,0,919,7,926
Jammu & Kashmir,2012,District Jail,156,8,164,1212,78,1290,49,0,49,0,0,0,1417,86,1503
Jammu & Kashmir,2012,Sub_Jail,0,0,0,102,0,102,9,0,9,0,0,0,111,0,111
Jammu & Kashmir,2012,Women Jail,0,0,0,0,0,0,0,0,0,0,0,0,0,0,0
Jammu & Kashmir,2012,Borstal School,0,0,0,0,0,0,0,0,0,0,0,0,0,0,0
Jammu & Kashmir,2012,Open Jail,0,0,0,0,0,0,0,0,0,0,0,0,0,0,0
Jammu & Kashmir,2012,Special Jail,0,0,0,0,0,0,0,0,0,0,0,0,0,0,0
Jammu & Kashmir,2012,Others,0,0,0,0,0,0,0,0,0,0,0,0,0,0,0
Jammu & Kashmir,2012,Total,376,13,389,1927,80,2007,144,0,144,0,0,0,2447,93,2540
Jharkhand,2001,Central Jail,1875,26,1901,2415,43,2458,6,0,6,0,0,0,4296,69,4365
Jharkhand,2001,District Jail,295,9,304,5137,166,5303,3,0,3,6,0,6,5441,175,5616
Jharkhand,2001,Sub_Jail,201,14,215,6089,183,6272,0,0,0,4,0,4,6294,197,6491
Jharkhand,2001,Women Jail,0,0,0,0,0,0,0,0,0,0,0,0,0,0,0
Jharkhand,2001,Borstal School,0,0,0,45,0,45,0,0,0,0,0,0,45,0,45
Jharkhand,2001,Open Jail,0,0,0,0,0,0,0,0,0,0,0,0,0,0,0
Jharkhand,2001,Special Jail,0,0,0,0,0,0,0,0,0,0,0,0,0,0,0
Jharkhand,2001,Others,0,0,0,0,0,0,0,0,0,0,0,0,0,0,0
Jharkhand,2001,Total,2371,49,2420,13686,392,14078,9,0,9,10,0,10,16076,441,16517
Jharkhand,2002,Central Jail,2288,55,2343,1937,59,1996,16,0,16,2,0,2,4243,114,4357
Jharkhand,2002,District Jail,362,7,369,3995,158,4153,1,0,1,0,0,0,4358,165,4523
Jharkhand,2002,Sub_Jail,292,9,301,5730,188,5918,1,0,1,1,0,1,6024,197,6221
Jharkhand,2002,Women Jail,0,0,0,0,0,0,0,0,0,0,0,0,0,0,0
Jharkhand,2002,Borstal School,0,0,0,27,0,27,0,0,0,0,0,0,27,0,27
Jharkhand,2002,Open Jail,0,0,0,0,0,0,0,0,0,0,0,0,0,0,0
Jharkhand,2002,Special Jail,0,0,0,0,0,0,0,0,0,0,0,0,0,0,0
Jharkhand,2002,Others,0,0,0,0,0,0,0,0,0,0,0,0,0,0,0
Jharkhand,2002,Total,2942,71,3013,11689,405,12094,18,0,18,3,0,3,14652,476,15128
Jharkhand,2003,Central Jail,3195,104,3299,3397,87,3484,11,0,11,1,0,1,6604,191,6795
Jharkhand,2003,District Jail,519,14,533,2897,126,3023,0,0,0,1,0,1,3417,140,3557
Jharkhand,2003,Sub_Jail,413,9,422,5389,201,5590,2,0,2,9,0,9,5813,210,6023
Jharkhand,2003,Women Jail,0,0,0,0,0,0,0,0,0,0,0,0,0,0,0
Jharkhand,2003,Borstal School,3,0,3,37,0,37,0,0,0,0,0,0,40,0,40
Jharkhand,2003,Open Jail,0,0,0,0,0,0,0,0,0,0,0,0,0,0,0
Jharkhand,2003,Special Jail,0,0,0,0,0,0,0,0,0,0,0,0,0,0,0
Jharkhand,2003,Others,0,0,0,0,0,0,0,0,0,0,0,0,0,0,0
Jharkhand,2003,Total,4130,127,4257,11720,414,12134,13,0,13,11,0,11,15874,541,16415
Jharkhand,2004,Central Jail,3793,118,3911,2433,89,2522,10,0,10,0,0,0,6236,207,6443
Jharkhand,2004,District Jail,655,12,667,4027,150,4177,0,0,0,0,0,0,4682,162,4844
Jharkhand,2004,Sub_Jail,452,8,460,5454,254,5708,0,0,0,0,0,0,5906,262,6168
Jharkhand,2004,Women Jail,0,0,0,0,0,0,0,0,0,0,0,0,0,0,0
Jharkhand,2004,Borstal School,2,0,2,40,0,40,0,0,0,0,0,0,42,0,42
Jharkhand,2004,Open Jail,0,0,0,0,0,0,0,0,0,0,0,0,0,0,0
Jharkhand,2004,Special Jail,0,0,0,0,0,0,0,0,0,0,0,0,0,0,0
Jharkhand,2004,Others,0,0,0,0,0,0,0,0,0,0,0,0,0,0,0
Jharkhand,2004,Total,4902,138,5040,11954,493,12447,10,0,10,0,0,0,16866,631,17497
Jharkhand,2005,Central Jail,4178,134,4312,3002,121,3123,0,0,0,0,0,0,7180,255,7435
Jharkhand,2005,District Jail,909,18,927,8985,391,9376,0,0,0,0,0,0,9894,409,10303
Jharkhand,2005,Sub_Jail,53,0,53,1378,34,1412,0,0,0,0,0,0,1431,34,1465
Jharkhand,2005,Women Jail,0,0,0,0,0,0,0,0,0,0,0,0,0,0,0
Jharkhand,2005,Borstal School,2,0,2,28,0,28,0,0,0,0,0,0,30,0,30
Jharkhand,2005,Open Jail,0,0,0,0,0,0,0,0,0,0,0,0,0,0,0
Jharkhand,2005,Special Jail,0,0,0,0,0,0,0,0,0,0,0,0,0,0,0
Jharkhand,2005,Others,0,0,0,0,0,0,0,0,0,0,0,0,0,0,0
Jharkhand,2005,Total,5142,152,5294,13393,546,13939,0,0,0,0,0,0,18535,698,19233
Jharkhand,2006,Central Jail,6174,224,6398,3671,152,3823,1,0,1,0,0,0,9846,376,10222
Jharkhand,2006,District Jail,908,22,930,8046,348,8394,0,0,0,0,0,0,8954,370,9324
Jharkhand,2006,Sub_Jail,39,0,39,1046,33,1079,0,0,0,0,0,0,1085,33,1118
Jharkhand,2006,Women Jail,0,0,0,0,0,0,0,0,0,0,0,0,0,0,0
Jharkhand,2006,Borstal School,2,0,2,43,0,43,0,0,0,0,0,0,45,0,45
Jharkhand,2006,Open Jail,0,0,0,0,0,0,0,0,0,0,0,0,0,0,0
Jharkhand,2006,Special Jail,0,0,0,0,0,0,0,0,0,0,0,0,0,0,0
Jharkhand,2006,Others,0,0,0,0,0,0,0,0,0,0,0,0,0,0,0
Jharkhand,2006,Total,7123,246,7369,12806,533,13339,1,0,1,0,0,0,19930,779,20709
Jharkhand,2007,Central Jail,4684,159,4843,2681,119,2800,2,0,2,0,0,0,7367,278,7645
Jharkhand,2007,District Jail,928,25,953,7974,313,8287,4,0,4,2,0,2,8908,338,9246
Jharkhand,2007,Sub_Jail,67,0,67,905,41,946,0,0,0,0,0,0,972,41,1013
Jharkhand,2007,Women Jail,0,0,0,0,0,0,0,0,0,0,0,0,0,0,0
Jharkhand,2007,Borstal School,2,0,2,30,0,30,0,0,0,0,0,0,32,0,32
Jharkhand,2007,Open Jail,0,0,0,0,0,0,0,0,0,0,0,0,0,0,0
Jharkhand,2007,Special Jail,0,0,0,0,0,0,0,0,0,0,0,0,0,0,0
Jharkhand,2007,Others,0,0,0,0,0,0,0,0,0,0,0,0,0,0,0
Jharkhand,2007,Total,5681,184,5865,11590,473,12063,6,0,6,2,0,2,17279,657,17936
Jharkhand,2008,Central Jail,4695,150,4845,2900,127,3027,0,0,0,0,0,0,7595,277,7872
Jharkhand,2008,District Jail,848,19,867,8204,318,8522,6,0,6,2,0,2,9060,337,9397
Jharkhand,2008,Sub_Jail,70,1,71,987,37,1024,0,0,0,1,0,1,1058,38,1096
Jharkhand,2008,Women Jail,0,0,0,0,0,0,0,0,0,0,0,0,0,0,0
Jharkhand,2008,Borstal School,1,0,1,37,0,37,0,0,0,0,0,0,38,0,38
Jharkhand,2008,Open Jail,0,0,0,0,0,0,0,0,0,0,0,0,0,0,0
Jharkhand,2008,Special Jail,0,0,0,0,0,0,0,0,0,0,0,0,0,0,0
Jharkhand,2008,Others,0,0,0,0,0,0,0,0,0,0,0,0,0,0,0
Jharkhand,2008,Total,5614,170,5784,12128,482,12610,6,0,6,3,0,3,17751,652,18403
Jharkhand,2009,Central Jail,4448,143,4591,2806,128,2934,0,0,0,0,0,0,7254,271,7525
Jharkhand,2009,District Jail,812,23,835,7542,315,7857,5,0,5,0,0,0,8359,338,8697
Jharkhand,2009,Sub_Jail,81,1,82,817,41,858,0,0,0,0,0,0,898,42,940
Jharkhand,2009,Women Jail,0,0,0,0,0,0,0,0,0,0,0,0,0,0,0
Jharkhand,2009,Borstal School,1,0,1,33,0,33,0,0,0,0,0,0,34,0,34
Jharkhand,2009,Open Jail,0,0,0,0,0,0,0,0,0,0,0,0,0,0,0
Jharkhand,2009,Special Jail,0,0,0,0,0,0,0,0,0,0,0,0,0,0,0
Jharkhand,2009,Others,0,0,0,0,0,0,0,0,0,0,0,0,0,0,0
Jharkhand,2009,Total,5342,167,5509,11198,484,11682,5,0,5,0,0,0,16545,651,17196
Jharkhand,2010,Central Jail,4525,153,4678,4098,199,4297,12,0,12,0,0,0,8635,352,8987
Jharkhand,2010,District Jail,524,15,539,7202,279,7481,4,0,4,0,0,0,7730,294,8024
Jharkhand,2010,Sub_Jail,44,0,44,898,61,959,0,0,0,0,0,0,942,61,1003
Jharkhand,2010,Women Jail,0,0,0,0,0,0,0,0,0,0,0,0,0,0,0
Jharkhand,2010,Borstal School,0,0,0,28,0,28,0,0,0,0,0,0,28,0,28
Jharkhand,2010,Open Jail,0,0,0,0,0,0,0,0,0,0,0,0,0,0,0
Jharkhand,2010,Special Jail,0,0,0,0,0,0,0,0,0,0,0,0,0,0,0
Jharkhand,2010,Others,0,0,0,0,0,0,0,0,0,0,0,0,0,0,0
Jharkhand,2010,Total,5093,168,5261,12226,539,12765,16,0,16,0,0,0,17335,707,18042
Jharkhand,2011,Central Jail,4067,133,4200,3831,202,4033,10,1,11,0,0,0,7908,336,8244
Jharkhand,2011,District Jail,260,6,266,6705,328,7033,7,0,7,0,0,0,6972,334,7306
Jharkhand,2011,Sub_Jail,27,0,27,937,48,985,0,0,0,2,0,2,966,48,1014
Jharkhand,2011,Women Jail,0,0,0,0,0,0,0,0,0,0,0,0,0,0,0
Jharkhand,2011,Borstal School,0,0,0,22,0,22,0,0,0,0,0,0,22,0,22
Jharkhand,2011,Open Jail,0,0,0,0,0,0,0,0,0,0,0,0,0,0,0
Jharkhand,2011,Special Jail,0,0,0,0,0,0,0,0,0,0,0,0,0,0,0
Jharkhand,2011,Others,0,0,0,0,0,0,0,0,0,0,0,0,0,0,0
Jharkhand,2011,Total,4354,139,4493,11495,578,12073,17,1,18,2,0,2,15868,718,16586
Jharkhand,2012,Central Jail,3875,140,4015,3950,197,4147,15,0,15,0,0,0,7840,337,8177
Jharkhand,2012,District Jail,233,3,236,7357,356,7713,1,0,1,0,0,0,7591,359,7950
Jharkhand,2012,Sub_Jail,27,1,28,1083,47,1130,0,0,0,1,0,1,1111,48,1159
Jharkhand,2012,Women Jail,0,0,0,0,0,0,0,0,0,0,0,0,0,0,0
Jharkhand,2012,Borstal School,0,0,0,45,0,45,0,0,0,0,0,0,45,0,45
Jharkhand,2012,Open Jail,0,0,0,0,0,0,0,0,0,0,0,0,0,0,0
Jharkhand,2012,Special Jail,0,0,0,0,0,0,0,0,0,0,0,0,0,0,0
Jharkhand,2012,Others,0,0,0,0,0,0,0,0,0,0,0,0,0,0,0
Jharkhand,2012,Total,4135,144,4279,12435,600,13035,16,0,16,1,0,1,16587,744,17331
Karnataka,2001,Central Jail,1659,54,1713,3897,112,4009,74,0,74,2,0,2,5632,166,5798
Karnataka,2001,District Jail,34,0,34,931,31,962,39,0,39,0,0,0,1004,31,1035
Karnataka,2001,Sub_Jail,28,0,28,2540,56,2596,9,0,9,3,0,3,2580,56,2636
Karnataka,2001,Women Jail,0,0,0,0,0,0,0,0,0,0,0,0,0,0,0
Karnataka,2001,Borstal School,0,0,0,0,0,0,0,0,0,0,0,0,0,0,0
Karnataka,2001,Open Jail,44,0,44,0,0,0,0,0,0,0,0,0,44,0,44
Karnataka,2001,Special Jail,0,0,0,149,0,149,0,0,0,0,0,0,149,0,149
Karnataka,2001,Others,84,0,84,0,0,0,0,0,0,0,0,0,84,0,84
Karnataka,2001,Total,1849,54,1903,7517,199,7716,122,0,122,5,0,5,9493,253,9746
Karnataka,2002,Central Jail,2030,80,2110,3873,165,4038,79,2,81,9,0,9,5991,247,6238
Karnataka,2002,District Jail,32,2,34,1091,43,1134,26,1,27,2,0,2,1151,46,1197
Karnataka,2002,Sub_Jail,62,1,63,2603,55,2658,15,1,16,7,0,7,2687,57,2744
Karnataka,2002,Women Jail,0,0,0,0,0,0,0,0,0,0,0,0,0,0,0
Karnataka,2002,Borstal School,0,0,0,0,0,0,0,0,0,0,0,0,0,0,0
Karnataka,2002,Open Jail,27,0,27,0,0,0,0,0,0,0,0,0,27,0,27
Karnataka,2002,Special Jail,3,0,3,142,0,142,0,0,0,0,0,0,145,0,145
Karnataka,2002,Others,61,0,61,0,0,0,0,0,0,0,0,0,61,0,61
Karnataka,2002,Total,2215,83,2298,7709,263,7972,120,4,124,18,0,18,10062,350,10412
Karnataka,2003,Central Jail,2484,78,2562,4050,177,4227,86,0,86,3,0,3,6623,255,6878
Karnataka,2003,District Jail,28,0,28,942,44,986,28,2,30,12,0,12,1010,46,1056
Karnataka,2003,Sub_Jail,83,0,83,2547,40,2587,16,1,17,6,0,6,2652,41,2693
Karnataka,2003,Women Jail,0,0,0,0,0,0,0,0,0,0,0,0,0,0,0
Karnataka,2003,Borstal School,0,0,0,0,0,0,0,0,0,0,0,0,0,0,0
Karnataka,2003,Open Jail,24,0,24,0,0,0,0,0,0,0,0,0,24,0,24
Karnataka,2003,Special Jail,22,0,22,175,0,175,0,0,0,0,0,0,197,0,197
Karnataka,2003,Others,54,0,54,0,0,0,0,0,0,0,0,0,54,0,54
Karnataka,2003,Total,2695,78,2773,7714,261,7975,130,3,133,21,0,21,10560,342,10902
Karnataka,2004,Central Jail,3125,120,3245,3821,193,4014,85,0,85,4,0,4,7035,313,7348
Karnataka,2004,District Jail,31,2,33,821,55,876,17,2,19,0,0,0,869,59,928
Karnataka,2004,Sub_Jail,60,4,64,2786,59,2845,17,1,18,7,0,7,2870,64,2934
Karnataka,2004,Women Jail,0,0,0,0,0,0,0,0,0,0,0,0,0,0,0
Karnataka,2004,Borstal School,0,0,0,0,0,0,0,0,0,0,0,0,0,0,0
Karnataka,2004,Open Jail,25,0,25,0,0,0,0,0,0,0,0,0,25,0,25
Karnataka,2004,Special Jail,16,0,16,227,0,227,0,0,0,0,0,0,243,0,243
Karnataka,2004,Others,64,0,64,0,0,0,0,0,0,0,0,0,64,0,64
Karnataka,2004,Total,3321,126,3447,7655,307,7962,119,3,122,11,0,11,11106,436,11542
Karnataka,2005,Central Jail,3667,143,3810,4078,188,4266,91,1,92,31,0,31,7867,332,8199
Karnataka,2005,District Jail,40,1,41,919,43,962,40,5,45,3,0,3,1002,49,1051
Karnataka,2005,Sub_Jail,88,0,88,2518,65,2583,19,2,21,5,0,5,2630,67,2697
Karnataka,2005,Women Jail,0,0,0,0,0,0,0,0,0,0,0,0,0,0,0
Karnataka,2005,Borstal School,0,0,0,0,0,0,0,0,0,0,0,0,0,0,0
Karnataka,2005,Open Jail,37,0,37,0,0,0,0,0,0,0,0,0,37,0,37
Karnataka,2005,Special Jail,15,0,15,168,0,168,0,0,0,2,0,2,185,0,185
Karnataka,2005,Others,58,0,58,0,0,0,0,0,0,0,0,0,58,0,58
Karnataka,2005,Total,3905,144,4049,7683,296,7979,150,8,158,41,0,41,11779,448,12227
Karnataka,2006,Central Jail,3485,182,3667,4503,215,4718,78,3,81,11,0,11,8077,400,8477
Karnataka,2006,District Jail,41,1,42,951,45,996,78,7,85,9,0,9,1079,53,1132
Karnataka,2006,Sub_Jail,77,2,79,2711,51,2762,9,0,9,4,0,4,2801,53,2854
Karnataka,2006,Women Jail,0,0,0,0,0,0,0,0,0,0,0,0,0,0,0
Karnataka,2006,Borstal School,0,0,0,0,0,0,0,0,0,0,0,0,0,0,0
Karnataka,2006,Open Jail,33,0,33,0,0,0,0,0,0,0,0,0,33,0,33
Karnataka,2006,Special Jail,7,0,7,173,0,173,0,0,0,0,0,0,180,0,180
Karnataka,2006,Others,24,0,24,0,0,0,0,0,0,0,0,0,24,0,24
Karnataka,2006,Total,3667,185,3852,8338,311,8649,165,10,175,24,0,24,12194,506,12700
Karnataka,2007,Central Jail,3499,170,3669,4897,218,5115,9,0,9,64,4,68,8469,392,8861
Karnataka,2007,District Jail,66,0,66,1610,99,1709,1,0,1,90,2,92,1767,101,1868
Karnataka,2007,Sub_Jail,31,0,31,2024,35,2059,0,0,0,6,0,6,2061,35,2096
Karnataka,2007,Women Jail,0,0,0,0,0,0,0,0,0,0,0,0,0,0,0
Karnataka,2007,Borstal School,0,0,0,0,0,0,0,0,0,0,0,0,0,0,0
Karnataka,2007,Open Jail,32,0,32,0,0,0,0,0,0,0,0,0,32,0,32
Karnataka,2007,Special Jail,8,0,8,163,0,163,0,0,0,0,0,0,171,0,171
Karnataka,2007,Others,24,0,24,0,0,0,0,0,0,0,0,0,24,0,24
Karnataka,2007,Total,3660,170,3830,8694,352,9046,10,0,10,160,6,166,12524,528,13052
Karnataka,2008,Central Jail,3646,177,3823,5006,227,5233,0,1,1,59,13,72,8711,418,9129
Karnataka,2008,District Jail,51,0,51,1767,86,1853,0,0,0,83,1,84,1901,87,1988
Karnataka,2008,Sub_Jail,37,2,39,2063,41,2104,0,0,0,14,0,14,2114,43,2157
Karnataka,2008,Women Jail,0,0,0,0,0,0,0,0,0,0,0,0,0,0,0
Karnataka,2008,Borstal School,0,0,0,0,0,0,0,0,0,0,0,0,0,0,0
Karnataka,2008,Open Jail,26,0,26,0,0,0,0,0,0,0,0,0,26,0,26
Karnataka,2008,Special Jail,12,0,12,218,0,218,0,0,0,0,0,0,230,0,230
Karnataka,2008,Others,8,0,8,0,0,0,0,0,0,0,0,0,8,0,8
Karnataka,2008,Total,3780,179,3959,9054,354,9408,0,1,1,156,14,170,12990,548,13538
Karnataka,2009,Central Jail,3453,149,3602,4689,210,4899,2,1,3,124,6,130,8268,366,8634
Karnataka,2009,District Jail,61,2,63,1904,98,2002,13,0,13,42,4,46,2020,104,2124
Karnataka,2009,Sub_Jail,28,0,28,2153,53,2206,1,0,1,7,1,8,2189,54,2243
Karnataka,2009,Women Jail,0,0,0,0,0,0,0,0,0,0,0,0,0,0,0
Karnataka,2009,Borstal School,0,0,0,0,0,0,0,0,0,0,0,0,0,0,0
Karnataka,2009,Open Jail,19,0,19,0,0,0,0,0,0,0,0,0,19,0,19
Karnataka,2009,Special Jail,3,0,3,214,0,214,0,0,0,1,0,1,218,0,218
Karnataka,2009,Others,3,0,3,0,0,0,0,0,0,0,0,0,3,0,3
Karnataka,2009,Total,3567,151,3718,8960,361,9321,16,1,17,174,11,185,12717,524,13241
Karnataka,2010,Central Jail,3629,162,3791,4296,199,4495,9,1,10,122,1,123,8056,363,8419
Karnataka,2010,District Jail,60,1,61,2002,58,2060,1,1,2,37,1,38,2100,61,2161
Karnataka,2010,Sub_Jail,35,2,37,1966,43,2009,0,0,0,11,0,11,2012,45,2057
Karnataka,2010,Women Jail,0,0,0,0,0,0,0,0,0,0,0,0,0,0,0
Karnataka,2010,Borstal School,0,0,0,0,0,0,0,0,0,0,0,0,0,0,0
Karnataka,2010,Open Jail,31,0,31,0,0,0,0,0,0,0,0,0,31,0,31
Karnataka,2010,Special Jail,3,0,3,212,0,212,0,0,0,6,0,6,221,0,221
Karnataka,2010,Others,0,0,0,0,0,0,0,0,0,0,0,0,0,0,0
Karnataka,2010,Total,3758,165,3923,8476,300,8776,10,2,12,176,2,178,12420,469,12889
Karnataka,2011,Central Jail,3887,187,4074,4148,209,4357,6,0,6,105,8,113,8146,404,8550
Karnataka,2011,District Jail,58,0,58,1834,68,1902,0,0,0,28,1,29,1920,69,1989
Karnataka,2011,Sub_Jail,23,1,24,1831,49,1880,0,0,0,8,0,8,1862,50,1912
Karnataka,2011,Women Jail,0,0,0,0,0,0,0,0,0,0,0,0,0,0,0
Karnataka,2011,Borstal School,0,0,0,0,0,0,0,0,0,0,0,0,0,0,0
Karnataka,2011,Open Jail,57,0,57,0,0,0,0,0,0,0,0,0,57,0,57
Karnataka,2011,Special Jail,8,0,8,147,0,147,0,0,0,3,0,3,158,0,158
Karnataka,2011,Others,0,0,0,0,0,0,0,0,0,0,0,0,0,0,0
Karnataka,2011,Total,4033,188,4221,7960,326,8286,6,0,6,144,9,153,12143,523,12666
Karnataka,2012,Central Jail,3757,184,3941,4359,221,4580,67,0,67,0,0,0,8183,405,8588
Karnataka,2012,District Jail,71,1,72,2098,90,2188,15,3,18,0,0,0,2184,94,2278
Karnataka,2012,Sub_Jail,33,2,35,1912,57,1969,9,0,9,0,0,0,1954,59,2013
Karnataka,2012,Women Jail,0,0,0,0,0,0,0,0,0,0,0,0,0,0,0
Karnataka,2012,Borstal School,0,0,0,0,0,0,0,0,0,0,0,0,0,0,0
Karnataka,2012,Open Jail,51,0,51,0,0,0,0,0,0,0,0,0,51,0,51
Karnataka,2012,Special Jail,1,0,1,203,0,203,3,0,3,0,0,0,207,0,207
Karnataka,2012,Others,0,0,0,0,0,0,0,0,0,0,0,0,0,0,0
Karnataka,2012,Total,3913,187,4100,8572,368,8940,94,3,97,0,0,0,12579,558,13137
Kerala,2001,Central Jail,1521,28,1549,1001,28,1029,19,0,19,13,0,13,2554,56,2610
Kerala,2001,District Jail,50,3,53,662,30,692,0,0,0,0,0,0,712,33,745
Kerala,2001,Sub_Jail,47,2,49,1395,31,1426,0,0,0,0,0,0,1442,33,1475
Kerala,2001,Women Jail,0,33,33,0,14,14,0,0,0,0,0,0,0,47,47
Kerala,2001,Borstal School,1,0,1,0,0,0,0,0,0,0,0,0,1,0,1
Kerala,2001,Open Jail,125,0,125,0,0,0,0,0,0,0,0,0,125,0,125
Kerala,2001,Special Jail,6,1,7,358,8,366,0,0,0,0,0,0,364,9,373
Kerala,2001,Others,0,0,0,0,0,0,0,0,0,0,0,0,0,0,0
Kerala,2001,Total,1750,67,1817,3416,111,3527,19,0,19,13,0,13,5198,178,5376
Kerala,2002,Central Jail,1405,28,1433,884,29,913,12,0,12,7,0,7,2308,57,2365
Kerala,2002,District Jail,39,3,42,704,18,722,0,0,0,0,0,0,743,21,764
Kerala,2002,Sub_Jail,30,0,30,1427,69,1496,0,0,0,0,0,0,1457,69,1526
Kerala,2002,Women Jail,0,18,18,0,17,17,0,0,0,0,0,0,0,35,35
Kerala,2002,Borstal School,1,0,1,0,0,0,0,0,0,0,0,0,1,0,1
Kerala,2002,Open Jail,172,0,172,0,0,0,0,0,0,0,0,0,172,0,172
Kerala,2002,Special Jail,14,1,15,306,4,310,0,0,0,0,0,0,320,5,325
Kerala,2002,Others,0,0,0,0,0,0,0,0,0,0,0,0,0,0,0
Kerala,2002,Total,1661,50,1711,3321,137,3458,12,0,12,7,0,7,5001,187,5188
Kerala,2003,Central Jail,1779,42,1821,1487,52,1539,8,0,8,6,0,6,3280,94,3374
Kerala,2003,District Jail,64,4,68,769,17,786,0,0,0,0,0,0,833,21,854
Kerala,2003,Sub_Jail,30,1,31,1383,23,1406,0,0,0,0,0,0,1413,24,1437
Kerala,2003,Women Jail,0,17,17,0,24,24,0,0,0,0,0,0,0,41,41
Kerala,2003,Borstal School,0,0,0,0,0,0,0,0,0,0,0,0,0,0,0
Kerala,2003,Open Jail,233,0,233,0,0,0,0,0,0,0,0,0,233,0,233
Kerala,2003,Special Jail,19,3,22,483,20,503,0,0,0,0,0,0,502,23,525
Kerala,2003,Others,0,0,0,0,0,0,0,0,0,0,0,0,0,0,0
Kerala,2003,Total,2125,67,2192,4122,136,4258,8,0,8,6,0,6,6261,203,6464
Kerala,2004,Central Jail,2331,57,2388,1248,48,1296,8,0,8,6,0,6,3593,105,3698
Kerala,2004,District Jail,61,1,62,958,19,977,0,0,0,0,0,0,1019,20,1039
Kerala,2004,Sub_Jail,39,2,41,1461,45,1506,0,0,0,0,0,0,1500,47,1547
Kerala,2004,Women Jail,0,23,23,0,25,25,0,0,0,0,0,0,0,48,48
Kerala,2004,Borstal School,0,0,0,0,0,0,0,0,0,0,0,0,0,0,0
Kerala,2004,Open Jail,234,0,234,0,0,0,0,0,0,0,0,0,234,0,234
Kerala,2004,Special Jail,31,1,32,579,17,596,0,0,0,0,0,0,610,18,628
Kerala,2004,Others,0,0,0,0,0,0,0,0,0,0,0,0,0,0,0
Kerala,2004,Total,2696,84,2780,4246,154,4400,8,0,8,6,0,6,6956,238,7194
Kerala,2005,Central Jail,2330,48,2378,1257,30,1287,13,0,13,2,0,2,3602,78,3680
Kerala,2005,District Jail,67,1,68,732,21,753,0,0,0,0,0,0,799,22,821
Kerala,2005,Sub_Jail,39,0,39,1336,34,1370,0,0,0,0,0,0,1375,34,1409
Kerala,2005,Women Jail,0,28,28,0,22,22,0,0,0,0,0,0,0,50,50
Kerala,2005,Borstal School,0,0,0,0,0,0,0,0,0,0,0,0,0,0,0
Kerala,2005,Open Jail,262,0,262,0,0,0,0,0,0,0,0,0,262,0,262
Kerala,2005,Special Jail,31,0,31,593,17,610,0,0,0,0,0,0,624,17,641
Kerala,2005,Others,0,0,0,0,0,0,0,0,0,0,0,0,0,0,0
Kerala,2005,Total,2729,77,2806,3918,124,4042,13,0,13,2,0,2,6662,201,6863
Kerala,2006,Central Jail,2453,32,2485,919,42,961,5,0,5,4,0,4,3381,74,3455
Kerala,2006,District Jail,71,7,78,723,17,740,0,0,0,0,0,0,794,24,818
Kerala,2006,Sub_Jail,22,0,22,1393,26,1419,0,0,0,0,0,0,1415,26,1441
Kerala,2006,Women Jail,0,25,25,0,21,21,0,0,0,0,0,0,0,46,46
Kerala,2006,Borstal School,0,0,0,0,0,0,0,0,0,0,0,0,0,0,0
Kerala,2006,Open Jail,254,0,254,0,0,0,0,0,0,0,0,0,254,0,254
Kerala,2006,Special Jail,12,0,12,459,19,478,0,0,0,0,0,0,471,19,490
Kerala,2006,Others,0,0,0,0,0,0,0,0,0,0,0,0,0,0,0
Kerala,2006,Total,2812,64,2876,3494,125,3619,5,0,5,4,0,4,6315,189,6504
Kerala,2007,Central Jail,2457,27,2484,789,35,824,32,0,32,7,0,7,3285,62,3347
Kerala,2007,District Jail,63,5,68,700,13,713,0,0,0,0,0,0,763,18,781
Kerala,2007,Sub_Jail,28,1,29,1649,38,1687,0,0,0,0,0,0,1677,39,1716
Kerala,2007,Women Jail,0,24,24,0,35,35,0,0,0,0,0,0,0,59,59
Kerala,2007,Borstal School,0,0,0,0,0,0,0,0,0,0,0,0,0,0,0
Kerala,2007,Open Jail,291,0,291,0,0,0,0,0,0,0,0,0,291,0,291
Kerala,2007,Special Jail,19,1,20,524,4,528,0,0,0,0,0,0,543,5,548
Kerala,2007,Others,0,0,0,0,0,0,0,0,0,0,0,0,0,0,0
Kerala,2007,Total,2858,58,2916,3662,125,3787,32,0,32,7,0,7,6559,183,6742
Kerala,2008,Central Jail,2230,30,2260,869,35,904,41,0,41,7,0,7,3147,65,3212
Kerala,2008,District Jail,93,1,94,713,17,730,0,0,0,0,0,0,806,18,824
Kerala,2008,Sub_Jail,26,0,26,1710,49,1759,0,0,0,0,0,0,1736,49,1785
Kerala,2008,Women Jail,0,22,22,0,17,17,0,0,0,0,0,0,0,39,39
Kerala,2008,Borstal School,0,0,0,0,0,0,0,0,0,0,0,0,0,0,0
Kerala,2008,Open Jail,321,0,321,0,0,0,0,0,0,0,0,0,321,0,321
Kerala,2008,Special Jail,26,1,27,514,10,524,0,0,0,0,0,0,540,11,551
Kerala,2008,Others,0,0,0,0,0,0,0,0,0,0,0,0,0,0,0
Kerala,2008,Total,2696,54,2750,3806,128,3934,41,0,41,7,0,7,6550,182,6732
Kerala,2009,Central Jail,2373,21,2394,885,60,945,70,0,70,3,0,3,3331,81,3412
Kerala,2009,District Jail,51,1,52,854,16,870,0,0,0,0,0,0,905,17,922
Kerala,2009,Sub_Jail,25,0,25,1567,39,1606,0,0,0,0,0,0,1592,39,1631
Kerala,2009,Women Jail,0,31,31,0,21,21,0,0,0,0,0,0,0,52,52
Kerala,2009,Borstal School,0,0,0,0,0,0,0,0,0,0,0,0,0,0,0
Kerala,2009,Open Jail,312,0,312,0,0,0,0,0,0,0,0,0,312,0,312
Kerala,2009,Special Jail,6,0,6,619,17,636,0,0,0,0,0,0,625,17,642
Kerala,2009,Others,0,0,0,0,0,0,0,0,0,0,0,0,0,0,0
Kerala,2009,Total,2767,53,2820,3925,153,4078,70,0,70,3,0,3,6765,206,6971
Kerala,2010,Central Jail,2326,13,2339,520,45,565,6,0,6,3,0,3,2855,58,2913
Kerala,2010,District Jail,55,3,58,544,18,562,0,0,0,0,0,0,599,21,620
Kerala,2010,Sub_Jail,18,0,18,1999,30,2029,0,0,0,0,0,0,2017,30,2047
Kerala,2010,Women Jail,0,34,34,0,44,44,0,0,0,0,0,0,0,78,78
Kerala,2010,Borstal School,0,0,0,0,0,0,0,0,0,0,0,0,0,0,0
Kerala,2010,Open Jail,333,0,333,0,0,0,0,0,0,0,0,0,333,0,333
Kerala,2010,Special Jail,2,0,2,674,25,699,0,0,0,0,0,0,676,25,701
Kerala,2010,Others,0,0,0,0,0,0,0,0,0,0,0,0,0,0,0
Kerala,2010,Total,2734,50,2784,3737,162,3899,6,0,6,3,0,3,6480,212,6692
Kerala,2011,Central Jail,1957,0,1957,328,0,328,8,0,8,3,0,3,2296,0,2296
Kerala,2011,District Jail,88,3,91,1019,17,1036,0,0,0,0,0,0,1107,20,1127
Kerala,2011,Sub_Jail,24,1,25,1428,27,1455,0,0,0,0,0,0,1452,28,1480
Kerala,2011,Women Jail,0,51,51,0,60,60,0,0,0,0,2,2,0,113,113
Kerala,2011,Borstal School,0,0,0,0,0,0,0,0,0,0,0,0,0,0,0
Kerala,2011,Open Jail,308,0,308,0,0,0,0,0,0,0,0,0,308,0,308
Kerala,2011,Special Jail,9,0,9,885,11,896,0,0,0,0,0,0,894,11,905
Kerala,2011,Others,0,0,0,0,0,0,0,0,0,0,0,0,0,0,0
Kerala,2011,Total,2386,55,2441,3660,115,3775,8,0,8,3,2,5,6057,172,6229
Kerala,2012,Central Jail,2023,0,2023,758,0,758,9,0,9,4,0,4,2794,0,2794
Kerala,2012,District Jail,96,1,97,1085,17,1102,0,0,0,0,0,0,1181,18,1199
Kerala,2012,Sub_Jail,98,0,98,1262,22,1284,0,0,0,0,0,0,1360,22,1382
Kerala,2012,Women Jail,0,55,55,0,69,69,0,0,0,0,3,3,0,127,127
Kerala,2012,Borstal School,0,0,0,50,13,63,0,0,0,0,0,0,50,13,63
Kerala,2012,Open Jail,463,0,463,0,0,0,0,0,0,0,0,0,463,0,463
Kerala,2012,Special Jail,30,0,30,865,24,889,0,0,0,0,0,0,895,24,919
Kerala,2012,Others,0,0,0,0,0,0,0,0,0,0,0,0,0,0,0
Kerala,2012,Total,2710,56,2766,4020,145,4165,9,0,9,4,3,7,6743,204,6947
Madhya Pradesh,2001,Central Jail,9871,232,10103,4059,163,4222,10,0,10,15,0,15,13955,395,14350
Madhya Pradesh,2001,District Jail,1206,30,1236,4982,218,5200,6,0,6,19,0,19,6213,248,6461
Madhya Pradesh,2001,Sub_Jail,657,0,657,7341,74,7415,0,0,0,5,0,5,8003,74,8077
Madhya Pradesh,2001,Women Jail,0,0,0,0,0,0,0,0,0,0,0,0,0,0,0
Madhya Pradesh,2001,Borstal School,199,0,199,0,0,0,0,0,0,0,0,0,199,0,199
Madhya Pradesh,2001,Open Jail,0,0,0,0,0,0,0,0,0,0,0,0,0,0,0
Madhya Pradesh,2001,Special Jail,0,0,0,0,0,0,0,0,0,0,0,0,0,0,0
Madhya Pradesh,2001,Others,0,0,0,0,0,0,0,0,0,0,0,0,0,0,0
Madhya Pradesh,2001,Total,11933,262,12195,16382,455,16837,16,0,16,39,0,39,28370,717,29087
Madhya Pradesh,2002,Central Jail,9857,221,10078,3902,174,4076,13,0,13,38,1,39,13810,396,14206
Madhya Pradesh,2002,District Jail,1147,38,1185,3977,220,4197,3,0,3,10,0,10,5137,258,5395
Madhya Pradesh,2002,Sub_Jail,642,1,643,7297,65,7362,0,0,0,10,0,10,7949,66,8015
Madhya Pradesh,2002,Women Jail,0,0,0,0,0,0,0,0,0,0,0,0,0,0,0
Madhya Pradesh,2002,Borstal School,151,0,151,0,0,0,0,0,0,0,0,0,151,0,151
Madhya Pradesh,2002,Open Jail,0,0,0,0,0,0,0,0,0,0,0,0,0,0,0
Madhya Pradesh,2002,Special Jail,0,0,0,0,0,0,0,0,0,0,0,0,0,0,0
Madhya Pradesh,2002,Others,0,0,0,0,0,0,0,0,0,0,0,0,0,0,0
Madhya Pradesh,2002,Total,11797,260,12057,15176,459,15635,16,0,16,58,1,59,27047,720,27767
Madhya Pradesh,2003,Central Jail,9927,226,10153,3723,193,3916,9,0,9,20,0,20,13679,419,14098
Madhya Pradesh,2003,District Jail,1204,318,1522,3315,189,3504,2,0,2,11,0,11,4532,507,5039
Madhya Pradesh,2003,Sub_Jail,957,1,958,6500,73,6573,2,0,2,15,0,15,7474,74,7548
Madhya Pradesh,2003,Women Jail,0,0,0,0,0,0,0,0,0,0,0,0,0,0,0
Madhya Pradesh,2003,Borstal School,147,0,147,0,0,0,0,0,0,0,0,0,147,0,147
Madhya Pradesh,2003,Open Jail,0,0,0,0,0,0,0,0,0,0,0,0,0,0,0
Madhya Pradesh,2003,Special Jail,0,0,0,0,0,0,0,0,0,0,0,0,0,0,0
Madhya Pradesh,2003,Others,0,0,0,0,0,0,0,0,0,0,0,0,0,0,0
Madhya Pradesh,2003,Total,12235,545,12780,13538,455,13993,13,0,13,46,0,46,25832,1000,26832
Madhya Pradesh,2004,Central Jail,10213,225,10438,4400,179,4579,5,0,5,32,0,32,14650,404,15054
Madhya Pradesh,2004,District Jail,1414,38,1452,4198,184,4382,0,0,0,29,0,29,5641,222,5863
Madhya Pradesh,2004,Sub_Jail,1021,6,1027,6718,98,6816,0,0,0,23,0,23,7762,104,7866
Madhya Pradesh,2004,Women Jail,0,0,0,0,0,0,0,0,0,0,0,0,0,0,0
Madhya Pradesh,2004,Borstal School,149,0,149,0,0,0,0,0,0,0,0,0,149,0,149
Madhya Pradesh,2004,Open Jail,0,0,0,0,0,0,0,0,0,0,0,0,0,0,0
Madhya Pradesh,2004,Special Jail,0,0,0,0,0,0,0,0,0,0,0,0,0,0,0
Madhya Pradesh,2004,Others,0,0,0,0,0,0,0,0,0,0,0,0,0,0,0
Madhya Pradesh,2004,Total,12797,269,13066,15316,461,15777,5,0,5,84,0,84,28202,730,28932
Madhya Pradesh,2005,Central Jail,11172,242,11414,4425,191,4616,21,0,21,23,0,23,15641,433,16074
Madhya Pradesh,2005,District Jail,1608,51,1659,4411,240,4651,0,0,0,14,0,14,6033,291,6324
Madhya Pradesh,2005,Sub_Jail,1128,4,1132,7635,89,7724,0,0,0,40,0,40,8803,93,8896
Madhya Pradesh,2005,Women Jail,0,0,0,0,0,0,0,0,0,0,0,0,0,0,0
Madhya Pradesh,2005,Borstal School,186,0,186,0,0,0,0,0,0,0,0,0,186,0,186
Madhya Pradesh,2005,Open Jail,0,0,0,0,0,0,0,0,0,0,0,0,0,0,0
Madhya Pradesh,2005,Special Jail,0,0,0,0,0,0,0,0,0,0,0,0,0,0,0
Madhya Pradesh,2005,Others,0,0,0,0,0,0,0,0,0,0,0,0,0,0,0
Madhya Pradesh,2005,Total,14094,297,14391,16471,520,16991,21,0,21,77,0,77,30663,817,31480
Madhya Pradesh,2006,Central Jail,11982,277,12259,4578,173,4751,21,0,21,24,3,27,16605,453,17058
Madhya Pradesh,2006,District Jail,1763,71,1834,4379,177,4556,0,0,0,18,0,18,6160,248,6408
Madhya Pradesh,2006,Sub_Jail,1121,1,1122,7302,77,7379,0,0,0,33,0,33,8456,78,8534
Madhya Pradesh,2006,Women Jail,0,0,0,0,0,0,0,0,0,0,0,0,0,0,0
Madhya Pradesh,2006,Borstal School,0,0,0,0,0,0,0,0,0,0,0,0,0,0,0
Madhya Pradesh,2006,Open Jail,0,0,0,0,0,0,0,0,0,0,0,0,0,0,0
Madhya Pradesh,2006,Special Jail,0,0,0,0,0,0,0,0,0,0,0,0,0,0,0
Madhya Pradesh,2006,Others,0,0,0,0,0,0,0,0,0,0,0,0,0,0,0
Madhya Pradesh,2006,Total,14866,349,15215,16259,427,16686,21,0,21,75,3,78,31221,779,32000
Madhya Pradesh,2007,Central Jail,12548,293,12841,4476,181,4657,34,0,34,24,0,24,17082,474,17556
Madhya Pradesh,2007,District Jail,1911,69,1980,3993,212,4205,0,0,0,13,0,13,5917,281,6198
Madhya Pradesh,2007,Sub_Jail,1481,11,1492,7350,88,7438,0,0,0,28,0,28,8859,99,8958
Madhya Pradesh,2007,Women Jail,0,0,0,0,0,0,0,0,0,0,0,0,0,0,0
Madhya Pradesh,2007,Borstal School,0,0,0,0,0,0,0,0,0,0,0,0,0,0,0
Madhya Pradesh,2007,Open Jail,0,0,0,0,0,0,0,0,0,0,0,0,0,0,0
Madhya Pradesh,2007,Special Jail,0,0,0,0,0,0,0,0,0,0,0,0,0,0,0
Madhya Pradesh,2007,Others,0,0,0,0,0,0,0,0,0,0,0,0,0,0,0
Madhya Pradesh,2007,Total,15940,373,16313,15819,481,16300,34,0,34,65,0,65,31858,854,32712
Madhya Pradesh,2008,Central Jail,12136,290,12426,4888,242,5130,93,0,93,20,0,20,17137,532,17669
Madhya Pradesh,2008,District Jail,1943,97,2040,5369,265,5634,10,0,10,24,0,24,7346,362,7708
Madhya Pradesh,2008,Sub_Jail,1627,9,1636,7645,79,7724,0,0,0,18,0,18,9290,88,9378
Madhya Pradesh,2008,Women Jail,0,0,0,0,0,0,0,0,0,0,0,0,0,0,0
Madhya Pradesh,2008,Borstal School,0,0,0,0,0,0,0,0,0,0,0,0,0,0,0
Madhya Pradesh,2008,Open Jail,0,0,0,0,0,0,0,0,0,0,0,0,0,0,0
Madhya Pradesh,2008,Special Jail,0,0,0,0,0,0,0,0,0,0,0,0,0,0,0
Madhya Pradesh,2008,Others,0,0,0,0,0,0,0,0,0,0,0,0,0,0,0
Madhya Pradesh,2008,Total,15706,396,16102,17902,586,18488,103,0,103,62,0,62,33773,982,34755
Madhya Pradesh,2009,Central Jail,11480,298,11778,4716,215,4931,51,0,51,27,0,27,16274,513,16787
Madhya Pradesh,2009,District Jail,2127,93,2220,4824,249,5073,0,0,0,25,0,25,6976,342,7318
Madhya Pradesh,2009,Sub_Jail,1360,9,1369,7240,67,7307,0,0,0,25,0,25,8625,76,8701
Madhya Pradesh,2009,Women Jail,0,0,0,0,0,0,0,0,0,0,0,0,0,0,0
Madhya Pradesh,2009,Borstal School,0,0,0,0,0,0,0,0,0,0,0,0,0,0,0
Madhya Pradesh,2009,Open Jail,0,0,0,0,0,0,0,0,0,0,0,0,0,0,0
Madhya Pradesh,2009,Special Jail,0,0,0,0,0,0,0,0,0,0,0,0,0,0,0
Madhya Pradesh,2009,Others,0,0,0,0,0,0,0,0,0,0,0,0,0,0,0
Madhya Pradesh,2009,Total,14967,400,15367,16780,531,17311,51,0,51,77,0,77,31875,931,32806
Madhya Pradesh,2010,Central Jail,11106,288,11394,4127,205,4332,86,0,86,31,0,31,15350,493,15843
Madhya Pradesh,2010,District Jail,1989,110,2099,4589,289,4878,0,0,0,64,9,73,6642,408,7050
Madhya Pradesh,2010,Sub_Jail,1050,14,1064,7232,80,7312,0,0,0,27,0,27,8309,94,8403
Madhya Pradesh,2010,Women Jail,0,0,0,0,0,0,0,0,0,0,0,0,0,0,0
Madhya Pradesh,2010,Borstal School,0,0,0,0,0,0,0,0,0,0,0,0,0,0,0
Madhya Pradesh,2010,Open Jail,22,0,22,0,0,0,0,0,0,0,0,0,22,0,22
Madhya Pradesh,2010,Special Jail,0,0,0,0,0,0,0,0,0,0,0,0,0,0,0
Madhya Pradesh,2010,Others,0,0,0,0,0,0,0,0,0,0,0,0,0,0,0
Madhya Pradesh,2010,Total,14167,412,14579,15948,574,16522,86,0,86,122,9,131,30323,995,31318
Madhya Pradesh,2011,Central Jail,11544,304,11848,4299,235,4534,130,0,130,35,0,35,16008,539,16547
Madhya Pradesh,2011,District Jail,2901,138,3039,4540,293,4833,2,0,2,51,1,52,7494,432,7926
Madhya Pradesh,2011,Sub_Jail,1033,12,1045,7232,102,7334,0,0,0,40,0,40,8305,114,8419
Madhya Pradesh,2011,Women Jail,0,0,0,0,0,0,0,0,0,0,0,0,0,0,0
Madhya Pradesh,2011,Borstal School,0,0,0,0,0,0,0,0,0,0,0,0,0,0,0
Madhya Pradesh,2011,Open Jail,24,0,24,0,0,0,0,0,0,0,0,0,24,0,24
Madhya Pradesh,2011,Special Jail,0,0,0,0,0,0,0,0,0,0,0,0,0,0,0
Madhya Pradesh,2011,Others,0,0,0,0,0,0,0,0,0,0,0,0,0,0,0
Madhya Pradesh,2011,Total,15502,454,15956,16071,630,16701,132,0,132,126,1,127,31831,1085,32916
Madhya Pradesh,2012,Central Jail,11575,326,11901,4212,229,4441,138,1,139,9,0,9,15934,556,16490
Madhya Pradesh,2012,District Jail,3072,149,3221,5591,370,5961,0,0,0,47,0,47,8710,519,9229
Madhya Pradesh,2012,Sub_Jail,959,19,978,7130,87,7217,0,0,0,20,0,20,8109,106,8215
Madhya Pradesh,2012,Women Jail,0,0,0,0,0,0,0,0,0,0,0,0,0,0,0
Madhya Pradesh,2012,Borstal School,0,0,0,0,0,0,0,0,0,0,0,0,0,0,0
Madhya Pradesh,2012,Open Jail,25,0,25,0,0,0,0,0,0,0,0,0,25,0,25
Madhya Pradesh,2012,Special Jail,0,0,0,0,0,0,0,0,0,0,0,0,0,0,0
Madhya Pradesh,2012,Others,0,0,0,0,0,0,0,0,0,0,0,0,0,0,0
Madhya Pradesh,2012,Total,15631,494,16125,16933,686,17619,138,1,139,76,0,76,32778,1181,33959
Maharashtra,2001,Central Jail,5379,265,5644,9250,290,9540,322,1,323,0,0,0,14951,556,15507
Maharashtra,2001,District Jail,656,11,667,5505,291,5796,8,0,8,4,0,4,6173,302,6475
Maharashtra,2001,Sub_Jail,0,0,0,0,0,0,0,0,0,0,0,0,0,0,0
Maharashtra,2001,Women Jail,0,0,0,0,0,0,0,0,0,0,0,0,0,0,0
Maharashtra,2001,Borstal School,0,0,0,0,0,0,34,0,34,0,0,0,34,0,34
Maharashtra,2001,Open Jail,357,0,357,0,0,0,0,0,0,0,0,0,357,0,357
Maharashtra,2001,Special Jail,20,1,21,108,2,110,0,0,0,0,0,0,128,3,131
Maharashtra,2001,Others,21,2,23,0,0,0,0,0,0,0,0,0,21,2,23
Maharashtra,2001,Total,6433,279,6712,14863,583,15446,364,1,365,4,0,4,21664,863,22527
Maharashtra,2002,Central Jail,5825,298,6123,8287,297,8584,279,8,287,0,0,0,14391,603,14994
Maharashtra,2002,District Jail,649,11,660,5492,348,5840,2,0,2,0,0,0,6143,359,6502
Maharashtra,2002,Sub_Jail,0,0,0,0,0,0,0,0,0,0,0,0,0,0,0
Maharashtra,2002,Women Jail,0,0,0,0,0,0,0,0,0,0,0,0,0,0,0
Maharashtra,2002,Borstal School,0,0,0,0,0,0,18,0,18,0,0,0,18,0,18
Maharashtra,2002,Open Jail,369,0,369,0,0,0,0,0,0,0,0,0,369,0,369
Maharashtra,2002,Special Jail,24,0,24,90,3,93,0,0,0,0,0,0,114,3,117
Maharashtra,2002,Others,20,2,22,0,0,0,0,0,0,0,0,0,20,2,22
Maharashtra,2002,Total,6887,311,7198,13869,648,14517,299,8,307,0,0,0,21055,967,22022
Maharashtra,2003,Central Jail,6565,360,6925,8984,129,9113,188,1,189,0,0,0,15737,490,16227
Maharashtra,2003,District Jail,830,14,844,5688,378,6066,0,0,0,4,0,4,6522,392,6914
Maharashtra,2003,Sub_Jail,0,0,0,0,0,0,0,0,0,0,0,0,0,0,0
Maharashtra,2003,Women Jail,0,14,14,0,220,220,0,0,0,0,0,0,0,234,234
Maharashtra,2003,Borstal School,0,0,0,0,0,0,0,0,0,17,0,17,17,0,17
Maharashtra,2003,Open Jail,390,0,390,0,0,0,0,0,0,0,0,0,390,0,390
Maharashtra,2003,Special Jail,24,0,24,104,1,105,0,0,0,0,0,0,128,1,129
Maharashtra,2003,Others,16,2,18,0,0,0,0,0,0,0,0,0,16,2,18
Maharashtra,2003,Total,7825,390,8215,14776,728,15504,188,1,189,21,0,21,22810,1119,23929
Maharashtra,2004,Central Jail,7159,443,7602,9472,141,9613,165,0,165,1,0,1,16797,584,17381
Maharashtra,2004,District Jail,837,25,862,5434,371,5805,5,0,5,7,0,7,6283,396,6679
Maharashtra,2004,Sub_Jail,0,0,0,0,0,0,0,0,0,0,0,0,0,0,0
Maharashtra,2004,Women Jail,0,15,15,0,259,259,0,0,0,0,0,0,0,274,274
Maharashtra,2004,Borstal School,0,0,0,0,0,0,0,0,0,29,0,29,29,0,29
Maharashtra,2004,Open Jail,418,0,418,0,0,0,0,0,0,0,0,0,418,0,418
Maharashtra,2004,Special Jail,20,0,20,106,1,107,0,0,0,0,0,0,126,1,127
Maharashtra,2004,Others,13,1,14,0,0,0,0,0,0,0,0,0,13,1,14
Maharashtra,2004,Total,8447,484,8931,15012,772,15784,170,0,170,37,0,37,23666,1256,24922
Maharashtra,2005,Central Jail,7225,428,7653,9383,173,9556,234,1,235,0,0,0,16842,602,17444
Maharashtra,2005,District Jail,887,18,905,5615,359,5974,0,0,0,0,0,0,6502,377,6879
Maharashtra,2005,Sub_Jail,0,0,0,0,0,0,0,0,0,0,0,0,0,0,0
Maharashtra,2005,Women Jail,0,12,12,0,326,326,0,0,0,0,0,0,0,338,338
Maharashtra,2005,Borstal School,0,0,0,0,0,0,0,0,0,21,0,21,21,0,21
Maharashtra,2005,Open Jail,559,0,559,0,0,0,0,0,0,0,0,0,559,0,559
Maharashtra,2005,Special Jail,85,1,86,86,4,90,0,0,0,0,0,0,171,5,176
Maharashtra,2005,Others,10,4,14,0,0,0,0,0,0,0,0,0,10,4,14
Maharashtra,2005,Total,8766,463,9229,15084,862,15946,234,1,235,21,0,21,24105,1326,25431
Maharashtra,2006,Central Jail,7213,385,7598,9405,192,9597,242,1,243,0,0,0,16860,578,17438
Maharashtra,2006,District Jail,741,23,764,5776,361,6137,2,0,2,1,0,1,6520,384,6904
Maharashtra,2006,Sub_Jail,7,0,7,148,9,157,0,0,0,0,0,0,155,9,164
Maharashtra,2006,Women Jail,0,36,36,0,345,345,0,0,0,0,0,0,0,381,381
Maharashtra,2006,Borstal School,0,0,0,0,0,0,29,0,29,0,0,0,29,0,29
Maharashtra,2006,Open Jail,642,0,642,0,0,0,0,0,0,0,0,0,642,0,642
Maharashtra,2006,Special Jail,71,1,72,125,4,129,0,0,0,0,0,0,196,5,201
Maharashtra,2006,Others,26,4,30,0,0,0,0,0,0,0,0,0,26,4,30
Maharashtra,2006,Total,8700,449,9149,15454,911,16365,273,1,274,1,0,1,24428,1361,25789
Maharashtra,2007,Central Jail,7360,449,7809,9314,191,9505,112,1,113,0,0,0,16786,641,17427
Maharashtra,2007,District Jail,649,32,681,6130,442,6572,4,0,4,0,0,0,6783,474,7257
Maharashtra,2007,Sub_Jail,4,0,4,121,9,130,0,0,0,0,0,0,125,9,134
Maharashtra,2007,Women Jail,0,26,26,0,193,193,0,0,0,0,0,0,0,219,219
Maharashtra,2007,Borstal School,0,0,0,0,0,0,35,0,35,0,0,0,35,0,35
Maharashtra,2007,Open Jail,624,0,624,0,0,0,0,0,0,0,0,0,624,0,624
Maharashtra,2007,Special Jail,35,0,35,131,6,137,0,0,0,0,0,0,166,6,172
Maharashtra,2007,Others,20,4,24,0,0,0,0,0,0,0,0,0,20,4,24
Maharashtra,2007,Total,8692,511,9203,15696,841,16537,151,1,152,0,0,0,24539,1353,25892
Maharashtra,2008,Central Jail,7501,466,7967,9604,193,9797,66,2,68,0,0,0,17171,661,17832
Maharashtra,2008,District Jail,547,12,559,5781,434,6215,3,0,3,0,0,0,6331,446,6777
Maharashtra,2008,Sub_Jail,0,0,0,114,9,123,0,0,0,0,0,0,114,9,123
Maharashtra,2008,Women Jail,0,18,18,0,296,296,0,0,0,0,0,0,0,314,314
Maharashtra,2008,Borstal School,0,0,0,0,0,0,42,0,42,0,0,0,42,0,42
Maharashtra,2008,Open Jail,584,0,584,0,0,0,0,0,0,0,0,0,584,0,584
Maharashtra,2008,Special Jail,26,0,26,119,4,123,0,0,0,0,0,0,145,4,149
Maharashtra,2008,Others,7,3,10,0,0,0,0,0,0,0,0,0,7,3,10
Maharashtra,2008,Total,8665,499,9164,15618,936,16554,111,2,113,0,0,0,24394,1437,25831
Maharashtra,2009,Central Jail,6879,471,7350,9608,165,9773,33,0,33,0,0,0,16520,636,17156
Maharashtra,2009,District Jail,463,6,469,5293,448,5741,0,0,0,0,0,0,5756,454,6210
Maharashtra,2009,Sub_Jail,4,0,4,251,12,263,0,0,0,0,0,0,255,12,267
Maharashtra,2009,Women Jail,0,49,49,0,323,323,0,0,0,0,0,0,0,372,372
Maharashtra,2009,Borstal School,0,0,0,0,0,0,49,0,49,0,0,0,49,0,49
Maharashtra,2009,Open Jail,713,0,713,0,0,0,0,0,0,0,0,0,713,0,713
Maharashtra,2009,Special Jail,16,0,16,75,5,80,0,0,0,0,0,0,91,5,96
Maharashtra,2009,Others,18,3,21,0,0,0,0,0,0,0,0,0,18,3,21
Maharashtra,2009,Total,8093,529,8622,15227,953,16180,82,0,82,0,0,0,23402,1482,24884
Maharashtra,2010,Central Jail,6481,392,6873,9770,194,9964,34,1,35,0,0,0,16285,587,16872
Maharashtra,2010,District Jail,414,4,418,5175,389,5564,1,0,1,0,0,0,5590,393,5983
Maharashtra,2010,Sub_Jail,10,0,10,201,6,207,0,0,0,0,0,0,211,6,217
Maharashtra,2010,Women Jail,0,5,5,0,253,253,0,1,1,0,0,0,0,259,259
Maharashtra,2010,Borstal School,0,0,0,0,0,0,40,0,40,0,0,0,40,0,40
Maharashtra,2010,Open Jail,771,46,817,0,0,0,0,0,0,0,0,0,771,46,817
Maharashtra,2010,Special Jail,4,0,4,73,4,77,0,0,0,0,0,0,77,4,81
Maharashtra,2010,Others,10,2,12,0,0,0,0,0,0,0,0,0,10,2,12
Maharashtra,2010,Total,7690,449,8139,15219,846,16065,75,2,77,0,0,0,22984,1297,24281
Maharashtra,2011,Central Jail,6248,383,6631,9834,196,10030,36,0,36,0,0,0,16118,579,16697
Maharashtra,2011,District Jail,474,10,484,5207,482,5689,1,0,1,0,0,0,5682,492,6174
Maharashtra,2011,Sub_Jail,0,0,0,44,3,47,0,0,0,0,0,0,44,3,47
Maharashtra,2011,Women Jail,0,25,25,0,231,231,0,0,0,0,0,0,0,256,256
Maharashtra,2011,Borstal School,0,0,0,0,0,0,29,0,29,0,0,0,29,0,29
Maharashtra,2011,Open Jail,741,41,782,0,0,0,0,0,0,0,0,0,741,41,782
Maharashtra,2011,Special Jail,9,0,9,64,3,67,0,0,0,0,0,0,73,3,76
Maharashtra,2011,Others,19,2,21,0,0,0,0,0,0,0,0,0,19,2,21
Maharashtra,2011,Total,7491,461,7952,15149,915,16064,66,0,66,0,0,0,22706,1376,24082
Maharashtra,2012,Central Jail,6484,375,6859,9970,140,10110,39,0,39,0,0,0,16493,515,17008
Maharashtra,2012,District Jail,402,47,449,5456,462,5918,3,0,3,0,0,0,5861,509,6370
Maharashtra,2012,Sub_Jail,0,0,0,46,0,46,0,0,0,0,0,0,46,0,46
Maharashtra,2012,Women Jail,0,4,4,0,277,277,0,0,0,0,0,0,0,281,281
Maharashtra,2012,Borstal School,0,0,0,0,0,0,0,0,0,15,0,15,15,0,15
Maharashtra,2012,Open Jail,660,29,689,0,0,0,0,0,0,0,0,0,660,29,689
Maharashtra,2012,Special Jail,6,1,7,73,2,75,0,0,0,0,0,0,79,3,82
Maharashtra,2012,Others,17,1,18,0,0,0,0,0,0,0,0,0,17,1,18
Maharashtra,2012,Total,7569,457,8026,15545,881,16426,42,0,42,15,0,15,23171,1338,24509
Manipur,2001,Central Jail,22,0,22,315,13,328,85,11,96,0,0,0,422,24,446
Manipur,2001,District Jail,0,0,0,16,0,16,0,0,0,0,0,0,16,0,16
Manipur,2001,Sub_Jail,0,0,0,0,0,0,0,0,0,0,0,0,0,0,0
Manipur,2001,Women Jail,0,0,0,0,0,0,0,0,0,0,0,0,0,0,0
Manipur,2001,Borstal School,0,0,0,0,0,0,0,0,0,0,0,0,0,0,0
Manipur,2001,Open Jail,0,0,0,0,0,0,0,0,0,0,0,0,0,0,0
Manipur,2001,Special Jail,0,0,0,0,0,0,0,0,0,0,0,0,0,0,0
Manipur,2001,Others,0,0,0,0,0,0,0,0,0,0,0,0,0,0,0
Manipur,2001,Total,22,0,22,331,13,344,85,11,96,0,0,0,438,24,462
Manipur,2002,Central Jail,36,1,37,332,21,353,113,6,119,0,0,0,481,28,509
Manipur,2002,District Jail,0,0,0,7,0,7,0,0,0,0,0,0,7,0,7
Manipur,2002,Sub_Jail,0,0,0,0,0,0,0,0,0,0,0,0,0,0,0
Manipur,2002,Women Jail,0,0,0,0,0,0,0,0,0,0,0,0,0,0,0
Manipur,2002,Borstal School,0,0,0,0,0,0,0,0,0,0,0,0,0,0,0
Manipur,2002,Open Jail,0,0,0,0,0,0,0,0,0,0,0,0,0,0,0
Manipur,2002,Special Jail,0,0,0,0,0,0,0,0,0,0,0,0,0,0,0
Manipur,2002,Others,0,0,0,0,0,0,0,0,0,0,0,0,0,0,0
Manipur,2002,Total,36,1,37,339,21,360,113,6,119,0,0,0,488,28,516
Manipur,2003,Central Jail,32,1,33,338,18,356,130,8,138,0,0,0,500,27,527
Manipur,2003,District Jail,0,0,0,5,0,5,0,0,0,0,0,0,5,0,5
Manipur,2003,Sub_Jail,0,0,0,0,0,0,0,0,0,0,0,0,0,0,0
Manipur,2003,Women Jail,0,0,0,0,0,0,0,0,0,0,0,0,0,0,0
Manipur,2003,Borstal School,0,0,0,0,0,0,0,0,0,0,0,0,0,0,0
Manipur,2003,Open Jail,0,0,0,0,0,0,0,0,0,0,0,0,0,0,0
Manipur,2003,Special Jail,0,0,0,0,0,0,0,0,0,0,0,0,0,0,0
Manipur,2003,Others,0,0,0,0,0,0,0,0,0,0,0,0,0,0,0
Manipur,2003,Total,32,1,33,343,18,361,130,8,138,0,0,0,505,27,532
Manipur,2004,Central Jail,32,0,32,338,21,359,72,2,74,0,0,0,442,23,465
Manipur,2004,District Jail,0,0,0,0,0,0,0,0,0,0,0,0,0,0,0
Manipur,2004,Sub_Jail,0,0,0,0,0,0,0,0,0,0,0,0,0,0,0
Manipur,2004,Women Jail,0,0,0,0,0,0,0,0,0,0,0,0,0,0,0
Manipur,2004,Borstal School,0,0,0,0,0,0,0,0,0,0,0,0,0,0,0
Manipur,2004,Open Jail,0,0,0,0,0,0,0,0,0,0,0,0,0,0,0
Manipur,2004,Special Jail,0,0,0,0,0,0,0,0,0,0,0,0,0,0,0
Manipur,2004,Others,0,0,0,0,0,0,0,0,0,0,0,0,0,0,0
Manipur,2004,Total,32,0,32,338,21,359,72,2,74,0,0,0,442,23,465
Manipur,2005,Central Jail,31,0,31,376,19,395,96,7,103,0,0,0,503,26,529
Manipur,2005,District Jail,0,0,0,0,0,0,0,0,0,0,0,0,0,0,0
Manipur,2005,Sub_Jail,0,0,0,0,0,0,0,0,0,0,0,0,0,0,0
Manipur,2005,Women Jail,0,0,0,0,0,0,0,0,0,0,0,0,0,0,0
Manipur,2005,Borstal School,0,0,0,0,0,0,0,0,0,0,0,0,0,0,0
Manipur,2005,Open Jail,0,0,0,0,0,0,0,0,0,0,0,0,0,0,0
Manipur,2005,Special Jail,0,0,0,0,0,0,0,0,0,0,0,0,0,0,0
Manipur,2005,Others,0,0,0,0,0,0,0,0,0,0,0,0,0,0,0
Manipur,2005,Total,31,0,31,376,19,395,96,7,103,0,0,0,503,26,529
Manipur,2006,Central Jail,33,0,33,308,15,323,42,0,42,0,0,0,383,15,398
Manipur,2006,District Jail,0,0,0,0,0,0,0,0,0,0,0,0,0,0,0
Manipur,2006,Sub_Jail,0,0,0,0,0,0,0,0,0,0,0,0,0,0,0
Manipur,2006,Women Jail,0,0,0,0,0,0,0,0,0,0,0,0,0,0,0
Manipur,2006,Borstal School,0,0,0,0,0,0,0,0,0,0,0,0,0,0,0
Manipur,2006,Open Jail,0,0,0,0,0,0,0,0,0,0,0,0,0,0,0
Manipur,2006,Special Jail,0,0,0,0,0,0,0,0,0,0,0,0,0,0,0
Manipur,2006,Others,0,0,0,0,0,0,0,0,0,0,0,0,0,0,0
Manipur,2006,Total,33,0,33,308,15,323,42,0,42,0,0,0,383,15,398
Manipur,2007,Central Jail,56,0,56,246,6,252,132,4,136,0,0,0,434,10,444
Manipur,2007,District Jail,0,0,0,0,0,0,0,0,0,0,0,0,0,0,0
Manipur,2007,Sub_Jail,0,0,0,0,0,0,0,0,0,0,0,0,0,0,0
Manipur,2007,Women Jail,0,0,0,0,0,0,0,0,0,0,0,0,0,0,0
Manipur,2007,Borstal School,0,0,0,0,0,0,0,0,0,0,0,0,0,0,0
Manipur,2007,Open Jail,0,0,0,0,0,0,0,0,0,0,0,0,0,0,0
Manipur,2007,Special Jail,0,0,0,0,0,0,0,0,0,0,0,0,0,0,0
Manipur,2007,Others,0,0,0,0,0,0,0,0,0,0,0,0,0,0,0
Manipur,2007,Total,56,0,56,246,6,252,132,4,136,0,0,0,434,10,444
Manipur,2008,Central Jail,36,0,36,252,17,269,150,10,160,0,0,0,438,27,465
Manipur,2008,District Jail,0,0,0,0,0,0,0,0,0,0,0,0,0,0,0
Manipur,2008,Sub_Jail,0,0,0,0,0,0,0,0,0,0,0,0,0,0,0
Manipur,2008,Women Jail,0,0,0,0,0,0,0,0,0,0,0,0,0,0,0
Manipur,2008,Borstal School,0,0,0,0,0,0,0,0,0,0,0,0,0,0,0
Manipur,2008,Open Jail,0,0,0,0,0,0,0,0,0,0,0,0,0,0,0
Manipur,2008,Special Jail,0,0,0,0,0,0,0,0,0,0,0,0,0,0,0
Manipur,2008,Others,0,0,0,0,0,0,0,0,0,0,0,0,0,0,0
Manipur,2008,Total,36,0,36,252,17,269,150,10,160,0,0,0,438,27,465
Manipur,2009,Central Jail,34,0,34,323,32,355,127,16,143,0,0,0,484,48,532
Manipur,2009,District Jail,0,0,0,0,0,0,0,0,0,0,0,0,0,0,0
Manipur,2009,Sub_Jail,0,0,0,0,0,0,0,0,0,0,0,0,0,0,0
Manipur,2009,Women Jail,0,0,0,0,0,0,0,0,0,0,0,0,0,0,0
Manipur,2009,Borstal School,0,0,0,0,0,0,0,0,0,0,0,0,0,0,0
Manipur,2009,Open Jail,0,0,0,0,0,0,0,0,0,0,0,0,0,0,0
Manipur,2009,Special Jail,0,0,0,0,0,0,0,0,0,0,0,0,0,0,0
Manipur,2009,Others,0,0,0,0,0,0,0,0,0,0,0,0,0,0,0
Manipur,2009,Total,34,0,34,323,32,355,127,16,143,0,0,0,484,48,532
Manipur,2010,Central Jail,31,1,32,363,10,373,185,28,213,0,0,0,579,39,618
Manipur,2010,District Jail,0,0,0,0,0,0,0,0,0,0,0,0,0,0,0
Manipur,2010,Sub_Jail,0,0,0,0,0,0,0,0,0,0,0,0,0,0,0
Manipur,2010,Women Jail,0,0,0,0,0,0,0,0,0,0,0,0,0,0,0
Manipur,2010,Borstal School,0,0,0,0,0,0,0,0,0,0,0,0,0,0,0
Manipur,2010,Open Jail,0,0,0,0,0,0,0,0,0,0,0,0,0,0,0
Manipur,2010,Special Jail,0,0,0,0,0,0,0,0,0,0,0,0,0,0,0
Manipur,2010,Others,0,0,0,0,0,0,0,0,0,0,0,0,0,0,0
Manipur,2010,Total,31,1,32,363,10,373,185,28,213,0,0,0,579,39,618
Manipur,2011,Central Jail,31,1,32,428,26,454,149,12,161,0,0,0,608,39,647
Manipur,2011,District Jail,0,0,0,0,0,0,0,0,0,0,0,0,0,0,0
Manipur,2011,Sub_Jail,0,0,0,0,0,0,0,0,0,0,0,0,0,0,0
Manipur,2011,Women Jail,0,0,0,0,0,0,0,0,0,0,0,0,0,0,0
Manipur,2011,Borstal School,0,0,0,0,0,0,0,0,0,0,0,0,0,0,0
Manipur,2011,Open Jail,0,0,0,0,0,0,0,0,0,0,0,0,0,0,0
Manipur,2011,Special Jail,0,0,0,0,0,0,0,0,0,0,0,0,0,0,0
Manipur,2011,Others,0,0,0,0,0,0,0,0,0,0,0,0,0,0,0
Manipur,2011,Total,31,1,32,428,26,454,149,12,161,0,0,0,608,39,647
Manipur,2012,Central Jail,63,1,64,506,21,527,121,11,132,0,0,0,690,33,723
Manipur,2012,District Jail,0,0,0,0,0,0,0,0,0,0,0,0,0,0,0
Manipur,2012,Sub_Jail,0,0,0,0,0,0,0,0,0,0,0,0,0,0,0
Manipur,2012,Women Jail,0,0,0,0,0,0,0,0,0,0,0,0,0,0,0
Manipur,2012,Borstal School,0,0,0,0,0,0,0,0,0,0,0,0,0,0,0
Manipur,2012,Open Jail,0,0,0,0,0,0,0,0,0,0,0,0,0,0,0
Manipur,2012,Special Jail,0,0,0,0,0,0,0,0,0,0,0,0,0,0,0
Manipur,2012,Others,0,0,0,0,0,0,0,0,0,0,0,0,0,0,0
Manipur,2012,Total,63,1,64,506,21,527,121,11,132,0,0,0,690,33,723
Meghalaya,2001,Central Jail,0,0,0,0,0,0,0,0,0,0,0,0,0,0,0
Meghalaya,2001,District Jail,14,0,14,497,8,505,7,0,7,0,0,0,518,8,526
Meghalaya,2001,Sub_Jail,0,0,0,0,0,0,0,0,0,0,0,0,0,0,0
Meghalaya,2001,Women Jail,0,0,0,0,0,0,0,0,0,0,0,0,0,0,0
Meghalaya,2001,Borstal School,0,0,0,0,0,0,0,0,0,0,0,0,0,0,0
Meghalaya,2001,Open Jail,0,0,0,0,0,0,0,0,0,0,0,0,0,0,0
Meghalaya,2001,Special Jail,0,0,0,0,0,0,0,0,0,0,0,0,0,0,0
Meghalaya,2001,Others,0,0,0,0,0,0,0,0,0,0,0,0,0,0,0
Meghalaya,2001,Total,14,0,14,497,8,505,7,0,7,0,0,0,518,8,526
Meghalaya,2002,Central Jail,0,0,0,0,0,0,0,0,0,0,0,0,0,0,0
Meghalaya,2002,District Jail,20,0,20,495,11,506,6,0,6,0,0,0,521,11,532
Meghalaya,2002,Sub_Jail,0,0,0,0,0,0,0,0,0,0,0,0,0,0,0
Meghalaya,2002,Women Jail,0,0,0,0,0,0,0,0,0,0,0,0,0,0,0
Meghalaya,2002,Borstal School,0,0,0,0,0,0,0,0,0,0,0,0,0,0,0
Meghalaya,2002,Open Jail,0,0,0,0,0,0,0,0,0,0,0,0,0,0,0
Meghalaya,2002,Special Jail,0,0,0,0,0,0,0,0,0,0,0,0,0,0,0
Meghalaya,2002,Others,0,0,0,0,0,0,0,0,0,0,0,0,0,0,0
Meghalaya,2002,Total,20,0,20,495,11,506,6,0,6,0,0,0,521,11,532
Meghalaya,2003,Central Jail,0,0,0,0,0,0,0,0,0,0,0,0,0,0,0
Meghalaya,2003,District Jail,39,0,39,500,8,508,8,0,8,0,0,0,547,8,555
Meghalaya,2003,Sub_Jail,0,0,0,0,0,0,0,0,0,0,0,0,0,0,0
Meghalaya,2003,Women Jail,0,0,0,0,0,0,0,0,0,0,0,0,0,0,0
Meghalaya,2003,Borstal School,0,0,0,0,0,0,0,0,0,0,0,0,0,0,0
Meghalaya,2003,Open Jail,0,0,0,0,0,0,0,0,0,0,0,0,0,0,0
Meghalaya,2003,Special Jail,0,0,0,0,0,0,0,0,0,0,0,0,0,0,0
Meghalaya,2003,Others,0,0,0,0,0,0,0,0,0,0,0,0,0,0,0
Meghalaya,2003,Total,39,0,39,500,8,508,8,0,8,0,0,0,547,8,555
Meghalaya,2004,Central Jail,0,0,0,0,0,0,0,0,0,0,0,0,0,0,0
Meghalaya,2004,District Jail,41,0,41,420,10,430,22,0,22,0,0,0,483,10,493
Meghalaya,2004,Sub_Jail,0,0,0,0,0,0,0,0,0,0,0,0,0,0,0
Meghalaya,2004,Women Jail,0,0,0,0,0,0,0,0,0,0,0,0,0,0,0
Meghalaya,2004,Borstal School,0,0,0,0,0,0,0,0,0,0,0,0,0,0,0
Meghalaya,2004,Open Jail,0,0,0,0,0,0,0,0,0,0,0,0,0,0,0
Meghalaya,2004,Special Jail,0,0,0,0,0,0,0,0,0,0,0,0,0,0,0
Meghalaya,2004,Others,0,0,0,0,0,0,0,0,0,0,0,0,0,0,0
Meghalaya,2004,Total,41,0,41,420,10,430,22,0,22,0,0,0,483,10,493
Meghalaya,2005,Central Jail,0,0,0,0,0,0,0,0,0,0,0,0,0,0,0
Meghalaya,2005,District Jail,42,4,46,478,9,487,22,0,22,0,0,0,542,13,555
Meghalaya,2005,Sub_Jail,0,0,0,0,0,0,0,0,0,0,0,0,0,0,0
Meghalaya,2005,Women Jail,0,0,0,0,0,0,0,0,0,0,0,0,0,0,0
Meghalaya,2005,Borstal School,0,0,0,0,0,0,0,0,0,0,0,0,0,0,0
Meghalaya,2005,Open Jail,0,0,0,0,0,0,0,0,0,0,0,0,0,0,0
Meghalaya,2005,Special Jail,0,0,0,0,0,0,0,0,0,0,0,0,0,0,0
Meghalaya,2005,Others,0,0,0,0,0,0,0,0,0,0,0,0,0,0,0
Meghalaya,2005,Total,42,4,46,478,9,487,22,0,22,0,0,0,542,13,555
Meghalaya,2006,Central Jail,0,0,0,0,0,0,0,0,0,0,0,0,0,0,0
Meghalaya,2006,District Jail,56,2,58,532,7,539,24,0,24,0,0,0,612,9,621
Meghalaya,2006,Sub_Jail,0,0,0,0,0,0,0,0,0,0,0,0,0,0,0
Meghalaya,2006,Women Jail,0,0,0,0,0,0,0,0,0,0,0,0,0,0,0
Meghalaya,2006,Borstal School,0,0,0,0,0,0,0,0,0,0,0,0,0,0,0
Meghalaya,2006,Open Jail,0,0,0,0,0,0,0,0,0,0,0,0,0,0,0
Meghalaya,2006,Special Jail,0,0,0,0,0,0,0,0,0,0,0,0,0,0,0
Meghalaya,2006,Others,0,0,0,0,0,0,0,0,0,0,0,0,0,0,0
Meghalaya,2006,Total,56,2,58,532,7,539,24,0,24,0,0,0,612,9,621
Meghalaya,2007,Central Jail,0,0,0,0,0,0,0,0,0,0,0,0,0,0,0
Meghalaya,2007,District Jail,70,2,72,553,4,557,36,0,36,0,0,0,659,6,665
Meghalaya,2007,Sub_Jail,0,0,0,0,0,0,0,0,0,0,0,0,0,0,0
Meghalaya,2007,Women Jail,0,0,0,0,0,0,0,0,0,0,0,0,0,0,0
Meghalaya,2007,Borstal School,0,0,0,0,0,0,0,0,0,0,0,0,0,0,0
Meghalaya,2007,Open Jail,0,0,0,0,0,0,0,0,0,0,0,0,0,0,0
Meghalaya,2007,Special Jail,0,0,0,0,0,0,0,0,0,0,0,0,0,0,0
Meghalaya,2007,Others,0,0,0,0,0,0,0,0,0,0,0,0,0,0,0
Meghalaya,2007,Total,70,2,72,553,4,557,36,0,36,0,0,0,659,6,665
Meghalaya,2008,Central Jail,0,0,0,0,0,0,0,0,0,0,0,0,0,0,0
Meghalaya,2008,District Jail,90,2,92,476,4,480,47,0,47,0,0,0,613,6,619
Meghalaya,2008,Sub_Jail,0,0,0,0,0,0,0,0,0,0,0,0,0,0,0
Meghalaya,2008,Women Jail,0,0,0,0,0,0,0,0,0,0,0,0,0,0,0
Meghalaya,2008,Borstal School,0,0,0,0,0,0,0,0,0,0,0,0,0,0,0
Meghalaya,2008,Open Jail,0,0,0,0,0,0,0,0,0,0,0,0,0,0,0
Meghalaya,2008,Special Jail,0,0,0,0,0,0,0,0,0,0,0,0,0,0,0
Meghalaya,2008,Others,0,0,0,0,0,0,0,0,0,0,0,0,0,0,0
Meghalaya,2008,Total,90,2,92,476,4,480,47,0,47,0,0,0,613,6,619
Meghalaya,2009,Central Jail,0,0,0,0,0,0,0,0,0,0,0,0,0,0,0
Meghalaya,2009,District Jail,97,1,98,513,7,520,38,0,38,0,0,0,648,8,656
Meghalaya,2009,Sub_Jail,0,0,0,0,0,0,0,0,0,0,0,0,0,0,0
Meghalaya,2009,Women Jail,0,0,0,0,0,0,0,0,0,0,0,0,0,0,0
Meghalaya,2009,Borstal School,0,0,0,0,0,0,0,0,0,0,0,0,0,0,0
Meghalaya,2009,Open Jail,0,0,0,0,0,0,0,0,0,0,0,0,0,0,0
Meghalaya,2009,Special Jail,0,0,0,0,0,0,0,0,0,0,0,0,0,0,0
Meghalaya,2009,Others,0,0,0,0,0,0,0,0,0,0,0,0,0,0,0
Meghalaya,2009,Total,97,1,98,513,7,520,38,0,38,0,0,0,648,8,656
Meghalaya,2010,Central Jail,0,0,0,0,0,0,0,0,0,0,0,0,0,0,0
Meghalaya,2010,District Jail,70,0,70,507,6,513,43,0,43,0,0,0,620,6,626
Meghalaya,2010,Sub_Jail,0,0,0,0,0,0,0,0,0,0,0,0,0,0,0
Meghalaya,2010,Women Jail,0,0,0,0,0,0,0,0,0,0,0,0,0,0,0
Meghalaya,2010,Borstal School,0,0,0,0,0,0,0,0,0,0,0,0,0,0,0
Meghalaya,2010,Open Jail,0,0,0,0,0,0,0,0,0,0,0,0,0,0,0
Meghalaya,2010,Special Jail,0,0,0,0,0,0,0,0,0,0,0,0,0,0,0
Meghalaya,2010,Others,0,0,0,0,0,0,0,0,0,0,0,0,0,0,0
Meghalaya,2010,Total,70,0,70,507,6,513,43,0,43,0,0,0,620,6,626
Meghalaya,2011,Central Jail,0,0,0,0,0,0,0,0,0,0,0,0,0,0,0
Meghalaya,2011,District Jail,65,0,65,466,12,478,27,0,27,0,0,0,558,12,570
Meghalaya,2011,Sub_Jail,0,0,0,0,0,0,0,0,0,0,0,0,0,0,0
Meghalaya,2011,Women Jail,0,0,0,0,0,0,0,0,0,0,0,0,0,0,0
Meghalaya,2011,Borstal School,0,0,0,0,0,0,0,0,0,0,0,0,0,0,0
Meghalaya,2011,Open Jail,0,0,0,0,0,0,0,0,0,0,0,0,0,0,0
Meghalaya,2011,Special Jail,0,0,0,0,0,0,0,0,0,0,0,0,0,0,0
Meghalaya,2011,Others,0,0,0,0,0,0,0,0,0,0,0,0,0,0,0
Meghalaya,2011,Total,65,0,65,466,12,478,27,0,27,0,0,0,558,12,570
Meghalaya,2012,Central Jail,0,0,0,0,0,0,0,0,0,0,0,0,0,0,0
Meghalaya,2012,District Jail,70,0,70,593,12,605,21,0,21,0,0,0,684,12,696
Meghalaya,2012,Sub_Jail,0,0,0,0,0,0,0,0,0,0,0,0,0,0,0
Meghalaya,2012,Women Jail,0,0,0,0,0,0,0,0,0,0,0,0,0,0,0
Meghalaya,2012,Borstal School,0,0,0,0,0,0,0,0,0,0,0,0,0,0,0
Meghalaya,2012,Open Jail,0,0,0,0,0,0,0,0,0,0,0,0,0,0,0
Meghalaya,2012,Special Jail,0,0,0,0,0,0,0,0,0,0,0,0,0,0,0
Meghalaya,2012,Others,0,0,0,0,0,0,0,0,0,0,0,0,0,0,0
Meghalaya,2012,Total,70,0,70,593,12,605,21,0,21,0,0,0,684,12,696
Mizoram,2001,Central Jail,54,2,56,294,51,345,0,0,0,0,0,0,348,53,401
Mizoram,2001,District Jail,89,9,98,338,21,359,0,0,0,0,0,0,427,30,457
Mizoram,2001,Sub_Jail,0,0,0,0,0,0,0,0,0,0,0,0,0,0,0
Mizoram,2001,Women Jail,0,0,0,0,0,0,0,0,0,0,0,0,0,0,0
Mizoram,2001,Borstal School,0,0,0,0,0,0,0,0,0,0,0,0,0,0,0
Mizoram,2001,Open Jail,0,0,0,0,0,0,0,0,0,0,0,0,0,0,0
Mizoram,2001,Special Jail,0,0,0,0,0,0,0,0,0,0,0,0,0,0,0
Mizoram,2001,Others,0,0,0,0,0,0,0,0,0,0,0,0,0,0,0
Mizoram,2001,Total,143,11,154,632,72,704,0,0,0,0,0,0,775,83,858
Mizoram,2002,Central Jail,118,11,129,248,41,289,0,0,0,0,0,0,366,52,418
Mizoram,2002,District Jail,138,10,148,268,24,292,0,0,0,0,0,0,406,34,440
Mizoram,2002,Sub_Jail,0,0,0,0,0,0,0,0,0,0,0,0,0,0,0
Mizoram,2002,Women Jail,0,0,0,0,0,0,0,0,0,0,0,0,0,0,0
Mizoram,2002,Borstal School,0,0,0,0,0,0,0,0,0,0,0,0,0,0,0
Mizoram,2002,Open Jail,0,0,0,0,0,0,0,0,0,0,0,0,0,0,0
Mizoram,2002,Special Jail,0,0,0,0,0,0,0,0,0,0,0,0,0,0,0
Mizoram,2002,Others,0,0,0,0,0,0,0,0,0,0,0,0,0,0,0
Mizoram,2002,Total,256,21,277,516,65,581,0,0,0,0,0,0,772,86,858
Mizoram,2003,Central Jail,61,1,62,250,30,280,0,0,0,0,0,0,311,31,342
Mizoram,2003,District Jail,133,7,140,317,38,355,0,0,0,0,0,0,450,45,495
Mizoram,2003,Sub_Jail,0,0,0,0,0,0,0,0,0,0,0,0,0,0,0
Mizoram,2003,Women Jail,0,0,0,0,0,0,0,0,0,0,0,0,0,0,0
Mizoram,2003,Borstal School,0,0,0,0,0,0,0,0,0,0,0,0,0,0,0
Mizoram,2003,Open Jail,0,0,0,0,0,0,0,0,0,0,0,0,0,0,0
Mizoram,2003,Special Jail,0,0,0,0,0,0,0,0,0,0,0,0,0,0,0
Mizoram,2003,Others,0,0,0,0,0,0,0,0,0,0,0,0,0,0,0
Mizoram,2003,Total,194,8,202,567,68,635,0,0,0,0,0,0,761,76,837
Mizoram,2004,Central Jail,67,2,69,273,59,332,0,0,0,0,0,0,340,61,401
Mizoram,2004,District Jail,141,7,148,383,27,410,0,0,0,0,0,0,524,34,558
Mizoram,2004,Sub_Jail,0,0,0,0,0,0,0,0,0,0,0,0,0,0,0
Mizoram,2004,Women Jail,0,0,0,0,0,0,0,0,0,0,0,0,0,0,0
Mizoram,2004,Borstal School,0,0,0,0,0,0,0,0,0,0,0,0,0,0,0
Mizoram,2004,Open Jail,0,0,0,0,0,0,0,0,0,0,0,0,0,0,0
Mizoram,2004,Special Jail,0,0,0,0,0,0,0,0,0,0,0,0,0,0,0
Mizoram,2004,Others,0,0,0,0,0,0,0,0,0,0,0,0,0,0,0
Mizoram,2004,Total,208,9,217,656,86,742,0,0,0,0,0,0,864,95,959
Mizoram,2005,Central Jail,64,3,67,194,17,211,0,0,0,0,0,0,258,20,278
Mizoram,2005,District Jail,87,17,104,289,42,331,0,0,0,0,0,0,376,59,435
Mizoram,2005,Sub_Jail,0,0,0,0,0,0,0,0,0,0,0,0,0,0,0
Mizoram,2005,Women Jail,0,0,0,0,0,0,0,0,0,0,0,0,0,0,0
Mizoram,2005,Borstal School,0,0,0,0,0,0,0,0,0,0,0,0,0,0,0
Mizoram,2005,Open Jail,0,0,0,0,0,0,0,0,0,0,0,0,0,0,0
Mizoram,2005,Special Jail,0,0,0,0,0,0,0,0,0,0,0,0,0,0,0
Mizoram,2005,Others,0,0,0,0,0,0,0,0,0,0,0,0,0,0,0
Mizoram,2005,Total,151,20,171,483,59,542,0,0,0,0,0,0,634,79,713
Mizoram,2006,Central Jail,109,6,115,229,34,263,0,0,0,0,0,0,338,40,378
Mizoram,2006,District Jail,87,11,98,224,29,253,0,0,0,0,0,0,311,40,351
Mizoram,2006,Sub_Jail,0,0,0,0,0,0,0,0,0,0,0,0,0,0,0
Mizoram,2006,Women Jail,0,0,0,0,0,0,0,0,0,0,0,0,0,0,0
Mizoram,2006,Borstal School,0,0,0,0,0,0,0,0,0,0,0,0,0,0,0
Mizoram,2006,Open Jail,0,0,0,0,0,0,0,0,0,0,0,0,0,0,0
Mizoram,2006,Special Jail,0,0,0,0,0,0,0,0,0,0,0,0,0,0,0
Mizoram,2006,Others,0,0,0,0,0,0,0,0,0,0,0,0,0,0,0
Mizoram,2006,Total,196,17,213,453,63,516,0,0,0,0,0,0,649,80,729
Mizoram,2007,Central Jail,148,11,159,296,50,346,0,0,0,0,0,0,444,61,505
Mizoram,2007,District Jail,136,11,147,266,23,289,0,0,0,0,0,0,402,34,436
Mizoram,2007,Sub_Jail,0,0,0,0,0,0,0,0,0,0,0,0,0,0,0
Mizoram,2007,Women Jail,0,0,0,0,0,0,0,0,0,0,0,0,0,0,0
Mizoram,2007,Borstal School,0,0,0,0,0,0,0,0,0,0,0,0,0,0,0
Mizoram,2007,Open Jail,0,0,0,0,0,0,0,0,0,0,0,0,0,0,0
Mizoram,2007,Special Jail,0,0,0,0,0,0,0,0,0,0,0,0,0,0,0
Mizoram,2007,Others,0,0,0,0,0,0,0,0,0,0,0,0,0,0,0
Mizoram,2007,Total,284,22,306,562,73,635,0,0,0,0,0,0,846,95,941
Mizoram,2008,Central Jail,153,8,161,219,27,246,0,0,0,0,0,0,372,35,407
Mizoram,2008,District Jail,161,7,168,195,20,215,0,0,0,0,0,0,356,27,383
Mizoram,2008,Sub_Jail,0,0,0,0,0,0,0,0,0,0,0,0,0,0,0
Mizoram,2008,Women Jail,0,0,0,0,0,0,0,0,0,0,0,0,0,0,0
Mizoram,2008,Borstal School,0,0,0,0,0,0,0,0,0,0,0,0,0,0,0
Mizoram,2008,Open Jail,0,0,0,0,0,0,0,0,0,0,0,0,0,0,0
Mizoram,2008,Special Jail,0,0,0,0,0,0,0,0,0,0,0,0,0,0,0
Mizoram,2008,Others,0,0,0,0,0,0,0,0,0,0,0,0,0,0,0
Mizoram,2008,Total,314,15,329,414,47,461,0,0,0,0,0,0,728,62,790
Mizoram,2009,Central Jail,197,5,202,204,27,231,0,0,0,0,0,0,401,32,433
Mizoram,2009,District Jail,145,6,151,163,18,181,0,0,0,0,0,0,308,24,332
Mizoram,2009,Sub_Jail,0,0,0,0,0,0,0,0,0,0,0,0,0,0,0
Mizoram,2009,Women Jail,0,0,0,0,0,0,0,0,0,0,0,0,0,0,0
Mizoram,2009,Borstal School,0,0,0,0,0,0,0,0,0,0,0,0,0,0,0
Mizoram,2009,Open Jail,0,0,0,0,0,0,0,0,0,0,0,0,0,0,0
Mizoram,2009,Special Jail,0,0,0,0,0,0,0,0,0,0,0,0,0,0,0
Mizoram,2009,Others,0,0,0,0,0,0,0,0,0,0,0,0,0,0,0
Mizoram,2009,Total,342,11,353,367,45,412,0,0,0,0,0,0,709,56,765
Mizoram,2010,Central Jail,273,16,289,263,39,302,0,0,0,0,0,0,536,55,591
Mizoram,2010,District Jail,157,5,162,218,21,239,0,0,0,0,0,0,375,26,401
Mizoram,2010,Sub_Jail,0,0,0,0,0,0,0,0,0,0,0,0,0,0,0
Mizoram,2010,Women Jail,0,0,0,0,0,0,0,0,0,0,0,0,0,0,0
Mizoram,2010,Borstal School,0,0,0,0,0,0,0,0,0,0,0,0,0,0,0
Mizoram,2010,Open Jail,0,0,0,0,0,0,0,0,0,0,0,0,0,0,0
Mizoram,2010,Special Jail,0,0,0,0,0,0,0,0,0,0,0,0,0,0,0
Mizoram,2010,Others,0,0,0,0,0,0,0,0,0,0,0,0,0,0,0
Mizoram,2010,Total,430,21,451,481,60,541,0,0,0,0,0,0,911,81,992
Mizoram,2011,Central Jail,210,17,227,231,32,263,0,0,0,0,0,0,441,49,490
Mizoram,2011,District Jail,152,3,155,216,20,236,0,0,0,0,0,0,368,23,391
Mizoram,2011,Sub_Jail,0,0,0,0,0,0,0,0,0,0,0,0,0,0,0
Mizoram,2011,Women Jail,0,0,0,0,0,0,0,0,0,0,0,0,0,0,0
Mizoram,2011,Borstal School,0,0,0,0,0,0,0,0,0,0,0,0,0,0,0
Mizoram,2011,Open Jail,0,0,0,0,0,0,0,0,0,0,0,0,0,0,0
Mizoram,2011,Special Jail,0,0,0,0,0,0,0,0,0,0,0,0,0,0,0
Mizoram,2011,Others,0,0,0,0,0,0,0,0,0,0,0,0,0,0,0
Mizoram,2011,Total,362,20,382,447,52,499,0,0,0,0,0,0,809,72,881
Mizoram,2012,Central Jail,177,5,182,212,31,243,0,0,0,0,0,0,389,36,425
Mizoram,2012,District Jail,133,4,137,263,22,285,0,0,0,0,0,0,396,26,422
Mizoram,2012,Sub_Jail,0,0,0,0,0,0,0,0,0,0,0,0,0,0,0
Mizoram,2012,Women Jail,0,0,0,0,0,0,0,0,0,0,0,0,0,0,0
Mizoram,2012,Borstal School,0,0,0,0,0,0,0,0,0,0,0,0,0,0,0
Mizoram,2012,Open Jail,0,0,0,0,0,0,0,0,0,0,0,0,0,0,0
Mizoram,2012,Special Jail,0,0,0,0,0,0,0,0,0,0,0,0,0,0,0
Mizoram,2012,Others,0,0,0,0,0,0,0,0,0,0,0,0,0,0,0
Mizoram,2012,Total,310,9,319,475,53,528,0,0,0,0,0,0,785,62,847
Nagaland,2001,Central Jail,40,0,40,225,0,225,52,0,52,0,0,0,317,0,317
Nagaland,2001,District Jail,14,0,14,205,6,211,0,0,0,0,0,0,219,6,225
Nagaland,2001,Sub_Jail,12,2,14,97,12,109,0,0,0,0,0,0,109,14,123
Nagaland,2001,Women Jail,0,0,0,0,0,0,0,0,0,0,0,0,0,0,0
Nagaland,2001,Borstal School,0,0,0,0,0,0,0,0,0,0,0,0,0,0,0
Nagaland,2001,Open Jail,0,0,0,0,0,0,0,0,0,0,0,0,0,0,0
Nagaland,2001,Special Jail,0,0,0,0,0,0,0,0,0,0,0,0,0,0,0
Nagaland,2001,Others,0,0,0,0,0,0,0,0,0,0,0,0,0,0,0
Nagaland,2001,Total,66,2,68,527,18,545,52,0,52,0,0,0,645,20,665
Nagaland,2002,Central Jail,7,0,7,263,0,263,57,0,57,0,0,0,327,0,327
Nagaland,2002,District Jail,13,0,13,183,5,188,0,0,0,0,0,0,196,5,201
Nagaland,2002,Sub_Jail,9,1,10,87,6,93,0,0,0,0,0,0,96,7,103
Nagaland,2002,Women Jail,0,0,0,0,0,0,0,0,0,0,0,0,0,0,0
Nagaland,2002,Borstal School,0,0,0,0,0,0,0,0,0,0,0,0,0,0,0
Nagaland,2002,Open Jail,0,0,0,0,0,0,0,0,0,0,0,0,0,0,0
Nagaland,2002,Special Jail,0,0,0,0,0,0,0,0,0,0,0,0,0,0,0
Nagaland,2002,Others,0,0,0,0,0,0,0,0,0,0,0,0,0,0,0
Nagaland,2002,Total,29,1,30,533,11,544,57,0,57,0,0,0,619,12,631
Nagaland,2003,Central Jail,70,0,70,121,0,121,72,0,72,0,0,0,263,0,263
Nagaland,2003,District Jail,9,0,9,189,7,196,0,0,0,0,0,0,198,7,205
Nagaland,2003,Sub_Jail,9,1,10,84,6,90,0,0,0,0,0,0,93,7,100
Nagaland,2003,Women Jail,0,0,0,0,0,0,0,0,0,0,0,0,0,0,0
Nagaland,2003,Borstal School,0,0,0,0,0,0,0,0,0,0,0,0,0,0,0
Nagaland,2003,Open Jail,0,0,0,0,0,0,0,0,0,0,0,0,0,0,0
Nagaland,2003,Special Jail,0,0,0,0,0,0,0,0,0,0,0,0,0,0,0
Nagaland,2003,Others,0,0,0,0,0,0,0,0,0,0,0,0,0,0,0
Nagaland,2003,Total,88,1,89,394,13,407,72,0,72,0,0,0,554,14,568
Nagaland,2004,Central Jail,104,0,104,119,0,119,37,0,37,0,0,0,260,0,260
Nagaland,2004,District Jail,16,0,16,140,10,150,0,0,0,0,0,0,156,10,166
Nagaland,2004,Sub_Jail,40,1,41,115,6,121,1,0,1,0,0,0,156,7,163
Nagaland,2004,Women Jail,0,0,0,0,0,0,0,0,0,0,0,0,0,0,0
Nagaland,2004,Borstal School,0,0,0,0,0,0,0,0,0,0,0,0,0,0,0
Nagaland,2004,Open Jail,0,0,0,0,0,0,0,0,0,0,0,0,0,0,0
Nagaland,2004,Special Jail,0,0,0,0,0,0,0,0,0,0,0,0,0,0,0
Nagaland,2004,Others,0,0,0,0,0,0,0,0,0,0,0,0,0,0,0
Nagaland,2004,Total,160,1,161,374,16,390,38,0,38,0,0,0,572,17,589
Nagaland,2005,Central Jail,85,0,85,166,0,166,24,0,24,0,0,0,275,0,275
Nagaland,2005,District Jail,15,0,15,178,5,183,0,0,0,0,0,0,193,5,198
Nagaland,2005,Sub_Jail,13,4,17,124,11,135,0,0,0,0,0,0,137,15,152
Nagaland,2005,Women Jail,0,0,0,0,0,0,0,0,0,0,0,0,0,0,0
Nagaland,2005,Borstal School,0,0,0,0,0,0,0,0,0,0,0,0,0,0,0
Nagaland,2005,Open Jail,0,0,0,0,0,0,0,0,0,0,0,0,0,0,0
Nagaland,2005,Special Jail,0,0,0,0,0,0,0,0,0,0,0,0,0,0,0
Nagaland,2005,Others,0,0,0,0,0,0,0,0,0,0,0,0,0,0,0
Nagaland,2005,Total,113,4,117,468,16,484,24,0,24,0,0,0,605,20,625
Nagaland,2006,Central Jail,94,0,94,142,0,142,20,0,20,0,0,0,256,0,256
Nagaland,2006,District Jail,15,0,15,158,5,163,0,0,0,0,0,0,173,5,178
Nagaland,2006,Sub_Jail,18,6,24,198,14,212,1,3,4,0,0,0,217,23,240
Nagaland,2006,Women Jail,0,0,0,0,0,0,0,0,0,0,0,0,0,0,0
Nagaland,2006,Borstal School,0,0,0,0,0,0,0,0,0,0,0,0,0,0,0
Nagaland,2006,Open Jail,0,0,0,0,0,0,0,0,0,0,0,0,0,0,0
Nagaland,2006,Special Jail,0,0,0,0,0,0,0,0,0,0,0,0,0,0,0
Nagaland,2006,Others,0,0,0,0,0,0,0,0,0,0,0,0,0,0,0
Nagaland,2006,Total,127,6,133,498,19,517,21,3,24,0,0,0,646,28,674
Nagaland,2007,Central Jail,71,0,71,123,0,123,5,0,5,0,0,0,199,0,199
Nagaland,2007,District Jail,10,0,10,131,7,138,0,0,0,0,0,0,141,7,148
Nagaland,2007,Sub_Jail,14,6,20,128,5,133,1,0,1,0,0,0,143,11,154
Nagaland,2007,Women Jail,0,0,0,0,0,0,0,0,0,0,0,0,0,0,0
Nagaland,2007,Borstal School,0,0,0,0,0,0,0,0,0,0,0,0,0,0,0
Nagaland,2007,Open Jail,0,0,0,0,0,0,0,0,0,0,0,0,0,0,0
Nagaland,2007,Special Jail,0,0,0,0,0,0,0,0,0,0,0,0,0,0,0
Nagaland,2007,Others,0,0,0,0,0,0,0,0,0,0,0,0,0,0,0
Nagaland,2007,Total,95,6,101,382,12,394,6,0,6,0,0,0,483,18,501
Nagaland,2008,Central Jail,94,0,94,137,0,137,63,0,63,0,0,0,294,0,294
Nagaland,2008,District Jail,35,1,36,101,2,103,0,0,0,0,0,0,136,3,139
Nagaland,2008,Sub_Jail,25,5,30,148,8,156,0,0,0,0,0,0,173,13,186
Nagaland,2008,Women Jail,0,0,0,0,0,0,0,0,0,0,0,0,0,0,0
Nagaland,2008,Borstal School,0,0,0,0,0,0,0,0,0,0,0,0,0,0,0
Nagaland,2008,Open Jail,0,0,0,0,0,0,0,0,0,0,0,0,0,0,0
Nagaland,2008,Special Jail,0,0,0,0,0,0,0,0,0,0,0,0,0,0,0
Nagaland,2008,Others,0,0,0,0,0,0,0,0,0,0,0,0,0,0,0
Nagaland,2008,Total,154,6,160,386,10,396,63,0,63,0,0,0,603,16,619
Nagaland,2009,Central Jail,95,0,95,146,0,146,42,0,42,0,0,0,283,0,283
Nagaland,2009,District Jail,32,0,32,96,4,100,0,0,0,0,0,0,128,4,132
Nagaland,2009,Sub_Jail,25,2,27,170,11,181,0,0,0,0,0,0,195,13,208
Nagaland,2009,Women Jail,0,0,0,0,0,0,0,0,0,0,0,0,0,0,0
Nagaland,2009,Borstal School,0,0,0,0,0,0,0,0,0,0,0,0,0,0,0
Nagaland,2009,Open Jail,0,0,0,0,0,0,0,0,0,0,0,0,0,0,0
Nagaland,2009,Special Jail,0,0,0,0,0,0,0,0,0,0,0,0,0,0,0
Nagaland,2009,Others,0,0,0,0,0,0,0,0,0,0,0,0,0,0,0
Nagaland,2009,Total,152,2,154,412,15,427,42,0,42,0,0,0,606,17,623
Nagaland,2010,Central Jail,96,0,96,152,0,152,33,0,33,0,0,0,281,0,281
Nagaland,2010,District Jail,41,1,42,81,4,85,0,0,0,0,0,0,122,5,127
Nagaland,2010,Sub_Jail,22,3,25,78,10,88,0,0,0,0,0,0,100,13,113
Nagaland,2010,Women Jail,0,0,0,0,0,0,0,0,0,0,0,0,0,0,0
Nagaland,2010,Borstal School,0,0,0,0,0,0,0,0,0,0,0,0,0,0,0
Nagaland,2010,Open Jail,0,0,0,0,0,0,0,0,0,0,0,0,0,0,0
Nagaland,2010,Special Jail,0,0,0,0,0,0,0,0,0,0,0,0,0,0,0
Nagaland,2010,Others,0,0,0,0,0,0,0,0,0,0,0,0,0,0,0
Nagaland,2010,Total,159,4,163,311,14,325,33,0,33,0,0,0,503,18,521
Nagaland,2011,Central Jail,74,0,74,106,0,106,70,0,70,0,0,0,250,0,250
Nagaland,2011,District Jail,36,1,37,91,2,93,0,0,0,0,0,0,127,3,130
Nagaland,2011,Sub_Jail,13,6,19,94,6,100,2,1,3,0,0,0,109,13,122
Nagaland,2011,Women Jail,0,0,0,0,0,0,0,0,0,0,0,0,0,0,0
Nagaland,2011,Borstal School,0,0,0,0,0,0,0,0,0,0,0,0,0,0,0
Nagaland,2011,Open Jail,0,0,0,0,0,0,0,0,0,0,0,0,0,0,0
Nagaland,2011,Special Jail,0,0,0,0,0,0,0,0,0,0,0,0,0,0,0
Nagaland,2011,Others,0,0,0,0,0,0,0,0,0,0,0,0,0,0,0
Nagaland,2011,Total,123,7,130,291,8,299,72,1,73,0,0,0,486,16,502
Nagaland,2012,Central Jail,67,0,67,69,0,69,16,0,16,1,0,1,153,0,153
Nagaland,2012,District Jail,27,1,28,73,4,77,0,0,0,0,0,0,100,5,105
Nagaland,2012,Sub_Jail,26,4,30,101,6,107,2,1,3,0,0,0,129,11,140
Nagaland,2012,Women Jail,0,0,0,0,0,0,0,0,0,0,0,0,0,0,0
Nagaland,2012,Borstal School,0,0,0,0,0,0,0,0,0,0,0,0,0,0,0
Nagaland,2012,Open Jail,0,0,0,0,0,0,0,0,0,0,0,0,0,0,0
Nagaland,2012,Special Jail,0,0,0,0,0,0,0,0,0,0,0,0,0,0,0
Nagaland,2012,Others,0,0,0,0,0,0,0,0,0,0,0,0,0,0,0
Nagaland,2012,Total,120,5,125,243,10,253,18,1,19,1,0,1,382,16,398
Orissa,2001,Central Jail,0,0,0,0,0,0,0,0,0,0,0,0,0,0,0
Orissa,2001,District Jail,2214,13,2227,3257,76,3333,30,0,30,45,0,45,5546,89,5635
Orissa,2001,Sub_Jail,318,1,319,4027,154,4181,10,0,10,0,0,0,4355,155,4510
Orissa,2001,Women Jail,0,37,37,0,3,3,0,0,0,0,0,0,0,40,40
Orissa,2001,Borstal School,80,0,80,176,0,176,1,0,1,0,0,0,257,0,257
Orissa,2001,Open Jail,0,0,0,0,0,0,0,0,0,0,0,0,0,0,0
Orissa,2001,Special Jail,152,1,153,1059,16,1075,4,0,4,1,0,1,1216,17,1233
Orissa,2001,Others,0,0,0,0,0,0,0,0,0,0,0,0,0,0,0
Orissa,2001,Total,2764,52,2816,8519,249,8768,45,0,45,46,0,46,11374,301,11675
Orissa,2002,Central Jail,0,0,0,0,0,0,0,0,0,0,0,0,0,0,0
Orissa,2002,District Jail,2313,38,2351,3613,105,3718,0,0,0,37,0,37,5963,143,6106
Orissa,2002,Sub_Jail,339,2,341,4457,155,4612,0,0,0,6,0,6,4802,157,4959
Orissa,2002,Women Jail,0,8,8,0,6,6,0,0,0,0,0,0,0,14,14
Orissa,2002,Borstal School,96,0,96,131,0,131,0,0,0,1,0,1,228,0,228
Orissa,2002,Open Jail,0,0,0,0,0,0,0,0,0,0,0,0,0,0,0
Orissa,2002,Special Jail,178,1,179,1123,26,1149,0,0,0,2,0,2,1303,27,1330
Orissa,2002,Others,0,0,0,0,0,0,0,0,0,0,0,0,0,0,0
Orissa,2002,Total,2926,49,2975,9324,292,9616,0,0,0,46,0,46,12296,341,12637
Orissa,2003,Central Jail,0,0,0,0,0,0,0,0,0,0,0,0,0,0,0
Orissa,2003,District Jail,2582,53,2635,3572,101,3673,0,0,0,22,0,22,6176,154,6330
Orissa,2003,Sub_Jail,339,1,340,4654,152,4806,0,0,0,12,0,12,5005,153,5158
Orissa,2003,Women Jail,0,10,10,0,10,10,0,0,0,0,0,0,0,20,20
Orissa,2003,Borstal School,81,0,81,143,0,143,0,0,0,1,0,1,225,0,225
Orissa,2003,Open Jail,0,0,0,0,0,0,0,0,0,0,0,0,0,0,0
Orissa,2003,Special Jail,224,2,226,981,27,1008,0,0,0,0,0,0,1205,29,1234
Orissa,2003,Others,0,0,0,0,0,0,0,0,0,0,0,0,0,0,0
Orissa,2003,Total,3226,66,3292,9350,290,9640,0,0,0,35,0,35,12611,356,12967
Orissa,2004,Central Jail,0,0,0,0,0,0,0,0,0,0,0,0,0,0,0
Orissa,2004,District Jail,2837,49,2886,3526,107,3633,3,0,3,14,1,15,6380,157,6537
Orissa,2004,Sub_Jail,401,5,406,4579,154,4733,3,0,3,9,0,9,4992,159,5151
Orissa,2004,Women Jail,0,9,9,0,5,5,0,0,0,0,0,0,0,14,14
Orissa,2004,Borstal School,72,0,72,163,0,163,1,0,1,1,0,1,237,0,237
Orissa,2004,Open Jail,50,0,50,0,0,0,0,0,0,0,0,0,50,0,50
Orissa,2004,Special Jail,255,2,257,881,29,910,2,0,2,0,0,0,1138,31,1169
Orissa,2004,Others,0,0,0,0,0,0,0,0,0,0,0,0,0,0,0
Orissa,2004,Total,3615,65,3680,9149,295,9444,9,0,9,24,1,25,12797,361,13158
Orissa,2005,Central Jail,0,0,0,0,0,0,0,0,0,0,0,0,0,0,0
Orissa,2005,District Jail,3169,62,3231,3477,124,3601,15,0,15,17,0,17,6678,186,6864
Orissa,2005,Sub_Jail,483,6,489,4791,189,4980,0,0,0,8,0,8,5282,195,5477
Orissa,2005,Women Jail,0,16,16,0,12,12,0,0,0,0,0,0,0,28,28
Orissa,2005,Borstal School,109,0,109,198,0,198,0,0,0,0,0,0,307,0,307
Orissa,2005,Open Jail,39,0,39,0,0,0,0,0,0,0,0,0,39,0,39
Orissa,2005,Special Jail,308,4,312,912,17,929,0,0,0,2,0,2,1222,21,1243
Orissa,2005,Others,0,0,0,0,0,0,0,0,0,0,0,0,0,0,0
Orissa,2005,Total,4108,88,4196,9378,342,9720,15,0,15,27,0,27,13528,430,13958
Orissa,2006,Central Jail,0,0,0,0,0,0,0,0,0,0,0,0,0,0,0
Orissa,2006,District Jail,3234,68,3302,3741,124,3865,0,0,0,22,1,23,6997,193,7190
Orissa,2006,Sub_Jail,578,7,585,5009,224,5233,0,0,0,9,0,9,5596,231,5827
Orissa,2006,Women Jail,0,12,12,0,9,9,0,0,0,0,0,0,0,21,21
Orissa,2006,Borstal School,0,0,0,0,0,0,0,0,0,0,0,0,0,0,0
Orissa,2006,Open Jail,68,0,68,0,0,0,0,0,0,0,0,0,68,0,68
Orissa,2006,Special Jail,301,4,305,947,29,976,0,0,0,0,0,0,1248,33,1281
Orissa,2006,Others,93,0,93,164,0,164,0,0,0,0,0,0,257,0,257
Orissa,2006,Total,4274,91,4365,9861,386,10247,0,0,0,31,1,32,14166,478,14644
Orissa,2007,Central Jail,0,0,0,0,0,0,0,0,0,0,0,0,0,0,0
Orissa,2007,District Jail,3248,75,3323,4011,195,4206,3,0,3,0,0,0,7262,270,7532
Orissa,2007,Sub_Jail,517,9,526,5320,279,5599,0,0,0,0,0,0,5837,288,6125
Orissa,2007,Women Jail,0,14,14,0,14,14,0,0,0,0,0,0,0,28,28
Orissa,2007,Borstal School,0,0,0,0,0,0,0,0,0,0,0,0,0,0,0
Orissa,2007,Open Jail,59,0,59,0,0,0,0,0,0,0,0,0,59,0,59
Orissa,2007,Special Jail,324,5,329,982,29,1011,0,0,0,0,0,0,1306,34,1340
Orissa,2007,Others,94,0,94,190,0,190,0,0,0,0,0,0,284,0,284
Orissa,2007,Total,4242,103,4345,10503,517,11020,3,0,3,0,0,0,14748,620,15368
Orissa,2008,Central Jail,0,0,0,0,0,0,0,0,0,0,0,0,0,0,0
Orissa,2008,District Jail,3105,87,3192,3575,111,3686,12,0,12,0,0,0,6692,198,6890
Orissa,2008,Sub_Jail,558,16,574,4994,231,5225,0,0,0,0,0,0,5552,247,5799
Orissa,2008,Women Jail,0,12,12,0,16,16,0,0,0,0,0,0,0,28,28
Orissa,2008,Borstal School,0,0,0,0,0,0,0,0,0,0,0,0,0,0,0
Orissa,2008,Open Jail,102,0,102,0,0,0,0,0,0,0,0,0,102,0,102
Orissa,2008,Special Jail,322,7,329,872,34,906,0,0,0,0,0,0,1194,41,1235
Orissa,2008,Others,91,0,91,219,9,228,0,0,0,0,0,0,310,9,319
Orissa,2008,Total,4178,122,4300,9660,401,10061,12,0,12,0,0,0,13850,523,14373
Orissa,2009,Central Jail,963,33,996,1414,55,1469,0,0,0,0,0,0,2377,88,2465
Orissa,2009,District Jail,1742,43,1785,1722,73,1795,0,0,0,0,0,0,3464,116,3580
Orissa,2009,Sub_Jail,760,16,776,4911,207,5118,0,0,0,0,0,0,5671,223,5894
Orissa,2009,Women Jail,0,10,10,0,9,9,0,0,0,0,0,0,0,19,19
Orissa,2009,Borstal School,0,0,0,0,0,0,0,0,0,0,0,0,0,0,0
Orissa,2009,Open Jail,98,0,98,0,0,0,0,0,0,0,0,0,98,0,98
Orissa,2009,Special Jail,256,6,262,857,40,897,0,0,0,0,0,0,1113,46,1159
Orissa,2009,Others,96,0,96,216,7,223,0,0,0,0,0,0,312,7,319
Orissa,2009,Total,3915,108,4023,9120,391,9511,0,0,0,0,0,0,13035,499,13534
Orissa,2010,Central Jail,847,37,884,1268,23,1291,0,0,0,0,0,0,2115,60,2175
Orissa,2010,District Jail,1538,39,1577,1970,87,2057,0,0,0,0,0,0,3508,126,3634
Orissa,2010,Sub_Jail,1101,21,1122,4130,223,4353,0,0,0,0,0,0,5231,244,5475
Orissa,2010,Women Jail,0,12,12,0,9,9,0,0,0,0,0,0,0,21,21
Orissa,2010,Borstal School,0,0,0,0,0,0,0,0,0,0,0,0,0,0,0
Orissa,2010,Open Jail,112,0,112,0,0,0,0,0,0,0,0,0,112,0,112
Orissa,2010,Special Jail,239,5,244,734,34,768,0,0,0,0,0,0,973,39,1012
Orissa,2010,Others,0,0,0,0,0,0,0,0,0,0,0,0,0,0,0
Orissa,2010,Total,3837,114,3951,8102,376,8478,0,0,0,0,0,0,11939,490,12429
Orissa,2011,Central Jail,837,41,878,1326,35,1361,0,0,0,0,0,0,2163,76,2239
Orissa,2011,District Jail,1437,37,1474,1800,67,1867,0,0,0,0,0,0,3237,104,3341
Orissa,2011,Sub_Jail,1023,18,1041,4861,185,5046,0,0,0,0,0,0,5884,203,6087
Orissa,2011,Women Jail,0,12,12,0,10,10,0,0,0,0,0,0,0,22,22
Orissa,2011,Borstal School,0,0,0,0,0,0,0,0,0,0,0,0,0,0,0
Orissa,2011,Open Jail,65,0,65,0,0,0,0,0,0,0,0,0,65,0,65
Orissa,2011,Special Jail,227,4,231,734,34,768,0,0,0,0,0,0,961,38,999
Orissa,2011,Others,0,0,0,0,0,0,0,0,0,0,0,0,0,0,0
Orissa,2011,Total,3589,112,3701,8721,331,9052,0,0,0,0,0,0,12310,443,12753
Orissa,2012,Central Jail,1049,37,1086,1637,55,1692,0,0,0,0,0,0,2686,92,2778
Orissa,2012,District Jail,1079,27,1106,1724,57,1781,0,0,0,0,0,0,2803,84,2887
Orissa,2012,Sub_Jail,1064,25,1089,4718,219,4937,0,0,0,0,0,0,5782,244,6026
Orissa,2012,Women Jail,0,8,8,0,11,11,0,0,0,0,0,0,0,19,19
Orissa,2012,Borstal School,0,0,0,0,0,0,0,0,0,0,0,0,0,0,0
Orissa,2012,Open Jail,100,0,100,0,0,0,0,0,0,0,0,0,100,0,100
Orissa,2012,Special Jail,233,8,241,787,29,816,0,0,0,0,0,0,1020,37,1057
Orissa,2012,Others,0,0,0,0,0,0,0,0,0,0,0,0,0,0,0
Orissa,2012,Total,3525,105,3630,8866,371,9237,0,0,0,0,0,0,12391,476,12867
Punjab,2001,Central Jail,2954,63,3017,5786,269,6055,12,0,12,133,2,135,8885,334,9219
Punjab,2001,District Jail,375,4,379,931,80,1011,0,0,0,1,0,1,1307,84,1391
Punjab,2001,Sub_Jail,52,0,52,755,0,755,0,0,0,1,0,1,808,0,808
Punjab,2001,Women Jail,0,103,103,0,104,104,0,0,0,0,3,3,0,210,210
Punjab,2001,Borstal School,94,0,94,233,0,233,0,0,0,0,0,0,327,0,327
Punjab,2001,Open Jail,22,0,22,0,0,0,0,0,0,0,0,0,22,0,22
Punjab,2001,Special Jail,27,0,27,50,0,50,0,0,0,0,0,0,77,0,77
Punjab,2001,Others,0,0,0,0,0,0,0,0,0,0,0,0,0,0,0
Punjab,2001,Total,3524,170,3694,7755,453,8208,12,0,12,135,5,140,11426,628,12054
Punjab,2002,Central Jail,3018,82,3100,5391,273,5664,0,0,0,0,0,0,8409,355,8764
Punjab,2002,District Jail,519,26,545,1184,100,1284,12,0,12,0,0,0,1715,126,1841
Punjab,2002,Sub_Jail,74,0,74,828,0,828,0,0,0,0,0,0,902,0,902
Punjab,2002,Women Jail,0,151,151,0,98,98,0,0,0,0,0,0,0,249,249
Punjab,2002,Borstal School,89,0,89,239,0,239,0,0,0,0,0,0,328,0,328
Punjab,2002,Open Jail,25,0,25,0,0,0,0,0,0,0,0,0,25,0,25
Punjab,2002,Special Jail,0,0,0,0,0,0,0,0,0,0,0,0,0,0,0
Punjab,2002,Others,0,0,0,0,0,0,0,0,0,0,0,0,0,0,0
Punjab,2002,Total,3725,259,3984,7642,471,8113,12,0,12,0,0,0,11379,730,12109
Punjab,2003,Central Jail,3232,72,3304,6223,333,6556,2,0,2,31,0,31,9488,405,9893
Punjab,2003,District Jail,708,27,735,1227,104,1331,0,0,0,0,0,0,1935,131,2066
Punjab,2003,Sub_Jail,55,0,55,560,0,560,0,0,0,0,0,0,615,0,615
Punjab,2003,Women Jail,0,165,165,0,101,101,0,0,0,0,0,0,0,266,266
Punjab,2003,Borstal School,125,0,125,234,0,234,0,0,0,0,0,0,359,0,359
Punjab,2003,Open Jail,33,0,33,0,0,0,0,0,0,0,0,0,33,0,33
Punjab,2003,Special Jail,0,0,0,0,0,0,0,0,0,0,0,0,0,0,0
Punjab,2003,Others,0,0,0,0,0,0,0,0,0,0,0,0,0,0,0
Punjab,2003,Total,4153,264,4417,8244,538,8782,2,0,2,31,0,31,12430,802,13232
Punjab,2004,Central Jail,3786,65,3851,6928,291,7219,4,0,4,15,0,15,10733,356,11089
Punjab,2004,District Jail,737,31,768,1421,106,1527,19,0,19,0,0,0,2177,137,2314
Punjab,2004,Sub_Jail,91,0,91,842,0,842,0,0,0,0,0,0,933,0,933
Punjab,2004,Women Jail,0,178,178,0,104,104,0,0,0,0,0,0,0,282,282
Punjab,2004,Borstal School,110,0,110,309,0,309,0,0,0,0,0,0,419,0,419
Punjab,2004,Open Jail,27,0,27,0,0,0,0,0,0,0,0,0,27,0,27
Punjab,2004,Special Jail,0,0,0,0,0,0,0,0,0,0,0,0,0,0,0
Punjab,2004,Others,0,0,0,0,0,0,0,0,0,0,0,0,0,0,0
Punjab,2004,Total,4751,274,5025,9500,501,10001,23,0,23,15,0,15,14289,775,15064
Punjab,2005,Central Jail,3855,105,3960,6544,319,6863,3,0,3,9,0,9,10411,424,10835
Punjab,2005,District Jail,673,36,709,1316,92,1408,20,0,20,2,0,2,2011,128,2139
Punjab,2005,Sub_Jail,188,0,188,961,0,961,0,0,0,0,0,0,1149,0,1149
Punjab,2005,Women Jail,0,96,96,0,132,132,0,0,0,0,0,0,0,228,228
Punjab,2005,Borstal School,77,0,77,208,0,208,0,0,0,0,0,0,285,0,285
Punjab,2005,Open Jail,42,0,42,0,0,0,0,0,0,0,0,0,42,0,42
Punjab,2005,Special Jail,0,0,0,0,0,0,0,0,0,0,0,0,0,0,0
Punjab,2005,Others,0,0,0,0,0,0,0,0,0,0,0,0,0,0,0
Punjab,2005,Total,4835,237,5072,9029,543,9572,23,0,23,11,0,11,13898,780,14678
Punjab,2006,Central Jail,3841,120,3961,6593,342,6935,2,0,2,4,0,4,10440,462,10902
Punjab,2006,District Jail,910,39,949,1392,69,1461,18,0,18,0,0,0,2320,108,2428
Punjab,2006,Sub_Jail,241,0,241,1059,0,1059,0,0,0,0,0,0,1300,0,1300
Punjab,2006,Women Jail,0,98,98,0,108,108,0,0,0,0,0,0,0,206,206
Punjab,2006,Borstal School,62,0,62,188,0,188,0,0,0,0,0,0,250,0,250
Punjab,2006,Open Jail,29,0,29,0,0,0,0,0,0,0,0,0,29,0,29
Punjab,2006,Special Jail,0,0,0,0,0,0,0,0,0,0,0,0,0,0,0
Punjab,2006,Others,0,0,0,0,0,0,0,0,0,0,0,0,0,0,0
Punjab,2006,Total,5083,257,5340,9232,519,9751,20,0,20,4,0,4,14339,776,15115
Punjab,2007,Central Jail,3434,114,3548,7293,398,7691,0,0,0,13,0,13,10740,512,11252
Punjab,2007,District Jail,924,31,955,1654,78,1732,16,0,16,0,0,0,2594,109,2703
Punjab,2007,Sub_Jail,247,0,247,1183,0,1183,0,0,0,3,0,3,1433,0,1433
Punjab,2007,Women Jail,0,69,69,0,145,145,0,0,0,0,0,0,0,214,214
Punjab,2007,Borstal School,85,0,85,230,0,230,0,0,0,0,0,0,315,0,315
Punjab,2007,Open Jail,55,0,55,0,0,0,0,0,0,0,0,0,55,0,55
Punjab,2007,Special Jail,0,0,0,0,0,0,0,0,0,0,0,0,0,0,0
Punjab,2007,Others,0,0,0,0,0,0,0,0,0,0,0,0,0,0,0
Punjab,2007,Total,4745,214,4959,10360,621,10981,16,0,16,16,0,16,15137,835,15972
Punjab,2008,Central Jail,3872,152,4024,6908,316,7224,1,0,1,1,0,1,10782,468,11250
Punjab,2008,District Jail,937,30,967,1671,120,1791,12,0,12,0,0,0,2620,150,2770
Punjab,2008,Sub_Jail,241,0,241,1145,0,1145,0,0,0,1,0,1,1387,0,1387
Punjab,2008,Women Jail,0,82,82,0,122,122,0,0,0,0,0,0,0,204,204
Punjab,2008,Borstal School,98,0,98,347,0,347,0,0,0,0,0,0,445,0,445
Punjab,2008,Open Jail,59,0,59,0,0,0,0,0,0,0,0,0,59,0,59
Punjab,2008,Special Jail,0,0,0,0,0,0,0,0,0,0,0,0,0,0,0
Punjab,2008,Others,0,0,0,0,0,0,0,0,0,0,0,0,0,0,0
Punjab,2008,Total,5207,264,5471,10071,558,10629,13,0,13,2,0,2,15293,822,16115
Punjab,2009,Central Jail,4514,216,4730,7585,345,7930,0,0,0,7,0,7,12106,561,12667
Punjab,2009,District Jail,1235,51,1286,1809,141,1950,11,0,11,5,0,5,3060,192,3252
Punjab,2009,Sub_Jail,160,0,160,993,0,993,2,0,2,0,0,0,1155,0,1155
Punjab,2009,Women Jail,0,85,85,0,143,143,0,0,0,0,0,0,0,228,228
Punjab,2009,Borstal School,115,0,115,375,0,375,0,0,0,0,0,0,490,0,490
Punjab,2009,Open Jail,62,0,62,0,0,0,0,0,0,0,0,0,62,0,62
Punjab,2009,Special Jail,0,0,0,0,0,0,0,0,0,0,0,0,0,0,0
Punjab,2009,Others,0,0,0,0,0,0,0,0,0,0,0,0,0,0,0
Punjab,2009,Total,6086,352,6438,10762,629,11391,13,0,13,12,0,12,16873,981,17854
Punjab,2010,Central Jail,4795,215,5010,7170,448,7618,0,0,0,0,0,0,11965,663,12628
Punjab,2010,District Jail,1149,54,1203,1902,108,2010,0,0,0,0,0,0,3051,162,3213
Punjab,2010,Sub_Jail,199,0,199,957,0,957,0,0,0,0,0,0,1156,0,1156
Punjab,2010,Women Jail,0,87,87,0,106,106,0,0,0,0,0,0,0,193,193
Punjab,2010,Borstal School,92,0,92,304,0,304,0,0,0,0,0,0,396,0,396
Punjab,2010,Open Jail,58,0,58,0,0,0,0,0,0,0,0,0,58,0,58
Punjab,2010,Special Jail,0,0,0,0,0,0,0,0,0,0,0,0,0,0,0
Punjab,2010,Others,0,0,0,0,0,0,0,0,0,0,0,0,0,0,0
Punjab,2010,Total,6293,356,6649,10333,662,10995,0,0,0,0,0,0,16626,1018,17644
Punjab,2011,Central Jail,5118,247,5365,6770,369,7139,0,0,0,0,0,0,11888,616,12504
Punjab,2011,District Jail,1488,78,1566,1803,101,1904,0,0,0,0,0,0,3291,179,3470
Punjab,2011,Sub_Jail,303,0,303,806,0,806,0,0,0,0,0,0,1109,0,1109
Punjab,2011,Women Jail,0,129,129,0,113,113,0,0,0,0,0,0,0,242,242
Punjab,2011,Borstal School,123,0,123,333,0,333,0,0,0,0,0,0,456,0,456
Punjab,2011,Open Jail,40,0,40,0,0,0,0,0,0,0,0,0,40,0,40
Punjab,2011,Special Jail,0,0,0,0,0,0,0,0,0,0,0,0,0,0,0
Punjab,2011,Others,0,0,0,0,0,0,0,0,0,0,0,0,0,0,0
Punjab,2011,Total,7072,454,7526,9712,583,10295,0,0,0,0,0,0,16784,1037,17821
Punjab,2012,Central Jail,5491,217,5708,10712,544,11256,4,1,5,2,0,2,16209,762,16971
Punjab,2012,District Jail,1521,109,1630,2325,182,2507,3,0,3,0,0,0,3849,291,4140
Punjab,2012,Sub_Jail,257,0,257,1169,0,1169,0,0,0,3,0,3,1429,0,1429
Punjab,2012,Women Jail,0,81,81,0,139,139,0,0,0,0,2,2,0,222,222
Punjab,2012,Borstal School,93,0,93,302,0,302,0,0,0,0,0,0,395,0,395
Punjab,2012,Open Jail,62,0,62,0,0,0,0,0,0,0,0,0,62,0,62
Punjab,2012,Special Jail,0,0,0,0,0,0,0,0,0,0,0,0,0,0,0
Punjab,2012,Others,0,0,0,0,0,0,0,0,0,0,0,0,0,0,0
Punjab,2012,Total,7424,407,7831,14508,865,15373,7,1,8,5,2,7,21944,1275,23219
Rajasthan,2001,Central Jail,3328,0,3328,2813,92,2905,45,0,45,16,0,16,6202,92,6294
Rajasthan,2001,District Jail,411,0,411,3508,107,3615,2,0,2,10,0,10,3931,107,4038
Rajasthan,2001,Sub_Jail,11,0,11,2148,27,2175,0,0,0,2,0,2,2161,27,2188
Rajasthan,2001,Women Jail,0,96,96,0,42,42,0,0,0,0,0,0,0,138,138
Rajasthan,2001,Borstal School,33,0,33,0,0,0,0,0,0,0,0,0,33,0,33
Rajasthan,2001,Open Jail,297,7,304,0,0,0,0,0,0,0,0,0,297,7,304
Rajasthan,2001,Special Jail,0,0,0,0,0,0,0,0,0,0,0,0,0,0,0
Rajasthan,2001,Others,0,0,0,0,0,0,0,0,0,0,0,0,0,0,0
Rajasthan,2001,Total,4080,103,4183,8469,268,8737,47,0,47,28,0,28,12624,371,12995
Rajasthan,2002,Central Jail,3658,0,3658,2321,56,2377,37,0,37,31,0,31,6047,56,6103
Rajasthan,2002,District Jail,738,9,747,2847,101,2948,1,0,1,17,0,17,3603,110,3713
Rajasthan,2002,Sub_Jail,16,1,17,1947,19,1966,0,0,0,2,0,2,1965,20,1985
Rajasthan,2002,Women Jail,0,165,165,0,31,31,0,0,0,0,0,0,0,196,196
Rajasthan,2002,Borstal School,46,0,46,0,0,0,0,0,0,0,0,0,46,0,46
Rajasthan,2002,Open Jail,332,11,343,0,0,0,0,0,0,0,0,0,332,11,343
Rajasthan,2002,Special Jail,0,0,0,0,0,0,0,0,0,0,0,0,0,0,0
Rajasthan,2002,Others,0,0,0,0,0,0,0,0,0,0,0,0,0,0,0
Rajasthan,2002,Total,4790,186,4976,7115,207,7322,38,0,38,50,0,50,11993,393,12386
Rajasthan,2003,Central Jail,4954,0,4954,2333,86,2419,31,0,31,15,0,15,7333,86,7419
Rajasthan,2003,District Jail,558,1,559,2181,78,2259,1,0,1,8,0,8,2748,79,2827
Rajasthan,2003,Sub_Jail,19,0,19,1852,21,1873,0,0,0,3,0,3,1874,21,1895
Rajasthan,2003,Women Jail,0,180,180,0,33,33,0,0,0,0,0,0,0,213,213
Rajasthan,2003,Borstal School,39,0,39,0,0,0,0,0,0,0,0,0,39,0,39
Rajasthan,2003,Open Jail,291,11,302,0,0,0,0,0,0,0,0,0,291,11,302
Rajasthan,2003,Special Jail,0,0,0,0,0,0,0,0,0,0,0,0,0,0,0
Rajasthan,2003,Others,0,0,0,0,0,0,0,0,0,0,0,0,0,0,0
Rajasthan,2003,Total,5861,192,6053,6366,218,6584,32,0,32,26,0,26,12285,410,12695
Rajasthan,2004,Central Jail,4724,0,4724,2676,93,2769,29,0,29,10,0,10,7439,93,7532
Rajasthan,2004,District Jail,512,0,512,2357,93,2450,0,0,0,10,0,10,2879,93,2972
Rajasthan,2004,Sub_Jail,12,0,12,1995,18,2013,0,0,0,1,0,1,2008,18,2026
Rajasthan,2004,Women Jail,0,164,164,0,51,51,0,0,0,0,0,0,0,215,215
Rajasthan,2004,Borstal School,20,0,20,0,0,0,0,0,0,0,0,0,20,0,20
Rajasthan,2004,Open Jail,391,15,406,0,0,0,0,0,0,0,0,0,391,15,406
Rajasthan,2004,Special Jail,0,0,0,0,0,0,0,0,0,0,0,0,0,0,0
Rajasthan,2004,Others,0,0,0,0,0,0,0,0,0,0,0,0,0,0,0
Rajasthan,2004,Total,5659,179,5838,7028,255,7283,29,0,29,21,0,21,12737,434,13171
Rajasthan,2005,Central Jail,4153,0,4153,2730,119,2849,32,0,32,16,0,16,6931,119,7050
Rajasthan,2005,District Jail,799,0,799,2497,81,2578,0,0,0,9,0,9,3305,81,3386
Rajasthan,2005,Sub_Jail,11,0,11,1889,9,1898,0,0,0,1,0,1,1901,9,1910
Rajasthan,2005,Women Jail,0,167,167,0,38,38,0,0,0,0,0,0,0,205,205
Rajasthan,2005,Borstal School,32,0,32,0,0,0,0,0,0,0,0,0,32,0,32
Rajasthan,2005,Open Jail,396,14,410,0,0,0,0,0,0,0,0,0,396,14,410
Rajasthan,2005,Special Jail,0,0,0,0,0,0,0,0,0,0,0,0,0,0,0
Rajasthan,2005,Others,0,0,0,0,0,0,0,0,0,0,0,0,0,0,0
Rajasthan,2005,Total,5391,181,5572,7116,247,7363,32,0,32,26,0,26,12565,428,12993
Rajasthan,2006,Central Jail,4497,1,4498,3000,96,3096,35,0,35,24,0,24,7556,97,7653
Rajasthan,2006,District Jail,477,4,481,2859,130,2989,0,0,0,32,0,32,3368,134,3502
Rajasthan,2006,Sub_Jail,20,0,20,2145,10,2155,0,0,0,11,0,11,2176,10,2186
Rajasthan,2006,Women Jail,0,167,167,0,48,48,0,0,0,0,0,0,0,215,215
Rajasthan,2006,Borstal School,16,0,16,0,0,0,0,0,0,0,0,0,16,0,16
Rajasthan,2006,Open Jail,396,15,411,0,0,0,0,0,0,0,0,0,396,15,411
Rajasthan,2006,Special Jail,0,0,0,0,0,0,0,0,0,0,0,0,0,0,0
Rajasthan,2006,Others,0,0,0,0,0,0,0,0,0,0,0,0,0,0,0
Rajasthan,2006,Total,5406,187,5593,8004,284,8288,35,0,35,67,0,67,13512,471,13983
Rajasthan,2007,Central Jail,4685,7,4692,3170,113,3283,20,0,20,26,0,26,7901,120,8021
Rajasthan,2007,District Jail,550,0,550,3014,131,3145,4,0,4,0,0,0,3568,131,3699
Rajasthan,2007,Sub_Jail,14,0,14,2239,26,2265,2,0,2,0,0,0,2255,26,2281
Rajasthan,2007,Women Jail,0,170,170,0,72,72,0,0,0,0,0,0,0,242,242
Rajasthan,2007,Borstal School,13,0,13,0,0,0,0,0,0,0,0,0,13,0,13
Rajasthan,2007,Open Jail,416,15,431,0,0,0,0,0,0,0,0,0,416,15,431
Rajasthan,2007,Special Jail,0,0,0,0,0,0,0,0,0,0,0,0,0,0,0
Rajasthan,2007,Others,0,0,0,0,0,0,0,0,0,0,0,0,0,0,0
Rajasthan,2007,Total,5678,192,5870,8423,342,8765,26,0,26,26,0,26,14153,534,14687
Rajasthan,2008,Central Jail,4660,0,4660,3281,92,3373,48,0,48,57,0,57,8046,92,8138
Rajasthan,2008,District Jail,887,0,887,3194,152,3346,4,0,4,8,0,8,4093,152,4245
Rajasthan,2008,Sub_Jail,19,1,20,2315,25,2340,3,0,3,0,0,0,2337,26,2363
Rajasthan,2008,Women Jail,0,198,198,0,61,61,0,0,0,0,0,0,0,259,259
Rajasthan,2008,Borstal School,13,0,13,0,0,0,0,0,0,0,0,0,13,0,13
Rajasthan,2008,Open Jail,484,18,502,0,0,0,0,0,0,0,0,0,484,18,502
Rajasthan,2008,Special Jail,0,0,0,0,0,0,0,0,0,0,0,0,0,0,0
Rajasthan,2008,Others,0,0,0,0,0,0,0,0,0,0,0,0,0,0,0
Rajasthan,2008,Total,6063,217,6280,8790,330,9120,55,0,55,65,0,65,14973,547,15520
Rajasthan,2009,Central Jail,4958,8,4966,4069,140,4209,26,0,26,28,0,28,9081,148,9229
Rajasthan,2009,District Jail,835,0,835,4166,153,4319,0,0,0,10,0,10,5011,153,5164
Rajasthan,2009,Sub_Jail,10,0,10,2667,28,2695,1,0,1,2,0,2,2680,28,2708
Rajasthan,2009,Women Jail,0,222,222,0,90,90,0,0,0,0,0,0,0,312,312
Rajasthan,2009,Borstal School,13,0,13,0,0,0,0,0,0,0,0,0,13,0,13
Rajasthan,2009,Open Jail,491,15,506,0,0,0,0,0,0,0,0,0,491,15,506
Rajasthan,2009,Special Jail,0,0,0,0,0,0,0,0,0,0,0,0,0,0,0
Rajasthan,2009,Others,0,0,0,0,0,0,0,0,0,0,0,0,0,0,0
Rajasthan,2009,Total,6307,245,6552,10902,411,11313,27,0,27,40,0,40,17276,656,17932
Rajasthan,2010,Central Jail,4745,0,4745,3874,120,3994,24,0,24,4,0,4,8647,120,8767
Rajasthan,2010,District Jail,753,3,756,3995,160,4155,6,0,6,0,0,0,4754,163,4917
Rajasthan,2010,Sub_Jail,12,0,12,2674,22,2696,0,0,0,0,0,0,2686,22,2708
Rajasthan,2010,Women Jail,0,204,204,0,83,83,0,0,0,0,0,0,0,287,287
Rajasthan,2010,Borstal School,10,0,10,0,0,0,0,0,0,0,0,0,10,0,10
Rajasthan,2010,Open Jail,490,15,505,0,0,0,0,0,0,0,0,0,490,15,505
Rajasthan,2010,Special Jail,0,0,0,0,0,0,0,0,0,0,0,0,0,0,0
Rajasthan,2010,Others,0,0,0,0,0,0,0,0,0,0,0,0,0,0,0
Rajasthan,2010,Total,6010,222,6232,10543,385,10928,30,0,30,4,0,4,16587,607,17194
Rajasthan,2011,Central Jail,4599,6,4605,4407,141,4548,19,0,19,3,0,3,9028,147,9175
Rajasthan,2011,District Jail,765,0,765,4287,157,4444,18,0,18,3,0,3,5073,157,5230
Rajasthan,2011,Sub_Jail,12,0,12,2786,10,2796,3,0,3,0,0,0,2801,10,2811
Rajasthan,2011,Women Jail,0,211,211,0,111,111,0,0,0,0,0,0,0,322,322
Rajasthan,2011,Borstal School,9,0,9,0,0,0,0,0,0,0,0,0,9,0,9
Rajasthan,2011,Open Jail,543,14,557,0,0,0,0,0,0,0,0,0,543,14,557
Rajasthan,2011,Special Jail,0,0,0,0,0,0,0,0,0,0,0,0,0,0,0
Rajasthan,2011,Others,0,0,0,0,0,0,0,0,0,0,0,0,0,0,0
Rajasthan,2011,Total,5928,231,6159,11480,419,11899,40,0,40,6,0,6,17454,650,18104
Rajasthan,2012,Central Jail,4480,0,4480,4933,130,5063,1,0,1,86,0,86,9500,130,9630
Rajasthan,2012,District Jail,778,0,778,4903,189,5092,0,0,0,7,0,7,5688,189,5877
Rajasthan,2012,Sub_Jail,2,0,2,2879,6,2885,0,0,0,4,0,4,2885,6,2891
Rajasthan,2012,Women Jail,0,228,228,0,130,130,0,0,0,0,0,0,0,358,358
Rajasthan,2012,Borstal School,18,0,18,0,0,0,0,0,0,0,0,0,18,0,18
Rajasthan,2012,Open Jail,565,12,577,0,0,0,0,0,0,0,0,0,565,12,577
Rajasthan,2012,Special Jail,0,0,0,0,0,0,0,0,0,0,0,0,0,0,0
Rajasthan,2012,Others,0,0,0,0,0,0,0,0,0,0,0,0,0,0,0
Rajasthan,2012,Total,5843,240,6083,12715,455,13170,1,0,1,97,0,97,18656,695,19351
Sikkim,2001,Central Jail,77,0,77,109,0,109,0,0,0,0,0,0,186,0,186
Sikkim,2001,District Jail,0,0,0,0,0,0,0,0,0,0,0,0,0,0,0
Sikkim,2001,Sub_Jail,0,0,0,0,0,0,0,0,0,0,0,0,0,0,0
Sikkim,2001,Women Jail,0,0,0,0,0,0,0,0,0,0,0,0,0,0,0
Sikkim,2001,Borstal School,0,0,0,0,0,0,0,0,0,0,0,0,0,0,0
Sikkim,2001,Open Jail,0,0,0,0,0,0,0,0,0,0,0,0,0,0,0
Sikkim,2001,Special Jail,0,0,0,0,0,0,0,0,0,0,0,0,0,0,0
Sikkim,2001,Others,0,0,0,0,0,0,0,0,0,0,0,0,0,0,0
Sikkim,2001,Total,77,0,77,109,0,109,0,0,0,0,0,0,186,0,186
Sikkim,2002,Central Jail,81,0,81,89,2,91,0,0,0,0,0,0,170,2,172
Sikkim,2002,District Jail,0,0,0,0,0,0,0,0,0,0,0,0,0,0,0
Sikkim,2002,Sub_Jail,0,0,0,0,0,0,0,0,0,0,0,0,0,0,0
Sikkim,2002,Women Jail,0,0,0,0,0,0,0,0,0,0,0,0,0,0,0
Sikkim,2002,Borstal School,0,0,0,0,0,0,0,0,0,0,0,0,0,0,0
Sikkim,2002,Open Jail,0,0,0,0,0,0,0,0,0,0,0,0,0,0,0
Sikkim,2002,Special Jail,0,0,0,0,0,0,0,0,0,0,0,0,0,0,0
Sikkim,2002,Others,0,0,0,0,0,0,0,0,0,0,0,0,0,0,0
Sikkim,2002,Total,81,0,81,89,2,91,0,0,0,0,0,0,170,2,172
Sikkim,2003,Central Jail,80,2,82,87,2,89,0,0,0,0,0,0,167,4,171
Sikkim,2003,District Jail,0,0,0,0,0,0,0,0,0,0,0,0,0,0,0
Sikkim,2003,Sub_Jail,0,0,0,0,0,0,0,0,0,0,0,0,0,0,0
Sikkim,2003,Women Jail,0,0,0,0,0,0,0,0,0,0,0,0,0,0,0
Sikkim,2003,Borstal School,0,0,0,0,0,0,0,0,0,0,0,0,0,0,0
Sikkim,2003,Open Jail,0,0,0,0,0,0,0,0,0,0,0,0,0,0,0
Sikkim,2003,Special Jail,0,0,0,0,0,0,0,0,0,0,0,0,0,0,0
Sikkim,2003,Others,0,0,0,0,0,0,0,0,0,0,0,0,0,0,0
Sikkim,2003,Total,80,2,82,87,2,89,0,0,0,0,0,0,167,4,171
Sikkim,2004,Central Jail,61,2,63,99,0,99,0,0,0,0,0,0,160,2,162
Sikkim,2004,District Jail,0,0,0,0,0,0,0,0,0,0,0,0,0,0,0
Sikkim,2004,Sub_Jail,0,0,0,0,0,0,0,0,0,0,0,0,0,0,0
Sikkim,2004,Women Jail,0,0,0,0,0,0,0,0,0,0,0,0,0,0,0
Sikkim,2004,Borstal School,0,0,0,0,0,0,0,0,0,0,0,0,0,0,0
Sikkim,2004,Open Jail,0,0,0,0,0,0,0,0,0,0,0,0,0,0,0
Sikkim,2004,Special Jail,0,0,0,0,0,0,0,0,0,0,0,0,0,0,0
Sikkim,2004,Others,0,0,0,0,0,0,0,0,0,0,0,0,0,0,0
Sikkim,2004,Total,61,2,63,99,0,99,0,0,0,0,0,0,160,2,162
Sikkim,2005,Central Jail,71,2,73,117,5,122,0,0,0,0,0,0,188,7,195
Sikkim,2005,District Jail,0,0,0,0,0,0,0,0,0,0,0,0,0,0,0
Sikkim,2005,Sub_Jail,0,0,0,0,0,0,0,0,0,0,0,0,0,0,0
Sikkim,2005,Women Jail,0,0,0,0,0,0,0,0,0,0,0,0,0,0,0
Sikkim,2005,Borstal School,0,0,0,0,0,0,0,0,0,0,0,0,0,0,0
Sikkim,2005,Open Jail,0,0,0,0,0,0,0,0,0,0,0,0,0,0,0
Sikkim,2005,Special Jail,0,0,0,0,0,0,0,0,0,0,0,0,0,0,0
Sikkim,2005,Others,0,0,0,0,0,0,0,0,0,0,0,0,0,0,0
Sikkim,2005,Total,71,2,73,117,5,122,0,0,0,0,0,0,188,7,195
Sikkim,2006,Central Jail,90,1,91,132,2,134,0,0,0,0,0,0,222,3,225
Sikkim,2006,District Jail,0,0,0,0,0,0,0,0,0,0,0,0,0,0,0
Sikkim,2006,Sub_Jail,0,0,0,0,0,0,0,0,0,0,0,0,0,0,0
Sikkim,2006,Women Jail,0,0,0,0,0,0,0,0,0,0,0,0,0,0,0
Sikkim,2006,Borstal School,0,0,0,0,0,0,0,0,0,0,0,0,0,0,0
Sikkim,2006,Open Jail,0,0,0,0,0,0,0,0,0,0,0,0,0,0,0
Sikkim,2006,Special Jail,0,0,0,0,0,0,0,0,0,0,0,0,0,0,0
Sikkim,2006,Others,0,0,0,0,0,0,0,0,0,0,0,0,0,0,0
Sikkim,2006,Total,90,1,91,132,2,134,0,0,0,0,0,0,222,3,225
Sikkim,2007,Central Jail,81,1,82,92,3,95,0,0,0,0,0,0,173,4,177
Sikkim,2007,District Jail,0,0,0,49,0,49,0,0,0,0,0,0,49,0,49
Sikkim,2007,Sub_Jail,0,0,0,0,0,0,0,0,0,0,0,0,0,0,0
Sikkim,2007,Women Jail,0,0,0,0,0,0,0,0,0,0,0,0,0,0,0
Sikkim,2007,Borstal School,0,0,0,0,0,0,0,0,0,0,0,0,0,0,0
Sikkim,2007,Open Jail,0,0,0,0,0,0,0,0,0,0,0,0,0,0,0
Sikkim,2007,Special Jail,0,0,0,0,0,0,0,0,0,0,0,0,0,0,0
Sikkim,2007,Others,0,0,0,0,0,0,0,0,0,0,0,0,0,0,0
Sikkim,2007,Total,81,1,82,141,3,144,0,0,0,0,0,0,222,4,226
Sikkim,2008,Central Jail,67,1,68,105,7,112,0,0,0,0,0,0,172,8,180
Sikkim,2008,District Jail,0,0,0,79,1,80,0,0,0,0,0,0,79,1,80
Sikkim,2008,Sub_Jail,0,0,0,0,0,0,0,0,0,0,0,0,0,0,0
Sikkim,2008,Women Jail,0,0,0,0,0,0,0,0,0,0,0,0,0,0,0
Sikkim,2008,Borstal School,0,0,0,0,0,0,0,0,0,0,0,0,0,0,0
Sikkim,2008,Open Jail,0,0,0,0,0,0,0,0,0,0,0,0,0,0,0
Sikkim,2008,Special Jail,0,0,0,0,0,0,0,0,0,0,0,0,0,0,0
Sikkim,2008,Others,0,0,0,0,0,0,0,0,0,0,0,0,0,0,0
Sikkim,2008,Total,67,1,68,184,8,192,0,0,0,0,0,0,251,9,260
Sikkim,2009,Central Jail,68,1,69,60,5,65,0,0,0,0,0,0,128,6,134
Sikkim,2009,District Jail,0,0,0,58,1,59,0,0,0,0,0,0,58,1,59
Sikkim,2009,Sub_Jail,0,0,0,0,0,0,0,0,0,0,0,0,0,0,0
Sikkim,2009,Women Jail,0,0,0,0,0,0,0,0,0,0,0,0,0,0,0
Sikkim,2009,Borstal School,0,0,0,0,0,0,0,0,0,0,0,0,0,0,0
Sikkim,2009,Open Jail,0,0,0,0,0,0,0,0,0,0,0,0,0,0,0
Sikkim,2009,Special Jail,0,0,0,0,0,0,0,0,0,0,0,0,0,0,0
Sikkim,2009,Others,0,0,0,0,0,0,0,0,0,0,0,0,0,0,0
Sikkim,2009,Total,68,1,69,118,6,124,0,0,0,0,0,0,186,7,193
Sikkim,2010,Central Jail,74,2,76,64,3,67,0,0,0,0,0,0,138,5,143
Sikkim,2010,District Jail,0,0,0,62,2,64,0,0,0,0,0,0,62,2,64
Sikkim,2010,Sub_Jail,0,0,0,0,0,0,0,0,0,0,0,0,0,0,0
Sikkim,2010,Women Jail,0,0,0,0,0,0,0,0,0,0,0,0,0,0,0
Sikkim,2010,Borstal School,0,0,0,0,0,0,0,0,0,0,0,0,0,0,0
Sikkim,2010,Open Jail,0,0,0,0,0,0,0,0,0,0,0,0,0,0,0
Sikkim,2010,Special Jail,0,0,0,0,0,0,0,0,0,0,0,0,0,0,0
Sikkim,2010,Others,0,0,0,0,0,0,0,0,0,0,0,0,0,0,0
Sikkim,2010,Total,74,2,76,126,5,131,0,0,0,0,0,0,200,7,207
Sikkim,2011,Central Jail,69,1,70,60,1,61,0,0,0,0,0,0,129,2,131
Sikkim,2011,District Jail,0,0,0,59,0,59,0,0,0,0,0,0,59,0,59
Sikkim,2011,Sub_Jail,0,0,0,0,0,0,0,0,0,0,0,0,0,0,0
Sikkim,2011,Women Jail,0,0,0,0,0,0,0,0,0,0,0,0,0,0,0
Sikkim,2011,Borstal School,0,0,0,0,0,0,0,0,0,0,0,0,0,0,0
Sikkim,2011,Open Jail,0,0,0,0,0,0,0,0,0,0,0,0,0,0,0
Sikkim,2011,Special Jail,0,0,0,0,0,0,0,0,0,0,0,0,0,0,0
Sikkim,2011,Others,0,0,0,0,0,0,0,0,0,0,0,0,0,0,0
Sikkim,2011,Total,69,1,70,119,1,120,0,0,0,0,0,0,188,2,190
Sikkim,2012,Central Jail,87,1,88,73,1,74,0,0,0,0,0,0,160,2,162
Sikkim,2012,District Jail,0,0,0,70,4,74,0,0,0,0,0,0,70,4,74
Sikkim,2012,Sub_Jail,0,0,0,0,0,0,0,0,0,0,0,0,0,0,0
Sikkim,2012,Women Jail,0,0,0,0,0,0,0,0,0,0,0,0,0,0,0
Sikkim,2012,Borstal School,0,0,0,0,0,0,0,0,0,0,0,0,0,0,0
Sikkim,2012,Open Jail,0,0,0,0,0,0,0,0,0,0,0,0,0,0,0
Sikkim,2012,Special Jail,0,0,0,0,0,0,0,0,0,0,0,0,0,0,0
Sikkim,2012,Others,0,0,0,0,0,0,0,0,0,0,0,0,0,0,0
Sikkim,2012,Total,87,1,88,143,5,148,0,0,0,0,0,0,230,6,236
Tamilnadu,2001,Central Jail,4658,5,4663,1822,14,1836,1014,9,1023,7128,30,7158,14622,58,14680
Tamilnadu,2001,District Jail,0,0,0,0,0,0,0,0,0,0,0,0,0,0,0
Tamilnadu,2001,Sub_Jail,4,0,4,378,95,473,0,0,0,3989,832,4821,4371,927,5298
Tamilnadu,2001,Women Jail,0,154,154,0,25,25,0,210,210,0,436,436,0,825,825
Tamilnadu,2001,Borstal School,25,0,25,0,0,0,0,0,0,0,0,0,25,0,25
Tamilnadu,2001,Open Jail,11,0,11,0,0,0,0,0,0,0,0,0,11,0,11
Tamilnadu,2001,Special Jail,0,0,0,24,7,31,0,0,0,247,143,390,271,150,421
Tamilnadu,2001,Others,0,0,0,0,0,0,0,0,0,0,0,0,0,0,0
Tamilnadu,2001,Total,4698,159,4857,2224,141,2365,1014,219,1233,11364,1441,12805,19300,1960,21260
Tamilnadu,2002,Central Jail,5357,5,5362,2480,2,2482,1716,10,1726,6730,32,6762,16283,49,16332
Tamilnadu,2002,District Jail,0,0,0,0,0,0,0,0,0,0,0,0,0,0,0
Tamilnadu,2002,Sub_Jail,2,0,2,22,3,25,0,0,0,3402,528,3930,3426,531,3957
Tamilnadu,2002,Women Jail,0,174,174,0,49,49,0,174,174,0,683,683,0,1080,1080
Tamilnadu,2002,Borstal School,25,0,25,0,0,0,0,0,0,0,0,0,25,0,25
Tamilnadu,2002,Open Jail,16,0,16,0,0,0,0,0,0,0,0,0,16,0,16
Tamilnadu,2002,Special Jail,2,1,3,6,5,11,0,0,0,348,123,471,356,129,485
Tamilnadu,2002,Others,0,0,0,0,0,0,0,0,0,0,0,0,0,0,0
Tamilnadu,2002,Total,5402,180,5582,2508,59,2567,1716,184,1900,10480,1366,11846,20106,1789,21895
Tamilnadu,2003,Central Jail,5865,4,5869,3015,7,3022,1003,3,1006,6524,170,6694,16407,184,16591
Tamilnadu,2003,District Jail,0,0,0,0,0,0,0,0,0,0,0,0,0,0,0
Tamilnadu,2003,Sub_Jail,1,0,1,0,0,0,0,0,0,4152,478,4630,4153,478,4631
Tamilnadu,2003,Women Jail,0,188,188,0,47,47,0,78,78,0,550,550,0,863,863
Tamilnadu,2003,Borstal School,11,0,11,0,0,0,0,0,0,0,0,0,11,0,11
Tamilnadu,2003,Open Jail,89,0,89,0,0,0,0,0,0,0,0,0,89,0,89
Tamilnadu,2003,Special Jail,3,0,3,0,0,0,0,0,0,134,331,465,137,331,468
Tamilnadu,2003,Others,0,0,0,0,0,0,0,0,0,0,0,0,0,0,0
Tamilnadu,2003,Total,5969,192,6161,3015,54,3069,1003,81,1084,10810,1529,12339,20797,1856,22653
Tamilnadu,2004,Central Jail,6495,1,6496,2855,14,2869,593,2,595,6166,83,6249,16109,100,16209
Tamilnadu,2004,District Jail,0,0,0,0,0,0,0,0,0,0,0,0,0,0,0
Tamilnadu,2004,Sub_Jail,0,0,0,4,0,4,0,0,0,2855,688,3543,2859,688,3547
Tamilnadu,2004,Women Jail,0,200,200,0,45,45,0,17,17,0,566,566,0,828,828
Tamilnadu,2004,Borstal School,9,0,9,0,0,0,0,0,0,0,0,0,9,0,9
Tamilnadu,2004,Open Jail,89,0,89,0,0,0,0,0,0,0,0,0,89,0,89
Tamilnadu,2004,Special Jail,0,0,0,0,0,0,0,0,0,197,214,411,197,214,411
Tamilnadu,2004,Others,9,0,9,0,0,0,0,0,0,0,0,0,9,0,9
Tamilnadu,2004,Total,6602,201,6803,2859,59,2918,593,19,612,9218,1551,10769,19272,1830,21102
Tamilnadu,2005,Central Jail,7127,3,7130,2948,13,2961,787,2,789,4869,86,4955,15731,104,15835
Tamilnadu,2005,District Jail,0,0,0,0,0,0,0,0,0,0,0,0,0,0,0
Tamilnadu,2005,Sub_Jail,0,0,0,0,0,0,0,0,0,3106,621,3727,3106,621,3727
Tamilnadu,2005,Women Jail,0,243,243,0,47,47,0,38,38,0,534,534,0,862,862
Tamilnadu,2005,Borstal School,11,0,11,0,0,0,0,0,0,0,0,0,11,0,11
Tamilnadu,2005,Open Jail,65,0,65,0,0,0,0,0,0,20,0,20,85,0,85
Tamilnadu,2005,Special Jail,4,0,4,0,0,0,0,0,0,125,22,147,129,22,151
Tamilnadu,2005,Others,10,0,10,0,0,0,0,0,0,0,0,0,10,0,10
Tamilnadu,2005,Total,7217,246,7463,2948,60,3008,787,40,827,8120,1263,9383,19072,1609,20681
Tamilnadu,2006,Central Jail,6434,0,6434,2835,5,2840,622,0,622,4049,39,4088,13940,44,13984
Tamilnadu,2006,District Jail,0,0,0,0,0,0,0,0,0,61,119,180,61,119,180
Tamilnadu,2006,Sub_Jail,0,0,0,0,0,0,0,0,0,2749,502,3251,2749,502,3251
Tamilnadu,2006,Women Jail,0,197,197,0,45,45,0,29,29,0,518,518,0,789,789
Tamilnadu,2006,Borstal School,0,0,0,0,0,0,0,0,0,339,0,339,339,0,339
Tamilnadu,2006,Open Jail,53,0,53,0,0,0,0,0,0,0,0,0,53,0,53
Tamilnadu,2006,Special Jail,10,0,10,0,0,0,0,0,0,0,0,0,10,0,10
Tamilnadu,2006,Others,12,0,12,0,0,0,0,0,0,38,0,38,50,0,50
Tamilnadu,2006,Total,6509,197,6706,2835,50,2885,622,29,651,7236,1178,8414,17202,1454,18656
Tamilnadu,2007,Central Jail,6123,3,6126,6190,46,6236,636,0,636,8,0,8,12957,49,13006
Tamilnadu,2007,District Jail,0,0,0,444,0,444,0,0,0,0,0,0,444,0,444
Tamilnadu,2007,Sub_Jail,0,0,0,1718,238,1956,0,0,0,0,0,0,1718,238,1956
Tamilnadu,2007,Women Jail,0,189,189,0,606,606,0,29,29,0,0,0,0,824,824
Tamilnadu,2007,Borstal School,7,0,7,131,0,131,2,0,2,0,0,0,140,0,140
Tamilnadu,2007,Open Jail,59,0,59,0,0,0,0,0,0,0,0,0,59,0,59
Tamilnadu,2007,Special Jail,1,0,1,65,104,169,0,0,0,0,0,0,66,104,170
Tamilnadu,2007,Others,0,0,0,0,0,0,0,0,0,0,0,0,0,0,0
Tamilnadu,2007,Total,6190,192,6382,8548,994,9542,638,29,667,8,0,8,15384,1215,16599
Tamilnadu,2008,Central Jail,5142,1,5143,6350,48,6398,989,0,989,4,0,4,12485,49,12534
Tamilnadu,2008,District Jail,0,0,0,365,0,365,0,0,0,0,0,0,365,0,365
Tamilnadu,2008,Sub_Jail,0,0,0,1675,230,1905,0,0,0,0,0,0,1675,230,1905
Tamilnadu,2008,Women Jail,0,173,173,0,507,507,0,32,32,0,0,0,0,712,712
Tamilnadu,2008,Borstal School,58,0,58,491,0,491,14,0,14,0,0,0,563,0,563
Tamilnadu,2008,Open Jail,45,0,45,0,0,0,0,0,0,0,0,0,45,0,45
Tamilnadu,2008,Special Jail,0,0,0,0,80,80,0,0,0,0,0,0,0,80,80
Tamilnadu,2008,Others,0,0,0,0,0,0,0,0,0,0,0,0,0,0,0
Tamilnadu,2008,Total,5245,174,5419,8881,865,9746,1003,32,1035,4,0,4,15133,1071,16204
Tamilnadu,2009,Central Jail,5121,1,5122,5359,70,5429,819,0,819,4,0,4,11303,71,11374
Tamilnadu,2009,District Jail,0,0,0,571,0,571,0,0,0,0,0,0,571,0,571
Tamilnadu,2009,Sub_Jail,0,0,0,1324,117,1441,0,0,0,0,0,0,1324,117,1441
Tamilnadu,2009,Women Jail,0,177,177,0,312,312,0,16,16,0,1,1,0,506,506
Tamilnadu,2009,Borstal School,7,0,7,330,0,330,0,0,0,0,0,0,337,0,337
Tamilnadu,2009,Open Jail,55,0,55,0,0,0,0,0,0,0,0,0,55,0,55
Tamilnadu,2009,Special Jail,0,0,0,0,76,76,0,0,0,0,0,0,0,76,76
Tamilnadu,2009,Others,0,0,0,0,0,0,0,0,0,0,0,0,0,0,0
Tamilnadu,2009,Total,5183,178,5361,7584,575,8159,819,16,835,4,1,5,13590,770,14360
Tamilnadu,2010,Central Jail,5136,1,5137,5183,56,5239,801,0,801,3,0,3,11123,57,11180
Tamilnadu,2010,District Jail,0,0,0,449,0,449,0,0,0,0,0,0,449,0,449
Tamilnadu,2010,Sub_Jail,0,0,0,1179,120,1299,0,0,0,0,0,0,1179,120,1299
Tamilnadu,2010,Women Jail,0,167,167,0,284,284,0,23,23,0,0,0,0,474,474
Tamilnadu,2010,Borstal School,5,0,5,343,0,343,9,0,9,0,0,0,357,0,357
Tamilnadu,2010,Open Jail,24,0,24,0,0,0,0,0,0,0,0,0,24,0,24
Tamilnadu,2010,Special Jail,0,0,0,0,83,83,0,0,0,0,0,0,0,83,83
Tamilnadu,2010,Others,0,0,0,0,0,0,0,0,0,0,0,0,0,0,0
Tamilnadu,2010,Total,5165,168,5333,7154,543,7697,810,23,833,3,0,3,13132,734,13866
Tamilnadu,2011,Central Jail,4955,0,4955,4760,55,4815,957,0,957,4,0,4,10676,55,10731
Tamilnadu,2011,District Jail,1,0,1,611,0,611,0,0,0,0,0,0,612,0,612
Tamilnadu,2011,Sub_Jail,0,0,0,1362,184,1546,0,0,0,0,0,0,1362,184,1546
Tamilnadu,2011,Women Jail,0,175,175,0,277,277,0,21,21,0,0,0,0,473,473
Tamilnadu,2011,Borstal School,3,0,3,375,0,375,5,0,5,0,0,0,383,0,383
Tamilnadu,2011,Open Jail,66,0,66,0,0,0,0,0,0,0,0,0,66,0,66
Tamilnadu,2011,Special Jail,0,0,0,0,58,58,0,0,0,0,0,0,0,58,58
Tamilnadu,2011,Others,0,0,0,0,0,0,0,0,0,0,0,0,0,0,0
Tamilnadu,2011,Total,5025,175,5200,7108,574,7682,962,21,983,4,0,4,13099,770,13869
Tamilnadu,2012,Central Jail,4436,0,4436,5159,47,5206,501,0,501,0,0,0,10096,47,10143
Tamilnadu,2012,District Jail,0,0,0,613,0,613,0,0,0,0,0,0,613,0,613
Tamilnadu,2012,Sub_Jail,0,0,0,1355,154,1509,0,0,0,0,0,0,1355,154,1509
Tamilnadu,2012,Women Jail,0,168,168,0,293,293,0,21,21,0,0,0,0,482,482
Tamilnadu,2012,Borstal School,11,0,11,309,0,309,1,0,1,0,0,0,321,0,321
Tamilnadu,2012,Open Jail,63,0,63,0,0,0,0,0,0,0,0,0,63,0,63
Tamilnadu,2012,Special Jail,0,0,0,0,64,64,0,0,0,0,0,0,0,64,64
Tamilnadu,2012,Others,0,0,0,0,0,0,0,0,0,0,0,0,0,0,0
Tamilnadu,2012,Total,4510,168,4678,7436,558,7994,502,21,523,0,0,0,12448,747,13195
Tripura,2001,Central Jail,316,0,316,136,0,136,1,0,1,0,0,0,453,0,453
Tripura,2001,District Jail,14,0,14,248,0,248,0,0,0,0,0,0,262,0,262
Tripura,2001,Sub_Jail,28,0,28,280,3,283,1,0,1,0,0,0,309,3,312
Tripura,2001,Women Jail,0,4,4,0,9,9,0,0,0,0,0,0,0,13,13
Tripura,2001,Borstal School,0,0,0,0,0,0,0,0,0,0,0,0,0,0,0
Tripura,2001,Open Jail,0,0,0,0,0,0,0,0,0,0,0,0,0,0,0
Tripura,2001,Special Jail,0,0,0,0,0,0,0,0,0,0,0,0,0,0,0
Tripura,2001,Others,0,0,0,0,0,0,0,0,0,0,0,0,0,0,0
Tripura,2001,Total,358,4,362,664,12,676,2,0,2,0,0,0,1024,16,1040
Tripura,2002,Central Jail,447,0,447,152,0,152,0,0,0,0,0,0,599,0,599
Tripura,2002,District Jail,19,0,19,121,4,125,0,0,0,0,0,0,140,4,144
Tripura,2002,Sub_Jail,16,0,16,270,0,270,2,0,2,0,0,0,288,0,288
Tripura,2002,Women Jail,0,6,6,0,4,4,0,0,0,0,0,0,0,10,10
Tripura,2002,Borstal School,0,0,0,0,0,0,0,0,0,0,0,0,0,0,0
Tripura,2002,Open Jail,0,0,0,0,0,0,0,0,0,0,0,0,0,0,0
Tripura,2002,Special Jail,0,0,0,0,0,0,0,0,0,0,0,0,0,0,0
Tripura,2002,Others,0,0,0,0,0,0,0,0,0,0,0,0,0,0,0
Tripura,2002,Total,482,6,488,543,8,551,2,0,2,0,0,0,1027,14,1041
Tripura,2003,Central Jail,274,0,274,201,0,201,0,0,0,1,0,1,476,0,476
Tripura,2003,District Jail,102,0,102,170,0,170,0,0,0,0,0,0,272,0,272
Tripura,2003,Sub_Jail,117,0,117,516,6,522,2,0,2,0,0,0,635,6,641
Tripura,2003,Women Jail,0,7,7,0,5,5,0,0,0,0,0,0,0,12,12
Tripura,2003,Borstal School,0,0,0,0,0,0,0,0,0,0,0,0,0,0,0
Tripura,2003,Open Jail,0,0,0,0,0,0,0,0,0,0,0,0,0,0,0
Tripura,2003,Special Jail,0,0,0,0,0,0,0,0,0,0,0,0,0,0,0
Tripura,2003,Others,0,0,0,0,0,0,0,0,0,0,0,0,0,0,0
Tripura,2003,Total,493,7,500,887,11,898,2,0,2,1,0,1,1383,18,1401
Tripura,2004,Central Jail,351,0,351,159,0,159,0,0,0,0,0,0,510,0,510
Tripura,2004,District Jail,97,0,97,157,3,160,0,0,0,1,0,1,255,3,258
Tripura,2004,Sub_Jail,92,0,92,382,3,385,0,0,0,2,0,2,476,3,479
Tripura,2004,Women Jail,0,14,14,0,4,4,0,0,0,0,0,0,0,18,18
Tripura,2004,Borstal School,0,0,0,0,0,0,0,0,0,0,0,0,0,0,0
Tripura,2004,Open Jail,0,0,0,0,0,0,0,0,0,0,0,0,0,0,0
Tripura,2004,Special Jail,0,0,0,0,0,0,0,0,0,0,0,0,0,0,0
Tripura,2004,Others,0,0,0,0,0,0,0,0,0,0,0,0,0,0,0
Tripura,2004,Total,540,14,554,698,10,708,0,0,0,3,0,3,1241,24,1265
Tripura,2005,Central Jail,512,0,512,167,0,167,1,0,1,1,0,1,681,0,681
Tripura,2005,District Jail,105,0,105,116,6,122,0,0,0,0,0,0,221,6,227
Tripura,2005,Sub_Jail,120,0,120,352,11,363,0,0,0,0,0,0,472,11,483
Tripura,2005,Women Jail,0,15,15,0,4,4,0,0,0,0,0,0,0,19,19
Tripura,2005,Borstal School,0,0,0,0,0,0,0,0,0,0,0,0,0,0,0
Tripura,2005,Open Jail,0,0,0,0,0,0,0,0,0,0,0,0,0,0,0
Tripura,2005,Special Jail,0,0,0,0,0,0,0,0,0,0,0,0,0,0,0
Tripura,2005,Others,0,0,0,0,0,0,0,0,0,0,0,0,0,0,0
Tripura,2005,Total,737,15,752,635,21,656,1,0,1,1,0,1,1374,36,1410
Tripura,2006,Central Jail,556,0,556,137,0,137,0,0,0,0,0,0,693,0,693
Tripura,2006,District Jail,115,0,115,85,3,88,0,0,0,0,0,0,200,3,203
Tripura,2006,Sub_Jail,100,1,101,344,7,351,0,0,0,0,0,0,444,8,452
Tripura,2006,Women Jail,0,17,17,0,5,5,0,0,0,0,0,0,0,22,22
Tripura,2006,Borstal School,0,0,0,0,0,0,0,0,0,0,0,0,0,0,0
Tripura,2006,Open Jail,0,0,0,0,0,0,0,0,0,0,0,0,0,0,0
Tripura,2006,Special Jail,0,0,0,0,0,0,0,0,0,0,0,0,0,0,0
Tripura,2006,Others,0,0,0,0,0,0,0,0,0,0,0,0,0,0,0
Tripura,2006,Total,771,18,789,566,15,581,0,0,0,0,0,0,1337,33,1370
Tripura,2007,Central Jail,533,0,533,137,0,137,0,0,0,0,0,0,670,0,670
Tripura,2007,District Jail,161,1,162,62,0,62,1,0,1,0,0,0,224,1,225
Tripura,2007,Sub_Jail,96,1,97,290,6,296,0,0,0,0,0,0,386,7,393
Tripura,2007,Women Jail,0,21,21,0,8,8,0,0,0,0,0,0,0,29,29
Tripura,2007,Borstal School,0,0,0,0,0,0,0,0,0,0,0,0,0,0,0
Tripura,2007,Open Jail,0,0,0,0,0,0,0,0,0,0,0,0,0,0,0
Tripura,2007,Special Jail,0,0,0,0,0,0,0,0,0,0,0,0,0,0,0
Tripura,2007,Others,0,0,0,0,0,0,0,0,0,0,0,0,0,0,0
Tripura,2007,Total,790,23,813,489,14,503,1,0,1,0,0,0,1280,37,1317
Tripura,2008,Central Jail,531,0,531,140,0,140,0,0,0,0,0,0,671,0,671
Tripura,2008,District Jail,177,0,177,77,1,78,0,0,0,0,0,0,254,1,255
Tripura,2008,Sub_Jail,100,0,100,226,4,230,0,0,0,0,0,0,326,4,330
Tripura,2008,Women Jail,0,19,19,0,3,3,0,0,0,0,0,0,0,22,22
Tripura,2008,Borstal School,0,0,0,0,0,0,0,0,0,0,0,0,0,0,0
Tripura,2008,Open Jail,0,0,0,0,0,0,0,0,0,0,0,0,0,0,0
Tripura,2008,Special Jail,0,0,0,0,0,0,0,0,0,0,0,0,0,0,0
Tripura,2008,Others,0,0,0,0,0,0,0,0,0,0,0,0,0,0,0
Tripura,2008,Total,808,19,827,443,8,451,0,0,0,0,0,0,1251,27,1278
Tripura,2009,Central Jail,382,0,382,117,0,117,0,0,0,0,0,0,499,0,499
Tripura,2009,District Jail,147,0,147,69,4,73,0,0,0,0,0,0,216,4,220
Tripura,2009,Sub_Jail,110,1,111,133,8,141,0,0,0,0,0,0,243,9,252
Tripura,2009,Women Jail,0,13,13,0,4,4,0,0,0,0,0,0,0,17,17
Tripura,2009,Borstal School,0,0,0,0,0,0,0,0,0,0,0,0,0,0,0
Tripura,2009,Open Jail,0,0,0,0,0,0,0,0,0,0,0,0,0,0,0
Tripura,2009,Special Jail,0,0,0,0,0,0,0,0,0,0,0,0,0,0,0
Tripura,2009,Others,0,0,0,0,0,0,0,0,0,0,0,0,0,0,0
Tripura,2009,Total,639,14,653,319,16,335,0,0,0,0,0,0,958,30,988
Tripura,2010,Central Jail,329,0,329,121,0,121,0,0,0,0,0,0,450,0,450
Tripura,2010,District Jail,108,0,108,44,3,47,0,0,0,0,0,0,152,3,155
Tripura,2010,Sub_Jail,154,1,155,173,6,179,0,0,0,0,0,0,327,7,334
Tripura,2010,Women Jail,0,11,11,0,1,1,0,0,0,0,0,0,0,12,12
Tripura,2010,Borstal School,0,0,0,0,0,0,0,0,0,0,0,0,0,0,0
Tripura,2010,Open Jail,0,0,0,0,0,0,0,0,0,0,0,0,0,0,0
Tripura,2010,Special Jail,0,0,0,0,0,0,0,0,0,0,0,0,0,0,0
Tripura,2010,Others,0,0,0,0,0,0,0,0,0,0,0,0,0,0,0
Tripura,2010,Total,591,12,603,338,10,348,0,0,0,0,0,0,929,22,951
Tripura,2011,Central Jail,314,0,314,110,0,110,0,0,0,0,0,0,424,0,424
Tripura,2011,District Jail,123,0,123,44,2,46,0,0,0,0,0,0,167,2,169
Tripura,2011,Sub_Jail,117,1,118,156,7,163,0,0,0,0,0,0,273,8,281
Tripura,2011,Women Jail,0,14,14,0,11,11,0,0,0,0,0,0,0,25,25
Tripura,2011,Borstal School,0,0,0,0,0,0,0,0,0,0,0,0,0,0,0
Tripura,2011,Open Jail,0,0,0,0,0,0,0,0,0,0,0,0,0,0,0
Tripura,2011,Special Jail,0,0,0,0,0,0,0,0,0,0,0,0,0,0,0
Tripura,2011,Others,0,0,0,0,0,0,0,0,0,0,0,0,0,0,0
Tripura,2011,Total,554,15,569,310,20,330,0,0,0,0,0,0,864,35,899
Tripura,2012,Central Jail,307,0,307,119,0,119,0,0,0,0,0,0,426,0,426
Tripura,2012,District Jail,113,0,113,47,0,47,0,0,0,0,0,0,160,0,160
Tripura,2012,Sub_Jail,115,1,116,172,2,174,0,0,0,0,0,0,287,3,290
Tripura,2012,Women Jail,0,13,13,0,12,12,0,0,0,0,0,0,0,25,25
Tripura,2012,Borstal School,0,0,0,0,0,0,0,0,0,0,0,0,0,0,0
Tripura,2012,Open Jail,0,0,0,0,0,0,0,0,0,0,0,0,0,0,0
Tripura,2012,Special Jail,0,0,0,0,0,0,0,0,0,0,0,0,0,0,0
Tripura,2012,Others,0,0,0,0,0,0,0,0,0,0,0,0,0,0,0
Tripura,2012,Total,535,14,549,338,14,352,0,0,0,0,0,0,873,28,901
Uttar Pradesh,2001,Central Jail,3347,6,3353,3655,47,3702,29,0,29,2,0,2,7033,53,7086
Uttar Pradesh,2001,District Jail,1896,17,1913,41471,1121,42592,290,5,295,313,4,317,43970,1147,45117
Uttar Pradesh,2001,Sub_Jail,22,0,22,572,9,581,185,1,186,24,0,24,803,10,813
Uttar Pradesh,2001,Women Jail,0,18,18,0,0,0,0,0,0,0,0,0,0,18,18
Uttar Pradesh,2001,Borstal School,0,0,0,0,0,0,0,0,0,0,0,0,0,0,0
Uttar Pradesh,2001,Open Jail,0,0,0,0,0,0,0,0,0,0,0,0,0,0,0
Uttar Pradesh,2001,Special Jail,160,102,262,0,0,0,0,0,0,0,0,0,160,102,262
Uttar Pradesh,2001,Others,0,0,0,0,0,0,0,0,0,0,0,0,0,0,0
Uttar Pradesh,2001,Total,5425,143,5568,45698,1177,46875,504,6,510,339,4,343,51966,1330,53296
Uttar Pradesh,2002,Central Jail,3665,6,3671,1947,29,1976,119,0,119,15,0,15,5746,35,5781
Uttar Pradesh,2002,District Jail,1996,25,2021,41533,1059,42592,940,5,945,41,0,41,44510,1089,45599
Uttar Pradesh,2002,Sub_Jail,26,0,26,336,12,348,11,2,13,67,0,67,440,14,454
Uttar Pradesh,2002,Women Jail,0,126,126,0,0,0,0,0,0,0,0,0,0,126,126
Uttar Pradesh,2002,Borstal School,0,0,0,0,0,0,0,0,0,0,0,0,0,0,0
Uttar Pradesh,2002,Open Jail,0,0,0,0,0,0,0,0,0,0,0,0,0,0,0
Uttar Pradesh,2002,Special Jail,229,0,229,35,0,35,1,0,1,0,0,0,265,0,265
Uttar Pradesh,2002,Others,0,0,0,0,0,0,0,0,0,0,0,0,0,0,0
Uttar Pradesh,2002,Total,5916,157,6073,43851,1100,44951,1071,7,1078,123,0,123,50961,1264,52225
Uttar Pradesh,2003,Central Jail,3954,4,3958,2311,12,2323,23,0,23,19,0,19,6307,16,6323
Uttar Pradesh,2003,District Jail,2861,32,2893,38053,912,38965,1375,19,1394,164,0,164,42453,963,43416
Uttar Pradesh,2003,Sub_Jail,23,0,23,420,2,422,0,0,0,32,0,32,475,2,477
Uttar Pradesh,2003,Women Jail,0,140,140,0,0,0,0,0,0,0,0,0,0,140,140
Uttar Pradesh,2003,Borstal School,0,0,0,0,0,0,0,0,0,0,0,0,0,0,0
Uttar Pradesh,2003,Open Jail,0,0,0,0,0,0,0,0,0,0,0,0,0,0,0
Uttar Pradesh,2003,Special Jail,175,0,175,0,0,0,0,0,0,0,0,0,175,0,175
Uttar Pradesh,2003,Others,0,0,0,0,0,0,0,0,0,0,0,0,0,0,0
Uttar Pradesh,2003,Total,7013,176,7189,40784,926,41710,1398,19,1417,215,0,215,49410,1121,50531
Uttar Pradesh,2004,Central Jail,4737,6,4743,2140,23,2163,12,0,12,23,0,23,6912,29,6941
Uttar Pradesh,2004,District Jail,3123,184,3307,37746,750,38496,1968,73,2041,94,1,95,42931,1008,43939
Uttar Pradesh,2004,Sub_Jail,41,1,42,457,4,461,0,0,0,0,0,0,498,5,503
Uttar Pradesh,2004,Women Jail,0,6,6,0,104,104,0,0,0,0,0,0,0,110,110
Uttar Pradesh,2004,Borstal School,0,0,0,0,0,0,0,0,0,0,0,0,0,0,0
Uttar Pradesh,2004,Open Jail,0,0,0,0,0,0,0,0,0,0,0,0,0,0,0
Uttar Pradesh,2004,Special Jail,213,0,213,0,0,0,0,0,0,0,0,0,213,0,213
Uttar Pradesh,2004,Others,0,0,0,0,0,0,0,0,0,0,0,0,0,0,0
Uttar Pradesh,2004,Total,8114,197,8311,40343,881,41224,1980,73,2053,117,1,118,50554,1152,51706
Uttar Pradesh,2005,Central Jail,7192,6,7198,1369,27,1396,22,0,22,6,0,6,8589,33,8622
Uttar Pradesh,2005,District Jail,5497,162,5659,40230,1019,41249,203,1,204,91,0,91,46021,1182,47203
Uttar Pradesh,2005,Sub_Jail,36,0,36,407,3,410,21,0,21,10,0,10,474,3,477
Uttar Pradesh,2005,Women Jail,0,125,125,0,0,0,0,0,0,0,0,0,0,125,125
Uttar Pradesh,2005,Borstal School,0,0,0,0,0,0,0,0,0,0,0,0,0,0,0
Uttar Pradesh,2005,Open Jail,0,0,0,0,0,0,0,0,0,0,0,0,0,0,0
Uttar Pradesh,2005,Special Jail,266,0,266,23,0,23,2,0,2,0,0,0,291,0,291
Uttar Pradesh,2005,Others,0,0,0,0,0,0,0,0,0,0,0,0,0,0,0
Uttar Pradesh,2005,Total,12991,293,13284,42029,1049,43078,248,1,249,107,0,107,55375,1343,56718
Uttar Pradesh,2006,Central Jail,9797,9,9806,1707,47,1754,31,0,31,0,0,0,11535,56,11591
Uttar Pradesh,2006,District Jail,5709,291,6000,46373,1408,47781,160,1,161,24,0,24,52266,1700,53966
Uttar Pradesh,2006,Sub_Jail,73,2,75,593,14,607,0,0,0,0,0,0,666,16,682
Uttar Pradesh,2006,Women Jail,0,175,175,0,0,0,0,0,0,0,0,0,0,175,175
Uttar Pradesh,2006,Borstal School,0,0,0,0,0,0,0,0,0,0,0,0,0,0,0
Uttar Pradesh,2006,Open Jail,0,0,0,0,0,0,0,0,0,0,0,0,0,0,0
Uttar Pradesh,2006,Special Jail,233,0,233,21,0,21,1,0,1,0,0,0,255,0,255
Uttar Pradesh,2006,Others,0,0,0,0,0,0,0,0,0,0,0,0,0,0,0
Uttar Pradesh,2006,Total,15812,477,16289,48694,1469,50163,192,1,193,24,0,24,64722,1947,66669
Uttar Pradesh,2007,Central Jail,12323,13,12336,2332,67,2399,57,0,57,0,0,0,14712,80,14792
Uttar Pradesh,2007,District Jail,6346,408,6754,49415,1619,51034,2185,53,2238,193,1,194,58139,2081,60220
Uttar Pradesh,2007,Sub_Jail,127,3,130,549,10,559,1,0,1,4,0,4,681,13,694
Uttar Pradesh,2007,Women Jail,0,155,155,0,0,0,0,0,0,0,0,0,0,155,155
Uttar Pradesh,2007,Borstal School,0,0,0,0,0,0,0,0,0,0,0,0,0,0,0
Uttar Pradesh,2007,Open Jail,0,0,0,0,0,0,0,0,0,0,0,0,0,0,0
Uttar Pradesh,2007,Special Jail,318,0,318,0,0,0,1,0,1,0,0,0,319,0,319
Uttar Pradesh,2007,Others,0,0,0,0,0,0,0,0,0,0,0,0,0,0,0
Uttar Pradesh,2007,Total,19114,579,19693,52296,1696,53992,2244,53,2297,197,1,198,73851,2329,76180
Uttar Pradesh,2008,Central Jail,12139,17,12156,2060,71,2131,106,0,106,0,0,0,14305,88,14393
Uttar Pradesh,2008,District Jail,8401,497,8898,53873,1936,55809,499,0,499,26,1,27,62799,2434,65233
Uttar Pradesh,2008,Sub_Jail,143,5,148,545,13,558,3,0,3,1,0,1,692,18,710
Uttar Pradesh,2008,Women Jail,0,154,154,0,0,0,0,0,0,0,0,0,0,154,154
Uttar Pradesh,2008,Borstal School,0,0,0,0,0,0,0,0,0,0,0,0,0,0,0
Uttar Pradesh,2008,Open Jail,0,0,0,0,0,0,0,0,0,0,0,0,0,0,0
Uttar Pradesh,2008,Special Jail,319,0,319,0,0,0,0,0,0,0,0,0,319,0,319
Uttar Pradesh,2008,Others,0,0,0,0,0,0,0,0,0,0,0,0,0,0,0
Uttar Pradesh,2008,Total,21002,673,21675,56478,2020,58498,608,0,608,27,1,28,78115,2694,80809
Uttar Pradesh,2009,Central Jail,11123,22,11145,1995,69,2064,82,0,82,7,0,7,13207,91,13298
Uttar Pradesh,2009,District Jail,12041,467,12508,54513,1956,56469,207,2,209,16,0,16,66777,2425,69202
Uttar Pradesh,2009,Sub_Jail,173,8,181,509,16,525,3,0,3,0,0,0,685,24,709
Uttar Pradesh,2009,Women Jail,0,219,219,0,0,0,0,0,0,0,0,0,0,219,219
Uttar Pradesh,2009,Borstal School,0,0,0,0,0,0,0,0,0,0,0,0,0,0,0
Uttar Pradesh,2009,Open Jail,0,0,0,0,0,0,0,0,0,0,0,0,0,0,0
Uttar Pradesh,2009,Special Jail,377,0,377,0,0,0,0,0,0,0,0,0,377,0,377
Uttar Pradesh,2009,Others,0,0,0,0,0,0,0,0,0,0,0,0,0,0,0
Uttar Pradesh,2009,Total,23714,716,24430,57017,2041,59058,292,2,294,23,0,23,81046,2759,83805
Uttar Pradesh,2010,Central Jail,12739,30,12769,2125,57,2182,23,0,23,0,0,0,14887,87,14974
Uttar Pradesh,2010,District Jail,12469,420,12889,51402,1769,53171,212,0,212,30,0,30,64113,2189,66302
Uttar Pradesh,2010,Sub_Jail,121,7,128,513,6,519,3,0,3,0,0,0,637,13,650
Uttar Pradesh,2010,Women Jail,0,342,342,0,0,0,0,0,0,0,0,0,0,342,342
Uttar Pradesh,2010,Borstal School,0,0,0,0,0,0,0,0,0,0,0,0,0,0,0
Uttar Pradesh,2010,Open Jail,0,0,0,0,0,0,0,0,0,0,0,0,0,0,0
Uttar Pradesh,2010,Special Jail,405,0,405,0,0,0,0,0,0,0,0,0,405,0,405
Uttar Pradesh,2010,Others,0,0,0,0,0,0,0,0,0,0,0,0,0,0,0
Uttar Pradesh,2010,Total,25734,799,26533,54040,1832,55872,238,0,238,30,0,30,80042,2631,82673
Uttar Pradesh,2011,Central Jail,11870,28,11898,1913,76,1989,9,0,9,0,0,0,13792,104,13896
Uttar Pradesh,2011,District Jail,14737,570,15307,49335,2044,51379,201,0,201,57,0,57,64330,2614,66944
Uttar Pradesh,2011,Sub_Jail,139,8,147,580,28,608,3,0,3,0,0,0,722,36,758
Uttar Pradesh,2011,Women Jail,0,299,299,0,86,86,0,0,0,0,0,0,0,385,385
Uttar Pradesh,2011,Borstal School,0,0,0,0,0,0,0,0,0,0,0,0,0,0,0
Uttar Pradesh,2011,Open Jail,0,0,0,0,0,0,0,0,0,0,0,0,0,0,0
Uttar Pradesh,2011,Special Jail,400,0,400,0,0,0,0,0,0,0,0,0,400,0,400
Uttar Pradesh,2011,Others,0,0,0,0,0,0,0,0,0,0,0,0,0,0,0
Uttar Pradesh,2011,Total,27146,905,28051,51828,2234,54062,213,0,213,57,0,57,79244,3139,82383
Uttar Pradesh,2012,Central Jail,10686,22,10708,2064,78,2142,6,0,6,2,0,2,12758,100,12858
Uttar Pradesh,2012,District Jail,14224,558,14782,48794,2162,50956,191,0,191,39,0,39,63248,2720,65968
Uttar Pradesh,2012,Sub_Jail,99,8,107,639,29,668,0,0,0,2,0,2,740,37,777
Uttar Pradesh,2012,Women Jail,0,256,256,0,50,50,0,0,0,0,0,0,0,306,306
Uttar Pradesh,2012,Borstal School,0,0,0,0,0,0,0,0,0,0,0,0,0,0,0
Uttar Pradesh,2012,Open Jail,0,0,0,0,0,0,0,0,0,0,0,0,0,0,0
Uttar Pradesh,2012,Special Jail,397,0,397,5,0,5,0,0,0,0,0,0,402,0,402
Uttar Pradesh,2012,Others,0,0,0,0,0,0,0,0,0,0,0,0,0,0,0
Uttar Pradesh,2012,Total,25406,844,26250,51502,2319,53821,197,0,197,43,0,43,77148,3163,80311
Uttaranchal,2001,Central Jail,0,0,0,0,0,0,0,0,0,0,0,0,0,0,0
Uttaranchal,2001,District Jail,127,1,128,913,36,949,0,0,0,0,0,0,1040,37,1077
Uttaranchal,2001,Sub_Jail,121,2,123,805,27,832,0,0,0,0,0,0,926,29,955
Uttaranchal,2001,Women Jail,0,0,0,0,0,0,0,0,0,0,0,0,0,0,0
Uttaranchal,2001,Borstal School,0,0,0,0,0,0,0,0,0,0,0,0,0,0,0
Uttaranchal,2001,Open Jail,258,0,258,0,0,0,0,0,0,0,0,0,258,0,258
Uttaranchal,2001,Special Jail,0,0,0,0,0,0,0,0,0,0,0,0,0,0,0
Uttaranchal,2001,Others,0,0,0,0,0,0,0,0,0,0,0,0,0,0,0
Uttaranchal,2001,Total,506,3,509,1718,63,1781,0,0,0,0,0,0,2224,66,2290
Uttaranchal,2002,Central Jail,0,0,0,0,0,0,0,0,0,0,0,0,0,0,0
Uttaranchal,2002,District Jail,259,8,267,1014,27,1041,0,0,0,0,0,0,1273,35,1308
Uttaranchal,2002,Sub_Jail,116,4,120,638,23,661,0,0,0,0,0,0,754,27,781
Uttaranchal,2002,Women Jail,0,0,0,0,0,0,0,0,0,0,0,0,0,0,0
Uttaranchal,2002,Borstal School,0,0,0,0,0,0,0,0,0,0,0,0,0,0,0
Uttaranchal,2002,Open Jail,270,0,270,0,0,0,0,0,0,0,0,0,270,0,270
Uttaranchal,2002,Special Jail,0,0,0,0,0,0,0,0,0,0,0,0,0,0,0
Uttaranchal,2002,Others,0,0,0,0,0,0,0,0,0,0,0,0,0,0,0
Uttaranchal,2002,Total,645,12,657,1652,50,1702,0,0,0,0,0,0,2297,62,2359
Uttaranchal,2003,Central Jail,0,0,0,0,0,0,0,0,0,0,0,0,0,0,0
Uttaranchal,2003,District Jail,389,11,400,972,28,1000,1,0,1,0,0,0,1362,39,1401
Uttaranchal,2003,Sub_Jail,52,1,53,700,19,719,4,0,4,2,0,2,758,20,778
Uttaranchal,2003,Women Jail,0,0,0,0,0,0,0,0,0,0,0,0,0,0,0
Uttaranchal,2003,Borstal School,0,0,0,0,0,0,0,0,0,0,0,0,0,0,0
Uttaranchal,2003,Open Jail,252,0,252,0,0,0,0,0,0,0,0,0,252,0,252
Uttaranchal,2003,Special Jail,0,0,0,0,0,0,0,0,0,0,0,0,0,0,0
Uttaranchal,2003,Others,0,0,0,0,0,0,0,0,0,0,0,0,0,0,0
Uttaranchal,2003,Total,693,12,705,1672,47,1719,5,0,5,2,0,2,2372,59,2431
Uttaranchal,2004,Central Jail,0,0,0,0,0,0,0,0,0,0,0,0,0,0,0
Uttaranchal,2004,District Jail,373,16,389,877,65,942,2,0,2,0,0,0,1252,81,1333
Uttaranchal,2004,Sub_Jail,46,5,51,650,18,668,3,0,3,0,0,0,699,23,722
Uttaranchal,2004,Women Jail,0,0,0,0,0,0,0,0,0,0,0,0,0,0,0
Uttaranchal,2004,Borstal School,0,0,0,0,0,0,0,0,0,0,0,0,0,0,0
Uttaranchal,2004,Open Jail,310,0,310,0,0,0,0,0,0,0,0,0,310,0,310
Uttaranchal,2004,Special Jail,0,0,0,0,0,0,0,0,0,0,0,0,0,0,0
Uttaranchal,2004,Others,0,0,0,0,0,0,0,0,0,0,0,0,0,0,0
Uttaranchal,2004,Total,729,21,750,1527,83,1610,5,0,5,0,0,0,2261,104,2365
Uttaranchal,2005,Central Jail,0,0,0,0,0,0,0,0,0,0,0,0,0,0,0
Uttaranchal,2005,District Jail,399,14,413,867,22,889,0,0,0,5,0,5,1271,36,1307
Uttaranchal,2005,Sub_Jail,48,0,48,677,12,689,2,0,2,0,0,0,727,12,739
Uttaranchal,2005,Women Jail,0,0,0,0,0,0,0,0,0,0,0,0,0,0,0
Uttaranchal,2005,Borstal School,0,0,0,0,0,0,0,0,0,0,0,0,0,0,0
Uttaranchal,2005,Open Jail,304,0,304,0,0,0,0,0,0,0,0,0,304,0,304
Uttaranchal,2005,Special Jail,0,0,0,0,0,0,0,0,0,0,0,0,0,0,0
Uttaranchal,2005,Others,0,0,0,0,0,0,0,0,0,0,0,0,0,0,0
Uttaranchal,2005,Total,751,14,765,1544,34,1578,2,0,2,5,0,5,2302,48,2350
Uttaranchal,2006,Central Jail,0,0,0,0,0,0,0,0,0,0,0,0,0,0,0
Uttaranchal,2006,District Jail,613,16,629,921,29,950,0,0,0,0,0,0,1534,45,1579
Uttaranchal,2006,Sub_Jail,42,1,43,764,23,787,0,0,0,0,0,0,806,24,830
Uttaranchal,2006,Women Jail,0,0,0,0,0,0,0,0,0,0,0,0,0,0,0
Uttaranchal,2006,Borstal School,0,0,0,0,0,0,0,0,0,0,0,0,0,0,0
Uttaranchal,2006,Open Jail,235,0,235,0,0,0,0,0,0,0,0,0,235,0,235
Uttaranchal,2006,Special Jail,0,0,0,0,0,0,0,0,0,0,0,0,0,0,0
Uttaranchal,2006,Others,0,0,0,0,0,0,0,0,0,0,0,0,0,0,0
Uttaranchal,2006,Total,890,17,907,1685,52,1737,0,0,0,0,0,0,2575,69,2644
Uttaranchal,2007,Central Jail,0,0,0,0,0,0,0,0,0,0,0,0,0,0,0
Uttaranchal,2007,District Jail,758,27,785,866,31,897,0,0,0,0,0,0,1624,58,1682
Uttaranchal,2007,Sub_Jail,42,1,43,741,23,764,0,0,0,0,0,0,783,24,807
Uttaranchal,2007,Women Jail,0,0,0,0,0,0,0,0,0,0,0,0,0,0,0
Uttaranchal,2007,Borstal School,0,0,0,0,0,0,0,0,0,0,0,0,0,0,0
Uttaranchal,2007,Open Jail,220,0,220,0,0,0,0,0,0,0,0,0,220,0,220
Uttaranchal,2007,Special Jail,0,0,0,0,0,0,0,0,0,0,0,0,0,0,0
Uttaranchal,2007,Others,0,0,0,0,0,0,0,0,0,0,0,0,0,0,0
Uttaranchal,2007,Total,1020,28,1048,1607,54,1661,0,0,0,0,0,0,2627,82,2709
Uttaranchal,2008,Central Jail,0,0,0,0,0,0,0,0,0,0,0,0,0,0,0
Uttaranchal,2008,District Jail,942,34,976,1045,51,1096,0,0,0,0,0,0,1987,85,2072
Uttaranchal,2008,Sub_Jail,32,1,33,882,34,916,0,0,0,0,0,0,914,35,949
Uttaranchal,2008,Women Jail,0,0,0,0,0,0,0,0,0,0,0,0,0,0,0
Uttaranchal,2008,Borstal School,0,0,0,0,0,0,0,0,0,0,0,0,0,0,0
Uttaranchal,2008,Open Jail,213,0,213,0,0,0,0,0,0,0,0,0,213,0,213
Uttaranchal,2008,Special Jail,0,0,0,0,0,0,0,0,0,0,0,0,0,0,0
Uttaranchal,2008,Others,0,0,0,0,0,0,0,0,0,0,0,0,0,0,0
Uttaranchal,2008,Total,1187,35,1222,1927,85,2012,0,0,0,0,0,0,3114,120,3234
Uttaranchal,2009,Central Jail,0,0,0,0,0,0,0,0,0,0,0,0,0,0,0
Uttaranchal,2009,District Jail,997,43,1040,1191,44,1235,0,0,0,0,0,0,2188,87,2275
Uttaranchal,2009,Sub_Jail,44,1,45,957,32,989,0,0,0,0,0,0,1001,33,1034
Uttaranchal,2009,Women Jail,0,0,0,0,0,0,0,0,0,0,0,0,0,0,0
Uttaranchal,2009,Borstal School,0,0,0,0,0,0,0,0,0,0,0,0,0,0,0
Uttaranchal,2009,Open Jail,198,0,198,0,0,0,0,0,0,0,0,0,198,0,198
Uttaranchal,2009,Special Jail,0,0,0,0,0,0,0,0,0,0,0,0,0,0,0
Uttaranchal,2009,Others,0,0,0,0,0,0,0,0,0,0,0,0,0,0,0
Uttaranchal,2009,Total,1239,44,1283,2148,76,2224,0,0,0,0,0,0,3387,120,3507
Uttaranchal,2010,Central Jail,0,0,0,0,0,0,0,0,0,0,0,0,0,0,0
Uttaranchal,2010,District Jail,1102,53,1155,1186,25,1211,0,0,0,0,0,0,2288,78,2366
Uttaranchal,2010,Sub_Jail,85,3,88,843,33,876,0,0,0,0,0,0,928,36,964
Uttaranchal,2010,Women Jail,0,0,0,0,0,0,0,0,0,0,0,0,0,0,0
Uttaranchal,2010,Borstal School,0,0,0,0,0,0,0,0,0,0,0,0,0,0,0
Uttaranchal,2010,Open Jail,213,0,213,0,0,0,0,0,0,0,0,0,213,0,213
Uttaranchal,2010,Special Jail,0,0,0,0,0,0,0,0,0,0,0,0,0,0,0
Uttaranchal,2010,Others,0,0,0,0,0,0,0,0,0,0,0,0,0,0,0
Uttaranchal,2010,Total,1400,56,1456,2029,58,2087,0,0,0,0,0,0,3429,114,3543
Uttaranchal,2011,Central Jail,19,0,19,0,0,0,0,0,0,0,0,0,19,0,19
Uttaranchal,2011,District Jail,1217,66,1283,859,33,892,0,0,0,0,0,0,2076,99,2175
Uttaranchal,2011,Sub_Jail,35,1,36,781,35,816,0,0,0,0,0,0,816,36,852
Uttaranchal,2011,Women Jail,0,0,0,0,0,0,0,0,0,0,0,0,0,0,0
Uttaranchal,2011,Borstal School,0,0,0,0,0,0,0,0,0,0,0,0,0,0,0
Uttaranchal,2011,Open Jail,215,0,215,0,0,0,0,0,0,0,0,0,215,0,215
Uttaranchal,2011,Special Jail,0,0,0,0,0,0,0,0,0,0,0,0,0,0,0
Uttaranchal,2011,Others,0,0,0,0,0,0,0,0,0,0,0,0,0,0,0
Uttaranchal,2011,Total,1486,67,1553,1640,68,1708,0,0,0,0,0,0,3126,135,3261
Uttaranchal,2012,Central Jail,66,0,66,0,0,0,0,0,0,0,0,0,66,0,66
Uttaranchal,2012,District Jail,1344,67,1411,1015,52,1067,0,0,0,0,0,0,2359,119,2478
Uttaranchal,2012,Sub_Jail,53,1,54,766,29,795,0,0,0,0,0,0,819,30,849
Uttaranchal,2012,Women Jail,0,0,0,0,0,0,0,0,0,0,0,0,0,0,0
Uttaranchal,2012,Borstal School,0,0,0,0,0,0,0,0,0,0,0,0,0,0,0
Uttaranchal,2012,Open Jail,142,0,142,0,0,0,0,0,0,0,0,0,142,0,142
Uttaranchal,2012,Special Jail,0,0,0,0,0,0,0,0,0,0,0,0,0,0,0
Uttaranchal,2012,Others,0,0,0,0,0,0,0,0,0,0,0,0,0,0,0
Uttaranchal,2012,Total,1605,68,1673,1781,81,1862,0,0,0,0,0,0,3386,149,3535
West Bengal,2001,Central Jail,1973,57,2030,4019,148,4167,1,0,1,19,0,19,6012,205,6217
West Bengal,2001,District Jail,272,12,284,2181,115,2296,20,1,21,0,0,0,2473,128,2601
West Bengal,2001,Sub_Jail,92,21,113,2631,119,2750,0,0,0,0,0,0,2723,140,2863
West Bengal,2001,Women Jail,0,16,16,0,5,5,0,0,0,0,0,0,0,21,21
West Bengal,2001,Borstal School,0,0,0,0,0,0,0,0,0,0,0,0,0,0,0
West Bengal,2001,Open Jail,35,0,35,0,0,0,0,0,0,0,0,0,35,0,35
West Bengal,2001,Special Jail,29,0,29,462,42,504,0,0,0,77,0,77,568,42,610
West Bengal,2001,Others,0,0,0,0,0,0,0,0,0,0,0,0,0,0,0
West Bengal,2001,Total,2401,106,2507,9293,429,9722,21,1,22,96,0,96,11811,536,12347
West Bengal,2002,Central Jail,2087,80,2167,7801,278,8079,1,0,1,20,0,20,9909,358,10267
West Bengal,2002,District Jail,276,30,306,3546,208,3754,0,0,0,0,0,0,3822,238,4060
West Bengal,2002,Sub_Jail,61,12,73,3260,198,3458,0,0,0,0,1,1,3321,211,3532
West Bengal,2002,Women Jail,0,17,17,0,7,7,0,0,0,0,0,0,0,24,24
West Bengal,2002,Borstal School,0,0,0,0,0,0,0,0,0,0,0,0,0,0,0
West Bengal,2002,Open Jail,25,0,25,0,0,0,0,0,0,0,0,0,25,0,25
West Bengal,2002,Special Jail,23,0,23,707,31,738,0,0,0,74,0,74,804,31,835
West Bengal,2002,Others,0,0,0,0,0,0,0,0,0,0,0,0,0,0,0
West Bengal,2002,Total,2472,139,2611,15314,722,16036,1,0,1,94,1,95,17881,862,18743
West Bengal,2003,Central Jail,2623,181,2804,5789,177,5966,3,0,3,5,0,5,8420,358,8778
West Bengal,2003,District Jail,423,69,492,2845,233,3078,0,0,0,0,0,0,3268,302,3570
West Bengal,2003,Sub_Jail,76,1,77,2947,170,3117,0,0,0,0,0,0,3023,171,3194
West Bengal,2003,Women Jail,0,17,17,0,21,21,0,0,0,0,0,0,0,38,38
West Bengal,2003,Borstal School,0,0,0,0,0,0,0,0,0,0,0,0,0,0,0
West Bengal,2003,Open Jail,20,0,20,0,0,0,0,0,0,0,0,0,20,0,20
West Bengal,2003,Special Jail,40,0,40,553,22,575,0,0,0,74,0,74,667,22,689
West Bengal,2003,Others,0,0,0,0,0,0,0,0,0,0,0,0,0,0,0
West Bengal,2003,Total,3182,268,3450,12134,623,12757,3,0,3,79,0,79,15398,891,16289
West Bengal,2004,Central Jail,2881,133,3014,5829,217,6046,0,0,0,5,0,5,8715,350,9065
West Bengal,2004,District Jail,329,11,340,2735,166,2901,0,0,0,1,3,4,3065,180,3245
West Bengal,2004,Sub_Jail,68,4,72,2772,252,3024,0,0,0,0,0,0,2840,256,3096
West Bengal,2004,Women Jail,0,34,34,0,9,9,0,0,0,0,0,0,0,43,43
West Bengal,2004,Borstal School,0,0,0,0,0,0,0,0,0,0,0,0,0,0,0
West Bengal,2004,Open Jail,23,0,23,0,0,0,0,0,0,0,0,0,23,0,23
West Bengal,2004,Special Jail,33,4,37,766,44,810,0,0,0,0,0,0,799,48,847
West Bengal,2004,Others,0,0,0,0,0,0,0,0,0,0,0,0,0,0,0
West Bengal,2004,Total,3334,186,3520,12102,688,12790,0,0,0,6,3,9,15442,877,16319
West Bengal,2005,Central Jail,3211,146,3357,6558,518,7076,3,0,3,37,0,37,9809,664,10473
West Bengal,2005,District Jail,284,10,294,3169,215,3384,0,0,0,48,13,61,3501,238,3739
West Bengal,2005,Sub_Jail,53,17,70,2534,232,2766,45,2,47,64,13,77,2696,264,2960
West Bengal,2005,Women Jail,0,43,43,0,9,9,0,0,0,0,0,0,0,52,52
West Bengal,2005,Borstal School,0,0,0,0,0,0,0,0,0,0,0,0,0,0,0
West Bengal,2005,Open Jail,28,0,28,0,0,0,0,0,0,0,0,0,28,0,28
West Bengal,2005,Special Jail,52,4,56,744,38,782,8,0,8,60,0,60,864,42,906
West Bengal,2005,Others,0,0,0,0,0,0,0,0,0,0,0,0,0,0,0
West Bengal,2005,Total,3628,220,3848,13005,1012,14017,56,2,58,209,26,235,16898,1260,18158
West Bengal,2006,Central Jail,3266,173,3439,6465,321,6786,0,0,0,58,4,62,9789,498,10287
West Bengal,2006,District Jail,224,7,231,3311,280,3591,0,0,0,87,6,93,3622,293,3915
West Bengal,2006,Sub_Jail,53,3,56,2808,168,2976,0,0,0,60,10,70,2921,181,3102
West Bengal,2006,Women Jail,0,44,44,0,8,8,0,0,0,0,0,0,0,52,52
West Bengal,2006,Borstal School,0,0,0,0,0,0,0,0,0,0,0,0,0,0,0
West Bengal,2006,Open Jail,68,0,68,0,0,0,0,0,0,0,0,0,68,0,68
West Bengal,2006,Special Jail,36,2,38,705,26,731,0,0,0,0,0,0,741,28,769
West Bengal,2006,Others,0,0,0,0,0,0,0,0,0,0,0,0,0,0,0
West Bengal,2006,Total,3647,229,3876,13289,803,14092,0,0,0,205,20,225,17141,1052,18193
West Bengal,2007,Central Jail,3648,151,3799,5733,502,6235,0,0,0,149,19,168,9530,672,10202
West Bengal,2007,District Jail,292,13,305,3702,249,3951,0,0,0,7,2,9,4001,264,4265
West Bengal,2007,Sub_Jail,67,1,68,2791,195,2986,0,0,0,83,32,115,2941,228,3169
West Bengal,2007,Women Jail,0,40,40,0,11,11,0,0,0,0,0,0,0,51,51
West Bengal,2007,Borstal School,0,0,0,0,0,0,0,0,0,0,0,0,0,0,0
West Bengal,2007,Open Jail,86,0,86,0,0,0,0,0,0,0,0,0,86,0,86
West Bengal,2007,Special Jail,41,6,47,733,45,778,0,0,0,0,0,0,774,51,825
West Bengal,2007,Others,0,0,0,0,0,0,0,0,0,0,0,0,0,0,0
West Bengal,2007,Total,4134,211,4345,12959,1002,13961,0,0,0,239,53,292,17332,1266,18598
West Bengal,2008,Central Jail,4909,164,5073,5386,266,5652,0,0,0,29,0,29,10324,430,10754
West Bengal,2008,District Jail,445,44,489,3542,291,3833,0,0,0,0,4,4,3987,339,4326
West Bengal,2008,Sub_Jail,73,2,75,3352,217,3569,0,0,0,82,22,104,3507,241,3748
West Bengal,2008,Women Jail,0,114,114,0,225,225,0,0,0,0,0,0,0,339,339
West Bengal,2008,Borstal School,0,0,0,0,0,0,0,0,0,0,0,0,0,0,0
West Bengal,2008,Open Jail,103,0,103,0,0,0,0,0,0,0,0,0,103,0,103
West Bengal,2008,Special Jail,107,20,127,779,53,832,0,0,0,0,1,1,886,74,960
West Bengal,2008,Others,0,0,0,0,0,0,0,0,0,0,0,0,0,0,0
West Bengal,2008,Total,5637,344,5981,13059,1052,14111,0,0,0,111,27,138,18807,1423,20230
West Bengal,2009,Central Jail,4390,183,4573,5449,177,5626,1,2,3,108,14,122,9948,376,10324
West Bengal,2009,District Jail,798,71,869,2810,220,3030,0,0,0,4,1,5,3612,292,3904
West Bengal,2009,Sub_Jail,66,2,68,1891,96,1987,0,0,0,70,2,72,2027,100,2127
West Bengal,2009,Women Jail,0,112,112,0,154,154,0,0,0,0,0,0,0,266,266
West Bengal,2009,Borstal School,0,0,0,0,0,0,0,0,0,0,0,0,0,0,0
West Bengal,2009,Open Jail,98,0,98,0,0,0,0,0,0,0,0,0,98,0,98
West Bengal,2009,Special Jail,162,37,199,624,44,668,0,0,0,0,0,0,786,81,867
West Bengal,2009,Others,0,0,0,0,0,0,0,0,0,0,0,0,0,0,0
West Bengal,2009,Total,5514,405,5919,10774,691,11465,1,2,3,182,17,199,16471,1115,17586
West Bengal,2010,Central Jail,4073,194,4267,4949,149,5098,1,0,1,278,29,307,9301,372,9673
West Bengal,2010,District Jail,1075,60,1135,2950,204,3154,0,0,0,18,2,20,4043,266,4309
West Bengal,2010,Sub_Jail,37,2,39,3077,183,3260,0,0,0,33,0,33,3147,185,3332
West Bengal,2010,Women Jail,0,115,115,0,154,154,0,0,0,0,0,0,0,269,269
West Bengal,2010,Borstal School,0,0,0,0,0,0,0,0,0,0,0,0,0,0,0
West Bengal,2010,Open Jail,96,0,96,0,0,0,0,0,0,0,0,0,96,0,96
West Bengal,2010,Special Jail,116,10,126,649,46,695,0,0,0,14,5,19,779,61,840
West Bengal,2010,Others,0,0,0,0,0,0,0,0,0,0,0,0,0,0,0
West Bengal,2010,Total,5397,381,5778,11625,736,12361,1,0,1,343,36,379,17366,1153,18519
West Bengal,2011,Central Jail,4132,152,4284,5003,156,5159,5,0,5,236,27,263,9376,335,9711
West Bengal,2011,District Jail,905,48,953,3718,221,3939,0,0,0,7,4,11,4630,273,4903
West Bengal,2011,Sub_Jail,48,0,48,3379,172,3551,0,0,0,0,0,0,3427,172,3599
West Bengal,2011,Women Jail,0,152,152,0,178,178,0,0,0,0,0,0,0,330,330
West Bengal,2011,Borstal School,0,0,0,0,0,0,0,0,0,0,0,0,0,0,0
West Bengal,2011,Open Jail,99,0,99,0,0,0,0,0,0,0,0,0,99,0,99
West Bengal,2011,Special Jail,114,10,124,704,36,740,0,0,0,1,1,2,819,47,866
West Bengal,2011,Others,0,0,0,0,0,0,0,0,0,0,0,0,0,0,0
West Bengal,2011,Total,5298,362,5660,12804,763,13567,5,0,5,244,32,276,18351,1157,19508
West Bengal,2012,Central Jail,4608,185,4793,5622,249,5871,1,0,1,240,39,279,10471,473,10944
West Bengal,2012,District Jail,916,60,976,3122,202,3324,2,0,2,0,1,1,4040,263,4303
West Bengal,2012,Sub_Jail,99,2,101,3585,169,3754,0,0,0,0,0,0,3684,171,3855
West Bengal,2012,Women Jail,0,147,147,0,206,206,0,0,0,0,0,0,0,353,353
West Bengal,2012,Borstal School,0,0,0,0,0,0,0,0,0,0,0,0,0,0,0
West Bengal,2012,Open Jail,76,0,76,0,0,0,0,0,0,0,0,0,76,0,76
West Bengal,2012,Special Jail,68,10,78,777,45,822,0,0,0,0,0,0,845,55,900
West Bengal,2012,Others,0,0,0,0,0,0,0,0,0,0,0,0,0,0,0
West Bengal,2012,Total,5767,404,6171,13106,871,13977,3,0,3,240,40,280,19116,1315,20431
A & N Islands,2001,Central Jail,0,0,0,0,0,0,0,0,0,0,0,0,0,0,0
A & N Islands,2001,District Jail,214,3,217,159,0,159,0,0,0,0,0,0,373,3,376
A & N Islands,2001,Sub_Jail,0,0,0,0,0,0,0,0,0,0,0,0,0,0,0
A & N Islands,2001,Women Jail,0,0,0,0,0,0,0,0,0,0,0,0,0,0,0
A & N Islands,2001,Borstal School,0,0,0,0,0,0,0,0,0,0,0,0,0,0,0
A & N Islands,2001,Open Jail,0,0,0,0,0,0,0,0,0,0,0,0,0,0,0
A & N Islands,2001,Special Jail,0,0,0,0,0,0,0,0,0,0,0,0,0,0,0
A & N Islands,2001,Others,0,0,0,6,1,7,0,0,0,0,0,0,6,1,7
A & N Islands,2001,Total,214,3,217,165,1,166,0,0,0,0,0,0,379,4,383
A & N Islands,2002,Central Jail,0,0,0,0,0,0,0,0,0,0,0,0,0,0,0
A & N Islands,2002,District Jail,133,4,137,183,2,185,0,0,0,0,0,0,316,6,322
A & N Islands,2002,Sub_Jail,0,0,0,0,0,0,0,0,0,0,0,0,0,0,0
A & N Islands,2002,Women Jail,0,0,0,0,0,0,0,0,0,0,0,0,0,0,0
A & N Islands,2002,Borstal School,0,0,0,0,0,0,0,0,0,0,0,0,0,0,0
A & N Islands,2002,Open Jail,0,0,0,0,0,0,0,0,0,0,0,0,0,0,0
A & N Islands,2002,Special Jail,0,0,0,0,0,0,0,0,0,0,0,0,0,0,0
A & N Islands,2002,Others,0,0,0,7,2,9,0,0,0,0,0,0,7,2,9
A & N Islands,2002,Total,133,4,137,190,4,194,0,0,0,0,0,0,323,8,331
A & N Islands,2003,Central Jail,0,0,0,0,0,0,0,0,0,0,0,0,0,0,0
A & N Islands,2003,District Jail,90,2,92,189,1,190,0,0,0,0,0,0,279,3,282
A & N Islands,2003,Sub_Jail,0,0,0,0,0,0,0,0,0,0,0,0,0,0,0
A & N Islands,2003,Women Jail,0,0,0,0,0,0,0,0,0,0,0,0,0,0,0
A & N Islands,2003,Borstal School,0,0,0,0,0,0,0,0,0,0,0,0,0,0,0
A & N Islands,2003,Open Jail,0,0,0,0,0,0,0,0,0,0,0,0,0,0,0
A & N Islands,2003,Special Jail,0,0,0,0,0,0,0,0,0,0,0,0,0,0,0
A & N Islands,2003,Others,0,0,0,14,0,14,0,0,0,0,0,0,14,0,14
A & N Islands,2003,Total,90,2,92,203,1,204,0,0,0,0,0,0,293,3,296
A & N Islands,2004,Central Jail,0,0,0,0,0,0,0,0,0,0,0,0,0,0,0
A & N Islands,2004,District Jail,54,2,56,156,1,157,0,0,0,0,0,0,210,3,213
A & N Islands,2004,Sub_Jail,0,0,0,8,0,8,0,0,0,0,0,0,8,0,8
A & N Islands,2004,Women Jail,0,0,0,0,0,0,0,0,0,0,0,0,0,0,0
A & N Islands,2004,Borstal School,0,0,0,0,0,0,0,0,0,0,0,0,0,0,0
A & N Islands,2004,Open Jail,0,0,0,0,0,0,0,0,0,0,0,0,0,0,0
A & N Islands,2004,Special Jail,0,0,0,0,0,0,0,0,0,0,0,0,0,0,0
A & N Islands,2004,Others,0,0,0,0,0,0,0,0,0,0,0,0,0,0,0
A & N Islands,2004,Total,54,2,56,164,1,165,0,0,0,0,0,0,218,3,221
A & N Islands,2005,Central Jail,0,0,0,0,0,0,0,0,0,0,0,0,0,0,0
A & N Islands,2005,District Jail,64,1,65,151,3,154,0,0,0,0,0,0,215,4,219
A & N Islands,2005,Sub_Jail,1,0,1,4,0,4,0,0,0,0,0,0,5,0,5
A & N Islands,2005,Women Jail,0,0,0,0,0,0,0,0,0,0,0,0,0,0,0
A & N Islands,2005,Borstal School,0,0,0,0,0,0,0,0,0,0,0,0,0,0,0
A & N Islands,2005,Open Jail,0,0,0,0,0,0,0,0,0,0,0,0,0,0,0
A & N Islands,2005,Special Jail,0,0,0,0,0,0,0,0,0,0,0,0,0,0,0
A & N Islands,2005,Others,0,0,0,0,0,0,0,0,0,0,0,0,0,0,0
A & N Islands,2005,Total,65,1,66,155,3,158,0,0,0,0,0,0,220,4,224
A & N Islands,2006,Central Jail,0,0,0,0,0,0,0,0,0,0,0,0,0,0,0
A & N Islands,2006,District Jail,80,1,81,258,1,259,0,0,0,0,0,0,338,2,340
A & N Islands,2006,Sub_Jail,0,0,0,6,0,6,0,0,0,0,0,0,6,0,6
A & N Islands,2006,Women Jail,0,0,0,0,0,0,0,0,0,0,0,0,0,0,0
A & N Islands,2006,Borstal School,0,0,0,0,0,0,0,0,0,0,0,0,0,0,0
A & N Islands,2006,Open Jail,0,0,0,0,0,0,0,0,0,0,0,0,0,0,0
A & N Islands,2006,Special Jail,0,0,0,0,0,0,0,0,0,0,0,0,0,0,0
A & N Islands,2006,Others,0,0,0,0,0,0,0,0,0,0,0,0,0,0,0
A & N Islands,2006,Total,80,1,81,264,1,265,0,0,0,0,0,0,344,2,346
A & N Islands,2007,Central Jail,0,0,0,0,0,0,0,0,0,0,0,0,0,0,0
A & N Islands,2007,District Jail,86,1,87,314,0,314,0,0,0,0,0,0,400,1,401
A & N Islands,2007,Sub_Jail,1,0,1,10,1,11,0,0,0,0,0,0,11,1,12
A & N Islands,2007,Women Jail,0,0,0,0,0,0,0,0,0,0,0,0,0,0,0
A & N Islands,2007,Borstal School,0,0,0,0,0,0,0,0,0,0,0,0,0,0,0
A & N Islands,2007,Open Jail,0,0,0,0,0,0,0,0,0,0,0,0,0,0,0
A & N Islands,2007,Special Jail,0,0,0,0,0,0,0,0,0,0,0,0,0,0,0
A & N Islands,2007,Others,0,0,0,0,0,0,0,0,0,0,0,0,0,0,0
A & N Islands,2007,Total,87,1,88,324,1,325,0,0,0,0,0,0,411,2,413
A & N Islands,2008,Central Jail,0,0,0,0,0,0,0,0,0,0,0,0,0,0,0
A & N Islands,2008,District Jail,67,0,67,142,0,142,0,0,0,0,0,0,209,0,209
A & N Islands,2008,Sub_Jail,1,0,1,11,0,11,0,0,0,0,0,0,12,0,12
A & N Islands,2008,Women Jail,0,0,0,0,0,0,0,0,0,0,0,0,0,0,0
A & N Islands,2008,Borstal School,0,0,0,0,0,0,0,0,0,0,0,0,0,0,0
A & N Islands,2008,Open Jail,0,0,0,0,0,0,0,0,0,0,0,0,0,0,0
A & N Islands,2008,Special Jail,0,0,0,0,0,0,0,0,0,0,0,0,0,0,0
A & N Islands,2008,Others,0,0,0,0,0,0,0,0,0,0,0,0,0,0,0
A & N Islands,2008,Total,68,0,68,153,0,153,0,0,0,0,0,0,221,0,221
A & N Islands,2009,Central Jail,0,0,0,0,0,0,0,0,0,0,0,0,0,0,0
A & N Islands,2009,District Jail,46,0,46,165,0,165,0,0,0,0,0,0,211,0,211
A & N Islands,2009,Sub_Jail,2,0,2,15,0,15,0,0,0,0,0,0,17,0,17
A & N Islands,2009,Women Jail,0,0,0,0,0,0,0,0,0,0,0,0,0,0,0
A & N Islands,2009,Borstal School,0,0,0,0,0,0,0,0,0,0,0,0,0,0,0
A & N Islands,2009,Open Jail,0,0,0,0,0,0,0,0,0,0,0,0,0,0,0
A & N Islands,2009,Special Jail,0,0,0,0,0,0,0,0,0,0,0,0,0,0,0
A & N Islands,2009,Others,0,0,0,0,0,0,0,0,0,0,0,0,0,0,0
A & N Islands,2009,Total,48,0,48,180,0,180,0,0,0,0,0,0,228,0,228
A & N Islands,2010,Central Jail,0,0,0,0,0,0,0,0,0,0,0,0,0,0,0
A & N Islands,2010,District Jail,120,0,120,542,2,544,0,0,0,0,0,0,662,2,664
A & N Islands,2010,Sub_Jail,9,0,9,15,0,15,0,0,0,0,0,0,24,0,24
A & N Islands,2010,Women Jail,0,0,0,0,0,0,0,0,0,0,0,0,0,0,0
A & N Islands,2010,Borstal School,0,0,0,0,0,0,0,0,0,0,0,0,0,0,0
A & N Islands,2010,Open Jail,0,0,0,0,0,0,0,0,0,0,0,0,0,0,0
A & N Islands,2010,Special Jail,0,0,0,0,0,0,0,0,0,0,0,0,0,0,0
A & N Islands,2010,Others,0,0,0,0,0,0,0,0,0,0,0,0,0,0,0
A & N Islands,2010,Total,129,0,129,557,2,559,0,0,0,0,0,0,686,2,688
A & N Islands,2011,Central Jail,0,0,0,0,0,0,0,0,0,0,0,0,0,0,0
A & N Islands,2011,District Jail,411,0,411,684,6,690,0,0,0,0,0,0,1095,6,1101
A & N Islands,2011,Sub_Jail,4,0,4,13,1,14,0,0,0,0,0,0,17,1,18
A & N Islands,2011,Women Jail,0,0,0,0,0,0,0,0,0,0,0,0,0,0,0
A & N Islands,2011,Borstal School,0,0,0,0,0,0,0,0,0,0,0,0,0,0,0
A & N Islands,2011,Open Jail,0,0,0,0,0,0,0,0,0,0,0,0,0,0,0
A & N Islands,2011,Special Jail,0,0,0,0,0,0,0,0,0,0,0,0,0,0,0
A & N Islands,2011,Others,0,0,0,0,0,0,0,0,0,0,0,0,0,0,0
A & N Islands,2011,Total,415,0,415,697,7,704,0,0,0,0,0,0,1112,7,1119
A & N Islands,2012,Central Jail,0,0,0,0,0,0,0,0,0,0,0,0,0,0,0
A & N Islands,2012,District Jail,654,0,654,340,8,348,0,0,0,0,0,0,994,8,1002
A & N Islands,2012,Sub_Jail,4,0,4,17,1,18,0,0,0,0,0,0,21,1,22
A & N Islands,2012,Women Jail,0,0,0,0,0,0,0,0,0,0,0,0,0,0,0
A & N Islands,2012,Borstal School,0,0,0,0,0,0,0,0,0,0,0,0,0,0,0
A & N Islands,2012,Open Jail,0,0,0,0,0,0,0,0,0,0,0,0,0,0,0
A & N Islands,2012,Special Jail,102,0,102,0,0,0,0,0,0,0,0,0,102,0,102
A & N Islands,2012,Others,0,0,0,0,0,0,0,0,0,0,0,0,0,0,0
A & N Islands,2012,Total,760,0,760,357,9,366,0,0,0,0,0,0,1117,9,1126
Chandigarh,2001,Central Jail,0,0,0,0,0,0,0,0,0,0,0,0,0,0,0
Chandigarh,2001,District Jail,0,0,0,0,0,0,0,0,0,0,0,0,0,0,0
Chandigarh,2001,Sub_Jail,0,0,0,0,0,0,0,0,0,0,0,0,0,0,0
Chandigarh,2001,Women Jail,0,0,0,0,0,0,0,0,0,0,0,0,0,0,0
Chandigarh,2001,Borstal School,0,0,0,0,0,0,0,0,0,0,0,0,0,0,0
Chandigarh,2001,Open Jail,0,0,0,0,0,0,0,0,0,0,0,0,0,0,0
Chandigarh,2001,Special Jail,0,0,0,0,0,0,0,0,0,0,0,0,0,0,0
Chandigarh,2001,Others,96,6,102,306,18,324,0,0,0,0,0,0,402,24,426
Chandigarh,2001,Total,96,6,102,306,18,324,0,0,0,0,0,0,402,24,426
Chandigarh,2002,Central Jail,0,0,0,0,0,0,0,0,0,0,0,0,0,0,0
Chandigarh,2002,District Jail,0,0,0,0,0,0,0,0,0,0,0,0,0,0,0
Chandigarh,2002,Sub_Jail,0,0,0,0,0,0,0,0,0,0,0,0,0,0,0
Chandigarh,2002,Women Jail,0,0,0,0,0,0,0,0,0,0,0,0,0,0,0
Chandigarh,2002,Borstal School,0,0,0,0,0,0,0,0,0,0,0,0,0,0,0
Chandigarh,2002,Open Jail,0,0,0,0,0,0,0,0,0,0,0,0,0,0,0
Chandigarh,2002,Special Jail,0,0,0,0,0,0,0,0,0,0,0,0,0,0,0
Chandigarh,2002,Others,104,7,111,329,16,345,0,0,0,0,0,0,433,23,456
Chandigarh,2002,Total,104,7,111,329,16,345,0,0,0,0,0,0,433,23,456
Chandigarh,2003,Central Jail,0,0,0,0,0,0,0,0,0,0,0,0,0,0,0
Chandigarh,2003,District Jail,0,0,0,0,0,0,0,0,0,0,0,0,0,0,0
Chandigarh,2003,Sub_Jail,0,0,0,0,0,0,0,0,0,0,0,0,0,0,0
Chandigarh,2003,Women Jail,0,0,0,0,0,0,0,0,0,0,0,0,0,0,0
Chandigarh,2003,Borstal School,0,0,0,0,0,0,0,0,0,0,0,0,0,0,0
Chandigarh,2003,Open Jail,0,0,0,0,0,0,0,0,0,0,0,0,0,0,0
Chandigarh,2003,Special Jail,0,0,0,0,0,0,0,0,0,0,0,0,0,0,0
Chandigarh,2003,Others,135,9,144,363,18,381,0,0,0,0,0,0,498,27,525
Chandigarh,2003,Total,135,9,144,363,18,381,0,0,0,0,0,0,498,27,525
Chandigarh,2004,Central Jail,0,0,0,0,0,0,0,0,0,0,0,0,0,0,0
Chandigarh,2004,District Jail,0,0,0,0,0,0,0,0,0,0,0,0,0,0,0
Chandigarh,2004,Sub_Jail,0,0,0,0,0,0,0,0,0,0,0,0,0,0,0
Chandigarh,2004,Women Jail,0,0,0,0,0,0,0,0,0,0,0,0,0,0,0
Chandigarh,2004,Borstal School,0,0,0,0,0,0,0,0,0,0,0,0,0,0,0
Chandigarh,2004,Open Jail,0,0,0,0,0,0,0,0,0,0,0,0,0,0,0
Chandigarh,2004,Special Jail,0,0,0,0,0,0,0,0,0,0,0,0,0,0,0
Chandigarh,2004,Others,113,7,120,405,24,429,0,0,0,0,0,0,518,31,549
Chandigarh,2004,Total,113,7,120,405,24,429,0,0,0,0,0,0,518,31,549
Chandigarh,2005,Central Jail,0,0,0,0,0,0,0,0,0,0,0,0,0,0,0
Chandigarh,2005,District Jail,0,0,0,0,0,0,0,0,0,0,0,0,0,0,0
Chandigarh,2005,Sub_Jail,0,0,0,0,0,0,0,0,0,0,0,0,0,0,0
Chandigarh,2005,Women Jail,0,0,0,0,0,0,0,0,0,0,0,0,0,0,0
Chandigarh,2005,Borstal School,0,0,0,0,0,0,0,0,0,0,0,0,0,0,0
Chandigarh,2005,Open Jail,0,0,0,0,0,0,0,0,0,0,0,0,0,0,0
Chandigarh,2005,Special Jail,0,0,0,0,0,0,0,0,0,0,0,0,0,0,0
Chandigarh,2005,Others,78,6,84,351,20,371,0,0,0,0,0,0,429,26,455
Chandigarh,2005,Total,78,6,84,351,20,371,0,0,0,0,0,0,429,26,455
Chandigarh,2006,Central Jail,0,0,0,0,0,0,0,0,0,0,0,0,0,0,0
Chandigarh,2006,District Jail,0,0,0,0,0,0,0,0,0,0,0,0,0,0,0
Chandigarh,2006,Sub_Jail,0,0,0,0,0,0,0,0,0,0,0,0,0,0,0
Chandigarh,2006,Women Jail,0,0,0,0,0,0,0,0,0,0,0,0,0,0,0
Chandigarh,2006,Borstal School,0,0,0,0,0,0,0,0,0,0,0,0,0,0,0
Chandigarh,2006,Open Jail,0,0,0,0,0,0,0,0,0,0,0,0,0,0,0
Chandigarh,2006,Special Jail,0,0,0,0,0,0,0,0,0,0,0,0,0,0,0
Chandigarh,2006,Others,100,7,107,312,19,331,0,0,0,0,0,0,412,26,438
Chandigarh,2006,Total,100,7,107,312,19,331,0,0,0,0,0,0,412,26,438
Chandigarh,2007,Central Jail,141,5,146,342,13,355,0,0,0,0,0,0,483,18,501
Chandigarh,2007,District Jail,0,0,0,0,0,0,0,0,0,0,0,0,0,0,0
Chandigarh,2007,Sub_Jail,0,0,0,0,0,0,0,0,0,0,0,0,0,0,0
Chandigarh,2007,Women Jail,0,0,0,0,0,0,0,0,0,0,0,0,0,0,0
Chandigarh,2007,Borstal School,0,0,0,0,0,0,0,0,0,0,0,0,0,0,0
Chandigarh,2007,Open Jail,0,0,0,0,0,0,0,0,0,0,0,0,0,0,0
Chandigarh,2007,Special Jail,0,0,0,0,0,0,0,0,0,0,0,0,0,0,0
Chandigarh,2007,Others,0,0,0,0,0,0,0,0,0,0,0,0,0,0,0
Chandigarh,2007,Total,141,5,146,342,13,355,0,0,0,0,0,0,483,18,501
Chandigarh,2008,Central Jail,183,5,188,326,12,338,0,0,0,0,0,0,509,17,526
Chandigarh,2008,District Jail,0,0,0,0,0,0,0,0,0,0,0,0,0,0,0
Chandigarh,2008,Sub_Jail,0,0,0,0,0,0,0,0,0,0,0,0,0,0,0
Chandigarh,2008,Women Jail,0,0,0,0,0,0,0,0,0,0,0,0,0,0,0
Chandigarh,2008,Borstal School,0,0,0,0,0,0,0,0,0,0,0,0,0,0,0
Chandigarh,2008,Open Jail,0,0,0,0,0,0,0,0,0,0,0,0,0,0,0
Chandigarh,2008,Special Jail,0,0,0,0,0,0,0,0,0,0,0,0,0,0,0
Chandigarh,2008,Others,0,0,0,0,0,0,0,0,0,0,0,0,0,0,0
Chandigarh,2008,Total,183,5,188,326,12,338,0,0,0,0,0,0,509,17,526
Chandigarh,2009,Central Jail,235,9,244,379,20,399,0,0,0,0,0,0,614,29,643
Chandigarh,2009,District Jail,0,0,0,0,0,0,0,0,0,0,0,0,0,0,0
Chandigarh,2009,Sub_Jail,0,0,0,0,0,0,0,0,0,0,0,0,0,0,0
Chandigarh,2009,Women Jail,0,0,0,0,0,0,0,0,0,0,0,0,0,0,0
Chandigarh,2009,Borstal School,0,0,0,0,0,0,0,0,0,0,0,0,0,0,0
Chandigarh,2009,Open Jail,0,0,0,0,0,0,0,0,0,0,0,0,0,0,0
Chandigarh,2009,Special Jail,0,0,0,0,0,0,0,0,0,0,0,0,0,0,0
Chandigarh,2009,Others,0,0,0,0,0,0,0,0,0,0,0,0,0,0,0
Chandigarh,2009,Total,235,9,244,379,20,399,0,0,0,0,0,0,614,29,643
Chandigarh,2010,Central Jail,211,10,221,400,19,419,0,0,0,0,0,0,611,29,640
Chandigarh,2010,District Jail,0,0,0,0,0,0,0,0,0,0,0,0,0,0,0
Chandigarh,2010,Sub_Jail,0,0,0,0,0,0,0,0,0,0,0,0,0,0,0
Chandigarh,2010,Women Jail,0,0,0,0,0,0,0,0,0,0,0,0,0,0,0
Chandigarh,2010,Borstal School,0,0,0,0,0,0,0,0,0,0,0,0,0,0,0
Chandigarh,2010,Open Jail,0,0,0,0,0,0,0,0,0,0,0,0,0,0,0
Chandigarh,2010,Special Jail,0,0,0,0,0,0,0,0,0,0,0,0,0,0,0
Chandigarh,2010,Others,0,0,0,0,0,0,0,0,0,0,0,0,0,0,0
Chandigarh,2010,Total,211,10,221,400,19,419,0,0,0,0,0,0,611,29,640
Chandigarh,2011,Central Jail,236,6,242,368,16,384,0,0,0,0,0,0,604,22,626
Chandigarh,2011,District Jail,0,0,0,0,0,0,0,0,0,0,0,0,0,0,0
Chandigarh,2011,Sub_Jail,0,0,0,0,0,0,0,0,0,0,0,0,0,0,0
Chandigarh,2011,Women Jail,0,0,0,0,0,0,0,0,0,0,0,0,0,0,0
Chandigarh,2011,Borstal School,0,0,0,0,0,0,0,0,0,0,0,0,0,0,0
Chandigarh,2011,Open Jail,0,0,0,0,0,0,0,0,0,0,0,0,0,0,0
Chandigarh,2011,Special Jail,0,0,0,0,0,0,0,0,0,0,0,0,0,0,0
Chandigarh,2011,Others,0,0,0,0,0,0,0,0,0,0,0,0,0,0,0
Chandigarh,2011,Total,236,6,242,368,16,384,0,0,0,0,0,0,604,22,626
Chandigarh,2012,Central Jail,246,15,261,447,26,473,0,0,0,0,0,0,693,41,734
Chandigarh,2012,District Jail,0,0,0,0,0,0,0,0,0,0,0,0,0,0,0
Chandigarh,2012,Sub_Jail,0,0,0,0,0,0,0,0,0,0,0,0,0,0,0
Chandigarh,2012,Women Jail,0,0,0,0,0,0,0,0,0,0,0,0,0,0,0
Chandigarh,2012,Borstal School,0,0,0,0,0,0,0,0,0,0,0,0,0,0,0
Chandigarh,2012,Open Jail,0,0,0,0,0,0,0,0,0,0,0,0,0,0,0
Chandigarh,2012,Special Jail,0,0,0,0,0,0,0,0,0,0,0,0,0,0,0
Chandigarh,2012,Others,0,0,0,0,0,0,0,0,0,0,0,0,0,0,0
Chandigarh,2012,Total,246,15,261,447,26,473,0,0,0,0,0,0,693,41,734
D & N Haveli,2001,Central Jail,0,0,0,0,0,0,0,0,0,0,0,0,0,0,0
D & N Haveli,2001,District Jail,0,0,0,0,0,0,0,0,0,0,0,0,0,0,0
D & N Haveli,2001,Sub_Jail,8,0,8,153,5,158,0,0,0,0,0,0,161,5,166
D & N Haveli,2001,Women Jail,0,0,0,0,0,0,0,0,0,0,0,0,0,0,0
D & N Haveli,2001,Borstal School,0,0,0,0,0,0,0,0,0,0,0,0,0,0,0
D & N Haveli,2001,Open Jail,0,0,0,0,0,0,0,0,0,0,0,0,0,0,0
D & N Haveli,2001,Special Jail,0,0,0,0,0,0,0,0,0,0,0,0,0,0,0
D & N Haveli,2001,Others,0,0,0,0,0,0,0,0,0,0,0,0,0,0,0
D & N Haveli,2001,Total,8,0,8,153,5,158,0,0,0,0,0,0,161,5,166
D & N Haveli,2002,Central Jail,0,0,0,0,0,0,0,0,0,0,0,0,0,0,0
D & N Haveli,2002,District Jail,0,0,0,0,0,0,0,0,0,0,0,0,0,0,0
D & N Haveli,2002,Sub_Jail,4,1,5,154,1,155,0,0,0,0,0,0,158,2,160
D & N Haveli,2002,Women Jail,0,0,0,0,0,0,0,0,0,0,0,0,0,0,0
D & N Haveli,2002,Borstal School,0,0,0,0,0,0,0,0,0,0,0,0,0,0,0
D & N Haveli,2002,Open Jail,0,0,0,0,0,0,0,0,0,0,0,0,0,0,0
D & N Haveli,2002,Special Jail,0,0,0,0,0,0,0,0,0,0,0,0,0,0,0
D & N Haveli,2002,Others,0,0,0,0,0,0,0,0,0,0,0,0,0,0,0
D & N Haveli,2002,Total,4,1,5,154,1,155,0,0,0,0,0,0,158,2,160
D & N Haveli,2003,Central Jail,0,0,0,0,0,0,0,0,0,0,0,0,0,0,0
D & N Haveli,2003,District Jail,0,0,0,0,0,0,0,0,0,0,0,0,0,0,0
D & N Haveli,2003,Sub_Jail,0,0,0,172,0,172,0,0,0,0,0,0,172,0,172
D & N Haveli,2003,Women Jail,0,0,0,0,0,0,0,0,0,0,0,0,0,0,0
D & N Haveli,2003,Borstal School,0,0,0,0,0,0,0,0,0,0,0,0,0,0,0
D & N Haveli,2003,Open Jail,0,0,0,0,0,0,0,0,0,0,0,0,0,0,0
D & N Haveli,2003,Special Jail,0,0,0,0,0,0,0,0,0,0,0,0,0,0,0
D & N Haveli,2003,Others,0,0,0,0,0,0,0,0,0,0,0,0,0,0,0
D & N Haveli,2003,Total,0,0,0,172,0,172,0,0,0,0,0,0,172,0,172
D & N Haveli,2004,Central Jail,0,0,0,0,0,0,0,0,0,0,0,0,0,0,0
D & N Haveli,2004,District Jail,0,0,0,0,0,0,0,0,0,0,0,0,0,0,0
D & N Haveli,2004,Sub_Jail,0,0,0,33,0,33,0,0,0,0,0,0,33,0,33
D & N Haveli,2004,Women Jail,0,0,0,0,0,0,0,0,0,0,0,0,0,0,0
D & N Haveli,2004,Borstal School,0,0,0,0,0,0,0,0,0,0,0,0,0,0,0
D & N Haveli,2004,Open Jail,0,0,0,0,0,0,0,0,0,0,0,0,0,0,0
D & N Haveli,2004,Special Jail,0,0,0,0,0,0,0,0,0,0,0,0,0,0,0
D & N Haveli,2004,Others,0,0,0,0,0,0,0,0,0,0,0,0,0,0,0
D & N Haveli,2004,Total,0,0,0,33,0,33,0,0,0,0,0,0,33,0,33
D & N Haveli,2005,Central Jail,0,0,0,0,0,0,0,0,0,0,0,0,0,0,0
D & N Haveli,2005,District Jail,0,0,0,0,0,0,0,0,0,0,0,0,0,0,0
D & N Haveli,2005,Sub_Jail,0,0,0,29,0,29,0,0,0,0,0,0,29,0,29
D & N Haveli,2005,Women Jail,0,0,0,0,0,0,0,0,0,0,0,0,0,0,0
D & N Haveli,2005,Borstal School,0,0,0,0,0,0,0,0,0,0,0,0,0,0,0
D & N Haveli,2005,Open Jail,0,0,0,0,0,0,0,0,0,0,0,0,0,0,0
D & N Haveli,2005,Special Jail,0,0,0,0,0,0,0,0,0,0,0,0,0,0,0
D & N Haveli,2005,Others,0,0,0,0,0,0,0,0,0,0,0,0,0,0,0
D & N Haveli,2005,Total,0,0,0,29,0,29,0,0,0,0,0,0,29,0,29
D & N Haveli,2006,Central Jail,0,0,0,0,0,0,0,0,0,0,0,0,0,0,0
D & N Haveli,2006,District Jail,0,0,0,0,0,0,0,0,0,0,0,0,0,0,0
D & N Haveli,2006,Sub_Jail,0,0,0,33,0,33,0,0,0,0,0,0,33,0,33
D & N Haveli,2006,Women Jail,0,0,0,0,0,0,0,0,0,0,0,0,0,0,0
D & N Haveli,2006,Borstal School,0,0,0,0,0,0,0,0,0,0,0,0,0,0,0
D & N Haveli,2006,Open Jail,0,0,0,0,0,0,0,0,0,0,0,0,0,0,0
D & N Haveli,2006,Special Jail,0,0,0,0,0,0,0,0,0,0,0,0,0,0,0
D & N Haveli,2006,Others,0,0,0,0,0,0,0,0,0,0,0,0,0,0,0
D & N Haveli,2006,Total,0,0,0,33,0,33,0,0,0,0,0,0,33,0,33
D & N Haveli,2007,Central Jail,0,0,0,0,0,0,0,0,0,0,0,0,0,0,0
D & N Haveli,2007,District Jail,0,0,0,0,0,0,0,0,0,0,0,0,0,0,0
D & N Haveli,2007,Sub_Jail,0,0,0,28,0,28,0,0,0,0,0,0,28,0,28
D & N Haveli,2007,Women Jail,0,0,0,0,0,0,0,0,0,0,0,0,0,0,0
D & N Haveli,2007,Borstal School,0,0,0,0,0,0,0,0,0,0,0,0,0,0,0
D & N Haveli,2007,Open Jail,0,0,0,0,0,0,0,0,0,0,0,0,0,0,0
D & N Haveli,2007,Special Jail,0,0,0,0,0,0,0,0,0,0,0,0,0,0,0
D & N Haveli,2007,Others,0,0,0,0,0,0,0,0,0,0,0,0,0,0,0
D & N Haveli,2007,Total,0,0,0,28,0,28,0,0,0,0,0,0,28,0,28
D & N Haveli,2008,Central Jail,0,0,0,0,0,0,0,0,0,0,0,0,0,0,0
D & N Haveli,2008,District Jail,0,0,0,0,0,0,0,0,0,0,0,0,0,0,0
D & N Haveli,2008,Sub_Jail,11,0,11,32,3,35,0,0,0,0,0,0,43,3,46
D & N Haveli,2008,Women Jail,0,0,0,0,0,0,0,0,0,0,0,0,0,0,0
D & N Haveli,2008,Borstal School,0,0,0,0,0,0,0,0,0,0,0,0,0,0,0
D & N Haveli,2008,Open Jail,0,0,0,0,0,0,0,0,0,0,0,0,0,0,0
D & N Haveli,2008,Special Jail,0,0,0,0,0,0,0,0,0,0,0,0,0,0,0
D & N Haveli,2008,Others,0,0,0,0,0,0,0,0,0,0,0,0,0,0,0
D & N Haveli,2008,Total,11,0,11,32,3,35,0,0,0,0,0,0,43,3,46
D & N Haveli,2009,Central Jail,0,0,0,0,0,0,0,0,0,0,0,0,0,0,0
D & N Haveli,2009,District Jail,0,0,0,0,0,0,0,0,0,0,0,0,0,0,0
D & N Haveli,2009,Sub_Jail,2,0,2,52,2,54,0,0,0,0,0,0,54,2,56
D & N Haveli,2009,Women Jail,0,0,0,0,0,0,0,0,0,0,0,0,0,0,0
D & N Haveli,2009,Borstal School,0,0,0,0,0,0,0,0,0,0,0,0,0,0,0
D & N Haveli,2009,Open Jail,0,0,0,0,0,0,0,0,0,0,0,0,0,0,0
D & N Haveli,2009,Special Jail,0,0,0,0,0,0,0,0,0,0,0,0,0,0,0
D & N Haveli,2009,Others,0,0,0,0,0,0,0,0,0,0,0,0,0,0,0
D & N Haveli,2009,Total,2,0,2,52,2,54,0,0,0,0,0,0,54,2,56
D & N Haveli,2010,Central Jail,0,0,0,0,0,0,0,0,0,0,0,0,0,0,0
D & N Haveli,2010,District Jail,0,0,0,0,0,0,0,0,0,0,0,0,0,0,0
D & N Haveli,2010,Sub_Jail,0,0,0,42,0,42,0,0,0,0,0,0,42,0,42
D & N Haveli,2010,Women Jail,0,0,0,0,0,0,0,0,0,0,0,0,0,0,0
D & N Haveli,2010,Borstal School,0,0,0,0,0,0,0,0,0,0,0,0,0,0,0
D & N Haveli,2010,Open Jail,0,0,0,0,0,0,0,0,0,0,0,0,0,0,0
D & N Haveli,2010,Special Jail,0,0,0,0,0,0,0,0,0,0,0,0,0,0,0
D & N Haveli,2010,Others,0,0,0,0,0,0,0,0,0,0,0,0,0,0,0
D & N Haveli,2010,Total,0,0,0,42,0,42,0,0,0,0,0,0,42,0,42
D & N Haveli,2011,Central Jail,0,0,0,0,0,0,0,0,0,0,0,0,0,0,0
D & N Haveli,2011,District Jail,0,0,0,0,0,0,0,0,0,0,0,0,0,0,0
D & N Haveli,2011,Sub_Jail,0,0,0,23,2,25,0,0,0,0,0,0,23,2,25
D & N Haveli,2011,Women Jail,0,0,0,0,0,0,0,0,0,0,0,0,0,0,0
D & N Haveli,2011,Borstal School,0,0,0,0,0,0,0,0,0,0,0,0,0,0,0
D & N Haveli,2011,Open Jail,0,0,0,0,0,0,0,0,0,0,0,0,0,0,0
D & N Haveli,2011,Special Jail,0,0,0,0,0,0,0,0,0,0,0,0,0,0,0
D & N Haveli,2011,Others,0,0,0,0,0,0,0,0,0,0,0,0,0,0,0
D & N Haveli,2011,Total,0,0,0,23,2,25,0,0,0,0,0,0,23,2,25
D & N Haveli,2012,Central Jail,0,0,0,0,0,0,0,0,0,0,0,0,0,0,0
D & N Haveli,2012,District Jail,0,0,0,0,0,0,0,0,0,0,0,0,0,0,0
D & N Haveli,2012,Sub_Jail,0,0,0,35,2,37,0,0,0,0,0,0,35,2,37
D & N Haveli,2012,Women Jail,0,0,0,0,0,0,0,0,0,0,0,0,0,0,0
D & N Haveli,2012,Borstal School,0,0,0,0,0,0,0,0,0,0,0,0,0,0,0
D & N Haveli,2012,Open Jail,0,0,0,0,0,0,0,0,0,0,0,0,0,0,0
D & N Haveli,2012,Special Jail,0,0,0,0,0,0,0,0,0,0,0,0,0,0,0
D & N Haveli,2012,Others,0,0,0,0,0,0,0,0,0,0,0,0,0,0,0
D & N Haveli,2012,Total,0,0,0,35,2,37,0,0,0,0,0,0,35,2,37
Daman & Diu,2001,Central Jail,0,0,0,0,0,0,0,0,0,0,0,0,0,0,0
Daman & Diu,2001,District Jail,0,0,0,0,0,0,0,0,0,0,0,0,0,0,0
Daman & Diu,2001,Sub_Jail,23,0,23,17,1,18,0,0,0,0,0,0,40,1,41
Daman & Diu,2001,Women Jail,0,0,0,0,0,0,0,0,0,0,0,0,0,0,0
Daman & Diu,2001,Borstal School,0,0,0,0,0,0,0,0,0,0,0,0,0,0,0
Daman & Diu,2001,Open Jail,0,0,0,0,0,0,0,0,0,0,0,0,0,0,0
Daman & Diu,2001,Special Jail,0,0,0,0,0,0,0,0,0,0,0,0,0,0,0
Daman & Diu,2001,Others,0,0,0,0,0,0,0,0,0,0,0,0,0,0,0
Daman & Diu,2001,Total,23,0,23,17,1,18,0,0,0,0,0,0,40,1,41
Daman & Diu,2002,Central Jail,0,0,0,0,0,0,0,0,0,0,0,0,0,0,0
Daman & Diu,2002,District Jail,0,0,0,0,0,0,0,0,0,0,0,0,0,0,0
Daman & Diu,2002,Sub_Jail,13,0,13,20,0,20,0,0,0,0,0,0,33,0,33
Daman & Diu,2002,Women Jail,0,0,0,0,0,0,0,0,0,0,0,0,0,0,0
Daman & Diu,2002,Borstal School,0,0,0,0,0,0,0,0,0,0,0,0,0,0,0
Daman & Diu,2002,Open Jail,0,0,0,0,0,0,0,0,0,0,0,0,0,0,0
Daman & Diu,2002,Special Jail,0,0,0,0,0,0,0,0,0,0,0,0,0,0,0
Daman & Diu,2002,Others,0,0,0,0,0,0,0,0,0,0,0,0,0,0,0
Daman & Diu,2002,Total,13,0,13,20,0,20,0,0,0,0,0,0,33,0,33
Daman & Diu,2003,Central Jail,0,0,0,0,0,0,0,0,0,0,0,0,0,0,0
Daman & Diu,2003,District Jail,0,0,0,0,0,0,0,0,0,0,0,0,0,0,0
Daman & Diu,2003,Sub_Jail,13,0,13,20,0,20,0,0,0,0,0,0,33,0,33
Daman & Diu,2003,Women Jail,0,0,0,0,0,0,0,0,0,0,0,0,0,0,0
Daman & Diu,2003,Borstal School,0,0,0,0,0,0,0,0,0,0,0,0,0,0,0
Daman & Diu,2003,Open Jail,0,0,0,0,0,0,0,0,0,0,0,0,0,0,0
Daman & Diu,2003,Special Jail,0,0,0,0,0,0,0,0,0,0,0,0,0,0,0
Daman & Diu,2003,Others,0,0,0,0,0,0,0,0,0,0,0,0,0,0,0
Daman & Diu,2003,Total,13,0,13,20,0,20,0,0,0,0,0,0,33,0,33
Daman & Diu,2004,Central Jail,0,0,0,0,0,0,0,0,0,0,0,0,0,0,0
Daman & Diu,2004,District Jail,0,0,0,0,0,0,0,0,0,0,0,0,0,0,0
Daman & Diu,2004,Sub_Jail,8,0,8,18,1,19,0,0,0,0,0,0,26,1,27
Daman & Diu,2004,Women Jail,0,0,0,0,0,0,0,0,0,0,0,0,0,0,0
Daman & Diu,2004,Borstal School,0,0,0,0,0,0,0,0,0,0,0,0,0,0,0
Daman & Diu,2004,Open Jail,0,0,0,0,0,0,0,0,0,0,0,0,0,0,0
Daman & Diu,2004,Special Jail,0,0,0,0,0,0,0,0,0,0,0,0,0,0,0
Daman & Diu,2004,Others,0,0,0,0,0,0,0,0,0,0,0,0,0,0,0
Daman & Diu,2004,Total,8,0,8,18,1,19,0,0,0,0,0,0,26,1,27
Daman & Diu,2005,Central Jail,0,0,0,0,0,0,0,0,0,0,0,0,0,0,0
Daman & Diu,2005,District Jail,0,0,0,0,0,0,0,0,0,0,0,0,0,0,0
Daman & Diu,2005,Sub_Jail,11,0,11,23,1,24,0,0,0,0,0,0,34,1,35
Daman & Diu,2005,Women Jail,0,0,0,0,0,0,0,0,0,0,0,0,0,0,0
Daman & Diu,2005,Borstal School,0,0,0,0,0,0,0,0,0,0,0,0,0,0,0
Daman & Diu,2005,Open Jail,0,0,0,0,0,0,0,0,0,0,0,0,0,0,0
Daman & Diu,2005,Special Jail,0,0,0,0,0,0,0,0,0,0,0,0,0,0,0
Daman & Diu,2005,Others,0,0,0,0,0,0,0,0,0,0,0,0,0,0,0
Daman & Diu,2005,Total,11,0,11,23,1,24,0,0,0,0,0,0,34,1,35
Daman & Diu,2006,Central Jail,0,0,0,0,0,0,0,0,0,0,0,0,0,0,0
Daman & Diu,2006,District Jail,0,0,0,0,0,0,0,0,0,0,0,0,0,0,0
Daman & Diu,2006,Sub_Jail,12,0,12,41,1,42,0,0,0,0,0,0,53,1,54
Daman & Diu,2006,Women Jail,0,0,0,0,0,0,0,0,0,0,0,0,0,0,0
Daman & Diu,2006,Borstal School,0,0,0,0,0,0,0,0,0,0,0,0,0,0,0
Daman & Diu,2006,Open Jail,0,0,0,0,0,0,0,0,0,0,0,0,0,0,0
Daman & Diu,2006,Special Jail,0,0,0,0,0,0,0,0,0,0,0,0,0,0,0
Daman & Diu,2006,Others,0,0,0,0,0,0,0,0,0,0,0,0,0,0,0
Daman & Diu,2006,Total,12,0,12,41,1,42,0,0,0,0,0,0,53,1,54
Daman & Diu,2007,Central Jail,0,0,0,0,0,0,0,0,0,0,0,0,0,0,0
Daman & Diu,2007,District Jail,0,0,0,0,0,0,0,0,0,0,0,0,0,0,0
Daman & Diu,2007,Sub_Jail,8,2,10,52,4,56,0,0,0,0,0,0,60,6,66
Daman & Diu,2007,Women Jail,0,0,0,0,0,0,0,0,0,0,0,0,0,0,0
Daman & Diu,2007,Borstal School,0,0,0,0,0,0,0,0,0,0,0,0,0,0,0
Daman & Diu,2007,Open Jail,0,0,0,0,0,0,0,0,0,0,0,0,0,0,0
Daman & Diu,2007,Special Jail,0,0,0,0,0,0,0,0,0,0,0,0,0,0,0
Daman & Diu,2007,Others,0,0,0,0,0,0,0,0,0,0,0,0,0,0,0
Daman & Diu,2007,Total,8,2,10,52,4,56,0,0,0,0,0,0,60,6,66
Daman & Diu,2008,Central Jail,0,0,0,0,0,0,0,0,0,0,0,0,0,0,0
Daman & Diu,2008,District Jail,0,0,0,0,0,0,0,0,0,0,0,0,0,0,0
Daman & Diu,2008,Sub_Jail,14,2,16,26,1,27,0,0,0,0,0,0,40,3,43
Daman & Diu,2008,Women Jail,0,0,0,0,0,0,0,0,0,0,0,0,0,0,0
Daman & Diu,2008,Borstal School,0,0,0,0,0,0,0,0,0,0,0,0,0,0,0
Daman & Diu,2008,Open Jail,0,0,0,0,0,0,0,0,0,0,0,0,0,0,0
Daman & Diu,2008,Special Jail,0,0,0,0,0,0,0,0,0,0,0,0,0,0,0
Daman & Diu,2008,Others,0,0,0,0,0,0,0,0,0,0,0,0,0,0,0
Daman & Diu,2008,Total,14,2,16,26,1,27,0,0,0,0,0,0,40,3,43
Daman & Diu,2009,Central Jail,0,0,0,0,0,0,0,0,0,0,0,0,0,0,0
Daman & Diu,2009,District Jail,0,0,0,0,0,0,0,0,0,0,0,0,0,0,0
Daman & Diu,2009,Sub_Jail,15,1,16,24,0,24,0,0,0,0,0,0,39,1,40
Daman & Diu,2009,Women Jail,0,0,0,0,0,0,0,0,0,0,0,0,0,0,0
Daman & Diu,2009,Borstal School,0,0,0,0,0,0,0,0,0,0,0,0,0,0,0
Daman & Diu,2009,Open Jail,0,0,0,0,0,0,0,0,0,0,0,0,0,0,0
Daman & Diu,2009,Special Jail,0,0,0,0,0,0,0,0,0,0,0,0,0,0,0
Daman & Diu,2009,Others,0,0,0,0,0,0,0,0,0,0,0,0,0,0,0
Daman & Diu,2009,Total,15,1,16,24,0,24,0,0,0,0,0,0,39,1,40
Daman & Diu,2010,Central Jail,0,0,0,0,0,0,0,0,0,0,0,0,0,0,0
Daman & Diu,2010,District Jail,0,0,0,0,0,0,0,0,0,0,0,0,0,0,0
Daman & Diu,2010,Sub_Jail,13,1,14,16,0,16,0,0,0,0,0,0,29,1,30
Daman & Diu,2010,Women Jail,0,0,0,0,0,0,0,0,0,0,0,0,0,0,0
Daman & Diu,2010,Borstal School,0,0,0,0,0,0,0,0,0,0,0,0,0,0,0
Daman & Diu,2010,Open Jail,0,0,0,0,0,0,0,0,0,0,0,0,0,0,0
Daman & Diu,2010,Special Jail,0,0,0,0,0,0,0,0,0,0,0,0,0,0,0
Daman & Diu,2010,Others,0,0,0,0,0,0,0,0,0,0,0,0,0,0,0
Daman & Diu,2010,Total,13,1,14,16,0,16,0,0,0,0,0,0,29,1,30
Daman & Diu,2011,Central Jail,0,0,0,0,0,0,0,0,0,0,0,0,0,0,0
Daman & Diu,2011,District Jail,0,0,0,0,0,0,0,0,0,0,0,0,0,0,0
Daman & Diu,2011,Sub_Jail,11,1,12,17,0,17,0,0,0,0,0,0,28,1,29
Daman & Diu,2011,Women Jail,0,0,0,0,0,0,0,0,0,0,0,0,0,0,0
Daman & Diu,2011,Borstal School,0,0,0,0,0,0,0,0,0,0,0,0,0,0,0
Daman & Diu,2011,Open Jail,0,0,0,0,0,0,0,0,0,0,0,0,0,0,0
Daman & Diu,2011,Special Jail,0,0,0,0,0,0,0,0,0,0,0,0,0,0,0
Daman & Diu,2011,Others,0,0,0,0,0,0,0,0,0,0,0,0,0,0,0
Daman & Diu,2011,Total,11,1,12,17,0,17,0,0,0,0,0,0,28,1,29
Daman & Diu,2012,Central Jail,0,0,0,0,0,0,0,0,0,0,0,0,0,0,0
Daman & Diu,2012,District Jail,0,0,0,0,0,0,0,0,0,0,0,0,0,0,0
Daman & Diu,2012,Sub_Jail,13,1,14,10,1,11,0,0,0,0,0,0,23,2,25
Daman & Diu,2012,Women Jail,0,0,0,0,0,0,0,0,0,0,0,0,0,0,0
Daman & Diu,2012,Borstal School,0,0,0,0,0,0,0,0,0,0,0,0,0,0,0
Daman & Diu,2012,Open Jail,0,0,0,0,0,0,0,0,0,0,0,0,0,0,0
Daman & Diu,2012,Special Jail,0,0,0,0,0,0,0,0,0,0,0,0,0,0,0
Daman & Diu,2012,Others,0,0,0,0,0,0,0,0,0,0,0,0,0,0,0
Daman & Diu,2012,Total,13,1,14,10,1,11,0,0,0,0,0,0,23,2,25
Delhi,2001,Central Jail,2104,0,2104,8366,0,8366,49,0,49,0,0,0,10519,0,10519
Delhi,2001,District Jail,0,0,0,0,0,0,0,0,0,0,0,0,0,0,0
Delhi,2001,Sub_Jail,0,0,0,0,0,0,0,0,0,0,0,0,0,0,0
Delhi,2001,Women Jail,0,117,117,0,386,386,0,1,1,0,0,0,0,504,504
Delhi,2001,Borstal School,0,0,0,0,0,0,0,0,0,0,0,0,0,0,0
Delhi,2001,Open Jail,0,0,0,0,0,0,0,0,0,0,0,0,0,0,0
Delhi,2001,Special Jail,0,0,0,0,0,0,0,0,0,0,0,0,0,0,0
Delhi,2001,Others,0,0,0,0,0,0,0,0,0,0,0,0,0,0,0
Delhi,2001,Total,2104,117,2221,8366,386,8752,49,1,50,0,0,0,10519,504,11023
Delhi,2002,Central Jail,2218,0,2218,9275,0,9275,51,0,51,0,0,0,11544,0,11544
Delhi,2002,District Jail,0,0,0,0,0,0,0,0,0,0,0,0,0,0,0
Delhi,2002,Sub_Jail,0,0,0,0,0,0,0,0,0,0,0,0,0,0,0
Delhi,2002,Women Jail,0,115,115,0,381,381,0,1,1,0,0,0,0,497,497
Delhi,2002,Borstal School,0,0,0,0,0,0,0,0,0,0,0,0,0,0,0
Delhi,2002,Open Jail,0,0,0,0,0,0,0,0,0,0,0,0,0,0,0
Delhi,2002,Special Jail,0,0,0,0,0,0,0,0,0,0,0,0,0,0,0
Delhi,2002,Others,0,0,0,0,0,0,0,0,0,0,0,0,0,0,0
Delhi,2002,Total,2218,115,2333,9275,381,9656,51,1,52,0,0,0,11544,497,12041
Delhi,2003,Central Jail,2152,0,2152,9431,0,9431,39,0,39,0,0,0,11622,0,11622
Delhi,2003,District Jail,0,0,0,0,0,0,0,0,0,0,0,0,0,0,0
Delhi,2003,Sub_Jail,0,0,0,0,0,0,0,0,0,0,0,0,0,0,0
Delhi,2003,Women Jail,0,114,114,0,435,435,0,1,1,0,0,0,0,550,550
Delhi,2003,Borstal School,0,0,0,0,0,0,0,0,0,0,0,0,0,0,0
Delhi,2003,Open Jail,0,0,0,0,0,0,0,0,0,0,0,0,0,0,0
Delhi,2003,Special Jail,0,0,0,0,0,0,0,0,0,0,0,0,0,0,0
Delhi,2003,Others,0,0,0,0,0,0,0,0,0,0,0,0,0,0,0
Delhi,2003,Total,2152,114,2266,9431,435,9866,39,1,40,0,0,0,11622,550,12172
Delhi,2004,Central Jail,1774,0,1774,9688,0,9688,15,0,15,0,0,0,11477,0,11477
Delhi,2004,District Jail,602,0,602,0,0,0,0,0,0,0,0,0,602,0,602
Delhi,2004,Sub_Jail,0,0,0,0,0,0,0,0,0,0,0,0,0,0,0
Delhi,2004,Women Jail,0,132,132,0,399,399,0,0,0,0,0,0,0,531,531
Delhi,2004,Borstal School,0,0,0,0,0,0,0,0,0,0,0,0,0,0,0
Delhi,2004,Open Jail,0,0,0,0,0,0,0,0,0,0,0,0,0,0,0
Delhi,2004,Special Jail,0,0,0,0,0,0,0,0,0,0,0,0,0,0,0
Delhi,2004,Others,0,0,0,0,0,0,0,0,0,0,0,0,0,0,0
Delhi,2004,Total,2376,132,2508,9688,399,10087,15,0,15,0,0,0,12079,531,12610
Delhi,2005,Central Jail,1412,0,1412,9415,0,9415,12,0,12,0,0,0,10839,0,10839
Delhi,2005,District Jail,981,0,981,6,0,6,4,0,4,0,0,0,991,0,991
Delhi,2005,Sub_Jail,0,0,0,0,0,0,0,0,0,0,0,0,0,0,0
Delhi,2005,Women Jail,0,117,117,0,370,370,0,0,0,0,0,0,0,487,487
Delhi,2005,Borstal School,0,0,0,0,0,0,0,0,0,0,0,0,0,0,0
Delhi,2005,Open Jail,0,0,0,0,0,0,0,0,0,0,0,0,0,0,0
Delhi,2005,Special Jail,0,0,0,0,0,0,0,0,0,0,0,0,0,0,0
Delhi,2005,Others,0,0,0,0,0,0,0,0,0,0,0,0,0,0,0
Delhi,2005,Total,2393,117,2510,9421,370,9791,16,0,16,0,0,0,11830,487,12317
Delhi,2006,Central Jail,2233,0,2233,9129,0,9129,16,0,16,0,0,0,11378,0,11378
Delhi,2006,District Jail,137,0,137,1422,0,1422,0,0,0,0,0,0,1559,0,1559
Delhi,2006,Sub_Jail,0,0,0,0,0,0,0,0,0,0,0,0,0,0,0
Delhi,2006,Women Jail,0,79,79,0,383,383,0,1,1,0,0,0,0,463,463
Delhi,2006,Borstal School,0,0,0,0,0,0,0,0,0,0,0,0,0,0,0
Delhi,2006,Open Jail,0,0,0,0,0,0,0,0,0,0,0,0,0,0,0
Delhi,2006,Special Jail,0,0,0,0,0,0,0,0,0,0,0,0,0,0,0
Delhi,2006,Others,0,0,0,0,0,0,0,0,0,0,0,0,0,0,0
Delhi,2006,Total,2370,79,2449,10551,383,10934,16,1,17,0,0,0,12937,463,13400
Delhi,2007,Central Jail,2072,0,2072,7429,0,7429,22,0,22,0,0,0,9523,0,9523
Delhi,2007,District Jail,133,0,133,1463,0,1463,1,0,1,0,0,0,1597,0,1597
Delhi,2007,Sub_Jail,0,0,0,0,0,0,0,0,0,0,0,0,0,0,0
Delhi,2007,Women Jail,0,63,63,0,422,422,0,0,0,0,0,0,0,485,485
Delhi,2007,Borstal School,0,0,0,0,0,0,0,0,0,0,0,0,0,0,0
Delhi,2007,Open Jail,0,0,0,0,0,0,0,0,0,0,0,0,0,0,0
Delhi,2007,Special Jail,0,0,0,0,0,0,0,0,0,0,0,0,0,0,0
Delhi,2007,Others,0,0,0,0,0,0,0,0,0,0,0,0,0,0,0
Delhi,2007,Total,2205,63,2268,8892,422,9314,23,0,23,0,0,0,11120,485,11605
Delhi,2008,Central Jail,1775,0,1775,7603,0,7603,19,0,19,4,0,4,9401,0,9401
Delhi,2008,District Jail,147,0,147,1535,0,1535,0,0,0,0,0,0,1682,0,1682
Delhi,2008,Sub_Jail,0,0,0,0,0,0,0,0,0,0,0,0,0,0,0
Delhi,2008,Women Jail,0,56,56,0,414,414,0,0,0,0,0,0,0,470,470
Delhi,2008,Borstal School,0,0,0,0,0,0,0,0,0,0,0,0,0,0,0
Delhi,2008,Open Jail,0,0,0,0,0,0,0,0,0,0,0,0,0,0,0
Delhi,2008,Special Jail,0,0,0,0,0,0,0,0,0,0,0,0,0,0,0
Delhi,2008,Others,0,0,0,0,0,0,0,0,0,0,0,0,0,0,0
Delhi,2008,Total,1922,56,1978,9138,414,9552,19,0,19,4,0,4,11083,470,11553
Delhi,2009,Central Jail,2069,0,2069,7253,0,7253,15,0,15,5,0,5,9342,0,9342
Delhi,2009,District Jail,143,0,143,1314,0,1314,0,0,0,0,0,0,1457,0,1457
Delhi,2009,Sub_Jail,0,0,0,0,0,0,0,0,0,0,0,0,0,0,0
Delhi,2009,Women Jail,0,83,83,0,364,364,0,0,0,0,0,0,0,447,447
Delhi,2009,Borstal School,0,0,0,0,0,0,0,0,0,0,0,0,0,0,0
Delhi,2009,Open Jail,0,0,0,0,0,0,0,0,0,0,0,0,0,0,0
Delhi,2009,Special Jail,0,0,0,0,0,0,0,0,0,0,0,0,0,0,0
Delhi,2009,Others,0,0,0,0,0,0,0,0,0,0,0,0,0,0,0
Delhi,2009,Total,2212,83,2295,8567,364,8931,15,0,15,5,0,5,10799,447,11246
Delhi,2010,Central Jail,2500,0,2500,6401,0,6401,13,0,13,5,0,5,8919,0,8919
Delhi,2010,District Jail,147,0,147,1285,0,1285,0,0,0,0,0,0,1432,0,1432
Delhi,2010,Sub_Jail,0,0,0,0,0,0,0,0,0,0,0,0,0,0,0
Delhi,2010,Women Jail,0,104,104,0,401,401,0,0,0,0,0,0,0,505,505
Delhi,2010,Borstal School,0,0,0,0,0,0,0,0,0,0,0,0,0,0,0
Delhi,2010,Open Jail,0,0,0,0,0,0,0,0,0,0,0,0,0,0,0
Delhi,2010,Special Jail,0,0,0,0,0,0,0,0,0,0,0,0,0,0,0
Delhi,2010,Others,0,0,0,0,0,0,0,0,0,0,0,0,0,0,0
Delhi,2010,Total,2647,104,2751,7686,401,8087,13,0,13,5,0,5,10351,505,10856
Delhi,2011,Central Jail,2921,0,2921,7246,0,7246,6,0,6,0,0,0,10173,0,10173
Delhi,2011,District Jail,170,0,170,1255,0,1255,0,0,0,0,0,0,1425,0,1425
Delhi,2011,Sub_Jail,0,0,0,0,0,0,0,0,0,0,0,0,0,0,0
Delhi,2011,Women Jail,0,116,116,0,410,410,0,0,0,0,0,0,0,526,526
Delhi,2011,Borstal School,0,0,0,0,0,0,0,0,0,0,0,0,0,0,0
Delhi,2011,Open Jail,0,0,0,0,0,0,0,0,0,0,0,0,0,0,0
Delhi,2011,Special Jail,0,0,0,0,0,0,0,0,0,0,0,0,0,0,0
Delhi,2011,Others,0,0,0,0,0,0,0,0,0,0,0,0,0,0,0
Delhi,2011,Total,3091,116,3207,8501,410,8911,6,0,6,0,0,0,11598,526,12124
Delhi,2012,Central Jail,2881,0,2881,7105,0,7105,5,0,5,2,0,2,9993,0,9993
Delhi,2012,District Jail,213,0,213,1367,0,1367,0,0,0,0,0,0,1580,0,1580
Delhi,2012,Sub_Jail,0,0,0,0,0,0,0,0,0,0,0,0,0,0,0
Delhi,2012,Women Jail,0,125,125,0,415,415,0,0,0,0,0,0,0,540,540
Delhi,2012,Borstal School,0,0,0,0,0,0,0,0,0,0,0,0,0,0,0
Delhi,2012,Open Jail,0,0,0,0,0,0,0,0,0,0,0,0,0,0,0
Delhi,2012,Special Jail,0,0,0,0,0,0,0,0,0,0,0,0,0,0,0
Delhi,2012,Others,0,0,0,0,0,0,0,0,0,0,0,0,0,0,0
Delhi,2012,Total,3094,125,3219,8472,415,8887,5,0,5,2,0,2,11573,540,12113
Lakshadweep,2001,Central Jail,0,0,0,0,0,0,0,0,0,0,0,0,0,0,0
Lakshadweep,2001,District Jail,0,0,0,0,0,0,0,0,0,0,0,0,0,0,0
Lakshadweep,2001,Sub_Jail,0,0,0,1,0,1,0,0,0,0,0,0,1,0,1
Lakshadweep,2001,Women Jail,0,0,0,0,0,0,0,0,0,0,0,0,0,0,0
Lakshadweep,2001,Borstal School,0,0,0,0,0,0,0,0,0,0,0,0,0,0,0
Lakshadweep,2001,Open Jail,0,0,0,0,0,0,0,0,0,0,0,0,0,0,0
Lakshadweep,2001,Special Jail,0,0,0,0,0,0,0,0,0,0,0,0,0,0,0
Lakshadweep,2001,Others,0,0,0,0,0,0,0,0,0,0,0,0,0,0,0
Lakshadweep,2001,Total,0,0,0,1,0,1,0,0,0,0,0,0,1,0,1
Lakshadweep,2002,Central Jail,0,0,0,0,0,0,0,0,0,0,0,0,0,0,0
Lakshadweep,2002,District Jail,0,0,0,0,0,0,0,0,0,0,0,0,0,0,0
Lakshadweep,2002,Sub_Jail,2,0,2,14,0,14,0,0,0,0,0,0,16,0,16
Lakshadweep,2002,Women Jail,0,0,0,0,0,0,0,0,0,0,0,0,0,0,0
Lakshadweep,2002,Borstal School,0,0,0,0,0,0,0,0,0,0,0,0,0,0,0
Lakshadweep,2002,Open Jail,0,0,0,0,0,0,0,0,0,0,0,0,0,0,0
Lakshadweep,2002,Special Jail,0,0,0,0,0,0,0,0,0,0,0,0,0,0,0
Lakshadweep,2002,Others,0,0,0,0,0,0,0,0,0,0,0,0,0,0,0
Lakshadweep,2002,Total,2,0,2,14,0,14,0,0,0,0,0,0,16,0,16
Lakshadweep,2003,Central Jail,0,0,0,0,0,0,0,0,0,0,0,0,0,0,0
Lakshadweep,2003,District Jail,0,0,0,0,0,0,0,0,0,0,0,0,0,0,0
Lakshadweep,2003,Sub_Jail,0,0,0,4,0,4,0,0,0,0,0,0,4,0,4
Lakshadweep,2003,Women Jail,0,0,0,0,0,0,0,0,0,0,0,0,0,0,0
Lakshadweep,2003,Borstal School,0,0,0,0,0,0,0,0,0,0,0,0,0,0,0
Lakshadweep,2003,Open Jail,0,0,0,0,0,0,0,0,0,0,0,0,0,0,0
Lakshadweep,2003,Special Jail,0,0,0,0,0,0,0,0,0,0,0,0,0,0,0
Lakshadweep,2003,Others,0,0,0,0,0,0,0,0,0,0,0,0,0,0,0
Lakshadweep,2003,Total,0,0,0,4,0,4,0,0,0,0,0,0,4,0,4
Lakshadweep,2004,Central Jail,0,0,0,0,0,0,0,0,0,0,0,0,0,0,0
Lakshadweep,2004,District Jail,0,0,0,0,0,0,0,0,0,0,0,0,0,0,0
Lakshadweep,2004,Sub_Jail,0,0,0,0,0,0,0,0,0,0,0,0,0,0,0
Lakshadweep,2004,Women Jail,0,0,0,0,0,0,0,0,0,0,0,0,0,0,0
Lakshadweep,2004,Borstal School,0,0,0,0,0,0,0,0,0,0,0,0,0,0,0
Lakshadweep,2004,Open Jail,0,0,0,0,0,0,0,0,0,0,0,0,0,0,0
Lakshadweep,2004,Special Jail,0,0,0,0,0,0,0,0,0,0,0,0,0,0,0
Lakshadweep,2004,Others,0,0,0,0,0,0,0,0,0,0,0,0,0,0,0
Lakshadweep,2004,Total,0,0,0,0,0,0,0,0,0,0,0,0,0,0,0
Lakshadweep,2005,Central Jail,0,0,0,0,0,0,0,0,0,0,0,0,0,0,0
Lakshadweep,2005,District Jail,0,0,0,0,0,0,0,0,0,0,0,0,0,0,0
Lakshadweep,2005,Sub_Jail,0,0,0,6,0,6,0,0,0,0,0,0,6,0,6
Lakshadweep,2005,Women Jail,0,0,0,0,0,0,0,0,0,0,0,0,0,0,0
Lakshadweep,2005,Borstal School,0,0,0,0,0,0,0,0,0,0,0,0,0,0,0
Lakshadweep,2005,Open Jail,0,0,0,0,0,0,0,0,0,0,0,0,0,0,0
Lakshadweep,2005,Special Jail,0,0,0,0,0,0,0,0,0,0,0,0,0,0,0
Lakshadweep,2005,Others,0,0,0,0,0,0,0,0,0,0,0,0,0,0,0
Lakshadweep,2005,Total,0,0,0,6,0,6,0,0,0,0,0,0,6,0,6
Lakshadweep,2006,Central Jail,0,0,0,0,0,0,0,0,0,0,0,0,0,0,0
Lakshadweep,2006,District Jail,0,0,0,0,0,0,0,0,0,0,0,0,0,0,0
Lakshadweep,2006,Sub_Jail,0,0,0,0,0,0,0,0,0,0,0,0,0,0,0
Lakshadweep,2006,Women Jail,0,0,0,0,0,0,0,0,0,0,0,0,0,0,0
Lakshadweep,2006,Borstal School,0,0,0,0,0,0,0,0,0,0,0,0,0,0,0
Lakshadweep,2006,Open Jail,0,0,0,0,0,0,0,0,0,0,0,0,0,0,0
Lakshadweep,2006,Special Jail,0,0,0,0,0,0,0,0,0,0,0,0,0,0,0
Lakshadweep,2006,Others,0,0,0,0,0,0,0,0,0,0,0,0,0,0,0
Lakshadweep,2006,Total,0,0,0,0,0,0,0,0,0,0,0,0,0,0,0
Lakshadweep,2007,Central Jail,0,0,0,0,0,0,0,0,0,0,0,0,0,0,0
Lakshadweep,2007,District Jail,0,0,0,0,0,0,0,0,0,0,0,0,0,0,0
Lakshadweep,2007,Sub_Jail,3,0,3,11,0,11,0,0,0,8,0,8,22,0,22
Lakshadweep,2007,Women Jail,0,0,0,0,0,0,0,0,0,0,0,0,0,0,0
Lakshadweep,2007,Borstal School,0,0,0,0,0,0,0,0,0,0,0,0,0,0,0
Lakshadweep,2007,Open Jail,0,0,0,0,0,0,0,0,0,0,0,0,0,0,0
Lakshadweep,2007,Special Jail,0,0,0,0,0,0,0,0,0,0,0,0,0,0,0
Lakshadweep,2007,Others,0,0,0,0,0,0,0,0,0,0,0,0,0,0,0
Lakshadweep,2007,Total,3,0,3,11,0,11,0,0,0,8,0,8,22,0,22
Lakshadweep,2008,Central Jail,0,0,0,0,0,0,0,0,0,0,0,0,0,0,0
Lakshadweep,2008,District Jail,0,0,0,0,0,0,0,0,0,0,0,0,0,0,0
Lakshadweep,2008,Sub_Jail,0,0,0,19,0,19,0,0,0,0,0,0,19,0,19
Lakshadweep,2008,Women Jail,0,0,0,0,0,0,0,0,0,0,0,0,0,0,0
Lakshadweep,2008,Borstal School,0,0,0,0,0,0,0,0,0,0,0,0,0,0,0
Lakshadweep,2008,Open Jail,0,0,0,0,0,0,0,0,0,0,0,0,0,0,0
Lakshadweep,2008,Special Jail,0,0,0,0,0,0,0,0,0,0,0,0,0,0,0
Lakshadweep,2008,Others,0,0,0,0,0,0,0,0,0,0,0,0,0,0,0
Lakshadweep,2008,Total,0,0,0,19,0,19,0,0,0,0,0,0,19,0,19
Lakshadweep,2009,Central Jail,0,0,0,0,0,0,0,0,0,0,0,0,0,0,0
Lakshadweep,2009,District Jail,0,0,0,0,0,0,0,0,0,0,0,0,0,0,0
Lakshadweep,2009,Sub_Jail,1,0,1,43,0,43,0,0,0,0,0,0,44,0,44
Lakshadweep,2009,Women Jail,0,0,0,0,0,0,0,0,0,0,0,0,0,0,0
Lakshadweep,2009,Borstal School,0,0,0,0,0,0,0,0,0,0,0,0,0,0,0
Lakshadweep,2009,Open Jail,0,0,0,0,0,0,0,0,0,0,0,0,0,0,0
Lakshadweep,2009,Special Jail,0,0,0,0,0,0,0,0,0,0,0,0,0,0,0
Lakshadweep,2009,Others,0,0,0,0,0,0,0,0,0,0,0,0,0,0,0
Lakshadweep,2009,Total,1,0,1,43,0,43,0,0,0,0,0,0,44,0,44
Lakshadweep,2010,Central Jail,0,0,0,0,0,0,0,0,0,0,0,0,0,0,0
Lakshadweep,2010,District Jail,0,0,0,0,0,0,0,0,0,0,0,0,0,0,0
Lakshadweep,2010,Sub_Jail,0,0,0,27,0,27,0,0,0,0,0,0,27,0,27
Lakshadweep,2010,Women Jail,0,0,0,0,0,0,0,0,0,0,0,0,0,0,0
Lakshadweep,2010,Borstal School,0,0,0,0,0,0,0,0,0,0,0,0,0,0,0
Lakshadweep,2010,Open Jail,0,0,0,0,0,0,0,0,0,0,0,0,0,0,0
Lakshadweep,2010,Special Jail,0,0,0,0,0,0,0,0,0,0,0,0,0,0,0
Lakshadweep,2010,Others,0,0,0,0,0,0,0,0,0,0,0,0,0,0,0
Lakshadweep,2010,Total,0,0,0,27,0,27,0,0,0,0,0,0,27,0,27
Lakshadweep,2011,Central Jail,0,0,0,0,0,0,0,0,0,0,0,0,0,0,0
Lakshadweep,2011,District Jail,0,0,0,0,0,0,0,0,0,0,0,0,0,0,0
Lakshadweep,2011,Sub_Jail,0,0,0,29,1,30,50,0,50,0,0,0,79,1,80
Lakshadweep,2011,Women Jail,0,0,0,0,0,0,0,0,0,0,0,0,0,0,0
Lakshadweep,2011,Borstal School,0,0,0,0,0,0,0,0,0,0,0,0,0,0,0
Lakshadweep,2011,Open Jail,0,0,0,0,0,0,0,0,0,0,0,0,0,0,0
Lakshadweep,2011,Special Jail,0,0,0,0,0,0,0,0,0,0,0,0,0,0,0
Lakshadweep,2011,Others,0,0,0,0,0,0,0,0,0,0,0,0,0,0,0
Lakshadweep,2011,Total,0,0,0,29,1,30,50,0,50,0,0,0,79,1,80
Lakshadweep,2012,Central Jail,0,0,0,0,0,0,0,0,0,0,0,0,0,0,0
Lakshadweep,2012,District Jail,0,0,0,0,0,0,0,0,0,0,0,0,0,0,0
Lakshadweep,2012,Sub_Jail,0,0,0,0,0,0,0,0,0,0,0,0,0,0,0
Lakshadweep,2012,Women Jail,0,0,0,0,0,0,0,0,0,0,0,0,0,0,0
Lakshadweep,2012,Borstal School,0,0,0,0,0,0,0,0,0,0,0,0,0,0,0
Lakshadweep,2012,Open Jail,0,0,0,0,0,0,0,0,0,0,0,0,0,0,0
Lakshadweep,2012,Special Jail,0,0,0,0,0,0,0,0,0,0,0,0,0,0,0
Lakshadweep,2012,Others,0,0,0,0,0,0,0,0,0,0,0,0,0,0,0
Lakshadweep,2012,Total,0,0,0,0,0,0,0,0,0,0,0,0,0,0,0
Pondicherry,2001,Central Jail,99,1,100,141,3,144,0,0,0,0,0,0,240,4,244
Pondicherry,2001,District Jail,7,0,7,7,2,9,0,0,0,0,0,0,14,2,16
Pondicherry,2001,Sub_Jail,1,0,1,1,0,1,0,0,0,0,0,0,2,0,2
Pondicherry,2001,Women Jail,0,0,0,0,0,0,0,0,0,0,0,0,0,0,0
Pondicherry,2001,Borstal School,0,0,0,0,0,0,0,0,0,0,0,0,0,0,0
Pondicherry,2001,Open Jail,0,0,0,0,0,0,0,0,0,0,0,0,0,0,0
Pondicherry,2001,Special Jail,0,0,0,0,0,0,0,0,0,0,0,0,0,0,0
Pondicherry,2001,Others,0,0,0,0,0,0,0,0,0,0,0,0,0,0,0
Pondicherry,2001,Total,107,1,108,149,5,154,0,0,0,0,0,0,256,6,262
Pondicherry,2002,Central Jail,109,1,110,80,12,92,0,0,0,0,0,0,189,13,202
Pondicherry,2002,District Jail,20,0,20,18,0,18,0,0,0,0,0,0,38,0,38
Pondicherry,2002,Sub_Jail,4,0,4,2,0,2,0,0,0,0,0,0,6,0,6
Pondicherry,2002,Women Jail,0,0,0,0,0,0,0,0,0,0,0,0,0,0,0
Pondicherry,2002,Borstal School,0,0,0,0,0,0,0,0,0,0,0,0,0,0,0
Pondicherry,2002,Open Jail,0,0,0,0,0,0,0,0,0,0,0,0,0,0,0
Pondicherry,2002,Special Jail,0,0,0,0,0,0,0,0,0,0,0,0,0,0,0
Pondicherry,2002,Others,0,0,0,0,0,0,0,0,0,0,0,0,0,0,0
Pondicherry,2002,Total,133,1,134,100,12,112,0,0,0,0,0,0,233,13,246
Pondicherry,2003,Central Jail,119,2,121,121,4,125,0,0,0,0,0,0,240,6,246
Pondicherry,2003,District Jail,0,0,0,0,0,0,0,0,0,0,0,0,0,0,0
Pondicherry,2003,Sub_Jail,1,0,1,5,0,5,0,0,0,0,0,0,6,0,6
Pondicherry,2003,Women Jail,0,0,0,0,0,0,0,0,0,0,0,0,0,0,0
Pondicherry,2003,Borstal School,0,0,0,0,0,0,0,0,0,0,0,0,0,0,0
Pondicherry,2003,Open Jail,0,0,0,0,0,0,0,0,0,0,0,0,0,0,0
Pondicherry,2003,Special Jail,17,0,17,9,0,9,0,0,0,0,0,0,26,0,26
Pondicherry,2003,Others,0,0,0,0,0,0,0,0,0,0,0,0,0,0,0
Pondicherry,2003,Total,137,2,139,135,4,139,0,0,0,0,0,0,272,6,278
Pondicherry,2004,Central Jail,94,2,96,150,0,150,0,0,0,0,0,0,244,2,246
Pondicherry,2004,District Jail,11,0,11,38,1,39,0,0,0,0,0,0,49,1,50
Pondicherry,2004,Sub_Jail,2,0,2,3,0,3,0,0,0,0,0,0,5,0,5
Pondicherry,2004,Women Jail,0,0,0,0,0,0,0,0,0,0,0,0,0,0,0
Pondicherry,2004,Borstal School,0,0,0,0,0,0,0,0,0,0,0,0,0,0,0
Pondicherry,2004,Open Jail,0,0,0,0,0,0,0,0,0,0,0,0,0,0,0
Pondicherry,2004,Special Jail,0,0,0,0,0,0,0,0,0,0,0,0,0,0,0
Pondicherry,2004,Others,0,0,0,0,0,0,0,0,0,0,0,0,0,0,0
Pondicherry,2004,Total,107,2,109,191,1,192,0,0,0,0,0,0,298,3,301
Pondicherry,2005,Central Jail,109,5,114,137,1,138,0,0,0,0,0,0,246,6,252
Pondicherry,2005,District Jail,5,0,5,26,0,26,0,0,0,0,0,0,31,0,31
Pondicherry,2005,Sub_Jail,0,0,0,5,0,5,0,0,0,0,0,0,5,0,5
Pondicherry,2005,Women Jail,0,0,0,0,0,0,0,0,0,0,0,0,0,0,0
Pondicherry,2005,Borstal School,0,0,0,0,0,0,0,0,0,0,0,0,0,0,0
Pondicherry,2005,Open Jail,0,0,0,0,0,0,0,0,0,0,0,0,0,0,0
Pondicherry,2005,Special Jail,0,0,0,0,0,0,0,0,0,0,0,0,0,0,0
Pondicherry,2005,Others,0,0,0,0,0,0,0,0,0,0,0,0,0,0,0
Pondicherry,2005,Total,114,5,119,168,1,169,0,0,0,0,0,0,282,6,288
Pondicherry,2006,Central Jail,84,3,87,139,1,140,0,0,0,0,0,0,223,4,227
Pondicherry,2006,District Jail,20,0,20,58,0,58,0,0,0,0,0,0,78,0,78
Pondicherry,2006,Sub_Jail,2,0,2,5,0,5,0,0,0,0,0,0,7,0,7
Pondicherry,2006,Women Jail,0,0,0,0,0,0,0,0,0,0,0,0,0,0,0
Pondicherry,2006,Borstal School,0,0,0,0,0,0,0,0,0,0,0,0,0,0,0
Pondicherry,2006,Open Jail,0,0,0,0,0,0,0,0,0,0,0,0,0,0,0
Pondicherry,2006,Special Jail,0,0,0,0,0,0,0,0,0,0,0,0,0,0,0
Pondicherry,2006,Others,0,0,0,0,0,0,0,0,0,0,0,0,0,0,0
Pondicherry,2006,Total,106,3,109,202,1,203,0,0,0,0,0,0,308,4,312
Pondicherry,2007,Central Jail,83,2,85,194,2,196,0,0,0,0,0,0,277,4,281
Pondicherry,2007,District Jail,24,0,24,26,0,26,0,0,0,0,0,0,50,0,50
Pondicherry,2007,Sub_Jail,3,0,3,12,0,12,0,0,0,0,0,0,15,0,15
Pondicherry,2007,Women Jail,0,0,0,0,0,0,0,0,0,0,0,0,0,0,0
Pondicherry,2007,Borstal School,0,0,0,0,0,0,0,0,0,0,0,0,0,0,0
Pondicherry,2007,Open Jail,0,0,0,0,0,0,0,0,0,0,0,0,0,0,0
Pondicherry,2007,Special Jail,0,0,0,0,0,0,0,0,0,0,0,0,0,0,0
Pondicherry,2007,Others,0,0,0,0,0,0,0,0,0,0,0,0,0,0,0
Pondicherry,2007,Total,110,2,112,232,2,234,0,0,0,0,0,0,342,4,346
Pondicherry,2008,Central Jail,80,1,81,156,5,161,0,0,0,0,0,0,236,6,242
Pondicherry,2008,District Jail,16,0,16,33,0,33,0,0,0,0,0,0,49,0,49
Pondicherry,2008,Sub_Jail,0,0,0,9,0,9,0,0,0,0,0,0,9,0,9
Pondicherry,2008,Women Jail,0,0,0,0,0,0,0,0,0,0,0,0,0,0,0
Pondicherry,2008,Borstal School,0,0,0,0,0,0,0,0,0,0,0,0,0,0,0
Pondicherry,2008,Open Jail,0,0,0,0,0,0,0,0,0,0,0,0,0,0,0
Pondicherry,2008,Special Jail,0,0,0,0,0,0,0,0,0,0,0,0,0,0,0
Pondicherry,2008,Others,0,0,0,0,0,0,0,0,0,0,0,0,0,0,0
Pondicherry,2008,Total,96,1,97,198,5,203,0,0,0,0,0,0,294,6,300
Pondicherry,2009,Central Jail,100,2,102,116,1,117,0,0,0,0,0,0,216,3,219
Pondicherry,2009,District Jail,16,0,16,33,0,33,0,0,0,0,0,0,49,0,49
Pondicherry,2009,Sub_Jail,1,0,1,0,0,0,0,0,0,0,0,0,1,0,1
Pondicherry,2009,Women Jail,0,0,0,0,0,0,0,0,0,0,0,0,0,0,0
Pondicherry,2009,Borstal School,0,0,0,0,0,0,0,0,0,0,0,0,0,0,0
Pondicherry,2009,Open Jail,0,0,0,0,0,0,0,0,0,0,0,0,0,0,0
Pondicherry,2009,Special Jail,0,0,0,0,0,0,0,0,0,0,0,0,0,0,0
Pondicherry,2009,Others,0,0,0,0,0,0,0,0,0,0,0,0,0,0,0
Pondicherry,2009,Total,117,2,119,149,1,150,0,0,0,0,0,0,266,3,269
Pondicherry,2010,Central Jail,99,2,101,96,4,100,3,0,3,0,0,0,198,6,204
Pondicherry,2010,District Jail,29,0,29,26,0,26,0,0,0,0,0,0,55,0,55
Pondicherry,2010,Sub_Jail,0,0,0,2,0,2,0,0,0,0,0,0,2,0,2
Pondicherry,2010,Women Jail,0,0,0,0,0,0,0,0,0,0,0,0,0,0,0
Pondicherry,2010,Borstal School,0,0,0,0,0,0,0,0,0,0,0,0,0,0,0
Pondicherry,2010,Open Jail,0,0,0,0,0,0,0,0,0,0,0,0,0,0,0
Pondicherry,2010,Special Jail,0,0,0,0,0,0,0,0,0,0,0,0,0,0,0
Pondicherry,2010,Others,0,0,0,0,0,0,0,0,0,0,0,0,0,0,0
Pondicherry,2010,Total,128,2,130,124,4,128,3,0,3,0,0,0,255,6,261
Pondicherry,2011,Central Jail,97,3,100,97,2,99,0,0,0,0,0,0,194,5,199
Pondicherry,2011,District Jail,0,0,0,0,0,0,0,0,0,0,0,0,0,0,0
Pondicherry,2011,Sub_Jail,0,0,0,0,0,0,0,0,0,0,0,0,0,0,0
Pondicherry,2011,Women Jail,0,0,0,0,0,0,0,0,0,0,0,0,0,0,0
Pondicherry,2011,Borstal School,0,0,0,0,0,0,0,0,0,0,0,0,0,0,0
Pondicherry,2011,Open Jail,0,0,0,0,0,0,0,0,0,0,0,0,0,0,0
Pondicherry,2011,Special Jail,30,0,30,13,0,13,0,0,0,0,0,0,43,0,43
Pondicherry,2011,Others,0,0,0,0,0,0,0,0,0,0,0,0,0,0,0
Pondicherry,2011,Total,127,3,130,110,2,112,0,0,0,0,0,0,237,5,242
Pondicherry,2012,Central Jail,83,2,85,117,1,118,0,0,0,0,0,0,200,3,203
Pondicherry,2012,District Jail,0,0,0,0,0,0,0,0,0,0,0,0,0,0,0
Pondicherry,2012,Sub_Jail,0,0,0,2,0,2,0,0,0,0,0,0,2,0,2
Pondicherry,2012,Women Jail,0,0,0,0,0,0,0,0,0,0,0,0,0,0,0
Pondicherry,2012,Borstal School,0,0,0,0,0,0,0,0,0,0,0,0,0,0,0
Pondicherry,2012,Open Jail,0,0,0,0,0,0,0,0,0,0,0,0,0,0,0
Pondicherry,2012,Special Jail,24,0,24,56,0,56,0,0,0,0,0,0,80,0,80
Pondicherry,2012,Others,0,0,0,0,0,0,0,0,0,0,0,0,0,0,0
Pondicherry,2012,Total,107,2,109,175,1,176,0,0,0,0,0,0,282,3,285
Andhra Pradesh,2013,Central Jail,3527,117,3644,3448,77,3525,6,0,6,7,0,7,6988,194,7182
Andhra Pradesh,2013,District Jail,419,1,420,2710,203,2913,0,0,0,0,0,0,3129,204,3333
Andhra Pradesh,2013,Sub_Jail,79,0,79,2934,183,3117,0,0,0,0,0,0,3013,183,3196
Andhra Pradesh,2013,Women Jail,0,171,171,0,146,146,0,1,1,0,0,0,0,318,318
Andhra Pradesh,2013,Borstal School,3,0,3,0,0,0,0,0,0,0,0,0,3,0,3
Andhra Pradesh,2013,Open Jail,281,0,281,0,0,0,0,0,0,0,0,0,281,0,281
Andhra Pradesh,2013,Special Jail,0,0,0,0,0,0,0,0,0,0,0,0,0,0,0
Andhra Pradesh,2013,Others,0,0,0,0,0,0,0,0,0,0,0,0,0,0,0
Andhra Pradesh,2013,Total,4309,289,4598,9092,609,9701,6,1,7,7,0,7,13414,899,14313
Arunachal Pradesh,2013,Central Jail,0,0,0,0,0,0,0,0,0,0,0,0,0,0,0
Arunachal Pradesh,2013,District Jail,10,1,11,80,1,81,0,0,0,0,0,0,90,2,92
Arunachal Pradesh,2013,Sub_Jail,0,0,0,0,0,0,0,0,0,0,0,0,0,0,0
Arunachal Pradesh,2013,Women Jail,0,0,0,0,0,0,0,0,0,0,0,0,0,0,0
Arunachal Pradesh,2013,Borstal School,0,0,0,0,0,0,0,0,0,0,0,0,0,0,0
Arunachal Pradesh,2013,Open Jail,0,0,0,0,0,0,0,0,0,0,0,0,0,0,0
Arunachal Pradesh,2013,Special Jail,0,0,0,0,0,0,0,0,0,0,0,0,0,0,0
Arunachal Pradesh,2013,Others,0,0,0,0,0,0,0,0,0,0,0,0,0,0,0
Arunachal Pradesh,2013,Total,10,1,11,80,1,81,0,0,0,0,0,0,90,2,92
Assam,2013,Central Jail,1228,40,1268,1817,75,1892,1,0,1,1,0,1,3047,115,3162
Assam,2013,District Jail,1661,59,1720,2836,118,2954,4,0,4,1,0,1,4502,177,4679
Assam,2013,Sub_Jail,3,0,3,69,0,69,0,0,0,0,0,0,72,0,72
Assam,2013,Women Jail,0,0,0,0,0,0,0,0,0,0,0,0,0,0,0
Assam,2013,Borstal School,0,0,0,0,0,0,0,0,0,0,0,0,0,0,0
Assam,2013,Open Jail,27,0,27,0,0,0,0,0,0,0,0,0,27,0,27
Assam,2013,Special Jail,73,2,75,236,12,248,0,0,0,0,0,0,309,14,323
Assam,2013,Others,0,0,0,0,0,0,0,0,0,0,0,0,0,0,0
Assam,2013,Total,2992,101,3093,4958,205,5163,5,0,5,2,0,2,7957,306,8263
Bihar,2013,Central Jail,2242,47,2289,7425,303,7728,5,0,5,1,0,1,9673,350,10023
Bihar,2013,District Jail,1342,32,1374,14626,519,15145,21,0,21,127,4,131,16116,555,16671
Bihar,2013,Sub_Jail,148,4,152,3153,115,3268,0,0,0,12,0,12,3313,119,3432
Bihar,2013,Women Jail,0,40,40,0,36,36,0,0,0,0,0,0,0,76,76
Bihar,2013,Borstal School,0,0,0,0,0,0,0,0,0,0,0,0,0,0,0
Bihar,2013,Open Jail,92,0,92,0,0,0,0,0,0,0,0,0,92,0,92
Bihar,2013,Special Jail,533,0,533,432,0,432,0,0,0,0,0,0,965,0,965
Bihar,2013,Others,0,0,0,0,0,0,0,0,0,0,0,0,0,0,0
Bihar,2013,Total,4357,123,4480,25636,973,26609,26,0,26,140,4,144,30159,1100,31259
Chhatisgarh,2013,Central Jail,6069,303,6372,3895,405,4300,1,0,1,4,0,4,9969,708,10677
Chhatisgarh,2013,District Jail,169,2,171,3072,111,3183,0,0,0,4,0,4,3245,113,3358
Chhatisgarh,2013,Sub_Jail,43,0,43,1758,0,1758,0,0,0,4,0,4,1805,0,1805
Chhatisgarh,2013,Women Jail,0,0,0,0,0,0,0,0,0,0,0,0,0,0,0
Chhatisgarh,2013,Borstal School,0,0,0,0,0,0,0,0,0,0,0,0,0,0,0
Chhatisgarh,2013,Open Jail,0,0,0,0,0,0,0,0,0,0,0,0,0,0,0
Chhatisgarh,2013,Special Jail,0,0,0,0,0,0,0,0,0,0,0,0,0,0,0
Chhatisgarh,2013,Others,0,0,0,0,0,0,0,0,0,0,0,0,0,0,0
Chhatisgarh,2013,Total,6281,305,6586,8725,516,9241,1,0,1,12,0,12,15019,821,15840
Goa,2013,Central Jail,100,0,100,3,0,3,0,0,0,0,0,0,103,0,103
Goa,2013,District Jail,0,0,0,0,0,0,0,0,0,0,0,0,0,0,0
Goa,2013,Sub_Jail,20,7,27,270,21,291,0,0,0,0,0,0,290,28,318
Goa,2013,Women Jail,0,0,0,0,0,0,0,0,0,0,0,0,0,0,0
Goa,2013,Borstal School,0,0,0,0,0,0,0,0,0,0,0,0,0,0,0
Goa,2013,Open Jail,0,0,0,0,0,0,0,0,0,0,0,0,0,0,0
Goa,2013,Special Jail,0,0,0,0,0,0,0,0,0,0,0,0,0,0,0
Goa,2013,Others,0,0,0,102,0,102,0,0,0,0,0,0,102,0,102
Goa,2013,Total,120,7,127,375,21,396,0,0,0,0,0,0,495,28,523
Gujarat,2013,Central Jail,3127,113,3240,3601,130,3731,357,12,369,0,0,0,7085,255,7340
Gujarat,2013,District Jail,244,2,246,1834,74,1908,152,4,156,0,0,0,2230,80,2310
Gujarat,2013,Sub_Jail,152,1,153,1436,86,1522,21,0,21,0,0,0,1609,87,1696
Gujarat,2013,Women Jail,0,50,50,0,65,65,0,16,16,0,0,0,0,131,131
Gujarat,2013,Borstal School,0,0,0,0,0,0,0,0,0,0,0,0,0,0,0
Gujarat,2013,Open Jail,56,0,56,0,0,0,0,0,0,0,0,0,56,0,56
Gujarat,2013,Special Jail,63,0,63,354,24,378,84,0,84,0,0,0,501,24,525
Gujarat,2013,Others,0,0,0,0,0,0,0,0,0,0,0,0,0,0,0
Gujarat,2013,Total,3642,166,3808,7225,379,7604,614,32,646,0,0,0,11481,577,12058
Haryana,2013,Central Jail,1230,28,1258,1668,40,1708,0,0,0,0,0,0,2898,68,2966
Haryana,2013,District Jail,5358,292,5650,8369,385,8754,0,0,0,1,0,1,13728,677,14405
Haryana,2013,Sub_Jail,0,0,0,0,0,0,0,0,0,0,0,0,0,0,0
Haryana,2013,Women Jail,0,0,0,0,0,0,0,0,0,0,0,0,0,0,0
Haryana,2013,Borstal School,77,35,112,111,50,161,0,0,0,0,0,0,188,85,273
Haryana,2013,Open Jail,0,0,0,0,0,0,0,0,0,0,0,0,0,0,0
Haryana,2013,Special Jail,0,0,0,0,0,0,0,0,0,0,0,0,0,0,0
Haryana,2013,Others,0,0,0,0,0,0,0,0,0,0,0,0,0,0,0
Haryana,2013,Total,6665,355,7020,10148,475,10623,0,0,0,1,0,1,16814,830,17644
Himachal Pradesh,2013,Central Jail,634,21,655,249,15,264,0,0,0,0,0,0,883,36,919
Himachal Pradesh,2013,District Jail,190,5,195,192,18,210,0,0,0,0,0,0,382,23,405
Himachal Pradesh,2013,Sub_Jail,80,12,92,499,25,524,0,0,0,0,0,0,579,37,616
Himachal Pradesh,2013,Women Jail,0,0,0,0,0,0,0,0,0,0,0,0,0,0,0
Himachal Pradesh,2013,Borstal School,7,0,7,0,0,0,0,0,0,0,0,0,7,0,7
Himachal Pradesh,2013,Open Jail,52,0,52,0,0,0,0,0,0,0,0,0,52,0,52
Himachal Pradesh,2013,Special Jail,0,0,0,0,0,0,0,0,0,0,0,0,0,0,0
Himachal Pradesh,2013,Others,0,0,0,0,0,0,0,0,0,0,0,0,0,0,0
Himachal Pradesh,2013,Total,963,38,1001,940,58,998,0,0,0,0,0,0,1903,96,1999
Jammu & Kashmir,2013,Central Jail,243,4,247,533,22,555,32,1,33,0,0,0,808,27,835
Jammu & Kashmir,2013,District Jail,126,6,132,1186,54,1240,34,0,34,0,0,0,1346,60,1406
Jammu & Kashmir,2013,Sub_Jail,1,0,1,105,0,105,5,0,5,0,0,0,111,0,111
Jammu & Kashmir,2013,Women Jail,0,0,0,0,0,0,0,0,0,0,0,0,0,0,0
Jammu & Kashmir,2013,Borstal School,0,0,0,0,0,0,0,0,0,0,0,0,0,0,0
Jammu & Kashmir,2013,Open Jail,0,0,0,0,0,0,0,0,0,0,0,0,0,0,0
Jammu & Kashmir,2013,Special Jail,0,0,0,0,0,0,0,0,0,0,0,0,0,0,0
Jammu & Kashmir,2013,Others,0,0,0,0,0,0,0,0,0,0,0,0,0,0,0
Jammu & Kashmir,2013,Total,370,10,380,1824,76,1900,71,1,72,0,0,0,2265,87,2352
Jharkhand,2013,Central Jail,3782,152,3934,4336,217,4553,9,0,9,0,0,0,8127,369,8496
Jharkhand,2013,District Jail,185,5,190,7743,409,8152,1,0,1,0,0,0,7929,414,8343
Jharkhand,2013,Sub_Jail,31,1,32,1199,66,1265,0,0,0,0,0,0,1230,67,1297
Jharkhand,2013,Women Jail,0,0,0,0,0,0,0,0,0,0,0,0,0,0,0
Jharkhand,2013,Borstal School,0,0,0,61,0,61,0,0,0,0,0,0,61,0,61
Jharkhand,2013,Open Jail,6,0,6,17,0,17,0,0,0,0,0,0,23,0,23
Jharkhand,2013,Special Jail,0,0,0,0,0,0,0,0,0,0,0,0,0,0,0
Jharkhand,2013,Others,0,0,0,0,0,0,0,0,0,0,0,0,0,0,0
Jharkhand,2013,Total,4004,158,4162,13356,692,14048,10,0,10,0,0,0,17370,850,18220
Karnataka,2013,Central Jail,4052,196,4248,4847,235,5082,133,8,141,4,0,4,9036,439,9475
Karnataka,2013,District Jail,114,2,116,2090,69,2159,30,1,31,0,0,0,2234,72,2306
Karnataka,2013,Sub_Jail,39,0,39,2002,70,2072,12,3,15,2,0,2,2055,73,2128
Karnataka,2013,Women Jail,0,0,0,0,0,0,0,0,0,0,0,0,0,0,0
Karnataka,2013,Borstal School,0,0,0,0,0,0,0,0,0,0,0,0,0,0,0
Karnataka,2013,Open Jail,12,0,12,0,0,0,0,0,0,0,0,0,12,0,12
Karnataka,2013,Special Jail,3,0,3,193,0,193,0,0,0,1,0,1,197,0,197
Karnataka,2013,Others,0,0,0,0,0,0,0,0,0,0,0,0,0,0,0
Karnataka,2013,Total,4220,198,4418,9132,374,9506,175,12,187,7,0,7,13534,584,14118
Kerala,2013,Central Jail,1825,0,1825,1016,0,1016,0,0,0,0,0,0,2841,0,2841
Kerala,2013,District Jail,235,0,235,1505,22,1527,0,0,0,0,0,0,1740,22,1762
Kerala,2013,Sub_Jail,71,0,71,761,0,761,0,0,0,0,0,0,832,0,832
Kerala,2013,Women Jail,0,47,47,0,88,88,0,0,0,0,2,2,0,137,137
Kerala,2013,Borstal School,4,0,4,15,9,24,0,0,0,0,0,0,19,9,28
Kerala,2013,Open Jail,390,0,390,0,0,0,0,0,0,0,0,0,390,0,390
Kerala,2013,Special Jail,51,1,52,1184,21,1205,0,0,0,0,0,0,1235,22,1257
Kerala,2013,Others,148,0,148,0,0,0,0,0,0,0,0,0,148,0,148
Kerala,2013,Total,2724,48,2772,4481,140,4621,0,0,0,0,2,2,7205,190,7395
Madhya Pradesh,2013,Central Jail,12431,356,12787,5385,268,5653,117,0,117,34,0,34,17967,624,18591
Madhya Pradesh,2013,District Jail,2593,151,2744,5501,264,5765,3,0,3,83,3,86,8180,418,8598
Madhya Pradesh,2013,Sub_Jail,1304,9,1313,6115,35,6150,4,0,4,27,0,27,7450,44,7494
Madhya Pradesh,2013,Women Jail,0,0,0,0,0,0,0,0,0,0,0,0,0,0,0
Madhya Pradesh,2013,Borstal School,0,0,0,0,0,0,0,0,0,0,0,0,0,0,0
Madhya Pradesh,2013,Open Jail,25,0,25,0,0,0,0,0,0,0,0,0,25,0,25
Madhya Pradesh,2013,Special Jail,0,0,0,0,0,0,0,0,0,0,0,0,0,0,0
Madhya Pradesh,2013,Others,0,0,0,0,0,0,0,0,0,0,0,0,0,0,0
Madhya Pradesh,2013,Total,16353,516,16869,17001,567,17568,124,0,124,144,3,147,33622,1086,34708
Maharashtra,2013,Central Jail,6280,397,6677,11570,256,11826,24,0,24,0,0,0,17874,653,18527
Maharashtra,2013,District Jail,338,4,342,6506,501,7007,3,0,3,0,0,0,6847,505,7352
Maharashtra,2013,Sub_Jail,1,0,1,69,3,72,0,0,0,0,0,0,70,3,73
Maharashtra,2013,Women Jail,0,4,4,0,361,361,0,1,1,0,0,0,0,366,366
Maharashtra,2013,Borstal School,29,0,29,0,0,0,0,0,0,0,0,0,29,0,29
Maharashtra,2013,Open Jail,943,32,975,0,0,0,0,0,0,0,0,0,943,32,975
Maharashtra,2013,Special Jail,3,0,3,65,0,65,0,0,0,0,0,0,68,0,68
Maharashtra,2013,Others,10,0,10,0,0,0,0,0,0,0,0,0,10,0,10
Maharashtra,2013,Total,7604,437,8041,18210,1121,19331,27,1,28,0,0,0,25841,1559,27400
Manipur,2013,Central Jail,77,2,79,508,30,538,40,3,43,0,0,0,625,35,660
Manipur,2013,District Jail,0,0,0,0,0,0,0,0,0,0,0,0,0,0,0
Manipur,2013,Sub_Jail,0,0,0,0,0,0,0,0,0,0,0,0,0,0,0
Manipur,2013,Women Jail,0,0,0,0,0,0,0,0,0,0,0,0,0,0,0
Manipur,2013,Borstal School,0,0,0,0,0,0,0,0,0,0,0,0,0,0,0
Manipur,2013,Open Jail,0,0,0,0,0,0,0,0,0,0,0,0,0,0,0
Manipur,2013,Special Jail,0,0,0,0,0,0,0,0,0,0,0,0,0,0,0
Manipur,2013,Others,0,0,0,0,0,0,0,0,0,0,0,0,0,0,0
Manipur,2013,Total,77,2,79,508,30,538,40,3,43,0,0,0,625,35,660
Meghalaya,2013,Central Jail,0,0,0,0,0,0,0,0,0,0,0,0,0,0,0
Meghalaya,2013,District Jail,72,0,72,734,11,745,33,0,33,0,0,0,839,11,850
Meghalaya,2013,Sub_Jail,0,0,0,0,0,0,0,0,0,0,0,0,0,0,0
Meghalaya,2013,Women Jail,0,0,0,0,0,0,0,0,0,0,0,0,0,0,0
Meghalaya,2013,Borstal School,0,0,0,0,0,0,0,0,0,0,0,0,0,0,0
Meghalaya,2013,Open Jail,0,0,0,0,0,0,0,0,0,0,0,0,0,0,0
Meghalaya,2013,Special Jail,0,0,0,0,0,0,0,0,0,0,0,0,0,0,0
Meghalaya,2013,Others,0,0,0,0,0,0,0,0,0,0,0,0,0,0,0
Meghalaya,2013,Total,72,0,72,734,11,745,33,0,33,0,0,0,839,11,850
Mizoram,2013,Central Jail,221,3,224,153,20,173,0,0,0,0,0,0,374,23,397
Mizoram,2013,District Jail,181,5,186,249,38,287,0,0,0,0,0,0,430,43,473
Mizoram,2013,Sub_Jail,0,0,0,0,0,0,0,0,0,0,0,0,0,0,0
Mizoram,2013,Women Jail,0,0,0,0,0,0,0,0,0,0,0,0,0,0,0
Mizoram,2013,Borstal School,0,0,0,0,0,0,0,0,0,0,0,0,0,0,0
Mizoram,2013,Open Jail,0,0,0,0,0,0,0,0,0,0,0,0,0,0,0
Mizoram,2013,Special Jail,0,0,0,0,0,0,0,0,0,0,0,0,0,0,0
Mizoram,2013,Others,0,0,0,0,0,0,0,0,0,0,0,0,0,0,0
Mizoram,2013,Total,402,8,410,402,58,460,0,0,0,0,0,0,804,66,870
Nagaland,2013,Central Jail,57,0,57,104,0,104,46,0,46,1,0,1,208,0,208
Nagaland,2013,District Jail,7,0,7,97,2,99,1,0,1,0,0,0,105,2,107
Nagaland,2013,Sub_Jail,27,4,31,132,6,138,3,0,3,0,0,0,162,10,172
Nagaland,2013,Women Jail,0,0,0,0,0,0,0,0,0,0,0,0,0,0,0
Nagaland,2013,Borstal School,0,0,0,0,0,0,0,0,0,0,0,0,0,0,0
Nagaland,2013,Open Jail,0,0,0,0,0,0,0,0,0,0,0,0,0,0,0
Nagaland,2013,Special Jail,0,0,0,0,0,0,0,0,0,0,0,0,0,0,0
Nagaland,2013,Others,0,0,0,0,0,0,0,0,0,0,0,0,0,0,0
Nagaland,2013,Total,91,4,95,333,8,341,50,0,50,1,0,1,475,12,487
Orissa,2013,Central Jail,1085,44,1129,1970,78,2048,0,0,0,0,0,0,3055,122,3177
Orissa,2013,District Jail,957,28,985,2026,98,2124,0,0,0,0,0,0,2983,126,3109
Orissa,2013,Sub_Jail,1040,30,1070,5519,285,5804,0,0,0,0,0,0,6559,315,6874
Orissa,2013,Women Jail,0,11,11,0,16,16,0,0,0,0,0,0,0,27,27
Orissa,2013,Borstal School,0,0,0,0,0,0,0,0,0,0,0,0,0,0,0
Orissa,2013,Open Jail,95,0,95,0,0,0,0,0,0,0,0,0,95,0,95
Orissa,2013,Special Jail,209,9,218,931,42,973,0,0,0,0,0,0,1140,51,1191
Orissa,2013,Others,0,0,0,0,0,0,0,0,0,0,0,0,0,0,0
Orissa,2013,Total,3386,122,3508,10446,519,10965,0,0,0,0,0,0,13832,641,14473
Punjab,2013,Central Jail,6053,276,6329,13388,573,13961,1,0,1,1,0,1,19443,849,20292
Punjab,2013,District Jail,1861,133,1994,2764,227,2991,3,0,3,2,0,2,4630,360,4990
Punjab,2013,Sub_Jail,358,0,358,1178,0,1178,0,0,0,0,0,0,1536,0,1536
Punjab,2013,Women Jail,0,79,79,0,176,176,0,0,0,0,0,0,0,255,255
Punjab,2013,Borstal School,114,0,114,200,0,200,0,0,0,0,0,0,314,0,314
Punjab,2013,Open Jail,62,0,62,0,0,0,0,0,0,0,0,0,62,0,62
Punjab,2013,Special Jail,0,0,0,0,0,0,0,0,0,0,0,0,0,0,0
Punjab,2013,Others,0,0,0,0,0,0,0,0,0,0,0,0,0,0,0
Punjab,2013,Total,8448,488,8936,17530,976,18506,4,0,4,3,0,3,25985,1464,27449
Rajasthan,2013,Central Jail,4387,0,4387,4839,137,4976,0,0,0,2,0,2,9228,137,9365
Rajasthan,2013,District Jail,801,0,801,4817,150,4967,0,0,0,0,0,0,5618,150,5768
Rajasthan,2013,Sub_Jail,1,0,1,3147,21,3168,0,0,0,1,0,1,3149,21,3170
Rajasthan,2013,Women Jail,0,189,189,0,135,135,0,0,0,0,0,0,0,324,324
Rajasthan,2013,Borstal School,8,0,8,0,0,0,0,0,0,0,0,0,8,0,8
Rajasthan,2013,Open Jail,628,30,658,0,0,0,0,0,0,0,0,0,628,30,658
Rajasthan,2013,Special Jail,0,0,0,0,0,0,0,0,0,0,0,0,0,0,0
Rajasthan,2013,Others,0,0,0,0,0,0,0,0,0,0,0,0,0,0,0
Rajasthan,2013,Total,5825,219,6044,12803,443,13246,0,0,0,3,0,3,18631,662,19293
Sikkim,2013,Central Jail,102,2,104,74,3,77,0,0,0,0,0,0,176,5,181
Sikkim,2013,District Jail,0,0,0,46,3,49,0,0,0,0,0,0,46,3,49
Sikkim,2013,Sub_Jail,0,0,0,0,0,0,0,0,0,0,0,0,0,0,0
Sikkim,2013,Women Jail,0,0,0,0,0,0,0,0,0,0,0,0,0,0,0
Sikkim,2013,Borstal School,0,0,0,0,0,0,0,0,0,0,0,0,0,0,0
Sikkim,2013,Open Jail,0,0,0,0,0,0,0,0,0,0,0,0,0,0,0
Sikkim,2013,Special Jail,0,0,0,0,0,0,0,0,0,0,0,0,0,0,0
Sikkim,2013,Others,0,0,0,0,0,0,0,0,0,0,0,0,0,0,0
Sikkim,2013,Total,102,2,104,120,6,126,0,0,0,0,0,0,222,8,230
Tamilnadu,2013,Central Jail,4438,0,4438,4994,37,5031,1727,0,1727,0,0,0,11159,37,11196
Tamilnadu,2013,District Jail,0,0,0,699,0,699,0,0,0,0,0,0,699,0,699
Tamilnadu,2013,Sub_Jail,0,0,0,1618,114,1732,0,0,0,0,0,0,1618,114,1732
Tamilnadu,2013,Women Jail,0,162,162,0,278,278,0,48,48,0,0,0,0,488,488
Tamilnadu,2013,Borstal School,11,0,11,484,0,484,6,0,6,0,0,0,501,0,501
Tamilnadu,2013,Open Jail,37,0,37,0,0,0,0,0,0,0,0,0,37,0,37
Tamilnadu,2013,Special Jail,0,0,0,0,68,68,0,0,0,0,0,0,0,68,68
Tamilnadu,2013,Others,0,0,0,0,0,0,0,0,0,0,0,0,0,0,0
Tamilnadu,2013,Total,4486,162,4648,7795,497,8292,1733,48,1781,0,0,0,14014,707,14721
Tripura,2013,Central Jail,280,14,294,111,5,116,0,0,0,0,0,0,391,19,410
Tripura,2013,District Jail,101,0,101,64,0,64,0,0,0,0,0,0,165,0,165
Tripura,2013,Sub_Jail,107,0,107,213,6,219,0,0,0,0,0,0,320,6,326
Tripura,2013,Women Jail,0,0,0,0,0,0,0,0,0,0,0,0,0,0,0
Tripura,2013,Borstal School,0,0,0,0,0,0,0,0,0,0,0,0,0,0,0
Tripura,2013,Open Jail,0,0,0,0,0,0,0,0,0,0,0,0,0,0,0
Tripura,2013,Special Jail,0,0,0,0,0,0,0,0,0,0,0,0,0,0,0
Tripura,2013,Others,0,0,0,0,0,0,0,0,0,0,0,0,0,0,0
Tripura,2013,Total,488,14,502,388,11,399,0,0,0,0,0,0,876,25,901
Uttar Pradesh,2013,Central Jail,8283,31,8314,4092,78,4170,0,0,0,0,0,0,12375,109,12484
Uttar Pradesh,2013,District Jail,15537,625,16162,50924,2244,53168,90,0,90,18,0,18,66569,2869,69438
Uttar Pradesh,2013,Sub_Jail,109,4,113,730,27,757,0,0,0,0,0,0,839,31,870
Uttar Pradesh,2013,Women Jail,0,303,303,0,0,0,0,0,0,0,0,0,0,303,303
Uttar Pradesh,2013,Borstal School,0,0,0,0,0,0,0,0,0,0,0,0,0,0,0
Uttar Pradesh,2013,Open Jail,0,0,0,0,0,0,0,0,0,0,0,0,0,0,0
Uttar Pradesh,2013,Special Jail,418,0,418,5,0,5,0,0,0,0,0,0,423,0,423
Uttar Pradesh,2013,Others,0,0,0,0,0,0,0,0,0,0,0,0,0,0,0
Uttar Pradesh,2013,Total,24347,963,25310,55751,2349,58100,90,0,90,18,0,18,80206,3312,83518
Uttaranchal,2013,Central Jail,28,0,28,0,0,0,0,0,0,0,0,0,28,0,28
Uttaranchal,2013,District Jail,1601,84,1685,1080,73,1153,0,0,0,0,0,0,2681,157,2838
Uttaranchal,2013,Sub_Jail,56,1,57,747,24,771,0,0,0,0,0,0,803,25,828
Uttaranchal,2013,Women Jail,0,0,0,0,0,0,0,0,0,0,0,0,0,0,0
Uttaranchal,2013,Borstal School,0,0,0,0,0,0,0,0,0,0,0,0,0,0,0
Uttaranchal,2013,Open Jail,151,0,151,0,0,0,0,0,0,0,0,0,151,0,151
Uttaranchal,2013,Special Jail,0,0,0,0,0,0,0,0,0,0,0,0,0,0,0
Uttaranchal,2013,Others,0,0,0,0,0,0,0,0,0,0,0,0,0,0,0
Uttaranchal,2013,Total,1836,85,1921,1827,97,1924,0,0,0,0,0,0,3663,182,3845
West Bengal,2013,Central Jail,4590,174,4764,6650,261,6911,0,0,0,364,46,410,11604,481,12085
West Bengal,2013,District Jail,676,31,707,3714,259,3973,0,0,0,3,1,4,4393,291,4684
West Bengal,2013,Sub_Jail,99,7,106,4293,194,4487,0,0,0,2,1,3,4394,202,4596
West Bengal,2013,Women Jail,0,150,150,0,206,206,0,0,0,0,0,0,0,356,356
West Bengal,2013,Borstal School,0,0,0,0,0,0,0,0,0,0,0,0,0,0,0
West Bengal,2013,Open Jail,91,0,91,0,0,0,0,0,0,0,0,0,91,0,91
West Bengal,2013,Special Jail,67,5,72,836,58,894,0,0,0,0,0,0,903,63,966
West Bengal,2013,Others,0,0,0,0,0,0,0,0,0,0,0,0,0,0,0
West Bengal,2013,Total,5523,367,5890,15493,978,16471,0,0,0,369,48,417,21385,1393,22778
A & N Islands,2013,Central Jail,0,0,0,0,0,0,0,0,0,0,0,0,0,0,0
A & N Islands,2013,District Jail,709,1,710,172,7,179,0,0,0,0,0,0,881,8,889
A & N Islands,2013,Sub_Jail,2,0,2,14,0,14,0,0,0,0,0,0,16,0,16
A & N Islands,2013,Women Jail,0,0,0,0,0,0,0,0,0,0,0,0,0,0,0
A & N Islands,2013,Borstal School,0,0,0,0,0,0,0,0,0,0,0,0,0,0,0
A & N Islands,2013,Open Jail,0,0,0,0,0,0,0,0,0,0,0,0,0,0,0
A & N Islands,2013,Special Jail,244,0,244,0,0,0,0,0,0,0,0,0,244,0,244
A & N Islands,2013,Others,0,0,0,0,0,0,0,0,0,0,0,0,0,0,0
A & N Islands,2013,Total,955,1,956,186,7,193,0,0,0,0,0,0,1141,8,1149
Chandigarh,2013,Central Jail,258,12,270,379,12,391,0,0,0,0,0,0,637,24,661
Chandigarh,2013,District Jail,0,0,0,0,0,0,0,0,0,0,0,0,0,0,0
Chandigarh,2013,Sub_Jail,0,0,0,0,0,0,0,0,0,0,0,0,0,0,0
Chandigarh,2013,Women Jail,0,0,0,0,0,0,0,0,0,0,0,0,0,0,0
Chandigarh,2013,Borstal School,0,0,0,0,0,0,0,0,0,0,0,0,0,0,0
Chandigarh,2013,Open Jail,0,0,0,0,0,0,0,0,0,0,0,0,0,0,0
Chandigarh,2013,Special Jail,0,0,0,0,0,0,0,0,0,0,0,0,0,0,0
Chandigarh,2013,Others,0,0,0,0,0,0,0,0,0,0,0,0,0,0,0
Chandigarh,2013,Total,258,12,270,379,12,391,0,0,0,0,0,0,637,24,661
D & N Haveli,2013,Central Jail,0,0,0,0,0,0,0,0,0,0,0,0,0,0,0
D & N Haveli,2013,District Jail,0,0,0,0,0,0,0,0,0,0,0,0,0,0,0
D & N Haveli,2013,Sub_Jail,0,0,0,35,0,35,0,0,0,0,0,0,35,0,35
D & N Haveli,2013,Women Jail,0,0,0,0,0,0,0,0,0,0,0,0,0,0,0
D & N Haveli,2013,Borstal School,0,0,0,0,0,0,0,0,0,0,0,0,0,0,0
D & N Haveli,2013,Open Jail,0,0,0,0,0,0,0,0,0,0,0,0,0,0,0
D & N Haveli,2013,Special Jail,0,0,0,0,0,0,0,0,0,0,0,0,0,0,0
D & N Haveli,2013,Others,0,0,0,0,0,0,0,0,0,0,0,0,0,0,0
D & N Haveli,2013,Total,0,0,0,35,0,35,0,0,0,0,0,0,35,0,35
Daman & Diu,2013,Central Jail,0,0,0,0,0,0,0,0,0,0,0,0,0,0,0
Daman & Diu,2013,District Jail,0,0,0,0,0,0,0,0,0,0,0,0,0,0,0
Daman & Diu,2013,Sub_Jail,17,1,18,38,0,38,0,0,0,0,0,0,55,1,56
Daman & Diu,2013,Women Jail,0,0,0,0,0,0,0,0,0,0,0,0,0,0,0
Daman & Diu,2013,Borstal School,0,0,0,0,0,0,0,0,0,0,0,0,0,0,0
Daman & Diu,2013,Open Jail,0,0,0,0,0,0,0,0,0,0,0,0,0,0,0
Daman & Diu,2013,Special Jail,0,0,0,0,0,0,0,0,0,0,0,0,0,0,0
Daman & Diu,2013,Others,0,0,0,0,0,0,0,0,0,0,0,0,0,0,0
Daman & Diu,2013,Total,17,1,18,38,0,38,0,0,0,0,0,0,55,1,56
Delhi,2013,Central Jail,2962,0,2962,8065,0,8065,6,0,6,4,0,4,11037,0,11037
Delhi,2013,District Jail,285,0,285,1615,0,1615,0,0,0,0,0,0,1900,0,1900
Delhi,2013,Sub_Jail,0,0,0,0,0,0,0,0,0,0,0,0,0,0,0
Delhi,2013,Women Jail,0,141,141,0,474,474,0,0,0,0,0,0,0,615,615
Delhi,2013,Borstal School,0,0,0,0,0,0,0,0,0,0,0,0,0,0,0
Delhi,2013,Open Jail,0,0,0,0,0,0,0,0,0,0,0,0,0,0,0
Delhi,2013,Special Jail,0,0,0,0,0,0,0,0,0,0,0,0,0,0,0
Delhi,2013,Others,0,0,0,0,0,0,0,0,0,0,0,0,0,0,0
Delhi,2013,Total,3247,141,3388,9680,474,10154,6,0,6,4,0,4,12937,615,13552
Lakshadweep,2013,Central Jail,0,0,0,0,0,0,0,0,0,0,0,0,0,0,0
Lakshadweep,2013,District Jail,0,0,0,0,0,0,0,0,0,0,0,0,0,0,0
Lakshadweep,2013,Sub_Jail,0,0,0,0,0,0,0,0,0,0,0,0,0,0,0
Lakshadweep,2013,Women Jail,0,0,0,0,0,0,0,0,0,0,0,0,0,0,0
Lakshadweep,2013,Borstal School,0,0,0,0,0,0,0,0,0,0,0,0,0,0,0
Lakshadweep,2013,Open Jail,0,0,0,0,0,0,0,0,0,0,0,0,0,0,0
Lakshadweep,2013,Special Jail,0,0,0,0,0,0,0,0,0,0,0,0,0,0,0
Lakshadweep,2013,Others,0,0,0,0,0,0,0,0,0,0,0,0,0,0,0
Lakshadweep,2013,Total,0,0,0,0,0,0,0,0,0,0,0,0,0,0,0
Pondicherry,2013,Central Jail,66,2,68,134,5,139,0,0,0,0,0,0,200,7,207
Pondicherry,2013,District Jail,0,0,0,0,0,0,0,0,0,0,0,0,0,0,0
Pondicherry,2013,Sub_Jail,0,0,0,0,0,0,0,0,0,0,0,0,0,0,0
Pondicherry,2013,Women Jail,0,0,0,0,0,0,0,0,0,0,0,0,0,0,0
Pondicherry,2013,Borstal School,0,0,0,0,0,0,0,0,0,0,0,0,0,0,0
Pondicherry,2013,Open Jail,0,0,0,0,0,0,0,0,0,0,0,0,0,0,0
Pondicherry,2013,Special Jail,23,0,23,50,0,50,0,0,0,0,0,0,73,0,73
Pondicherry,2013,Others,0,0,0,0,0,0,0,0,0,0,0,0,0,0,0
Pondicherry,2013,Total,89,2,91,184,5,189,0,0,0,0,0,0,273,7,280
